State_Name,Year,Starting_Population,Ending_Population,Change,Percentage_Change,Natural_Increase,Net_Migration,STATEFP,COUNTYFP,CLASSFP
Alabama,2000-2001,4452173,4467634,15461,0.347,17195,-1734,1,0,STATE
Alabama,2001-2002,4467634,4480089,12455,0.279,13774,-1319,1,0,STATE
Alabama,2002-2003,4480089,4503491,23402,0.522,12689,10713,1,0,STATE
Alabama,2003-2004,4503491,4530729,27238,0.605,12634,14604,1,0,STATE
Alabama,2004-2005,4530729,4569805,39076,0.862,13528,25548,1,0,STATE
Alabama,2005-2006,4569805,4628981,59176,1.295,14278,44898,1,0,STATE
Alabama,2006-2007,4628981,4672840,43859,0.947,17770,26089,1,0,STATE
Alabama,2007-2008,4672840,4718206,45366,0.971,17049,28317,1,0,STATE
Alabama,2008-2009,4718206,4757938,39732,0.842,15108,24624,1,0,STATE
Alabama,2009-2010,4757938,4785161,27223,0.572,13606,13617,1,0,STATE
Alabama,2010-2011,4785161,4801108,15947,0.333,10878,5069,1,0,STATE
Alabama,2011-2012,4801108,4816089,14981,0.312,10705,4276,1,0,STATE
Alabama,2012-2013,4816089,4830533,14444,0.3,7095,7349,1,0,STATE
Alabama,2013-2014,4830533,4846411,15878,0.329,8106,7772,1,0,STATE
Alabama,2014-2015,4846411,4858979,12568,0.259,7975,4593,1,0,STATE
Alabama,2015-2016,4858979,4860545,1566,0.032,7018,-5452,1,0,STATE
Alabama,2016-2017,4860545,4874747,14202,0.292,5999,8203,1,0,STATE
"Autauga County, AL",2000-2001,44021,44889,868,1.972,281,587,1,1,H1
"Autauga County, AL",2001-2002,44889,45909,1020,2.272,226,794,1,1,H1
"Autauga County, AL",2002-2003,45909,46800,891,1.941,212,679,1,1,H1
"Autauga County, AL",2003-2004,46800,48366,1566,3.346,239,1327,1,1,H1
"Autauga County, AL",2004-2005,48366,49676,1310,2.709,267,1043,1,1,H1
"Autauga County, AL",2005-2006,49676,51328,1652,3.326,205,1447,1,1,H1
"Autauga County, AL",2006-2007,51328,52405,1077,2.098,227,850,1,1,H1
"Autauga County, AL",2007-2008,52405,53277,872,1.664,300,572,1,1,H1
"Autauga County, AL",2008-2009,53277,54135,858,1.61,254,604,1,1,H1
"Autauga County, AL",2009-2010,54135,54684,549,1.014,195,354,1,1,H1
"Autauga County, AL",2010-2011,54684,55275,591,1.081,131,460,1,1,H1
"Autauga County, AL",2011-2012,55275,55192,-83,-0.15,52,-135,1,1,H1
"Autauga County, AL",2012-2013,55192,55136,-56,-0.101,58,-114,1,1,H1
"Autauga County, AL",2013-2014,55136,55395,259,0.47,126,133,1,1,H1
"Autauga County, AL",2014-2015,55290,55347,57,0.103,133,-76,1,1,H1
"Autauga County, AL",2015-2016,55347,55278,-69,-0.125,161,-230,1,1,H1
"Autauga County, AL",2016-2017,55278,55504,226,0.409,154,72,1,1,H1
"Baldwin County, AL",2000-2001,141342,144875,3533,2.5,550,2983,1,3,H1
"Baldwin County, AL",2001-2002,144875,147957,3082,2.127,307,2775,1,3,H1
"Baldwin County, AL",2002-2003,147957,151509,3552,2.401,324,3228,1,3,H1
"Baldwin County, AL",2003-2004,151509,156266,4757,3.14,293,4464,1,3,H1
"Baldwin County, AL",2004-2005,156266,162183,5917,3.786,496,5421,1,3,H1
"Baldwin County, AL",2005-2006,162183,168121,5938,3.661,560,5378,1,3,H1
"Baldwin County, AL",2006-2007,168121,172404,4283,2.548,633,3650,1,3,H1
"Baldwin County, AL",2007-2008,172404,175827,3423,1.985,513,2910,1,3,H1
"Baldwin County, AL",2008-2009,175827,179406,3579,2.036,551,3028,1,3,H1
"Baldwin County, AL",2009-2010,179406,183216,3810,2.124,343,3467,1,3,H1
"Baldwin County, AL",2010-2011,183216,186694,3478,1.898,368,3110,1,3,H1
"Baldwin County, AL",2011-2012,186694,190561,3867,2.071,209,3658,1,3,H1
"Baldwin County, AL",2012-2013,190561,195443,4882,2.562,250,4632,1,3,H1
"Baldwin County, AL",2013-2014,195443,200111,4668,2.388,222,4446,1,3,H1
"Baldwin County, AL",2014-2015,199713,203709,3996,2.001,248,3748,1,3,H1
"Baldwin County, AL",2015-2016,203709,207509,3800,1.865,267,3533,1,3,H1
"Baldwin County, AL",2016-2017,207509,212628,5119,2.467,235,4884,1,3,H1
"Barbour County, AL",2000-2001,29015,28863,-152,-0.524,106,-258,1,5,H1
"Barbour County, AL",2001-2002,28863,28653,-210,-0.728,43,-253,1,5,H1
"Barbour County, AL",2002-2003,28653,28594,-59,-0.206,64,-123,1,5,H1
"Barbour County, AL",2003-2004,28594,28287,-307,-1.074,29,-336,1,5,H1
"Barbour County, AL",2004-2005,28287,28027,-260,-0.919,68,-328,1,5,H1
"Barbour County, AL",2005-2006,28027,27861,-166,-0.592,62,-228,1,5,H1
"Barbour County, AL",2006-2007,27861,27757,-104,-0.373,155,-259,1,5,H1
"Barbour County, AL",2007-2008,27757,27808,51,0.184,82,-31,1,5,H1
"Barbour County, AL",2008-2009,27808,27657,-151,-0.543,32,-183,1,5,H1
"Barbour County, AL",2009-2010,27657,27336,-321,-1.161,29,-350,1,5,H1
"Barbour County, AL",2010-2011,27336,27225,-111,-0.406,14,-125,1,5,H1
"Barbour County, AL",2011-2012,27225,27169,-56,-0.206,9,-65,1,5,H1
"Barbour County, AL",2012-2013,27169,26978,-191,-0.703,-22,-169,1,5,H1
"Barbour County, AL",2013-2014,26978,26887,-91,-0.337,-22,-69,1,5,H1
"Barbour County, AL",2014-2015,26815,26489,-326,-1.216,-40,-286,1,5,H1
"Barbour County, AL",2015-2016,26489,25774,-715,-2.699,3,-718,1,5,H1
"Barbour County, AL",2016-2017,25774,25270,-504,-1.955,-16,-488,1,5,H1
"Bibb County, AL",2000-2001,19913,21028,1115,5.599,79,1036,1,7,H1
"Bibb County, AL",2001-2002,21028,21199,171,0.813,82,89,1,7,H1
"Bibb County, AL",2002-2003,21199,21399,200,0.943,26,174,1,7,H1
"Bibb County, AL",2003-2004,21399,21721,322,1.505,40,282,1,7,H1
"Bibb County, AL",2004-2005,21721,22042,321,1.478,32,289,1,7,H1
"Bibb County, AL",2005-2006,22042,22099,57,0.259,37,20,1,7,H1
"Bibb County, AL",2006-2007,22099,22438,339,1.534,65,274,1,7,H1
"Bibb County, AL",2007-2008,22438,22705,267,1.19,34,233,1,7,H1
"Bibb County, AL",2008-2009,22705,22941,236,1.039,19,217,1,7,H1
"Bibb County, AL",2009-2010,22941,22879,-62,-0.27,11,-73,1,7,H1
"Bibb County, AL",2010-2011,22879,22740,-139,-0.608,-12,-127,1,7,H1
"Bibb County, AL",2011-2012,22740,22634,-106,-0.466,7,-113,1,7,H1
"Bibb County, AL",2012-2013,22634,22504,-130,-0.574,21,-151,1,7,H1
"Bibb County, AL",2013-2014,22504,22506,2,0.009,16,-14,1,7,H1
"Bibb County, AL",2014-2015,22549,22583,34,0.151,30,4,1,7,H1
"Bibb County, AL",2015-2016,22583,22633,50,0.221,83,-33,1,7,H1
"Bibb County, AL",2016-2017,22633,22668,35,0.155,37,-2,1,7,H1
"Blount County, AL",2000-2001,51107,51845,738,1.444,207,531,1,9,H1
"Blount County, AL",2001-2002,51845,52551,706,1.362,166,540,1,9,H1
"Blount County, AL",2002-2003,52551,53457,906,1.724,105,801,1,9,H1
"Blount County, AL",2003-2004,53457,54124,667,1.248,175,492,1,9,H1
"Blount County, AL",2004-2005,54124,54624,500,0.924,143,357,1,9,H1
"Blount County, AL",2005-2006,54624,55485,861,1.576,127,734,1,9,H1
"Blount County, AL",2006-2007,55485,56240,755,1.361,204,551,1,9,H1
"Blount County, AL",2007-2008,56240,57055,815,1.449,168,647,1,9,H1
"Blount County, AL",2008-2009,57055,57341,286,0.501,148,138,1,9,H1
"Blount County, AL",2009-2010,57341,57344,3,0.005,76,-73,1,9,H1
"Blount County, AL",2010-2011,57344,57694,350,0.61,178,172,1,9,H1
"Blount County, AL",2011-2012,57694,57748,54,0.094,118,-64,1,9,H1
"Blount County, AL",2012-2013,57748,57720,-28,-0.048,82,-110,1,9,H1
"Blount County, AL",2013-2014,57720,57719,-1,-0.002,112,-113,1,9,H1
"Blount County, AL",2014-2015,57658,57673,15,0.026,13,2,1,9,H1
"Blount County, AL",2015-2016,57673,57562,-111,-0.192,13,-124,1,9,H1
"Blount County, AL",2016-2017,57562,58013,451,0.784,32,419,1,9,H1
"Bullock County, AL",2000-2001,11581,11358,-223,-1.926,30,-253,1,11,H1
"Bullock County, AL",2001-2002,11358,11256,-102,-0.898,0,-102,1,11,H1
"Bullock County, AL",2002-2003,11256,11316,60,0.533,11,49,1,11,H1
"Bullock County, AL",2003-2004,11316,11056,-260,-2.298,15,-275,1,11,H1
"Bullock County, AL",2004-2005,11056,11011,-45,-0.407,31,-76,1,11,H1
"Bullock County, AL",2005-2006,11011,10776,-235,-2.134,82,-317,1,11,H1
"Bullock County, AL",2006-2007,10776,11011,235,2.181,37,198,1,11,H1
"Bullock County, AL",2007-2008,11011,10953,-58,-0.527,82,-140,1,11,H1
"Bullock County, AL",2008-2009,10953,10987,34,0.31,43,-9,1,11,H1
"Bullock County, AL",2009-2010,10987,10886,-101,-0.919,41,-142,1,11,H1
"Bullock County, AL",2010-2011,10886,10623,-263,-2.416,37,-300,1,11,H1
"Bullock County, AL",2011-2012,10623,10589,-34,-0.32,3,-37,1,11,H1
"Bullock County, AL",2012-2013,10589,10605,16,0.151,37,-21,1,11,H1
"Bullock County, AL",2013-2014,10605,10764,159,1.499,21,138,1,11,H1
"Bullock County, AL",2014-2015,10829,10696,-133,-1.228,14,-147,1,11,H1
"Bullock County, AL",2015-2016,10696,10441,-255,-2.384,29,-284,1,11,H1
"Bullock County, AL",2016-2017,10441,10309,-132,-1.264,20,-152,1,11,H1
"Butler County, AL",2000-2001,21325,21139,-186,-0.872,34,-220,1,13,H1
"Butler County, AL",2001-2002,21139,20803,-336,-1.589,-58,-278,1,13,H1
"Butler County, AL",2002-2003,20803,20833,30,0.144,-21,51,1,13,H1
"Butler County, AL",2003-2004,20833,20870,37,0.178,-20,57,1,13,H1
"Butler County, AL",2004-2005,20870,20830,-40,-0.192,-48,8,1,13,H1
"Butler County, AL",2005-2006,20830,20815,-15,-0.072,-5,-10,1,13,H1
"Butler County, AL",2006-2007,20815,20894,79,0.38,54,25,1,13,H1
"Butler County, AL",2007-2008,20894,20949,55,0.263,12,43,1,13,H1
"Butler County, AL",2008-2009,20949,20867,-82,-0.391,-4,-78,1,13,H1
"Butler County, AL",2009-2010,20867,20945,78,0.374,-3,81,1,13,H1
"Butler County, AL",2010-2011,20945,20676,-269,-1.284,11,-280,1,13,H1
"Butler County, AL",2011-2012,20676,20409,-267,-1.291,-36,-231,1,13,H1
"Butler County, AL",2012-2013,20409,20289,-120,-0.588,-15,-105,1,13,H1
"Butler County, AL",2013-2014,20289,20296,7,0.035,14,-7,1,13,H1
"Butler County, AL",2014-2015,20276,20154,-122,-0.602,21,-143,1,13,H1
"Butler County, AL",2015-2016,20154,19965,-189,-0.938,-30,-159,1,13,H1
"Butler County, AL",2016-2017,19965,19825,-140,-0.701,-25,-115,1,13,H1
"Calhoun County, AL",2000-2001,111081,111266,185,0.167,173,12,1,15,H1
"Calhoun County, AL",2001-2002,111266,111625,359,0.323,171,188,1,15,H1
"Calhoun County, AL",2002-2003,111625,112705,1080,0.968,200,880,1,15,H1
"Calhoun County, AL",2003-2004,112705,113462,757,0.672,208,549,1,15,H1
"Calhoun County, AL",2004-2005,113462,114477,1015,0.895,169,846,1,15,H1
"Calhoun County, AL",2005-2006,114477,115388,911,0.796,109,802,1,15,H1
"Calhoun County, AL",2006-2007,115388,116211,823,0.713,234,589,1,15,H1
"Calhoun County, AL",2007-2008,116211,117274,1063,0.915,242,821,1,15,H1
"Calhoun County, AL",2008-2009,117274,118363,1089,0.929,177,912,1,15,H1
"Calhoun County, AL",2009-2010,118363,118443,80,0.068,119,-39,1,15,H1
"Calhoun County, AL",2010-2011,118443,117760,-683,-0.577,58,-741,1,15,H1
"Calhoun County, AL",2011-2012,117760,117264,-496,-0.421,-6,-490,1,15,H1
"Calhoun County, AL",2012-2013,117264,116547,-717,-0.611,-91,-626,1,15,H1
"Calhoun County, AL",2013-2014,116547,115916,-631,-0.541,-109,-522,1,15,H1
"Calhoun County, AL",2014-2015,115993,115620,-373,-0.322,-60,-313,1,15,H1
"Calhoun County, AL",2015-2016,115620,114980,-640,-0.554,-107,-533,1,15,H1
"Calhoun County, AL",2016-2017,114980,114728,-252,-0.219,-85,-167,1,15,H1
"Chambers County, AL",2000-2001,36571,36274,-297,-0.812,-48,-249,1,17,H1
"Chambers County, AL",2001-2002,36274,35965,-309,-0.852,-38,-271,1,17,H1
"Chambers County, AL",2002-2003,35965,35680,-285,-0.792,-14,-271,1,17,H1
"Chambers County, AL",2003-2004,35680,35463,-217,-0.608,-15,-202,1,17,H1
"Chambers County, AL",2004-2005,35463,35279,-184,-0.519,-65,-119,1,17,H1
"Chambers County, AL",2005-2006,35279,34945,-334,-0.947,-89,-245,1,17,H1
"Chambers County, AL",2006-2007,34945,34847,-98,-0.28,-38,-60,1,17,H1
"Chambers County, AL",2007-2008,34847,34563,-284,-0.815,-24,-260,1,17,H1
"Chambers County, AL",2008-2009,34563,34384,-179,-0.518,-51,-128,1,17,H1
"Chambers County, AL",2009-2010,34384,34111,-273,-0.794,-55,-218,1,17,H1
"Chambers County, AL",2010-2011,34111,34004,-107,-0.314,-41,-66,1,17,H1
"Chambers County, AL",2011-2012,34004,34087,83,0.244,-82,165,1,17,H1
"Chambers County, AL",2012-2013,34087,34175,88,0.258,-76,164,1,17,H1
"Chambers County, AL",2013-2014,34175,34076,-99,-0.29,-48,-51,1,17,H1
"Chambers County, AL",2014-2015,34052,34123,71,0.209,-28,99,1,17,H1
"Chambers County, AL",2015-2016,34123,33717,-406,-1.19,-58,-348,1,17,H1
"Chambers County, AL",2016-2017,33717,33713,-4,-0.012,-84,80,1,17,H1
"Cherokee County, AL",2000-2001,24006,24182,176,0.733,49,127,1,19,H1
"Cherokee County, AL",2001-2002,24182,24403,221,0.914,-24,245,1,19,H1
"Cherokee County, AL",2002-2003,24403,24591,188,0.77,-14,202,1,19,H1
"Cherokee County, AL",2003-2004,24591,24887,296,1.204,-37,333,1,19,H1
"Cherokee County, AL",2004-2005,24887,25031,144,0.579,-18,162,1,19,H1
"Cherokee County, AL",2005-2006,25031,25466,435,1.738,-1,436,1,19,H1
"Cherokee County, AL",2006-2007,25466,25553,87,0.342,-46,133,1,19,H1
"Cherokee County, AL",2007-2008,25553,25636,83,0.325,-38,121,1,19,H1
"Cherokee County, AL",2008-2009,25636,25854,218,0.85,-49,267,1,19,H1
"Cherokee County, AL",2009-2010,25854,25968,114,0.441,-72,186,1,19,H1
"Cherokee County, AL",2010-2011,25968,26073,105,0.404,-88,193,1,19,H1
"Cherokee County, AL",2011-2012,26073,26017,-56,-0.215,-89,33,1,19,H1
"Cherokee County, AL",2012-2013,26017,26115,98,0.377,-84,182,1,19,H1
"Cherokee County, AL",2013-2014,26115,26037,-78,-0.299,-64,-14,1,19,H1
"Cherokee County, AL",2014-2015,25995,25859,-136,-0.523,-65,-71,1,19,H1
"Cherokee County, AL",2015-2016,25859,25766,-93,-0.36,-122,29,1,19,H1
"Cherokee County, AL",2016-2017,25766,25857,91,0.353,-94,185,1,19,H1
"Chilton County, AL",2000-2001,39897,40197,300,0.752,179,121,1,21,H1
"Chilton County, AL",2001-2002,40197,40683,486,1.209,97,389,1,21,H1
"Chilton County, AL",2002-2003,40683,41079,396,0.973,117,279,1,21,H1
"Chilton County, AL",2003-2004,41079,41534,455,1.108,73,382,1,21,H1
"Chilton County, AL",2004-2005,41534,41946,412,0.992,90,322,1,21,H1
"Chilton County, AL",2005-2006,41946,42318,372,0.887,95,277,1,21,H1
"Chilton County, AL",2006-2007,42318,42881,563,1.33,95,468,1,21,H1
"Chilton County, AL",2007-2008,42881,43239,358,0.835,210,148,1,21,H1
"Chilton County, AL",2008-2009,43239,43484,245,0.567,136,109,1,21,H1
"Chilton County, AL",2009-2010,43484,43682,198,0.455,82,116,1,21,H1
"Chilton County, AL",2010-2011,43682,43749,67,0.153,90,-23,1,21,H1
"Chilton County, AL",2011-2012,43749,43709,-40,-0.091,70,-110,1,21,H1
"Chilton County, AL",2012-2013,43709,43836,127,0.291,82,45,1,21,H1
"Chilton County, AL",2013-2014,43836,43931,95,0.217,92,3,1,21,H1
"Chilton County, AL",2014-2015,43921,43943,22,0.05,99,-77,1,21,H1
"Chilton County, AL",2015-2016,43943,43830,-113,-0.257,54,-167,1,21,H1
"Chilton County, AL",2016-2017,43830,44067,237,0.541,47,190,1,21,H1
"Choctaw County, AL",2000-2001,15875,15677,-198,-1.247,33,-231,1,23,H1
"Choctaw County, AL",2001-2002,15677,15367,-310,-1.977,20,-330,1,23,H1
"Choctaw County, AL",2002-2003,15367,15199,-168,-1.093,25,-193,1,23,H1
"Choctaw County, AL",2003-2004,15199,14930,-269,-1.77,-10,-259,1,23,H1
"Choctaw County, AL",2004-2005,14930,14545,-385,-2.579,-3,-382,1,23,H1
"Choctaw County, AL",2005-2006,14545,14431,-114,-0.784,8,-122,1,23,H1
"Choctaw County, AL",2006-2007,14431,14216,-215,-1.49,-16,-199,1,23,H1
"Choctaw County, AL",2007-2008,14216,14114,-102,-0.718,-9,-93,1,23,H1
"Choctaw County, AL",2008-2009,14114,13976,-138,-0.978,-21,-117,1,23,H1
"Choctaw County, AL",2009-2010,13976,13849,-127,-0.909,-41,-86,1,23,H1
"Choctaw County, AL",2010-2011,13849,13604,-245,-1.769,-46,-199,1,23,H1
"Choctaw County, AL",2011-2012,13604,13559,-45,-0.331,-34,-11,1,23,H1
"Choctaw County, AL",2012-2013,13559,13397,-162,-1.195,-66,-96,1,23,H1
"Choctaw County, AL",2013-2014,13397,13323,-74,-0.552,-50,-24,1,23,H1
"Choctaw County, AL",2014-2015,13289,13170,-119,-0.895,-41,-78,1,23,H1
"Choctaw County, AL",2015-2016,13170,13050,-120,-0.911,-33,-87,1,23,H1
"Choctaw County, AL",2016-2017,13050,12945,-105,-0.805,-31,-74,1,23,H1
"Clarke County, AL",2000-2001,27819,27624,-195,-0.701,137,-332,1,25,H1
"Clarke County, AL",2001-2002,27624,27267,-357,-1.292,58,-415,1,25,H1
"Clarke County, AL",2002-2003,27267,27090,-177,-0.649,94,-271,1,25,H1
"Clarke County, AL",2003-2004,27090,26958,-132,-0.487,58,-190,1,25,H1
"Clarke County, AL",2004-2005,26958,26764,-194,-0.72,80,-274,1,25,H1
"Clarke County, AL",2005-2006,26764,26755,-9,-0.034,16,-25,1,25,H1
"Clarke County, AL",2006-2007,26755,26436,-319,-1.192,36,-355,1,25,H1
"Clarke County, AL",2007-2008,26436,26283,-153,-0.579,43,-196,1,25,H1
"Clarke County, AL",2008-2009,26283,26038,-245,-0.932,28,-273,1,25,H1
"Clarke County, AL",2009-2010,26038,25782,-256,-0.983,20,-276,1,25,H1
"Clarke County, AL",2010-2011,25782,25592,-190,-0.737,-39,-151,1,25,H1
"Clarke County, AL",2011-2012,25592,25168,-424,-1.657,5,-429,1,25,H1
"Clarke County, AL",2012-2013,25168,25166,-2,-0.008,-12,10,1,25,H1
"Clarke County, AL",2013-2014,25166,24945,-221,-0.878,-15,-206,1,25,H1
"Clarke County, AL",2014-2015,24847,24675,-172,-0.692,-66,-106,1,25,H1
"Clarke County, AL",2015-2016,24675,24350,-325,-1.317,-16,-309,1,25,H1
"Clarke County, AL",2016-2017,24350,24083,-267,-1.097,-51,-216,1,25,H1
"Clay County, AL",2000-2001,14263,14298,35,0.245,21,14,1,27,H1
"Clay County, AL",2001-2002,14298,14257,-41,-0.287,-6,-35,1,27,H1
"Clay County, AL",2002-2003,14257,14203,-54,-0.379,-42,-12,1,27,H1
"Clay County, AL",2003-2004,14203,14121,-82,-0.577,-34,-48,1,27,H1
"Clay County, AL",2004-2005,14121,14077,-44,-0.312,-48,4,1,27,H1
"Clay County, AL",2005-2006,14077,14053,-24,-0.17,-7,-17,1,27,H1
"Clay County, AL",2006-2007,14053,14085,32,0.228,-22,54,1,27,H1
"Clay County, AL",2007-2008,14085,14161,76,0.54,-11,87,1,27,H1
"Clay County, AL",2008-2009,14161,14006,-155,-1.095,-13,-142,1,27,H1
"Clay County, AL",2009-2010,14006,13886,-120,-0.857,-36,-84,1,27,H1
"Clay County, AL",2010-2011,13886,13677,-209,-1.505,-58,-151,1,27,H1
"Clay County, AL",2011-2012,13677,13465,-212,-1.55,-36,-176,1,27,H1
"Clay County, AL",2012-2013,13465,13506,41,0.304,-20,61,1,27,H1
"Clay County, AL",2013-2014,13506,13552,46,0.341,-46,92,1,27,H1
"Clay County, AL",2014-2015,13538,13555,17,0.126,-45,62,1,27,H1
"Clay County, AL",2015-2016,13555,13410,-145,-1.07,-28,-117,1,27,H1
"Clay County, AL",2016-2017,13410,13367,-43,-0.321,-50,7,1,27,H1
"Cleburne County, AL",2000-2001,14172,14222,50,0.353,47,3,1,29,H1
"Cleburne County, AL",2001-2002,14222,14416,194,1.364,3,191,1,29,H1
"Cleburne County, AL",2002-2003,14416,14438,22,0.153,-40,62,1,29,H1
"Cleburne County, AL",2003-2004,14438,14339,-99,-0.686,-6,-93,1,29,H1
"Cleburne County, AL",2004-2005,14339,14368,29,0.202,8,21,1,29,H1
"Cleburne County, AL",2005-2006,14368,14538,170,1.183,28,142,1,29,H1
"Cleburne County, AL",2006-2007,14538,14799,261,1.795,61,200,1,29,H1
"Cleburne County, AL",2007-2008,14799,14874,75,0.507,-1,76,1,29,H1
"Cleburne County, AL",2008-2009,14874,14918,44,0.296,-9,53,1,29,H1
"Cleburne County, AL",2009-2010,14918,14969,51,0.342,-23,74,1,29,H1
"Cleburne County, AL",2010-2011,14969,14967,-2,-0.013,10,-12,1,29,H1
"Cleburne County, AL",2011-2012,14967,14918,-49,-0.327,25,-74,1,29,H1
"Cleburne County, AL",2012-2013,14918,15017,99,0.664,-5,104,1,29,H1
"Cleburne County, AL",2013-2014,15017,15080,63,0.42,19,44,1,29,H1
"Cleburne County, AL",2014-2015,15072,15018,-54,-0.358,-4,-50,1,29,H1
"Cleburne County, AL",2015-2016,15018,14873,-145,-0.966,-33,-112,1,29,H1
"Cleburne County, AL",2016-2017,14873,14900,27,0.182,-36,63,1,29,H1
"Coffee County, AL",2000-2001,43580,43716,136,0.312,96,40,1,31,H1
"Coffee County, AL",2001-2002,43716,43930,214,0.49,92,122,1,31,H1
"Coffee County, AL",2002-2003,43930,44315,385,0.876,104,281,1,31,H1
"Coffee County, AL",2003-2004,44315,45053,738,1.665,68,670,1,31,H1
"Coffee County, AL",2004-2005,45053,45604,551,1.223,132,419,1,31,H1
"Coffee County, AL",2005-2006,45604,46228,624,1.368,110,514,1,31,H1
"Coffee County, AL",2006-2007,46228,47458,1230,2.661,204,1026,1,31,H1
"Coffee County, AL",2007-2008,47458,48516,1058,2.229,200,858,1,31,H1
"Coffee County, AL",2008-2009,48516,49440,924,1.905,173,751,1,31,H1
"Coffee County, AL",2009-2010,49440,50179,739,1.495,156,583,1,31,H1
"Coffee County, AL",2010-2011,50179,50465,286,0.57,169,117,1,31,H1
"Coffee County, AL",2011-2012,50465,51217,752,1.49,131,621,1,31,H1
"Coffee County, AL",2012-2013,51217,50861,-356,-0.695,141,-497,1,31,H1
"Coffee County, AL",2013-2014,50861,50909,48,0.094,88,-40,1,31,H1
"Coffee County, AL",2014-2015,50831,51211,380,0.748,97,283,1,31,H1
"Coffee County, AL",2015-2016,51211,51217,6,0.012,174,-168,1,31,H1
"Coffee County, AL",2016-2017,51217,51874,657,1.283,126,531,1,31,H1
"Colbert County, AL",2000-2001,54997,54793,-204,-0.371,-42,-162,1,33,H1
"Colbert County, AL",2001-2002,54793,54536,-257,-0.469,62,-319,1,33,H1
"Colbert County, AL",2002-2003,54536,54279,-257,-0.471,-41,-216,1,33,H1
"Colbert County, AL",2003-2004,54279,54380,101,0.186,-36,137,1,33,H1
"Colbert County, AL",2004-2005,54380,54359,-21,-0.039,-3,-18,1,33,H1
"Colbert County, AL",2005-2006,54359,54413,54,0.099,-37,91,1,33,H1
"Colbert County, AL",2006-2007,54413,54486,73,0.134,36,37,1,33,H1
"Colbert County, AL",2007-2008,54486,54473,-13,-0.024,-55,42,1,33,H1
"Colbert County, AL",2008-2009,54473,54426,-47,-0.086,-41,-6,1,33,H1
"Colbert County, AL",2009-2010,54426,54505,79,0.145,-68,147,1,33,H1
"Colbert County, AL",2010-2011,54505,54433,-72,-0.132,-65,-7,1,33,H1
"Colbert County, AL",2011-2012,54433,54473,40,0.073,-47,87,1,33,H1
"Colbert County, AL",2012-2013,54473,54499,26,0.048,-117,143,1,33,H1
"Colbert County, AL",2013-2014,54499,54543,44,0.081,-47,91,1,33,H1
"Colbert County, AL",2014-2015,54480,54354,-126,-0.231,-76,-50,1,33,H1
"Colbert County, AL",2015-2016,54354,54327,-27,-0.05,-88,61,1,33,H1
"Colbert County, AL",2016-2017,54327,54500,173,0.318,-66,239,1,33,H1
"Conecuh County, AL",2000-2001,14035,13940,-95,-0.677,40,-135,1,35,H1
"Conecuh County, AL",2001-2002,13940,13793,-147,-1.055,-2,-145,1,35,H1
"Conecuh County, AL",2002-2003,13793,13585,-208,-1.508,-2,-206,1,35,H1
"Conecuh County, AL",2003-2004,13585,13430,-155,-1.141,-34,-121,1,35,H1
"Conecuh County, AL",2004-2005,13430,13421,-9,-0.067,-31,22,1,35,H1
"Conecuh County, AL",2005-2006,13421,13603,182,1.356,25,157,1,35,H1
"Conecuh County, AL",2006-2007,13603,13441,-162,-1.191,26,-188,1,35,H1
"Conecuh County, AL",2007-2008,13441,13388,-53,-0.394,9,-62,1,35,H1
"Conecuh County, AL",2008-2009,13388,13274,-114,-0.852,-19,-95,1,35,H1
"Conecuh County, AL",2009-2010,13274,13219,-55,-0.414,-40,-15,1,35,H1
"Conecuh County, AL",2010-2011,13219,13133,-86,-0.651,-30,-56,1,35,H1
"Conecuh County, AL",2011-2012,13133,13005,-128,-0.975,-26,-102,1,35,H1
"Conecuh County, AL",2012-2013,13005,12898,-107,-0.823,-23,-84,1,35,H1
"Conecuh County, AL",2013-2014,12898,12670,-228,-1.768,-30,-198,1,35,H1
"Conecuh County, AL",2014-2015,12662,12672,10,0.079,-37,47,1,35,H1
"Conecuh County, AL",2015-2016,12672,12515,-157,-1.239,-15,-142,1,35,H1
"Conecuh County, AL",2016-2017,12515,12469,-46,-0.368,-18,-28,1,35,H1
"Coosa County, AL",2000-2001,11844,11848,4,0.034,-1,5,1,37,H1
"Coosa County, AL",2001-2002,11848,11740,-108,-0.912,2,-110,1,37,H1
"Coosa County, AL",2002-2003,11740,11732,-8,-0.068,-4,-4,1,37,H1
"Coosa County, AL",2003-2004,11732,11560,-172,-1.466,-9,-163,1,37,H1
"Coosa County, AL",2004-2005,11560,11467,-93,-0.804,-58,-35,1,37,H1
"Coosa County, AL",2005-2006,11467,11451,-16,-0.14,-47,31,1,37,H1
"Coosa County, AL",2006-2007,11451,11439,-12,-0.105,-23,11,1,37,H1
"Coosa County, AL",2007-2008,11439,11493,54,0.472,-28,82,1,37,H1
"Coosa County, AL",2008-2009,11493,11410,-83,-0.722,-16,-67,1,37,H1
"Coosa County, AL",2009-2010,11410,11757,347,3.041,-26,373,1,37,H1
"Coosa County, AL",2010-2011,11757,11344,-413,-3.513,-68,-345,1,37,H1
"Coosa County, AL",2011-2012,11344,11181,-163,-1.437,-33,-130,1,37,H1
"Coosa County, AL",2012-2013,11181,11065,-116,-1.037,-11,-105,1,37,H1
"Coosa County, AL",2013-2014,11065,10886,-179,-1.618,-13,-166,1,37,H1
"Coosa County, AL",2014-2015,10807,10724,-83,-0.768,-15,-68,1,37,H1
"Coosa County, AL",2015-2016,10724,10809,85,0.793,-54,139,1,37,H1
"Coosa County, AL",2016-2017,10809,10754,-55,-0.509,-28,-27,1,37,H1
"Covington County, AL",2000-2001,37514,37069,-445,-1.186,-51,-394,1,39,H1
"Covington County, AL",2001-2002,37069,36901,-168,-0.453,-68,-100,1,39,H1
"Covington County, AL",2002-2003,36901,36860,-41,-0.111,-53,12,1,39,H1
"Covington County, AL",2003-2004,36860,36806,-54,-0.147,-48,-6,1,39,H1
"Covington County, AL",2004-2005,36806,37204,398,1.081,-30,428,1,39,H1
"Covington County, AL",2005-2006,37204,37441,237,0.637,-80,317,1,39,H1
"Covington County, AL",2006-2007,37441,37631,190,0.507,-41,231,1,39,H1
"Covington County, AL",2007-2008,37631,37545,-86,-0.229,-61,-25,1,39,H1
"Covington County, AL",2008-2009,37545,37648,103,0.274,-30,133,1,39,H1
"Covington County, AL",2009-2010,37648,37784,136,0.361,-49,185,1,39,H1
"Covington County, AL",2010-2011,37784,38049,265,0.701,-26,291,1,39,H1
"Covington County, AL",2011-2012,38049,37809,-240,-0.631,-68,-172,1,39,H1
"Covington County, AL",2012-2013,37809,37850,41,0.108,-20,61,1,39,H1
"Covington County, AL",2013-2014,37850,37914,64,0.169,-66,130,1,39,H1
"Covington County, AL",2014-2015,37888,37835,-53,-0.14,-59,6,1,39,H1
"Covington County, AL",2015-2016,37835,37386,-449,-1.187,-41,-408,1,39,H1
"Covington County, AL",2016-2017,37386,37092,-294,-0.786,-68,-226,1,39,H1
"Crenshaw County, AL",2000-2001,13692,13724,32,0.234,4,28,1,41,H1
"Crenshaw County, AL",2001-2002,13724,13635,-89,-0.648,-10,-79,1,41,H1
"Crenshaw County, AL",2002-2003,13635,13652,17,0.125,-32,49,1,41,H1
"Crenshaw County, AL",2003-2004,13652,13727,75,0.549,11,64,1,41,H1
"Crenshaw County, AL",2004-2005,13727,13699,-28,-0.204,-9,-19,1,41,H1
"Crenshaw County, AL",2005-2006,13699,13880,181,1.321,-32,213,1,41,H1
"Crenshaw County, AL",2006-2007,13880,13956,76,0.548,18,58,1,41,H1
"Crenshaw County, AL",2007-2008,13956,13922,-34,-0.244,-13,-21,1,41,H1
"Crenshaw County, AL",2008-2009,13922,14024,102,0.733,18,84,1,41,H1
"Crenshaw County, AL",2009-2010,14024,13866,-158,-1.127,24,-182,1,41,H1
"Crenshaw County, AL",2010-2011,13866,13914,48,0.346,2,46,1,41,H1
"Crenshaw County, AL",2011-2012,13914,13972,58,0.417,-18,76,1,41,H1
"Crenshaw County, AL",2012-2013,13972,13960,-12,-0.086,-16,4,1,41,H1
"Crenshaw County, AL",2013-2014,13960,13977,17,0.122,-39,56,1,41,H1
"Crenshaw County, AL",2014-2015,13948,13963,15,0.108,-46,61,1,41,H1
"Crenshaw County, AL",2015-2016,13963,13907,-56,-0.401,-15,-41,1,41,H1
"Crenshaw County, AL",2016-2017,13907,13871,-36,-0.259,-20,-16,1,41,H1
"Cullman County, AL",2000-2001,77473,77415,-58,-0.075,133,-191,1,43,H1
"Cullman County, AL",2001-2002,77415,77443,28,0.036,39,-11,1,43,H1
"Cullman County, AL",2002-2003,77443,77657,214,0.276,46,168,1,43,H1
"Cullman County, AL",2003-2004,77657,78131,474,0.61,108,366,1,43,H1
"Cullman County, AL",2004-2005,78131,78692,561,0.718,25,536,1,43,H1
"Cullman County, AL",2005-2006,78692,79044,352,0.447,107,245,1,43,H1
"Cullman County, AL",2006-2007,79044,79576,532,0.673,160,372,1,43,H1
"Cullman County, AL",2007-2008,79576,80273,697,0.876,164,533,1,43,H1
"Cullman County, AL",2008-2009,80273,80351,78,0.097,106,-28,1,43,H1
"Cullman County, AL",2009-2010,80351,80454,103,0.128,12,91,1,43,H1
"Cullman County, AL",2010-2011,80454,80455,1,0.001,87,-86,1,43,H1
"Cullman County, AL",2011-2012,80455,80361,-94,-0.117,-38,-56,1,43,H1
"Cullman County, AL",2012-2013,80361,80783,422,0.525,6,416,1,43,H1
"Cullman County, AL",2013-2014,80783,81289,506,0.626,16,490,1,43,H1
"Cullman County, AL",2014-2015,81221,82005,784,0.965,-4,788,1,43,H1
"Cullman County, AL",2015-2016,82005,82322,317,0.387,-24,341,1,43,H1
"Cullman County, AL",2016-2017,82322,82755,433,0.526,-23,456,1,43,H1
"Dale County, AL",2000-2001,49124,49254,130,0.265,357,-227,1,45,H1
"Dale County, AL",2001-2002,49254,49373,119,0.242,284,-165,1,45,H1
"Dale County, AL",2002-2003,49373,49215,-158,-0.32,287,-445,1,45,H1
"Dale County, AL",2003-2004,49215,49245,30,0.061,280,-250,1,45,H1
"Dale County, AL",2004-2005,49245,49050,-195,-0.396,351,-546,1,45,H1
"Dale County, AL",2005-2006,49050,49077,27,0.055,261,-234,1,45,H1
"Dale County, AL",2006-2007,49077,49488,411,0.837,360,51,1,45,H1
"Dale County, AL",2007-2008,49488,49871,383,0.774,308,75,1,45,H1
"Dale County, AL",2008-2009,49871,49854,-17,-0.034,244,-261,1,45,H1
"Dale County, AL",2009-2010,49854,50340,486,0.975,351,135,1,45,H1
"Dale County, AL",2010-2011,50340,50085,-255,-0.507,224,-479,1,45,H1
"Dale County, AL",2011-2012,50085,50310,225,0.449,255,-30,1,45,H1
"Dale County, AL",2012-2013,50310,49845,-465,-0.924,190,-655,1,45,H1
"Dale County, AL",2013-2014,49845,49484,-361,-0.724,133,-494,1,45,H1
"Dale County, AL",2014-2015,49501,49565,64,0.129,134,-70,1,45,H1
"Dale County, AL",2015-2016,49565,49228,-337,-0.68,127,-464,1,45,H1
"Dale County, AL",2016-2017,49228,49226,-2,-0.004,95,-97,1,45,H1
"Dallas County, AL",2000-2001,46198,46132,-66,-0.143,270,-336,1,47,H1
"Dallas County, AL",2001-2002,46132,45377,-755,-1.637,134,-889,1,47,H1
"Dallas County, AL",2002-2003,45377,45170,-207,-0.456,184,-391,1,47,H1
"Dallas County, AL",2003-2004,45170,44795,-375,-0.83,119,-494,1,47,H1
"Dallas County, AL",2004-2005,44795,44434,-361,-0.806,89,-450,1,47,H1
"Dallas County, AL",2005-2006,44434,44323,-111,-0.25,69,-180,1,47,H1
"Dallas County, AL",2006-2007,44323,44194,-129,-0.291,170,-299,1,47,H1
"Dallas County, AL",2007-2008,44194,44265,71,0.161,140,-69,1,47,H1
"Dallas County, AL",2008-2009,44265,43759,-506,-1.143,128,-634,1,47,H1
"Dallas County, AL",2009-2010,43759,43836,77,0.176,85,-8,1,47,H1
"Dallas County, AL",2010-2011,43836,43225,-611,-1.394,39,-650,1,47,H1
"Dallas County, AL",2011-2012,43225,42839,-386,-0.893,80,-466,1,47,H1
"Dallas County, AL",2012-2013,42839,42102,-737,-1.72,-14,-723,1,47,H1
"Dallas County, AL",2013-2014,42102,41711,-391,-0.929,9,-400,1,47,H1
"Dallas County, AL",2014-2015,41662,41131,-531,-1.275,42,-573,1,47,H1
"Dallas County, AL",2015-2016,41131,40081,-1050,-2.553,-59,-991,1,47,H1
"Dallas County, AL",2016-2017,40081,39215,-866,-2.161,-60,-806,1,47,H1
"DeKalb County, AL",2000-2001,64650,65678,1028,1.59,244,784,1,49,H1
"DeKalb County, AL",2001-2002,65678,65861,183,0.279,302,-119,1,49,H1
"DeKalb County, AL",2002-2003,65861,66530,669,1.016,253,416,1,49,H1
"DeKalb County, AL",2003-2004,66530,67260,730,1.097,296,434,1,49,H1
"DeKalb County, AL",2004-2005,67260,67794,534,0.794,296,238,1,49,H1
"DeKalb County, AL",2005-2006,67794,68495,701,1.034,224,477,1,49,H1
"DeKalb County, AL",2006-2007,68495,69450,955,1.394,356,599,1,49,H1
"DeKalb County, AL",2007-2008,69450,70228,778,1.12,318,460,1,49,H1
"DeKalb County, AL",2008-2009,70228,70864,636,0.906,298,338,1,49,H1
"DeKalb County, AL",2009-2010,70864,71118,254,0.358,241,13,1,49,H1
"DeKalb County, AL",2010-2011,71118,71361,243,0.342,121,122,1,49,H1
"DeKalb County, AL",2011-2012,71361,70930,-431,-0.604,158,-589,1,49,H1
"DeKalb County, AL",2012-2013,70930,70894,-36,-0.051,61,-97,1,49,H1
"DeKalb County, AL",2013-2014,70894,71065,171,0.241,87,84,1,49,H1
"DeKalb County, AL",2014-2015,71012,71130,118,0.166,84,34,1,49,H1
"DeKalb County, AL",2015-2016,71130,71216,86,0.121,52,34,1,49,H1
"DeKalb County, AL",2016-2017,71216,71617,401,0.563,69,332,1,49,H1
"Elmore County, AL",2000-2001,66160,67459,1299,1.963,494,805,1,51,H1
"Elmore County, AL",2001-2002,67459,68659,1200,1.779,406,794,1,51,H1
"Elmore County, AL",2002-2003,68659,69935,1276,1.858,306,970,1,51,H1
"Elmore County, AL",2003-2004,69935,71018,1083,1.549,322,761,1,51,H1
"Elmore County, AL",2004-2005,71018,72978,1960,2.76,366,1594,1,51,H1
"Elmore County, AL",2005-2006,72978,75246,2268,3.108,396,1872,1,51,H1
"Elmore County, AL",2006-2007,75246,77124,1878,2.496,379,1499,1,51,H1
"Elmore County, AL",2007-2008,77124,77698,574,0.744,429,145,1,51,H1
"Elmore County, AL",2008-2009,77698,78632,934,1.202,399,535,1,51,H1
"Elmore County, AL",2009-2010,78632,79444,812,1.033,293,519,1,51,H1
"Elmore County, AL",2010-2011,79444,79983,539,0.678,260,279,1,51,H1
"Elmore County, AL",2011-2012,79983,80392,409,0.511,298,111,1,51,H1
"Elmore County, AL",2012-2013,80392,80808,416,0.517,228,188,1,51,H1
"Elmore County, AL",2013-2014,80808,80977,169,0.209,209,-40,1,51,H1
"Elmore County, AL",2014-2015,81022,81468,446,0.55,190,256,1,51,H1
"Elmore County, AL",2015-2016,81468,81240,-228,-0.28,117,-345,1,51,H1
"Elmore County, AL",2016-2017,81240,81677,437,0.538,86,351,1,51,H1
"Escambia County, AL",2000-2001,38325,38197,-128,-0.334,139,-267,1,53,H1
"Escambia County, AL",2001-2002,38197,38035,-162,-0.424,77,-239,1,53,H1
"Escambia County, AL",2002-2003,38035,37796,-239,-0.628,61,-300,1,53,H1
"Escambia County, AL",2003-2004,37796,37713,-83,-0.22,80,-163,1,53,H1
"Escambia County, AL",2004-2005,37713,37601,-112,-0.297,-9,-103,1,53,H1
"Escambia County, AL",2005-2006,37601,37673,72,0.191,79,-7,1,53,H1
"Escambia County, AL",2006-2007,37673,37839,166,0.441,104,62,1,53,H1
"Escambia County, AL",2007-2008,37839,37929,90,0.238,70,20,1,53,H1
"Escambia County, AL",2008-2009,37929,38249,320,0.844,44,276,1,53,H1
"Escambia County, AL",2009-2010,38249,38312,63,0.165,32,31,1,53,H1
"Escambia County, AL",2010-2011,38312,38222,-90,-0.235,44,-134,1,53,H1
"Escambia County, AL",2011-2012,38222,38048,-174,-0.455,-36,-138,1,53,H1
"Escambia County, AL",2012-2013,38048,37893,-155,-0.407,-7,-148,1,53,H1
"Escambia County, AL",2013-2014,37893,37733,-160,-0.422,-31,-129,1,53,H1
"Escambia County, AL",2014-2015,37784,37789,5,0.013,-8,13,1,53,H1
"Escambia County, AL",2015-2016,37789,37476,-313,-0.828,-62,-251,1,53,H1
"Escambia County, AL",2016-2017,37476,37447,-29,-0.077,-70,41,1,53,H1
"Etowah County, AL",2000-2001,103286,102976,-310,-0.3,14,-324,1,55,H1
"Etowah County, AL",2001-2002,102976,102988,12,0.012,11,1,1,55,H1
"Etowah County, AL",2002-2003,102988,103025,37,0.036,-115,152,1,55,H1
"Etowah County, AL",2003-2004,103025,103080,55,0.053,-107,162,1,55,H1
"Etowah County, AL",2004-2005,103080,103174,94,0.091,-134,228,1,55,H1
"Etowah County, AL",2005-2006,103174,103528,354,0.343,-154,508,1,55,H1
"Etowah County, AL",2006-2007,103528,103893,365,0.353,32,333,1,55,H1
"Etowah County, AL",2007-2008,103893,104206,313,0.301,-108,421,1,55,H1
"Etowah County, AL",2008-2009,104206,104239,33,0.032,-39,72,1,55,H1
"Etowah County, AL",2009-2010,104239,104501,262,0.251,-127,389,1,55,H1
"Etowah County, AL",2010-2011,104501,104310,-191,-0.183,-105,-86,1,55,H1
"Etowah County, AL",2011-2012,104310,104324,14,0.013,-254,268,1,55,H1
"Etowah County, AL",2012-2013,104324,103962,-362,-0.347,-200,-162,1,55,H1
"Etowah County, AL",2013-2014,103962,103531,-431,-0.415,-287,-144,1,55,H1
"Etowah County, AL",2014-2015,103452,103057,-395,-0.382,-281,-114,1,55,H1
"Etowah County, AL",2015-2016,103057,102726,-331,-0.321,-216,-115,1,55,H1
"Etowah County, AL",2016-2017,102726,102755,29,0.028,-252,281,1,55,H1
"Fayette County, AL",2000-2001,18512,18384,-128,-0.691,23,-151,1,57,H1
"Fayette County, AL",2001-2002,18384,18278,-106,-0.577,-43,-63,1,57,H1
"Fayette County, AL",2002-2003,18278,18178,-100,-0.547,-11,-89,1,57,H1
"Fayette County, AL",2003-2004,18178,18022,-156,-0.858,-51,-105,1,57,H1
"Fayette County, AL",2004-2005,18022,18030,8,0.044,-56,64,1,57,H1
"Fayette County, AL",2005-2006,18030,17767,-263,-1.459,-48,-215,1,57,H1
"Fayette County, AL",2006-2007,17767,17523,-244,-1.373,-57,-187,1,57,H1
"Fayette County, AL",2007-2008,17523,17541,18,0.103,-12,30,1,57,H1
"Fayette County, AL",2008-2009,17541,17310,-231,-1.317,-12,-219,1,57,H1
"Fayette County, AL",2009-2010,17310,17247,-63,-0.364,-23,-40,1,57,H1
"Fayette County, AL",2010-2011,17247,17082,-165,-0.957,-68,-97,1,57,H1
"Fayette County, AL",2011-2012,17082,16982,-100,-0.585,-91,-9,1,57,H1
"Fayette County, AL",2012-2013,16982,16909,-73,-0.43,-12,-61,1,57,H1
"Fayette County, AL",2013-2014,16909,16874,-35,-0.207,-39,4,1,57,H1
"Fayette County, AL",2014-2015,16842,16759,-83,-0.493,-43,-40,1,57,H1
"Fayette County, AL",2015-2016,16759,16538,-221,-1.319,-62,-159,1,57,H1
"Fayette County, AL",2016-2017,16538,16468,-70,-0.423,-65,-5,1,57,H1
"Franklin County, AL",2000-2001,31242,31190,-52,-0.166,120,-172,1,59,H1
"Franklin County, AL",2001-2002,31190,30891,-299,-0.959,23,-322,1,59,H1
"Franklin County, AL",2002-2003,30891,30874,-17,-0.055,63,-80,1,59,H1
"Franklin County, AL",2003-2004,30874,30768,-106,-0.343,4,-110,1,59,H1
"Franklin County, AL",2004-2005,30768,30968,200,0.65,84,116,1,59,H1
"Franklin County, AL",2005-2006,30968,31134,166,0.536,125,41,1,59,H1
"Franklin County, AL",2006-2007,31134,31004,-130,-0.418,80,-210,1,59,H1
"Franklin County, AL",2007-2008,31004,31459,455,1.468,103,352,1,59,H1
"Franklin County, AL",2008-2009,31459,31589,130,0.413,110,20,1,59,H1
"Franklin County, AL",2009-2010,31589,31755,166,0.525,79,87,1,59,H1
"Franklin County, AL",2010-2011,31755,31757,2,0.006,0,2,1,59,H1
"Franklin County, AL",2011-2012,31757,31660,-97,-0.305,24,-121,1,59,H1
"Franklin County, AL",2012-2013,31660,31542,-118,-0.373,45,-163,1,59,H1
"Franklin County, AL",2013-2014,31542,31601,59,0.187,49,10,1,59,H1
"Franklin County, AL",2014-2015,31592,31696,104,0.329,68,36,1,59,H1
"Franklin County, AL",2015-2016,31696,31577,-119,-0.375,40,-159,1,59,H1
"Franklin County, AL",2016-2017,31577,31495,-82,-0.26,56,-138,1,59,H1
"Geneva County, AL",2000-2001,25740,25565,-175,-0.68,27,-202,1,61,H1
"Geneva County, AL",2001-2002,25565,25580,15,0.059,-37,52,1,61,H1
"Geneva County, AL",2002-2003,25580,25702,122,0.477,2,120,1,61,H1
"Geneva County, AL",2003-2004,25702,25772,70,0.272,-12,82,1,61,H1
"Geneva County, AL",2004-2005,25772,25988,216,0.838,-56,272,1,61,H1
"Geneva County, AL",2005-2006,25988,26271,283,1.089,-24,307,1,61,H1
"Geneva County, AL",2006-2007,26271,26322,51,0.194,-38,89,1,61,H1
"Geneva County, AL",2007-2008,26322,26646,324,1.231,40,284,1,61,H1
"Geneva County, AL",2008-2009,26646,26653,7,0.026,0,7,1,61,H1
"Geneva County, AL",2009-2010,26653,26793,140,0.525,-23,163,1,61,H1
"Geneva County, AL",2010-2011,26793,26829,36,0.134,-12,48,1,61,H1
"Geneva County, AL",2011-2012,26829,27002,173,0.645,-43,216,1,61,H1
"Geneva County, AL",2012-2013,27002,26742,-260,-0.963,-27,-233,1,61,H1
"Geneva County, AL",2013-2014,26742,26712,-30,-0.112,-32,2,1,61,H1
"Geneva County, AL",2014-2015,26707,26777,70,0.262,-43,113,1,61,H1
"Geneva County, AL",2015-2016,26777,26516,-261,-0.975,-75,-186,1,61,H1
"Geneva County, AL",2016-2017,26516,26421,-95,-0.358,-80,-15,1,61,H1
"Greene County, AL",2000-2001,9902,9866,-36,-0.364,43,-79,1,63,H1
"Greene County, AL",2001-2002,9866,9893,27,0.274,35,-8,1,63,H1
"Greene County, AL",2002-2003,9893,9805,-88,-0.89,6,-94,1,63,H1
"Greene County, AL",2003-2004,9805,9686,-119,-1.214,32,-151,1,63,H1
"Greene County, AL",2004-2005,9686,9675,-11,-0.114,-9,-2,1,63,H1
"Greene County, AL",2005-2006,9675,9361,-314,-3.245,23,-337,1,63,H1
"Greene County, AL",2006-2007,9361,9385,24,0.256,24,0,1,63,H1
"Greene County, AL",2007-2008,9385,9359,-26,-0.277,29,-55,1,63,H1
"Greene County, AL",2008-2009,9359,9182,-177,-1.891,1,-178,1,63,H1
"Greene County, AL",2009-2010,9182,8992,-190,-2.069,-7,-183,1,63,H1
"Greene County, AL",2010-2011,8992,8902,-90,-1.001,-2,-88,1,63,H1
"Greene County, AL",2011-2012,8902,8827,-75,-0.843,4,-79,1,63,H1
"Greene County, AL",2012-2013,8827,8718,-109,-1.235,-6,-103,1,63,H1
"Greene County, AL",2013-2014,8718,8553,-165,-1.893,8,-173,1,63,H1
"Greene County, AL",2014-2015,8553,8479,-74,-0.865,11,-85,1,63,H1
"Greene County, AL",2015-2016,8479,8488,9,0.106,-4,13,1,63,H1
"Greene County, AL",2016-2017,8488,8330,-158,-1.861,0,-158,1,63,H1
"Hale County, AL",2000-2001,18194,17868,-326,-1.792,79,-405,1,65,H1
"Hale County, AL",2001-2002,17868,17376,-492,-2.754,43,-535,1,65,H1
"Hale County, AL",2002-2003,17376,17116,-260,-1.496,22,-282,1,65,H1
"Hale County, AL",2003-2004,17116,16765,-351,-2.051,-11,-340,1,65,H1
"Hale County, AL",2004-2005,16765,16622,-143,-0.853,36,-179,1,65,H1
"Hale County, AL",2005-2006,16622,16427,-195,-1.173,18,-213,1,65,H1
"Hale County, AL",2006-2007,16427,16418,-9,-0.055,66,-75,1,65,H1
"Hale County, AL",2007-2008,16418,16260,-158,-0.962,36,-194,1,65,H1
"Hale County, AL",2008-2009,16260,16025,-235,-1.445,10,-245,1,65,H1
"Hale County, AL",2009-2010,16025,15727,-298,-1.86,-3,-295,1,65,H1
"Hale County, AL",2010-2011,15727,15355,-372,-2.365,-16,-356,1,65,H1
"Hale County, AL",2011-2012,15355,15390,35,0.228,47,-12,1,65,H1
"Hale County, AL",2012-2013,15390,15311,-79,-0.513,17,-96,1,65,H1
"Hale County, AL",2013-2014,15311,15184,-127,-0.829,12,-139,1,65,H1
"Hale County, AL",2014-2015,15131,15068,-63,-0.416,1,-64,1,65,H1
"Hale County, AL",2015-2016,15068,14847,-221,-1.467,18,-239,1,65,H1
"Hale County, AL",2016-2017,14847,14812,-35,-0.236,-8,-27,1,65,H1
"Henry County, AL",2000-2001,16341,16358,17,0.104,20,-3,1,67,H1
"Henry County, AL",2001-2002,16358,16447,89,0.544,8,81,1,67,H1
"Henry County, AL",2002-2003,16447,16563,116,0.705,-3,119,1,67,H1
"Henry County, AL",2003-2004,16563,16692,129,0.779,-18,147,1,67,H1
"Henry County, AL",2004-2005,16692,16752,60,0.359,-14,74,1,67,H1
"Henry County, AL",2005-2006,16752,16953,201,1.2,-29,230,1,67,H1
"Henry County, AL",2006-2007,16953,17108,155,0.914,-28,183,1,67,H1
"Henry County, AL",2007-2008,17108,17129,21,0.123,-23,44,1,67,H1
"Henry County, AL",2008-2009,17129,17243,114,0.666,-26,140,1,67,H1
"Henry County, AL",2009-2010,17243,17287,44,0.255,-51,95,1,67,H1
"Henry County, AL",2010-2011,17287,17403,116,0.671,-40,156,1,67,H1
"Henry County, AL",2011-2012,17403,17248,-155,-0.891,-49,-106,1,67,H1
"Henry County, AL",2012-2013,17248,17224,-24,-0.139,-23,-1,1,67,H1
"Henry County, AL",2013-2014,17224,17190,-34,-0.197,-24,-10,1,67,H1
"Henry County, AL",2014-2015,17176,17221,45,0.262,-34,79,1,67,H1
"Henry County, AL",2015-2016,17221,17092,-129,-0.749,-37,-92,1,67,H1
"Henry County, AL",2016-2017,17092,17147,55,0.322,-27,82,1,67,H1
"Houston County, AL",2000-2001,88943,89490,547,0.615,448,99,1,69,H1
"Houston County, AL",2001-2002,89490,89940,450,0.503,316,134,1,69,H1
"Houston County, AL",2002-2003,89940,91321,1381,1.535,447,934,1,69,H1
"Houston County, AL",2003-2004,91321,92593,1272,1.393,455,817,1,69,H1
"Houston County, AL",2004-2005,92593,93903,1310,1.415,320,990,1,69,H1
"Houston County, AL",2005-2006,93903,95846,1943,2.069,437,1506,1,69,H1
"Houston County, AL",2006-2007,95846,97727,1881,1.963,461,1420,1,69,H1
"Houston County, AL",2007-2008,97727,99183,1456,1.49,416,1040,1,69,H1
"Houston County, AL",2008-2009,99183,100500,1317,1.328,403,914,1,69,H1
"Houston County, AL",2009-2010,100500,101787,1287,1.281,398,889,1,69,H1
"Houston County, AL",2010-2011,101787,102423,636,0.625,419,217,1,69,H1
"Houston County, AL",2011-2012,102423,103368,945,0.923,333,612,1,69,H1
"Houston County, AL",2012-2013,103368,103626,258,0.25,124,134,1,69,H1
"Houston County, AL",2013-2014,103626,104193,567,0.547,168,399,1,69,H1
"Houston County, AL",2014-2015,104110,104173,63,0.061,173,-110,1,69,H1
"Houston County, AL",2015-2016,104173,104173,0,0,206,-206,1,69,H1
"Houston County, AL",2016-2017,104173,104346,173,0.166,170,3,1,69,H1
"Jackson County, AL",2000-2001,53979,53997,18,0.033,73,-55,1,71,H1
"Jackson County, AL",2001-2002,53997,53758,-239,-0.443,72,-311,1,71,H1
"Jackson County, AL",2002-2003,53758,53711,-47,-0.087,1,-48,1,71,H1
"Jackson County, AL",2003-2004,53711,53525,-186,-0.346,56,-242,1,71,H1
"Jackson County, AL",2004-2005,53525,53332,-193,-0.361,29,-222,1,71,H1
"Jackson County, AL",2005-2006,53332,53483,151,0.283,4,147,1,71,H1
"Jackson County, AL",2006-2007,53483,53333,-150,-0.28,-58,-92,1,71,H1
"Jackson County, AL",2007-2008,53333,53525,192,0.36,-2,194,1,71,H1
"Jackson County, AL",2008-2009,53525,53461,-64,-0.12,5,-69,1,71,H1
"Jackson County, AL",2009-2010,53461,53159,-302,-0.565,-32,-270,1,71,H1
"Jackson County, AL",2010-2011,53159,53244,85,0.16,-74,159,1,71,H1
"Jackson County, AL",2011-2012,53244,53048,-196,-0.368,-93,-103,1,71,H1
"Jackson County, AL",2012-2013,53048,52944,-104,-0.196,-85,-19,1,71,H1
"Jackson County, AL",2013-2014,52944,52665,-279,-0.527,-68,-211,1,71,H1
"Jackson County, AL",2014-2015,52631,52419,-212,-0.403,-96,-116,1,71,H1
"Jackson County, AL",2015-2016,52419,52049,-370,-0.706,-167,-203,1,71,H1
"Jackson County, AL",2016-2017,52049,51909,-140,-0.269,-132,-8,1,71,H1
"Jefferson County, AL",2000-2001,662033,660197,-1836,-0.277,2192,-4028,1,73,H1
"Jefferson County, AL",2001-2002,660197,657518,-2679,-0.406,1695,-4374,1,73,H1
"Jefferson County, AL",2002-2003,657518,657513,-5,-0.001,1646,-1651,1,73,H1
"Jefferson County, AL",2003-2004,657513,656023,-1490,-0.227,1768,-3258,1,73,H1
"Jefferson County, AL",2004-2005,656023,654919,-1104,-0.168,1908,-3012,1,73,H1
"Jefferson County, AL",2005-2006,654919,655893,974,0.149,2201,-1227,1,73,H1
"Jefferson County, AL",2006-2007,655893,655163,-730,-0.111,2698,-3428,1,73,H1
"Jefferson County, AL",2007-2008,655163,656510,1347,0.206,2701,-1354,1,73,H1
"Jefferson County, AL",2008-2009,656510,658441,1931,0.294,2037,-106,1,73,H1
"Jefferson County, AL",2009-2010,658441,658302,-139,-0.021,2280,-2419,1,73,H1
"Jefferson County, AL",2010-2011,658302,657927,-375,-0.057,1928,-2303,1,73,H1
"Jefferson County, AL",2011-2012,657927,657953,26,0.004,2270,-2244,1,73,H1
"Jefferson County, AL",2012-2013,657953,659197,1244,0.189,1916,-672,1,73,H1
"Jefferson County, AL",2013-2014,659197,660793,1596,0.242,1767,-171,1,73,H1
"Jefferson County, AL",2014-2015,660368,660367,-1,0,1606,-1607,1,73,H1
"Jefferson County, AL",2015-2016,660367,659747,-620,-0.094,1530,-2150,1,73,H1
"Jefferson County, AL",2016-2017,659747,659197,-550,-0.083,1340,-1890,1,73,H1
"Lamar County, AL",2000-2001,15923,15632,-291,-1.828,-20,-271,1,75,H1
"Lamar County, AL",2001-2002,15632,15446,-186,-1.19,-55,-131,1,75,H1
"Lamar County, AL",2002-2003,15446,15258,-188,-1.217,-38,-150,1,75,H1
"Lamar County, AL",2003-2004,15258,15075,-183,-1.199,-14,-169,1,75,H1
"Lamar County, AL",2004-2005,15075,15009,-66,-0.438,-23,-43,1,75,H1
"Lamar County, AL",2005-2006,15009,14816,-193,-1.286,9,-202,1,75,H1
"Lamar County, AL",2006-2007,14816,14901,85,0.574,0,85,1,75,H1
"Lamar County, AL",2007-2008,14901,14799,-102,-0.685,-9,-93,1,75,H1
"Lamar County, AL",2008-2009,14799,14689,-110,-0.743,-31,-79,1,75,H1
"Lamar County, AL",2009-2010,14689,14499,-190,-1.293,-44,-146,1,75,H1
"Lamar County, AL",2010-2011,14499,14295,-204,-1.407,-59,-145,1,75,H1
"Lamar County, AL",2011-2012,14295,14255,-40,-0.28,-31,-9,1,75,H1
"Lamar County, AL",2012-2013,14255,14203,-52,-0.365,-46,-6,1,75,H1
"Lamar County, AL",2013-2014,14203,14086,-117,-0.824,-47,-70,1,75,H1
"Lamar County, AL",2014-2015,14050,13886,-164,-1.167,-67,-97,1,75,H1
"Lamar County, AL",2015-2016,13886,13949,63,0.454,-50,113,1,75,H1
"Lamar County, AL",2016-2017,13949,13946,-3,-0.022,-34,31,1,75,H1
"Lauderdale County, AL",2000-2001,88039,87791,-248,-0.282,72,-320,1,77,H1
"Lauderdale County, AL",2001-2002,87791,87627,-164,-0.187,28,-192,1,77,H1
"Lauderdale County, AL",2002-2003,87627,88103,476,0.543,69,407,1,77,H1
"Lauderdale County, AL",2003-2004,88103,88732,629,0.714,89,540,1,77,H1
"Lauderdale County, AL",2004-2005,88732,89358,626,0.705,-100,726,1,77,H1
"Lauderdale County, AL",2005-2006,89358,90294,936,1.047,20,916,1,77,H1
"Lauderdale County, AL",2006-2007,90294,91107,813,0.9,63,750,1,77,H1
"Lauderdale County, AL",2007-2008,91107,92202,1095,1.202,12,1083,1,77,H1
"Lauderdale County, AL",2008-2009,92202,92526,324,0.351,32,292,1,77,H1
"Lauderdale County, AL",2009-2010,92526,92726,200,0.216,-35,235,1,77,H1
"Lauderdale County, AL",2010-2011,92726,92609,-117,-0.126,-148,31,1,77,H1
"Lauderdale County, AL",2011-2012,92609,92694,85,0.092,-130,215,1,77,H1
"Lauderdale County, AL",2012-2013,92694,92774,80,0.086,-176,256,1,77,H1
"Lauderdale County, AL",2013-2014,92774,93096,322,0.347,-165,487,1,77,H1
"Lauderdale County, AL",2014-2015,93063,92596,-467,-0.502,-107,-360,1,77,H1
"Lauderdale County, AL",2015-2016,92596,92319,-277,-0.299,-219,-58,1,77,H1
"Lauderdale County, AL",2016-2017,92319,92538,219,0.237,-203,422,1,77,H1
"Lawrence County, AL",2000-2001,34874,34870,-4,-0.011,94,-98,1,79,H1
"Lawrence County, AL",2001-2002,34870,34698,-172,-0.493,58,-230,1,79,H1
"Lawrence County, AL",2002-2003,34698,34488,-210,-0.605,53,-263,1,79,H1
"Lawrence County, AL",2003-2004,34488,34318,-170,-0.493,40,-210,1,79,H1
"Lawrence County, AL",2004-2005,34318,34435,117,0.341,68,49,1,79,H1
"Lawrence County, AL",2005-2006,34435,34028,-407,-1.182,39,-446,1,79,H1
"Lawrence County, AL",2006-2007,34028,34293,265,0.779,55,210,1,79,H1
"Lawrence County, AL",2007-2008,34293,34196,-97,-0.283,52,-149,1,79,H1
"Lawrence County, AL",2008-2009,34196,34315,119,0.348,66,53,1,79,H1
"Lawrence County, AL",2009-2010,34315,34306,-9,-0.026,66,-75,1,79,H1
"Lawrence County, AL",2010-2011,34306,34044,-262,-0.764,-77,-185,1,79,H1
"Lawrence County, AL",2011-2012,34044,33776,-268,-0.787,-14,-254,1,79,H1
"Lawrence County, AL",2012-2013,33776,33571,-205,-0.607,0,-205,1,79,H1
"Lawrence County, AL",2013-2014,33571,33477,-94,-0.28,-22,-72,1,79,H1
"Lawrence County, AL",2014-2015,33426,33115,-311,-0.93,-48,-263,1,79,H1
"Lawrence County, AL",2015-2016,33115,33232,117,0.353,-22,139,1,79,H1
"Lawrence County, AL",2016-2017,33232,33049,-183,-0.551,-37,-146,1,79,H1
"Lee County, AL",2000-2001,115430,116819,1389,1.203,593,796,1,81,H1
"Lee County, AL",2001-2002,116819,118392,1573,1.347,579,994,1,81,H1
"Lee County, AL",2002-2003,118392,120071,1679,1.418,620,1059,1,81,H1
"Lee County, AL",2003-2004,120071,122274,2203,1.835,593,1610,1,81,H1
"Lee County, AL",2004-2005,122274,126133,3859,3.156,699,3160,1,81,H1
"Lee County, AL",2005-2006,126133,129247,3114,2.469,730,2384,1,81,H1
"Lee County, AL",2006-2007,129247,131934,2687,2.079,845,1842,1,81,H1
"Lee County, AL",2007-2008,131934,134524,2590,1.963,780,1810,1,81,H1
"Lee County, AL",2008-2009,134524,138566,4042,3.005,778,3264,1,81,H1
"Lee County, AL",2009-2010,138566,140799,2233,1.612,760,1473,1,81,H1
"Lee County, AL",2010-2011,140799,144146,3347,2.377,826,2521,1,81,H1
"Lee County, AL",2011-2012,144146,148040,3894,2.701,781,3113,1,81,H1
"Lee County, AL",2012-2013,148040,151708,3668,2.478,765,2903,1,81,H1
"Lee County, AL",2013-2014,151708,154255,2547,1.679,831,1716,1,81,H1
"Lee County, AL",2014-2015,154426,156993,2567,1.662,911,1656,1,81,H1
"Lee County, AL",2015-2016,156993,158983,1990,1.268,933,1057,1,81,H1
"Lee County, AL",2016-2017,158983,161604,2621,1.649,899,1722,1,81,H1
"Limestone County, AL",2000-2001,65966,66936,970,1.47,366,604,1,83,H1
"Limestone County, AL",2001-2002,66936,67677,741,1.107,288,453,1,83,H1
"Limestone County, AL",2002-2003,67677,68578,901,1.331,167,734,1,83,H1
"Limestone County, AL",2003-2004,68578,69593,1015,1.48,215,800,1,83,H1
"Limestone County, AL",2004-2005,69593,71303,1710,2.457,300,1410,1,83,H1
"Limestone County, AL",2005-2006,71303,73651,2348,3.293,269,2079,1,83,H1
"Limestone County, AL",2006-2007,73651,76063,2412,3.275,320,2092,1,83,H1
"Limestone County, AL",2007-2008,76063,78835,2772,3.644,351,2421,1,83,H1
"Limestone County, AL",2008-2009,78835,81326,2491,3.16,297,2194,1,83,H1
"Limestone County, AL",2009-2010,81326,83179,1853,2.278,239,1614,1,83,H1
"Limestone County, AL",2010-2011,83179,85580,2401,2.887,327,2074,1,83,H1
"Limestone County, AL",2011-2012,85580,87363,1783,2.083,286,1497,1,83,H1
"Limestone County, AL",2012-2013,87363,88924,1561,1.787,318,1243,1,83,H1
"Limestone County, AL",2013-2014,88924,90787,1863,2.095,306,1557,1,83,H1
"Limestone County, AL",2014-2015,90612,91663,1051,1.16,271,780,1,83,H1
"Limestone County, AL",2015-2016,91663,92920,1257,1.371,251,1006,1,83,H1
"Limestone County, AL",2016-2017,92920,94402,1482,1.595,248,1234,1,83,H1
"Lowndes County, AL",2000-2001,13471,13329,-142,-1.054,99,-241,1,85,H1
"Lowndes County, AL",2001-2002,13329,13231,-98,-0.735,58,-156,1,85,H1
"Lowndes County, AL",2002-2003,13231,12996,-235,-1.776,42,-277,1,85,H1
"Lowndes County, AL",2003-2004,12996,12623,-373,-2.87,48,-421,1,85,H1
"Lowndes County, AL",2004-2005,12623,12397,-226,-1.79,15,-241,1,85,H1
"Lowndes County, AL",2005-2006,12397,12124,-273,-2.202,21,-294,1,85,H1
"Lowndes County, AL",2006-2007,12124,11973,-151,-1.245,57,-208,1,85,H1
"Lowndes County, AL",2007-2008,11973,11813,-160,-1.336,59,-219,1,85,H1
"Lowndes County, AL",2008-2009,11813,11486,-327,-2.768,26,-353,1,85,H1
"Lowndes County, AL",2009-2010,11486,11285,-201,-1.75,10,-211,1,85,H1
"Lowndes County, AL",2010-2011,11285,11131,-154,-1.365,-7,-147,1,85,H1
"Lowndes County, AL",2011-2012,11131,10864,-267,-2.399,35,-302,1,85,H1
"Lowndes County, AL",2012-2013,10864,10730,-134,-1.233,14,-148,1,85,H1
"Lowndes County, AL",2013-2014,10730,10580,-150,-1.398,5,-155,1,85,H1
"Lowndes County, AL",2014-2015,10555,10458,-97,-0.919,-28,-69,1,85,H1
"Lowndes County, AL",2015-2016,10458,10241,-217,-2.075,-6,-211,1,85,H1
"Lowndes County, AL",2016-2017,10241,10076,-165,-1.611,-27,-138,1,85,H1
"Macon County, AL",2000-2001,24047,23925,-122,-0.507,-27,-95,1,87,H1
"Macon County, AL",2001-2002,23925,23563,-362,-1.513,-5,-357,1,87,H1
"Macon County, AL",2002-2003,23563,23110,-453,-1.923,-19,-434,1,87,H1
"Macon County, AL",2003-2004,23110,22685,-425,-1.839,-48,-377,1,87,H1
"Macon County, AL",2004-2005,22685,22388,-297,-1.309,-9,-288,1,87,H1
"Macon County, AL",2005-2006,22388,22227,-161,-0.719,-3,-158,1,87,H1
"Macon County, AL",2006-2007,22227,21942,-285,-1.282,-38,-247,1,87,H1
"Macon County, AL",2007-2008,21942,21597,-345,-1.572,-15,-330,1,87,H1
"Macon County, AL",2008-2009,21597,21190,-407,-1.885,-27,-380,1,87,H1
"Macon County, AL",2009-2010,21190,21542,352,1.661,-37,389,1,87,H1
"Macon County, AL",2010-2011,21542,21264,-278,-1.291,-19,-259,1,87,H1
"Macon County, AL",2011-2012,21264,20470,-794,-3.734,-12,-782,1,87,H1
"Macon County, AL",2012-2013,20470,19822,-648,-3.166,-61,-587,1,87,H1
"Macon County, AL",2013-2014,19822,19425,-397,-2.003,-82,-315,1,87,H1
"Macon County, AL",2014-2015,19387,19105,-282,-1.455,-69,-213,1,87,H1
"Macon County, AL",2015-2016,19105,19072,-33,-0.173,-69,36,1,87,H1
"Macon County, AL",2016-2017,19072,18755,-317,-1.662,-73,-244,1,87,H1
"Madison County, AL",2000-2001,278006,281517,3511,1.263,1503,2008,1,89,H1
"Madison County, AL",2001-2002,281517,286439,4922,1.748,1346,3576,1,89,H1
"Madison County, AL",2002-2003,286439,291342,4903,1.712,1374,3529,1,89,H1
"Madison County, AL",2003-2004,291342,295655,4313,1.48,1246,3067,1,89,H1
"Madison County, AL",2004-2005,295655,301474,5819,1.968,1463,4356,1,89,H1
"Madison County, AL",2005-2006,301474,309170,7696,2.553,1578,6118,1,89,H1
"Madison County, AL",2006-2007,309170,315859,6689,2.164,1678,5011,1,89,H1
"Madison County, AL",2007-2008,315859,323526,7667,2.427,1781,5886,1,89,H1
"Madison County, AL",2008-2009,323526,330856,7330,2.266,1695,5635,1,89,H1
"Madison County, AL",2009-2010,330856,336239,5383,1.627,1524,3859,1,89,H1
"Madison County, AL",2010-2011,336239,339668,3429,1.02,1535,1894,1,89,H1
"Madison County, AL",2011-2012,339668,342868,3200,0.942,1459,1741,1,89,H1
"Madison County, AL",2012-2013,342868,347073,4205,1.226,1232,2973,1,89,H1
"Madison County, AL",2013-2014,347073,350299,3226,0.929,1232,1994,1,89,H1
"Madison County, AL",2014-2015,350112,353089,2977,0.85,1285,1692,1,89,H1
"Madison County, AL",2015-2016,353089,356312,3223,0.913,975,2248,1,89,H1
"Madison County, AL",2016-2017,356312,361046,4734,1.329,981,3753,1,89,H1
"Marengo County, AL",2000-2001,22564,22203,-361,-1.6,89,-450,1,91,H1
"Marengo County, AL",2001-2002,22203,22217,14,0.063,60,-46,1,91,H1
"Marengo County, AL",2002-2003,22217,22025,-192,-0.864,41,-233,1,91,H1
"Marengo County, AL",2003-2004,22025,21777,-248,-1.126,26,-274,1,91,H1
"Marengo County, AL",2004-2005,21777,21569,-208,-0.955,22,-230,1,91,H1
"Marengo County, AL",2005-2006,21569,21531,-38,-0.176,5,-43,1,91,H1
"Marengo County, AL",2006-2007,21531,21475,-56,-0.26,10,-66,1,91,H1
"Marengo County, AL",2007-2008,21475,21331,-144,-0.671,53,-197,1,91,H1
"Marengo County, AL",2008-2009,21331,21170,-161,-0.755,36,-197,1,91,H1
"Marengo County, AL",2009-2010,21170,20951,-219,-1.034,29,-248,1,91,H1
"Marengo County, AL",2010-2011,20951,20711,-240,-1.146,-14,-226,1,91,H1
"Marengo County, AL",2011-2012,20711,20443,-268,-1.294,27,-295,1,91,H1
"Marengo County, AL",2012-2013,20443,20228,-215,-1.052,-23,-192,1,91,H1
"Marengo County, AL",2013-2014,20228,20110,-118,-0.583,-17,-101,1,91,H1
"Marengo County, AL",2014-2015,20136,20028,-108,-0.536,5,-113,1,91,H1
"Marengo County, AL",2015-2016,20028,19505,-523,-2.611,-11,-512,1,91,H1
"Marengo County, AL",2016-2017,19505,19375,-130,-0.666,-34,-96,1,91,H1
"Marion County, AL",2000-2001,31137,30777,-360,-1.156,-66,-294,1,93,H1
"Marion County, AL",2001-2002,30777,30608,-169,-0.549,12,-181,1,93,H1
"Marion County, AL",2002-2003,30608,30554,-54,-0.176,-38,-16,1,93,H1
"Marion County, AL",2003-2004,30554,30516,-38,-0.124,-41,3,1,93,H1
"Marion County, AL",2004-2005,30516,30494,-22,-0.072,-50,28,1,93,H1
"Marion County, AL",2005-2006,30494,30779,285,0.935,-43,328,1,93,H1
"Marion County, AL",2006-2007,30779,30849,70,0.227,3,67,1,93,H1
"Marion County, AL",2007-2008,30849,30918,69,0.224,-41,110,1,93,H1
"Marion County, AL",2008-2009,30918,30646,-272,-0.88,-19,-253,1,93,H1
"Marion County, AL",2009-2010,30646,30810,164,0.535,-52,216,1,93,H1
"Marion County, AL",2010-2011,30810,30731,-79,-0.256,-136,57,1,93,H1
"Marion County, AL",2011-2012,30731,30516,-215,-0.7,-87,-128,1,93,H1
"Marion County, AL",2012-2013,30516,30305,-211,-0.691,-84,-127,1,93,H1
"Marion County, AL",2013-2014,30305,30271,-34,-0.112,-74,40,1,93,H1
"Marion County, AL",2014-2015,30246,30168,-78,-0.258,-84,6,1,93,H1
"Marion County, AL",2015-2016,30168,29922,-246,-0.815,-131,-115,1,93,H1
"Marion County, AL",2016-2017,29922,29833,-89,-0.297,-88,-1,1,93,H1
"Marshall County, AL",2000-2001,82429,82477,48,0.058,277,-229,1,95,H1
"Marshall County, AL",2001-2002,82477,83417,940,1.14,315,625,1,95,H1
"Marshall County, AL",2002-2003,83417,84348,931,1.116,368,563,1,95,H1
"Marshall County, AL",2003-2004,84348,85131,783,0.928,457,326,1,95,H1
"Marshall County, AL",2004-2005,85131,86516,1385,1.627,463,922,1,95,H1
"Marshall County, AL",2005-2006,86516,88209,1693,1.957,471,1222,1,95,H1
"Marshall County, AL",2006-2007,88209,89605,1396,1.583,536,860,1,95,H1
"Marshall County, AL",2007-2008,89605,91072,1467,1.637,517,950,1,95,H1
"Marshall County, AL",2008-2009,91072,92213,1141,1.253,530,611,1,95,H1
"Marshall County, AL",2009-2010,92213,93170,957,1.038,461,496,1,95,H1
"Marshall County, AL",2010-2011,93170,93927,757,0.812,297,460,1,95,H1
"Marshall County, AL",2011-2012,93927,94303,376,0.4,235,141,1,95,H1
"Marshall County, AL",2012-2013,94303,94569,266,0.282,115,151,1,95,H1
"Marshall County, AL",2013-2014,94569,94636,67,0.071,129,-62,1,95,H1
"Marshall County, AL",2014-2015,94356,94725,369,0.391,128,241,1,95,H1
"Marshall County, AL",2015-2016,94725,95043,318,0.336,184,134,1,95,H1
"Marshall County, AL",2016-2017,95043,95548,505,0.531,189,316,1,95,H1
"Mobile County, AL",2000-2001,400073,400129,56,0.014,2191,-2135,1,97,H1
"Mobile County, AL",2001-2002,400129,398549,-1580,-0.395,2046,-3626,1,97,H1
"Mobile County, AL",2002-2003,398549,398082,-467,-0.117,1864,-2331,1,97,H1
"Mobile County, AL",2003-2004,398082,397959,-123,-0.031,1741,-1864,1,97,H1
"Mobile County, AL",2004-2005,397959,398942,983,0.247,1863,-880,1,97,H1
"Mobile County, AL",2005-2006,398942,402916,3974,0.996,1886,2088,1,97,H1
"Mobile County, AL",2006-2007,402916,405715,2799,0.695,2295,504,1,97,H1
"Mobile County, AL",2007-2008,405715,409196,3481,0.858,2174,1307,1,97,H1
"Mobile County, AL",2008-2009,409196,411994,2798,0.684,2026,772,1,97,H1
"Mobile County, AL",2009-2010,411994,413432,1438,0.349,2004,-566,1,97,H1
"Mobile County, AL",2010-2011,413432,413154,-278,-0.067,1469,-1747,1,97,H1
"Mobile County, AL",2011-2012,413154,413955,801,0.194,1623,-822,1,97,H1
"Mobile County, AL",2012-2013,413955,414560,605,0.146,1127,-522,1,97,H1
"Mobile County, AL",2013-2014,414560,415123,563,0.136,1211,-648,1,97,H1
"Mobile County, AL",2014-2015,414926,415395,469,0.113,1242,-773,1,97,H1
"Mobile County, AL",2015-2016,415395,414852,-543,-0.131,1124,-1667,1,97,H1
"Mobile County, AL",2016-2017,414852,413955,-897,-0.216,994,-1891,1,97,H1
"Monroe County, AL",2000-2001,24319,24120,-199,-0.818,76,-275,1,99,H1
"Monroe County, AL",2001-2002,24120,24022,-98,-0.406,101,-199,1,99,H1
"Monroe County, AL",2002-2003,24022,23853,-169,-0.704,31,-200,1,99,H1
"Monroe County, AL",2003-2004,23853,23769,-84,-0.352,52,-136,1,99,H1
"Monroe County, AL",2004-2005,23769,23683,-86,-0.362,23,-109,1,99,H1
"Monroe County, AL",2005-2006,23683,23602,-81,-0.342,34,-115,1,99,H1
"Monroe County, AL",2006-2007,23602,23437,-165,-0.699,41,-206,1,99,H1
"Monroe County, AL",2007-2008,23437,23393,-44,-0.188,56,-100,1,99,H1
"Monroe County, AL",2008-2009,23393,23218,-175,-0.748,35,-210,1,99,H1
"Monroe County, AL",2009-2010,23218,23003,-215,-0.926,5,-220,1,99,H1
"Monroe County, AL",2010-2011,23003,22797,-206,-0.896,-6,-200,1,99,H1
"Monroe County, AL",2011-2012,22797,22609,-188,-0.825,-42,-146,1,99,H1
"Monroe County, AL",2012-2013,22609,22188,-421,-1.862,-11,-410,1,99,H1
"Monroe County, AL",2013-2014,22188,21947,-241,-1.086,-27,-214,1,99,H1
"Monroe County, AL",2014-2015,21897,21673,-224,-1.023,-56,-168,1,99,H1
"Monroe County, AL",2015-2016,21673,21572,-101,-0.466,-11,-90,1,99,H1
"Monroe County, AL",2016-2017,21572,21327,-245,-1.136,-35,-210,1,99,H1
"Montgomery County, AL",2000-2001,223428,223048,-380,-0.17,1541,-1921,1,101,H1
"Montgomery County, AL",2001-2002,223048,223185,137,0.061,1297,-1160,1,101,H1
"Montgomery County, AL",2002-2003,223185,222680,-505,-0.226,1207,-1712,1,101,H1
"Montgomery County, AL",2003-2004,222680,223002,322,0.145,1133,-811,1,101,H1
"Montgomery County, AL",2004-2005,223002,223608,606,0.272,1175,-569,1,101,H1
"Montgomery County, AL",2005-2006,223608,227291,3683,1.647,1282,2401,1,101,H1
"Montgomery County, AL",2006-2007,227291,227888,597,0.263,1480,-883,1,101,H1
"Montgomery County, AL",2007-2008,227888,227461,-427,-0.187,1336,-1763,1,101,H1
"Montgomery County, AL",2008-2009,227461,227607,146,0.064,1288,-1142,1,101,H1
"Montgomery County, AL",2009-2010,227607,229795,2188,0.961,1481,707,1,101,H1
"Montgomery County, AL",2010-2011,229795,231571,1776,0.773,1235,541,1,101,H1
"Montgomery County, AL",2011-2012,231571,229426,-2145,-0.926,1168,-3313,1,101,H1
"Montgomery County, AL",2012-2013,229426,227271,-2155,-0.939,986,-3141,1,101,H1
"Montgomery County, AL",2013-2014,227271,226189,-1082,-0.476,910,-1992,1,101,H1
"Montgomery County, AL",2014-2015,226389,226519,130,0.057,1002,-872,1,101,H1
"Montgomery County, AL",2015-2016,226519,226716,197,0.087,941,-744,1,101,H1
"Montgomery County, AL",2016-2017,226716,226646,-70,-0.031,880,-950,1,101,H1
"Morgan County, AL",2000-2001,111221,111682,461,0.414,487,-26,1,103,H1
"Morgan County, AL",2001-2002,111682,111766,84,0.075,370,-286,1,103,H1
"Morgan County, AL",2002-2003,111766,112898,1132,1.013,501,631,1,103,H1
"Morgan County, AL",2003-2004,112898,113006,108,0.096,418,-310,1,103,H1
"Morgan County, AL",2004-2005,113006,113964,958,0.848,423,535,1,103,H1
"Morgan County, AL",2005-2006,113964,115491,1527,1.34,406,1121,1,103,H1
"Morgan County, AL",2006-2007,115491,116397,906,0.784,391,515,1,103,H1
"Morgan County, AL",2007-2008,116397,117694,1297,1.114,449,848,1,103,H1
"Morgan County, AL",2008-2009,117694,118954,1260,1.071,437,823,1,103,H1
"Morgan County, AL",2009-2010,118954,119557,603,0.507,373,230,1,103,H1
"Morgan County, AL",2010-2011,119557,119870,313,0.262,265,48,1,103,H1
"Morgan County, AL",2011-2012,119870,120057,187,0.156,175,12,1,103,H1
"Morgan County, AL",2012-2013,120057,119628,-429,-0.357,164,-593,1,103,H1
"Morgan County, AL",2013-2014,119628,119607,-21,-0.018,170,-191,1,103,H1
"Morgan County, AL",2014-2015,119656,119565,-91,-0.076,207,-298,1,103,H1
"Morgan County, AL",2015-2016,119565,118819,-746,-0.624,59,-805,1,103,H1
"Morgan County, AL",2016-2017,118819,118818,-1,-0.001,118,-119,1,103,H1
"Perry County, AL",2000-2001,11809,11645,-164,-1.389,64,-228,1,105,H1
"Perry County, AL",2001-2002,11645,11549,-96,-0.824,20,-116,1,105,H1
"Perry County, AL",2002-2003,11549,11301,-248,-2.147,13,-261,1,105,H1
"Perry County, AL",2003-2004,11301,11153,-148,-1.31,58,-206,1,105,H1
"Perry County, AL",2004-2005,11153,10881,-272,-2.439,16,-288,1,105,H1
"Perry County, AL",2005-2006,10881,10677,-204,-1.875,1,-205,1,105,H1
"Perry County, AL",2006-2007,10677,10774,97,0.908,15,82,1,105,H1
"Perry County, AL",2007-2008,10774,10722,-52,-0.483,52,-104,1,105,H1
"Perry County, AL",2008-2009,10722,10690,-32,-0.298,-8,-24,1,105,H1
"Perry County, AL",2009-2010,10690,10536,-154,-1.441,-8,-146,1,105,H1
"Perry County, AL",2010-2011,10536,10502,-34,-0.323,-11,-23,1,105,H1
"Perry County, AL",2011-2012,10502,10172,-330,-3.142,-18,-312,1,105,H1
"Perry County, AL",2012-2013,10172,9978,-194,-1.907,-14,-180,1,105,H1
"Perry County, AL",2013-2014,9978,9826,-152,-1.523,-43,-109,1,105,H1
"Perry County, AL",2014-2015,9855,9652,-203,-2.06,-45,-158,1,105,H1
"Perry County, AL",2015-2016,9652,9570,-82,-0.85,30,-112,1,105,H1
"Perry County, AL",2016-2017,9570,9339,-231,-2.414,-3,-228,1,105,H1
"Pickens County, AL",2000-2001,20881,20873,-8,-0.038,35,-43,1,107,H1
"Pickens County, AL",2001-2002,20873,20835,-38,-0.182,27,-65,1,107,H1
"Pickens County, AL",2002-2003,20835,20527,-308,-1.478,-32,-276,1,107,H1
"Pickens County, AL",2003-2004,20527,20380,-147,-0.716,-17,-130,1,107,H1
"Pickens County, AL",2004-2005,20380,20192,-188,-0.922,0,-188,1,107,H1
"Pickens County, AL",2005-2006,20192,20128,-64,-0.317,-48,-16,1,107,H1
"Pickens County, AL",2006-2007,20128,19989,-139,-0.691,-27,-112,1,107,H1
"Pickens County, AL",2007-2008,19989,19951,-38,-0.19,-7,-31,1,107,H1
"Pickens County, AL",2008-2009,19951,19814,-137,-0.687,-20,-117,1,107,H1
"Pickens County, AL",2009-2010,19814,19706,-108,-0.545,-45,-63,1,107,H1
"Pickens County, AL",2010-2011,19706,19348,-358,-1.817,-45,-313,1,107,H1
"Pickens County, AL",2011-2012,19348,19344,-4,-0.021,-15,11,1,107,H1
"Pickens County, AL",2012-2013,19344,19383,39,0.202,-38,77,1,107,H1
"Pickens County, AL",2013-2014,19383,20365,982,5.066,-10,992,1,107,H1
"Pickens County, AL",2014-2015,20339,20864,525,2.581,-18,543,1,107,H1
"Pickens County, AL",2015-2016,20864,20315,-549,-2.631,-22,-527,1,107,H1
"Pickens County, AL",2016-2017,20315,20176,-139,-0.684,-25,-114,1,107,H1
"Pike County, AL",2000-2001,29748,29844,96,0.323,124,-28,1,109,H1
"Pike County, AL",2001-2002,29844,29695,-149,-0.499,55,-204,1,109,H1
"Pike County, AL",2002-2003,29695,30050,355,1.195,76,279,1,109,H1
"Pike County, AL",2003-2004,30050,30593,543,1.807,109,434,1,109,H1
"Pike County, AL",2004-2005,30593,30772,179,0.585,76,103,1,109,H1
"Pike County, AL",2005-2006,30772,31309,537,1.745,33,504,1,109,H1
"Pike County, AL",2006-2007,31309,31761,452,1.444,109,343,1,109,H1
"Pike County, AL",2007-2008,31761,32149,388,1.222,150,238,1,109,H1
"Pike County, AL",2008-2009,32149,32560,411,1.278,111,300,1,109,H1
"Pike County, AL",2009-2010,32560,32959,399,1.225,90,309,1,109,H1
"Pike County, AL",2010-2011,32959,32922,-37,-0.112,65,-102,1,109,H1
"Pike County, AL",2011-2012,32922,33128,206,0.626,100,106,1,109,H1
"Pike County, AL",2012-2013,33128,33682,554,1.672,17,537,1,109,H1
"Pike County, AL",2013-2014,33682,33389,-293,-0.87,15,-308,1,109,H1
"Pike County, AL",2014-2015,33090,33046,-44,-0.133,31,-75,1,109,H1
"Pike County, AL",2015-2016,33046,33215,169,0.511,109,60,1,109,H1
"Pike County, AL",2016-2017,33215,33267,52,0.157,48,4,1,109,H1
"Randolph County, AL",2000-2001,22377,22465,88,0.393,13,75,1,111,H1
"Randolph County, AL",2001-2002,22465,22464,-1,-0.004,-21,20,1,111,H1
"Randolph County, AL",2002-2003,22464,22359,-105,-0.467,10,-115,1,111,H1
"Randolph County, AL",2003-2004,22359,22525,166,0.742,-17,183,1,111,H1
"Randolph County, AL",2004-2005,22525,22658,133,0.59,-11,144,1,111,H1
"Randolph County, AL",2005-2006,22658,22695,37,0.163,2,35,1,111,H1
"Randolph County, AL",2006-2007,22695,22662,-33,-0.145,16,-49,1,111,H1
"Randolph County, AL",2007-2008,22662,22946,284,1.253,-4,288,1,111,H1
"Randolph County, AL",2008-2009,22946,22864,-82,-0.357,2,-84,1,111,H1
"Randolph County, AL",2009-2010,22864,22928,64,0.28,-22,86,1,111,H1
"Randolph County, AL",2010-2011,22928,22834,-94,-0.41,-79,-15,1,111,H1
"Randolph County, AL",2011-2012,22834,22657,-177,-0.775,-15,-162,1,111,H1
"Randolph County, AL",2012-2013,22657,22663,6,0.026,-6,12,1,111,H1
"Randolph County, AL",2013-2014,22663,22539,-124,-0.547,-23,-101,1,111,H1
"Randolph County, AL",2014-2015,22486,22696,210,0.934,-26,236,1,111,H1
"Randolph County, AL",2015-2016,22696,22498,-198,-0.872,-65,-133,1,111,H1
"Randolph County, AL",2016-2017,22498,22670,172,0.765,-48,220,1,111,H1
"Russell County, AL",2000-2001,49805,49622,-183,-0.367,63,-246,1,113,H1
"Russell County, AL",2001-2002,49622,49489,-133,-0.268,72,-205,1,113,H1
"Russell County, AL",2002-2003,49489,49065,-424,-0.857,71,-495,1,113,H1
"Russell County, AL",2003-2004,49065,49498,433,0.883,34,399,1,113,H1
"Russell County, AL",2004-2005,49498,49731,233,0.471,169,64,1,113,H1
"Russell County, AL",2005-2006,49731,50459,728,1.464,151,577,1,113,H1
"Russell County, AL",2006-2007,50459,51074,615,1.219,191,424,1,113,H1
"Russell County, AL",2007-2008,51074,51434,360,0.705,20,340,1,113,H1
"Russell County, AL",2008-2009,51434,52162,728,1.415,128,600,1,113,H1
"Russell County, AL",2009-2010,52162,53279,1117,2.141,179,938,1,113,H1
"Russell County, AL",2010-2011,53279,54845,1566,2.939,228,1338,1,113,H1
"Russell County, AL",2011-2012,54845,57736,2891,5.271,330,2561,1,113,H1
"Russell County, AL",2012-2013,57736,59430,1694,2.934,317,1377,1,113,H1
"Russell County, AL",2013-2014,59430,59608,178,0.3,320,-142,1,113,H1
"Russell County, AL",2014-2015,59712,59660,-52,-0.087,277,-329,1,113,H1
"Russell County, AL",2015-2016,59660,58177,-1483,-2.486,178,-1661,1,113,H1
"Russell County, AL",2016-2017,58177,57045,-1132,-1.946,179,-1311,1,113,H1
"St. Clair County, AL",2000-2001,65080,66093,1013,1.557,276,737,1,115,H1
"St. Clair County, AL",2001-2002,66093,67274,1181,1.787,270,911,1,115,H1
"St. Clair County, AL",2002-2003,67274,68629,1355,2.014,56,1299,1,115,H1
"St. Clair County, AL",2003-2004,68629,70416,1787,2.604,100,1687,1,115,H1
"St. Clair County, AL",2004-2005,70416,72596,2180,3.096,239,1941,1,115,H1
"St. Clair County, AL",2005-2006,72596,75948,3352,4.617,250,3102,1,115,H1
"St. Clair County, AL",2006-2007,75948,79348,3400,4.477,317,3083,1,115,H1
"St. Clair County, AL",2007-2008,79348,81223,1875,2.363,332,1543,1,115,H1
"St. Clair County, AL",2008-2009,81223,83009,1786,2.199,208,1578,1,115,H1
"St. Clair County, AL",2009-2010,83009,83800,791,0.953,105,686,1,115,H1
"St. Clair County, AL",2010-2011,83800,84305,505,0.603,274,231,1,115,H1
"St. Clair County, AL",2011-2012,84305,85165,860,1.02,258,602,1,115,H1
"St. Clair County, AL",2012-2013,85165,86244,1079,1.267,171,908,1,115,H1
"St. Clair County, AL",2013-2014,86244,86697,453,0.525,190,263,1,115,H1
"St. Clair County, AL",2014-2015,86561,87074,513,0.593,122,391,1,115,H1
"St. Clair County, AL",2015-2016,87074,87482,408,0.469,95,313,1,115,H1
"St. Clair County, AL",2016-2017,87482,88199,717,0.82,68,649,1,115,H1
"Shelby County, AL",2000-2001,144674,149358,4684,3.238,1431,3253,1,117,H1
"Shelby County, AL",2001-2002,149358,153976,4618,3.092,1516,3102,1,117,H1
"Shelby County, AL",2002-2003,153976,159704,5728,3.72,1419,4309,1,117,H1
"Shelby County, AL",2003-2004,159704,165757,6053,3.79,1486,4567,1,117,H1
"Shelby County, AL",2004-2005,165757,171691,5934,3.58,1542,4392,1,117,H1
"Shelby County, AL",2005-2006,171691,178841,7150,4.164,1543,5607,1,117,H1
"Shelby County, AL",2006-2007,178841,183491,4650,2.6,1595,3055,1,117,H1
"Shelby County, AL",2007-2008,183491,188534,5043,2.748,1620,3423,1,117,H1
"Shelby County, AL",2008-2009,188534,192708,4174,2.214,1703,2471,1,117,H1
"Shelby County, AL",2009-2010,192708,196036,3328,1.727,1615,1713,1,117,H1
"Shelby County, AL",2010-2011,196036,197988,1952,0.996,1218,734,1,117,H1
"Shelby County, AL",2011-2012,197988,200963,2975,1.503,1093,1882,1,117,H1
"Shelby County, AL",2012-2013,200963,204196,3233,1.609,1070,2163,1,117,H1
"Shelby County, AL",2013-2014,204196,206655,2459,1.204,1055,1404,1,117,H1
"Shelby County, AL",2014-2015,206199,208713,2514,1.219,909,1605,1,117,H1
"Shelby County, AL",2015-2016,208713,211073,2360,1.131,956,1404,1,117,H1
"Shelby County, AL",2016-2017,211073,213605,2532,1.2,829,1703,1,117,H1
"Sumter County, AL",2000-2001,14746,14630,-116,-0.787,42,-158,1,119,H1
"Sumter County, AL",2001-2002,14630,14376,-254,-1.736,16,-270,1,119,H1
"Sumter County, AL",2002-2003,14376,14329,-47,-0.327,15,-62,1,119,H1
"Sumter County, AL",2003-2004,14329,14324,-5,-0.035,27,-32,1,119,H1
"Sumter County, AL",2004-2005,14324,14143,-181,-1.264,-23,-158,1,119,H1
"Sumter County, AL",2005-2006,14143,14059,-84,-0.594,30,-114,1,119,H1
"Sumter County, AL",2006-2007,14059,13926,-133,-0.946,31,-164,1,119,H1
"Sumter County, AL",2007-2008,13926,13882,-44,-0.316,17,-61,1,119,H1
"Sumter County, AL",2008-2009,13882,13746,-136,-0.98,4,-140,1,119,H1
"Sumter County, AL",2009-2010,13746,13748,2,0.015,0,2,1,119,H1
"Sumter County, AL",2010-2011,13748,13494,-254,-1.848,-32,-222,1,119,H1
"Sumter County, AL",2011-2012,13494,13411,-83,-0.615,-28,-55,1,119,H1
"Sumter County, AL",2012-2013,13411,13345,-66,-0.492,-14,-52,1,119,H1
"Sumter County, AL",2013-2014,13345,13166,-179,-1.341,-22,-157,1,119,H1
"Sumter County, AL",2014-2015,13243,13103,-140,-1.057,-5,-135,1,119,H1
"Sumter County, AL",2015-2016,13103,12932,-171,-1.305,4,-175,1,119,H1
"Sumter County, AL",2016-2017,12932,12687,-245,-1.895,-18,-227,1,119,H1
"Talladega County, AL",2000-2001,80772,80939,167,0.207,244,-77,1,121,H1
"Talladega County, AL",2001-2002,80939,81095,156,0.193,171,-15,1,121,H1
"Talladega County, AL",2002-2003,81095,80900,-195,-0.24,97,-292,1,121,H1
"Talladega County, AL",2003-2004,80900,81139,239,0.295,106,133,1,121,H1
"Talladega County, AL",2004-2005,81139,81546,407,0.502,99,308,1,121,H1
"Talladega County, AL",2005-2006,81546,81991,445,0.546,98,347,1,121,H1
"Talladega County, AL",2006-2007,81991,82226,235,0.287,100,135,1,121,H1
"Talladega County, AL",2007-2008,82226,82735,509,0.619,182,327,1,121,H1
"Talladega County, AL",2008-2009,82735,82674,-61,-0.074,107,-168,1,121,H1
"Talladega County, AL",2009-2010,82674,82067,-607,-0.734,78,-685,1,121,H1
"Talladega County, AL",2010-2011,82067,81781,-286,-0.348,-75,-211,1,121,H1
"Talladega County, AL",2011-2012,81781,81858,77,0.094,-50,127,1,121,H1
"Talladega County, AL",2012-2013,81858,81339,-519,-0.634,-174,-345,1,121,H1
"Talladega County, AL",2013-2014,81339,81322,-17,-0.021,-153,136,1,121,H1
"Talladega County, AL",2014-2015,81258,80862,-396,-0.487,-147,-249,1,121,H1
"Talladega County, AL",2015-2016,80862,80386,-476,-0.589,-227,-249,1,121,H1
"Talladega County, AL",2016-2017,80386,80065,-321,-0.399,-206,-115,1,121,H1
"Tallapoosa County, AL",2000-2001,41689,41406,-283,-0.679,-30,-253,1,123,H1
"Tallapoosa County, AL",2001-2002,41406,41044,-362,-0.874,-133,-229,1,123,H1
"Tallapoosa County, AL",2002-2003,41044,40898,-146,-0.356,-25,-121,1,123,H1
"Tallapoosa County, AL",2003-2004,40898,40904,6,0.015,-81,87,1,123,H1
"Tallapoosa County, AL",2004-2005,40904,40857,-47,-0.115,-100,53,1,123,H1
"Tallapoosa County, AL",2005-2006,40857,41243,386,0.945,-26,412,1,123,H1
"Tallapoosa County, AL",2006-2007,41243,41414,171,0.415,25,146,1,123,H1
"Tallapoosa County, AL",2007-2008,41414,41668,254,0.613,20,234,1,123,H1
"Tallapoosa County, AL",2008-2009,41668,41831,163,0.391,-86,249,1,123,H1
"Tallapoosa County, AL",2009-2010,41831,41490,-341,-0.815,-69,-272,1,123,H1
"Tallapoosa County, AL",2010-2011,41490,41443,-47,-0.113,-39,-8,1,123,H1
"Tallapoosa County, AL",2011-2012,41443,41156,-287,-0.693,-30,-257,1,123,H1
"Tallapoosa County, AL",2012-2013,41156,41221,65,0.158,-76,141,1,123,H1
"Tallapoosa County, AL",2013-2014,41221,41165,-56,-0.136,-63,7,1,123,H1
"Tallapoosa County, AL",2014-2015,41112,40844,-268,-0.652,-57,-211,1,123,H1
"Tallapoosa County, AL",2015-2016,40844,40574,-270,-0.661,-88,-182,1,123,H1
"Tallapoosa County, AL",2016-2017,40574,40681,107,0.264,-109,216,1,123,H1
"Tuscaloosa County, AL",2000-2001,165414,166951,1537,0.929,795,742,1,125,H1
"Tuscaloosa County, AL",2001-2002,166951,168154,1203,0.721,744,459,1,125,H1
"Tuscaloosa County, AL",2002-2003,168154,169725,1571,0.934,577,994,1,125,H1
"Tuscaloosa County, AL",2003-2004,169725,171960,2235,1.317,639,1596,1,125,H1
"Tuscaloosa County, AL",2004-2005,171960,175731,3771,2.193,764,3007,1,125,H1
"Tuscaloosa County, AL",2005-2006,175731,181383,5652,3.216,773,4879,1,125,H1
"Tuscaloosa County, AL",2006-2007,181383,184350,2967,1.636,961,2006,1,125,H1
"Tuscaloosa County, AL",2007-2008,184350,188093,3743,2.03,897,2846,1,125,H1
"Tuscaloosa County, AL",2008-2009,188093,192792,4699,2.498,863,3836,1,125,H1
"Tuscaloosa County, AL",2009-2010,192792,195056,2264,1.174,937,1327,1,125,H1
"Tuscaloosa County, AL",2010-2011,195056,196697,1641,0.841,678,963,1,125,H1
"Tuscaloosa County, AL",2011-2012,196697,198643,1946,0.989,863,1083,1,125,H1
"Tuscaloosa County, AL",2012-2013,198643,200744,2101,1.058,766,1335,1,125,H1
"Tuscaloosa County, AL",2013-2014,200744,202212,1468,0.731,788,680,1,125,H1
"Tuscaloosa County, AL",2014-2015,202519,203976,1457,0.719,736,721,1,125,H1
"Tuscaloosa County, AL",2015-2016,203976,206282,2306,1.131,824,1482,1,125,H1
"Tuscaloosa County, AL",2016-2017,206282,207811,1529,0.741,738,791,1,125,H1
"Walker County, AL",2000-2001,70602,70364,-238,-0.337,83,-321,1,127,H1
"Walker County, AL",2001-2002,70364,69765,-599,-0.851,-43,-556,1,127,H1
"Walker County, AL",2002-2003,69765,69105,-660,-0.946,-80,-580,1,127,H1
"Walker County, AL",2003-2004,69105,68629,-476,-0.689,-133,-343,1,127,H1
"Walker County, AL",2004-2005,68629,68500,-129,-0.188,-90,-39,1,127,H1
"Walker County, AL",2005-2006,68500,68234,-266,-0.388,-151,-115,1,127,H1
"Walker County, AL",2006-2007,68234,67695,-539,-0.79,38,-577,1,127,H1
"Walker County, AL",2007-2008,67695,67835,140,0.207,-114,254,1,127,H1
"Walker County, AL",2008-2009,67835,67347,-488,-0.719,-113,-375,1,127,H1
"Walker County, AL",2009-2010,67347,66991,-356,-0.529,-201,-155,1,127,H1
"Walker County, AL",2010-2011,66991,66607,-384,-0.573,-96,-288,1,127,H1
"Walker County, AL",2011-2012,66607,66125,-482,-0.724,-202,-280,1,127,H1
"Walker County, AL",2012-2013,66125,65859,-266,-0.402,-242,-24,1,127,H1
"Walker County, AL",2013-2014,65859,65471,-388,-0.589,-183,-205,1,127,H1
"Walker County, AL",2014-2015,65567,65294,-273,-0.416,-156,-117,1,127,H1
"Walker County, AL",2015-2016,65294,64561,-733,-1.123,-184,-549,1,127,H1
"Walker County, AL",2016-2017,64561,64058,-503,-0.779,-197,-306,1,127,H1
"Washington County, AL",2000-2001,18101,17933,-168,-0.928,68,-236,1,129,H1
"Washington County, AL",2001-2002,17933,17895,-38,-0.212,75,-113,1,129,H1
"Washington County, AL",2002-2003,17895,17910,15,0.084,60,-45,1,129,H1
"Washington County, AL",2003-2004,17910,17801,-109,-0.609,17,-126,1,129,H1
"Washington County, AL",2004-2005,17801,17690,-111,-0.624,28,-139,1,129,H1
"Washington County, AL",2005-2006,17690,17705,15,0.085,35,-20,1,129,H1
"Washington County, AL",2006-2007,17705,17491,-214,-1.209,33,-247,1,129,H1
"Washington County, AL",2007-2008,17491,17496,5,0.029,48,-43,1,129,H1
"Washington County, AL",2008-2009,17496,17493,-3,-0.017,32,-35,1,129,H1
"Washington County, AL",2009-2010,17493,17601,108,0.617,20,88,1,129,H1
"Washington County, AL",2010-2011,17601,17319,-282,-1.602,-31,-251,1,129,H1
"Washington County, AL",2011-2012,17319,17088,-231,-1.334,-16,-215,1,129,H1
"Washington County, AL",2012-2013,17088,16842,-246,-1.44,-44,-202,1,129,H1
"Washington County, AL",2013-2014,16842,16834,-8,-0.048,-41,33,1,129,H1
"Washington County, AL",2014-2015,16863,16804,-59,-0.35,-55,-4,1,129,H1
"Washington County, AL",2015-2016,16804,16646,-158,-0.94,-8,-150,1,129,H1
"Washington County, AL",2016-2017,16646,16531,-115,-0.691,-31,-84,1,129,H1
"Wilcox County, AL",2000-2001,12939,12806,-133,-1.028,100,-233,1,131,H1
"Wilcox County, AL",2001-2002,12806,12778,-28,-0.219,64,-92,1,131,H1
"Wilcox County, AL",2002-2003,12778,12600,-178,-1.393,30,-208,1,131,H1
"Wilcox County, AL",2003-2004,12600,12493,-107,-0.849,76,-183,1,131,H1
"Wilcox County, AL",2004-2005,12493,12369,-124,-0.993,45,-169,1,131,H1
"Wilcox County, AL",2005-2006,12369,12221,-148,-1.197,49,-197,1,131,H1
"Wilcox County, AL",2006-2007,12221,12208,-13,-0.106,12,-25,1,131,H1
"Wilcox County, AL",2007-2008,12208,12148,-60,-0.491,45,-105,1,131,H1
"Wilcox County, AL",2008-2009,12148,11870,-278,-2.288,29,-307,1,131,H1
"Wilcox County, AL",2009-2010,11870,11579,-291,-2.452,5,-296,1,131,H1
"Wilcox County, AL",2010-2011,11579,11510,-69,-0.596,1,-70,1,131,H1
"Wilcox County, AL",2011-2012,11510,11386,-124,-1.077,-7,-117,1,131,H1
"Wilcox County, AL",2012-2013,11386,11262,-124,-1.089,-7,-117,1,131,H1
"Wilcox County, AL",2013-2014,11262,11098,-164,-1.456,-7,-157,1,131,H1
"Wilcox County, AL",2014-2015,11052,11059,7,0.063,4,3,1,131,H1
"Wilcox County, AL",2015-2016,11059,10875,-184,-1.664,22,-206,1,131,H1
"Wilcox County, AL",2016-2017,10875,10719,-156,-1.434,8,-164,1,131,H1
"Winston County, AL",2000-2001,24857,24597,-260,-1.046,12,-272,1,133,H1
"Winston County, AL",2001-2002,24597,24600,3,0.012,-45,48,1,133,H1
"Winston County, AL",2002-2003,24600,24576,-24,-0.098,-54,30,1,133,H1
"Winston County, AL",2003-2004,24576,24614,38,0.155,-6,44,1,133,H1
"Winston County, AL",2004-2005,24614,24629,15,0.061,13,2,1,133,H1
"Winston County, AL",2005-2006,24629,24796,167,0.678,-21,188,1,133,H1
"Winston County, AL",2006-2007,24796,24858,62,0.25,10,52,1,133,H1
"Winston County, AL",2007-2008,24858,24696,-162,-0.652,-28,-134,1,133,H1
"Winston County, AL",2008-2009,24696,24691,-5,-0.02,-55,50,1,133,H1
"Winston County, AL",2009-2010,24691,24409,-282,-1.142,-50,-232,1,133,H1
"Winston County, AL",2010-2011,24409,24348,-61,-0.25,-63,2,1,133,H1
"Winston County, AL",2011-2012,24348,24185,-163,-0.669,-69,-94,1,133,H1
"Winston County, AL",2012-2013,24185,24187,2,0.008,-62,64,1,133,H1
"Winston County, AL",2013-2014,24187,24150,-37,-0.153,-55,18,1,133,H1
"Winston County, AL",2014-2015,24101,23877,-224,-0.929,-60,-164,1,133,H1
"Winston County, AL",2015-2016,23877,23887,10,0.042,-82,92,1,133,H1
"Winston County, AL",2016-2017,23887,23722,-165,-0.691,-90,-75,1,133,H1
Arizona,2000-2001,5160586,5273477,112891,2.188,44770,68121,4,0,STATE
Arizona,2001-2002,5273477,5396255,122778,2.328,43647,79131,4,0,STATE
Arizona,2002-2003,5396255,5510364,114109,2.115,47041,67068,4,0,STATE
Arizona,2003-2004,5510364,5652404,142040,2.578,48462,93578,4,0,STATE
Arizona,2004-2005,5652404,5839077,186673,3.303,50802,135871,4,0,STATE
Arizona,2005-2006,5839077,6029141,190064,3.255,51818,138246,4,0,STATE
Arizona,2006-2007,6029141,6167681,138540,2.298,58405,80135,4,0,STATE
Arizona,2007-2008,6167681,6280362,112681,1.827,54595,58086,4,0,STATE
Arizona,2008-2009,6280362,6343154,62792,1,54299,8493,4,0,STATE
Arizona,2009-2010,6343154,6408208,65054,1.026,51998,13056,4,0,STATE
Arizona,2010-2011,6408208,6468732,60524,0.944,37952,22572,4,0,STATE
Arizona,2011-2012,6468732,6553262,84530,1.307,36807,47723,4,0,STATE
Arizona,2012-2013,6553262,6630799,77537,1.183,35511,42026,4,0,STATE
Arizona,2013-2014,6630799,6728783,97984,1.478,34408,63576,4,0,STATE
Arizona,2014-2015,6728783,6828065,99282,1.475,34152,65130,4,0,STATE
Arizona,2015-2016,6828065,6908642,80577,1.18,28086,52491,4,0,STATE
Arizona,2016-2017,6908642,7016270,107628,1.558,28081,79547,4,0,STATE
"Apache County, AZ",2000-2001,69507,67863,-1644,-2.365,724,-2368,4,1,H1
"Apache County, AZ",2001-2002,67863,67319,-544,-0.802,664,-1208,4,1,H1
"Apache County, AZ",2002-2003,67319,68072,753,1.119,759,-6,4,1,H1
"Apache County, AZ",2003-2004,68072,68161,89,0.131,825,-736,4,1,H1
"Apache County, AZ",2004-2005,68161,68521,360,0.528,798,-438,4,1,H1
"Apache County, AZ",2005-2006,68521,69390,869,1.268,708,161,4,1,H1
"Apache County, AZ",2006-2007,69390,69602,212,0.306,674,-462,4,1,H1
"Apache County, AZ",2007-2008,69602,69883,281,0.404,684,-403,4,1,H1
"Apache County, AZ",2008-2009,69883,71008,1125,1.61,822,303,4,1,H1
"Apache County, AZ",2009-2010,71008,71749,741,1.044,804,-63,4,1,H1
"Apache County, AZ",2010-2011,71749,72354,605,0.843,486,119,4,1,H1
"Apache County, AZ",2011-2012,72354,72911,557,0.77,468,89,4,1,H1
"Apache County, AZ",2012-2013,72911,71867,-1044,-1.432,421,-1465,4,1,H1
"Apache County, AZ",2013-2014,71867,71828,-39,-0.054,405,-444,4,1,H1
"Apache County, AZ",2014-2015,71858,71474,-384,-0.534,447,-831,4,1,H1
"Apache County, AZ",2015-2016,71474,71373,-101,-0.141,315,-416,4,1,H1
"Apache County, AZ",2016-2017,71373,71606,233,0.326,389,-156,4,1,H1
"Cochise County, AZ",2000-2001,118132,118798,666,0.564,597,69,4,3,H1
"Cochise County, AZ",2001-2002,118798,119847,1049,0.883,582,467,4,3,H1
"Cochise County, AZ",2002-2003,119847,120638,791,0.66,668,123,4,3,H1
"Cochise County, AZ",2003-2004,120638,123234,2596,2.152,657,1939,4,3,H1
"Cochise County, AZ",2004-2005,123234,125786,2552,2.071,728,1824,4,3,H1
"Cochise County, AZ",2005-2006,125786,127241,1455,1.157,567,888,4,3,H1
"Cochise County, AZ",2006-2007,127241,128206,965,0.758,799,166,4,3,H1
"Cochise County, AZ",2007-2008,128206,129023,817,0.637,710,107,4,3,H1
"Cochise County, AZ",2008-2009,129023,130081,1058,0.82,586,472,4,3,H1
"Cochise County, AZ",2009-2010,130081,131868,1787,1.374,674,1113,4,3,H1
"Cochise County, AZ",2010-2011,131868,133058,1190,0.902,557,633,4,3,H1
"Cochise County, AZ",2011-2012,133058,131919,-1139,-0.856,475,-1614,4,3,H1
"Cochise County, AZ",2012-2013,131919,129744,-2175,-1.649,401,-2576,4,3,H1
"Cochise County, AZ",2013-2014,129744,127448,-2296,-1.77,417,-2713,4,3,H1
"Cochise County, AZ",2014-2015,127321,126427,-894,-0.702,377,-1271,4,3,H1
"Cochise County, AZ",2015-2016,126427,125355,-1072,-0.848,189,-1261,4,3,H1
"Cochise County, AZ",2016-2017,125355,124756,-599,-0.478,206,-805,4,3,H1
"Coconino County, AZ",2000-2001,116773,118283,1510,1.293,1321,189,4,5,H1
"Coconino County, AZ",2001-2002,118283,121308,3025,2.557,1317,1708,4,5,H1
"Coconino County, AZ",2002-2003,121308,122882,1574,1.298,1324,250,4,5,H1
"Coconino County, AZ",2003-2004,122882,125117,2235,1.819,1296,939,4,5,H1
"Coconino County, AZ",2004-2005,125117,127025,1908,1.525,1478,430,4,5,H1
"Coconino County, AZ",2005-2006,127025,128695,1670,1.315,1376,294,4,5,H1
"Coconino County, AZ",2006-2007,128695,130442,1747,1.357,1558,189,4,5,H1
"Coconino County, AZ",2007-2008,130442,131853,1411,1.082,1340,71,4,5,H1
"Coconino County, AZ",2008-2009,131853,133477,1624,1.232,1369,255,4,5,H1
"Coconino County, AZ",2009-2010,133477,134603,1126,0.844,1435,-309,4,5,H1
"Coconino County, AZ",2010-2011,134603,134159,-444,-0.33,1081,-1525,4,5,H1
"Coconino County, AZ",2011-2012,134159,135949,1790,1.334,995,795,4,5,H1
"Coconino County, AZ",2012-2013,135949,136690,741,0.545,929,-188,4,5,H1
"Coconino County, AZ",2013-2014,136690,137682,992,0.726,925,67,4,5,H1
"Coconino County, AZ",2014-2015,137637,139097,1460,1.061,879,581,4,5,H1
"Coconino County, AZ",2015-2016,139097,140079,982,0.706,691,291,4,5,H1
"Coconino County, AZ",2016-2017,140079,140776,697,0.498,727,-30,4,5,H1
"Gila County, AZ",2000-2001,51332,51274,-58,-0.113,61,-119,4,7,H1
"Gila County, AZ",2001-2002,51274,51478,204,0.398,8,196,4,7,H1
"Gila County, AZ",2002-2003,51478,51337,-141,-0.274,89,-230,4,7,H1
"Gila County, AZ",2003-2004,51337,51423,86,0.168,48,38,4,7,H1
"Gila County, AZ",2004-2005,51423,51655,232,0.451,-40,272,4,7,H1
"Gila County, AZ",2005-2006,51655,52541,886,1.715,-36,922,4,7,H1
"Gila County, AZ",2006-2007,52541,53252,711,1.353,105,606,4,7,H1
"Gila County, AZ",2007-2008,53252,53437,185,0.347,-51,236,4,7,H1
"Gila County, AZ",2008-2009,53437,53561,124,0.232,-5,129,4,7,H1
"Gila County, AZ",2009-2010,53561,53534,-27,-0.05,75,-102,4,7,H1
"Gila County, AZ",2010-2011,53534,53469,-65,-0.121,-33,-32,4,7,H1
"Gila County, AZ",2011-2012,53469,53027,-442,-0.827,-107,-335,4,7,H1
"Gila County, AZ",2012-2013,53027,53063,36,0.068,-66,102,4,7,H1
"Gila County, AZ",2013-2014,53063,53119,56,0.106,-150,206,4,7,H1
"Gila County, AZ",2014-2015,53139,53159,20,0.038,-157,177,4,7,H1
"Gila County, AZ",2015-2016,53159,53297,138,0.26,-239,377,4,7,H1
"Gila County, AZ",2016-2017,53297,53501,204,0.383,-242,446,4,7,H1
"Graham County, AZ",2000-2001,33511,33356,-155,-0.463,225,-380,4,9,H1
"Graham County, AZ",2001-2002,33356,33224,-132,-0.396,181,-313,4,9,H1
"Graham County, AZ",2002-2003,33224,32985,-239,-0.719,201,-440,4,9,H1
"Graham County, AZ",2003-2004,32985,32703,-282,-0.855,181,-463,4,9,H1
"Graham County, AZ",2004-2005,32703,32964,261,0.798,160,101,4,9,H1
"Graham County, AZ",2005-2006,32964,33701,737,2.236,207,530,4,9,H1
"Graham County, AZ",2006-2007,33701,35175,1474,4.374,254,1220,4,9,H1
"Graham County, AZ",2007-2008,35175,36639,1464,4.162,343,1121,4,9,H1
"Graham County, AZ",2008-2009,36639,37525,886,2.418,326,560,4,9,H1
"Graham County, AZ",2009-2010,37525,37139,-386,-1.029,307,-693,4,9,H1
"Graham County, AZ",2010-2011,37139,37081,-58,-0.156,277,-335,4,9,H1
"Graham County, AZ",2011-2012,37081,36945,-136,-0.367,259,-395,4,9,H1
"Graham County, AZ",2012-2013,36945,37435,490,1.326,341,149,4,9,H1
"Graham County, AZ",2013-2014,37435,37957,522,1.394,289,233,4,9,H1
"Graham County, AZ",2014-2015,37958,37666,-292,-0.769,338,-630,4,9,H1
"Graham County, AZ",2015-2016,37666,37767,101,0.268,306,-205,4,9,H1
"Graham County, AZ",2016-2017,37767,37466,-301,-0.797,289,-590,4,9,H1
"Greenlee County, AZ",2000-2001,8547,8349,-198,-2.317,52,-250,4,11,H1
"Greenlee County, AZ",2001-2002,8349,7831,-518,-6.204,29,-547,4,11,H1
"Greenlee County, AZ",2002-2003,7831,7567,-264,-3.371,44,-308,4,11,H1
"Greenlee County, AZ",2003-2004,7567,7549,-18,-0.238,31,-49,4,11,H1
"Greenlee County, AZ",2004-2005,7549,7595,46,0.609,38,8,4,11,H1
"Greenlee County, AZ",2005-2006,7595,7838,243,3.199,53,190,4,11,H1
"Greenlee County, AZ",2006-2007,7838,8205,367,4.682,42,325,4,11,H1
"Greenlee County, AZ",2007-2008,8205,8561,356,4.339,105,251,4,11,H1
"Greenlee County, AZ",2008-2009,8561,8635,74,0.864,88,-14,4,11,H1
"Greenlee County, AZ",2009-2010,8635,8343,-292,-3.382,90,-382,4,11,H1
"Greenlee County, AZ",2010-2011,8343,8593,250,2.997,63,187,4,11,H1
"Greenlee County, AZ",2011-2012,8593,8775,182,2.118,42,140,4,11,H1
"Greenlee County, AZ",2012-2013,8775,8944,169,1.926,77,92,4,11,H1
"Greenlee County, AZ",2013-2014,8944,9346,402,4.495,83,319,4,11,H1
"Greenlee County, AZ",2014-2015,9323,9529,206,2.21,106,100,4,11,H1
"Greenlee County, AZ",2015-2016,9529,9623,94,0.986,83,11,4,11,H1
"Greenlee County, AZ",2016-2017,9623,9455,-168,-1.746,115,-283,4,11,H1
"La Paz County, AZ",2000-2001,19611,19580,-31,-0.158,19,-50,4,12,H1
"La Paz County, AZ",2001-2002,19580,19464,-116,-0.592,-17,-99,4,12,H1
"La Paz County, AZ",2002-2003,19464,19722,258,1.326,26,232,4,12,H1
"La Paz County, AZ",2003-2004,19722,19979,257,1.303,17,240,4,12,H1
"La Paz County, AZ",2004-2005,19979,20379,400,2.002,-8,408,4,12,H1
"La Paz County, AZ",2005-2006,20379,20573,194,0.952,28,166,4,12,H1
"La Paz County, AZ",2006-2007,20573,20647,74,0.36,10,64,4,12,H1
"La Paz County, AZ",2007-2008,20647,20555,-92,-0.446,35,-127,4,12,H1
"La Paz County, AZ",2008-2009,20555,20514,-41,-0.199,20,-61,4,12,H1
"La Paz County, AZ",2009-2010,20514,20446,-68,-0.331,-18,-50,4,12,H1
"La Paz County, AZ",2010-2011,20446,20443,-3,-0.015,-2,-1,4,12,H1
"La Paz County, AZ",2011-2012,20443,20289,-154,-0.753,-32,-122,4,12,H1
"La Paz County, AZ",2012-2013,20289,20331,42,0.207,-22,64,4,12,H1
"La Paz County, AZ",2013-2014,20331,20231,-100,-0.492,-30,-70,4,12,H1
"La Paz County, AZ",2014-2015,20314,20152,-162,-0.797,-39,-123,4,12,H1
"La Paz County, AZ",2015-2016,20152,20523,371,1.841,-45,416,4,12,H1
"La Paz County, AZ",2016-2017,20523,20601,78,0.38,-56,134,4,12,H1
"Maricopa County, AZ",2000-2001,3092197,3175989,83792,2.71,32634,51158,4,13,H1
"Maricopa County, AZ",2001-2002,3175989,3255388,79399,2.5,32019,47380,4,13,H1
"Maricopa County, AZ",2002-2003,3255388,3328468,73080,2.245,34744,38336,4,13,H1
"Maricopa County, AZ",2003-2004,3328468,3417860,89392,2.686,35543,53849,4,13,H1
"Maricopa County, AZ",2004-2005,3417860,3538988,121128,3.544,37373,83755,4,13,H1
"Maricopa County, AZ",2005-2006,3538988,3642884,103896,2.936,38429,65467,4,13,H1
"Maricopa County, AZ",2006-2007,3642884,3711954,69070,1.896,41698,27372,4,13,H1
"Maricopa County, AZ",2007-2008,3711954,3771061,59107,1.592,39078,20029,4,13,H1
"Maricopa County, AZ",2008-2009,3771061,3803779,32718,0.868,39087,-6369,4,13,H1
"Maricopa County, AZ",2009-2010,3803779,3823609,19830,0.521,37835,-18005,4,13,H1
"Maricopa County, AZ",2010-2011,3823609,3870076,46467,1.215,27438,19029,4,13,H1
"Maricopa County, AZ",2011-2012,3870076,3942868,72792,1.881,28260,44532,4,13,H1
"Maricopa County, AZ",2012-2013,3942868,4013164,70296,1.783,27838,42458,4,13,H1
"Maricopa County, AZ",2013-2014,4013164,4087191,74027,1.845,27251,46776,4,13,H1
"Maricopa County, AZ",2014-2015,4090022,4167947,77925,1.905,26690,51235,4,13,H1
"Maricopa County, AZ",2015-2016,4167947,4233383,65436,1.57,23714,41722,4,13,H1
"Maricopa County, AZ",2016-2017,4233383,4307033,73650,1.74,23764,49886,4,13,H1
"Mohave County, AZ",2000-2001,156215,160312,4097,2.623,-163,4260,4,15,H1
"Mohave County, AZ",2001-2002,160312,166155,5843,3.645,-51,5894,4,15,H1
"Mohave County, AZ",2002-2003,166155,172633,6478,3.899,-75,6553,4,15,H1
"Mohave County, AZ",2003-2004,172633,180521,7888,4.569,-24,7912,4,15,H1
"Mohave County, AZ",2004-2005,180521,188773,8252,4.571,-145,8397,4,15,H1
"Mohave County, AZ",2005-2006,188773,196168,7395,3.917,-97,7492,4,15,H1
"Mohave County, AZ",2006-2007,196168,199760,3592,1.831,197,3395,4,15,H1
"Mohave County, AZ",2007-2008,199760,200078,318,0.159,-44,362,4,15,H1
"Mohave County, AZ",2008-2009,200078,199696,-382,-0.191,-224,-158,4,15,H1
"Mohave County, AZ",2009-2010,199696,200380,684,0.343,-146,830,4,15,H1
"Mohave County, AZ",2010-2011,200380,202642,2262,1.129,-358,2620,4,15,H1
"Mohave County, AZ",2011-2012,202642,203174,532,0.263,-708,1240,4,15,H1
"Mohave County, AZ",2012-2013,203174,202855,-319,-0.157,-888,569,4,15,H1
"Mohave County, AZ",2013-2014,202855,203361,506,0.249,-942,1448,4,15,H1
"Mohave County, AZ",2014-2015,203331,204737,1406,0.691,-935,2341,4,15,H1
"Mohave County, AZ",2015-2016,204737,205385,648,0.317,-1332,1980,4,15,H1
"Mohave County, AZ",2016-2017,205385,207200,1815,0.884,-1371,3186,4,15,H1
"Navajo County, AZ",2000-2001,97689,97849,160,0.164,922,-762,4,17,H1
"Navajo County, AZ",2001-2002,97849,100123,2274,2.324,979,1295,4,17,H1
"Navajo County, AZ",2002-2003,100123,101529,1406,1.404,886,520,4,17,H1
"Navajo County, AZ",2003-2004,101529,102774,1245,1.226,953,292,4,17,H1
"Navajo County, AZ",2004-2005,102774,104184,1410,1.372,1069,341,4,17,H1
"Navajo County, AZ",2005-2006,104184,105624,1440,1.382,1012,428,4,17,H1
"Navajo County, AZ",2006-2007,105624,106927,1303,1.234,1134,169,4,17,H1
"Navajo County, AZ",2007-2008,106927,107626,699,0.654,1144,-445,4,17,H1
"Navajo County, AZ",2008-2009,107626,107571,-55,-0.051,1139,-1194,4,17,H1
"Navajo County, AZ",2009-2010,107571,107649,78,0.073,988,-910,4,17,H1
"Navajo County, AZ",2010-2011,107649,107374,-275,-0.255,857,-1132,4,17,H1
"Navajo County, AZ",2011-2012,107374,106973,-401,-0.373,691,-1092,4,17,H1
"Navajo County, AZ",2012-2013,106973,107346,373,0.349,625,-252,4,17,H1
"Navajo County, AZ",2013-2014,107346,108101,755,0.703,675,80,4,17,H1
"Navajo County, AZ",2014-2015,108119,108277,158,0.146,634,-476,4,17,H1
"Navajo County, AZ",2015-2016,108277,108322,45,0.042,531,-486,4,17,H1
"Navajo County, AZ",2016-2017,108322,108956,634,0.585,494,140,4,17,H1
"Pima County, AZ",2000-2001,848019,859280,11261,1.328,4973,6288,4,19,H1
"Pima County, AZ",2001-2002,859280,874267,14987,1.744,4548,10439,4,19,H1
"Pima County, AZ",2002-2003,874267,885893,11626,1.33,4911,6715,4,19,H1
"Pima County, AZ",2003-2004,885893,901342,15449,1.744,5170,10279,4,19,H1
"Pima County, AZ",2004-2005,901342,920298,18956,2.103,5203,13753,4,19,H1
"Pima County, AZ",2005-2006,920298,940930,20632,2.242,5284,15348,4,19,H1
"Pima County, AZ",2006-2007,940930,955869,14939,1.588,6134,8805,4,19,H1
"Pima County, AZ",2007-2008,955869,967778,11909,1.246,5282,6627,4,19,H1
"Pima County, AZ",2008-2009,967778,975580,7802,0.806,5151,2651,4,19,H1
"Pima County, AZ",2009-2010,975580,981935,6355,0.651,5059,1296,4,19,H1
"Pima County, AZ",2010-2011,981935,988125,6190,0.63,3454,2736,4,19,H1
"Pima County, AZ",2011-2012,988125,993094,4969,0.503,3110,1859,4,19,H1
"Pima County, AZ",2012-2013,993094,998050,4956,0.499,3177,1779,4,19,H1
"Pima County, AZ",2013-2014,998050,1004516,6466,0.648,2893,3573,4,19,H1
"Pima County, AZ",2014-2015,1004244,1010025,5781,0.576,2797,2984,4,19,H1
"Pima County, AZ",2015-2016,1010025,1012519,2494,0.247,1774,720,4,19,H1
"Pima County, AZ",2016-2017,1012519,1022769,10250,1.012,1609,8641,4,19,H1
"Pinal County, AZ",2000-2001,181280,187747,6467,3.567,1026,5441,4,21,H1
"Pinal County, AZ",2001-2002,187747,197082,9335,4.972,1058,8277,4,21,H1
"Pinal County, AZ",2002-2003,197082,207920,10838,5.499,1135,9703,4,21,H1
"Pinal County, AZ",2003-2004,207920,219472,11552,5.556,1281,10271,4,21,H1
"Pinal County, AZ",2004-2005,219472,235708,16236,7.398,1576,14660,4,21,H1
"Pinal County, AZ",2005-2006,235708,271328,35620,15.112,1912,33708,4,21,H1
"Pinal County, AZ",2006-2007,271328,306174,34846,12.843,3064,31782,4,21,H1
"Pinal County, AZ",2007-2008,306174,335311,29137,9.516,3492,25645,4,21,H1
"Pinal County, AZ",2008-2009,335311,349830,14519,4.33,3452,11067,4,21,H1
"Pinal County, AZ",2009-2010,349830,385738,35908,10.264,2679,33229,4,21,H1
"Pinal County, AZ",2010-2011,385738,384073,-1665,-0.432,2546,-4211,4,21,H1
"Pinal County, AZ",2011-2012,384073,388106,4033,1.05,2054,1979,4,21,H1
"Pinal County, AZ",2012-2013,388106,390965,2859,0.737,2142,717,4,21,H1
"Pinal County, AZ",2013-2014,390965,401918,10953,2.802,2046,8907,4,21,H1
"Pinal County, AZ",2014-2015,396521,406584,10063,2.538,1886,8177,4,21,H1
"Pinal County, AZ",2015-2016,406584,415115,8531,2.098,1384,7147,4,21,H1
"Pinal County, AZ",2016-2017,415115,430237,15122,3.643,1452,13670,4,21,H1
"Santa Cruz County, AZ",2000-2001,38589,39288,699,1.811,529,170,4,23,H1
"Santa Cruz County, AZ",2001-2002,39288,40009,721,1.835,577,144,4,23,H1
"Santa Cruz County, AZ",2002-2003,40009,40625,616,1.54,463,153,4,23,H1
"Santa Cruz County, AZ",2003-2004,40625,41623,998,2.457,637,361,4,23,H1
"Santa Cruz County, AZ",2004-2005,41623,42961,1338,3.215,549,789,4,23,H1
"Santa Cruz County, AZ",2005-2006,42961,44298,1337,3.112,535,802,4,23,H1
"Santa Cruz County, AZ",2006-2007,44298,45338,1040,2.348,545,495,4,23,H1
"Santa Cruz County, AZ",2007-2008,45338,46144,806,1.778,475,331,4,23,H1
"Santa Cruz County, AZ",2008-2009,46144,47011,867,1.879,531,336,4,23,H1
"Santa Cruz County, AZ",2009-2010,47011,47384,373,0.793,495,-122,4,23,H1
"Santa Cruz County, AZ",2010-2011,47384,47618,234,0.494,437,-203,4,23,H1
"Santa Cruz County, AZ",2011-2012,47618,47433,-185,-0.389,383,-568,4,23,H1
"Santa Cruz County, AZ",2012-2013,47433,47121,-312,-0.658,394,-706,4,23,H1
"Santa Cruz County, AZ",2013-2014,47121,46695,-426,-0.904,362,-788,4,23,H1
"Santa Cruz County, AZ",2014-2015,46661,46461,-200,-0.429,327,-527,4,23,H1
"Santa Cruz County, AZ",2015-2016,46461,46075,-386,-0.831,328,-714,4,23,H1
"Santa Cruz County, AZ",2016-2017,46075,46212,137,0.297,304,-167,4,23,H1
"Yavapai County, AZ",2000-2001,168608,172636,4028,2.389,-111,4139,4,25,H1
"Yavapai County, AZ",2001-2002,172636,177362,4726,2.738,-244,4970,4,25,H1
"Yavapai County, AZ",2002-2003,177362,182090,4728,2.666,-129,4857,4,25,H1
"Yavapai County, AZ",2003-2004,182090,187822,5732,3.148,-214,5946,4,25,H1
"Yavapai County, AZ",2004-2005,187822,195424,7602,4.047,-196,7798,4,25,H1
"Yavapai County, AZ",2005-2006,195424,204082,8658,4.43,-189,8847,4,25,H1
"Yavapai County, AZ",2006-2007,204082,208773,4691,2.299,93,4598,4,25,H1
"Yavapai County, AZ",2007-2008,208773,211211,2438,1.168,-141,2579,4,25,H1
"Yavapai County, AZ",2008-2009,211211,211172,-39,-0.018,-248,209,4,25,H1
"Yavapai County, AZ",2009-2010,211172,210517,-655,-0.31,-331,-324,4,25,H1
"Yavapai County, AZ",2010-2011,210517,211185,668,0.317,-767,1435,4,25,H1
"Yavapai County, AZ",2011-2012,211185,212509,1324,0.627,-865,2189,4,25,H1
"Yavapai County, AZ",2012-2013,212509,215389,2880,1.355,-795,3675,4,25,H1
"Yavapai County, AZ",2013-2014,215389,218844,3455,1.604,-826,4281,4,25,H1
"Yavapai County, AZ",2014-2015,218852,222255,3403,1.555,-812,4215,4,25,H1
"Yavapai County, AZ",2015-2016,222255,224363,2108,0.948,-1119,3227,4,25,H1
"Yavapai County, AZ",2016-2017,224363,228168,3805,1.696,-1008,4813,4,25,H1
"Yuma County, AZ",2000-2001,160576,162873,2297,1.43,1961,336,4,27,H1
"Yuma County, AZ",2001-2002,162873,165398,2525,1.55,1997,528,4,27,H1
"Yuma County, AZ",2002-2003,165398,168003,2605,1.575,1995,610,4,27,H1
"Yuma County, AZ",2003-2004,168003,172824,4821,2.87,2061,2760,4,27,H1
"Yuma County, AZ",2004-2005,172824,178816,5992,3.467,2219,3773,4,27,H1
"Yuma County, AZ",2005-2006,178816,183848,5032,2.814,2029,3003,4,27,H1
"Yuma County, AZ",2006-2007,183848,187357,3509,1.909,2098,1411,4,27,H1
"Yuma County, AZ",2007-2008,187357,191202,3845,2.052,2143,1702,4,27,H1
"Yuma County, AZ",2008-2009,191202,193714,2512,1.314,2205,307,4,27,H1
"Yuma County, AZ",2009-2010,193714,197105,3391,1.751,2052,1339,4,27,H1
"Yuma County, AZ",2010-2011,197105,202617,5512,2.796,1912,3600,4,27,H1
"Yuma County, AZ",2011-2012,202617,202264,-353,-0.174,1799,-2152,4,27,H1
"Yuma County, AZ",2012-2013,202264,202033,-231,-0.114,1768,-1999,4,27,H1
"Yuma County, AZ",2013-2014,202033,203247,1214,0.601,1722,-508,4,27,H1
"Yuma County, AZ",2014-2015,203483,204275,792,0.389,1614,-822,4,27,H1
"Yuma County, AZ",2015-2016,204275,205463,1188,0.582,1506,-318,4,27,H1
"Yuma County, AZ",2016-2017,205463,207534,2071,1.008,1409,662,4,27,H1
Arkansas,2000-2001,2678588,2691571,12983,0.485,8914,4069,5,0,STATE
Arkansas,2001-2002,2691571,2705927,14356,0.533,9622,4734,5,0,STATE
Arkansas,2002-2003,2705927,2724816,18889,0.698,9625,9264,5,0,STATE
Arkansas,2003-2004,2724816,2749686,24870,0.913,9567,15303,5,0,STATE
Arkansas,2004-2005,2749686,2781097,31411,1.142,11002,20409,5,0,STATE
Arkansas,2005-2006,2781097,2821761,40664,1.462,11886,28778,5,0,STATE
Arkansas,2006-2007,2821761,2848650,26889,0.953,13717,13172,5,0,STATE
Arkansas,2007-2008,2848650,2874554,25904,0.909,13337,12567,5,0,STATE
Arkansas,2008-2009,2874554,2896843,22289,0.775,12536,9753,5,0,STATE
Arkansas,2009-2010,2896843,2922394,25551,0.882,12306,13245,5,0,STATE
Arkansas,2010-2011,2922394,2938538,16144,0.552,9018,7126,5,0,STATE
Arkansas,2011-2012,2938538,2949499,10961,0.373,8863,2098,5,0,STATE
Arkansas,2012-2013,2949499,2957957,8458,0.287,7034,1424,5,0,STATE
Arkansas,2013-2014,2957957,2966835,8878,0.3,8758,120,5,0,STATE
Arkansas,2014-2015,2966835,2978204,11369,0.383,8419,2950,5,0,STATE
Arkansas,2015-2016,2978204,2988231,10027,0.337,7894,2133,5,0,STATE
Arkansas,2016-2017,2988231,3004279,16048,0.537,7841,8207,5,0,STATE
"Arkansas County, AR",2000-2001,20776,20593,-183,-0.881,-12,-171,5,1,H1
"Arkansas County, AR",2001-2002,20593,20351,-242,-1.175,12,-254,5,1,H1
"Arkansas County, AR",2002-2003,20351,19981,-370,-1.818,-57,-313,5,1,H1
"Arkansas County, AR",2003-2004,19981,19967,-14,-0.07,-10,-4,5,1,H1
"Arkansas County, AR",2004-2005,19967,19954,-13,-0.065,-31,18,5,1,H1
"Arkansas County, AR",2005-2006,19954,19785,-169,-0.847,27,-196,5,1,H1
"Arkansas County, AR",2006-2007,19785,19434,-351,-1.774,-2,-349,5,1,H1
"Arkansas County, AR",2007-2008,19434,19275,-159,-0.818,6,-165,5,1,H1
"Arkansas County, AR",2008-2009,19275,19134,-141,-0.732,-17,-124,5,1,H1
"Arkansas County, AR",2009-2010,19134,19009,-125,-0.653,-16,-109,5,1,H1
"Arkansas County, AR",2010-2011,19009,18887,-122,-0.642,-24,-98,5,1,H1
"Arkansas County, AR",2011-2012,18887,18994,107,0.567,32,75,5,1,H1
"Arkansas County, AR",2012-2013,18994,18820,-174,-0.916,38,-212,5,1,H1
"Arkansas County, AR",2013-2014,18820,18594,-226,-1.201,33,-259,5,1,H1
"Arkansas County, AR",2014-2015,18564,18433,-131,-0.706,11,-142,5,1,H1
"Arkansas County, AR",2015-2016,18433,18215,-218,-1.183,42,-260,5,1,H1
"Arkansas County, AR",2016-2017,18215,17967,-248,-1.362,10,-258,5,1,H1
"Ashley County, AR",2000-2001,24179,23824,-355,-1.468,-15,-340,5,3,H1
"Ashley County, AR",2001-2002,23824,23745,-79,-0.332,76,-155,5,3,H1
"Ashley County, AR",2002-2003,23745,23469,-276,-1.162,72,-348,5,3,H1
"Ashley County, AR",2003-2004,23469,23156,-313,-1.334,16,-329,5,3,H1
"Ashley County, AR",2004-2005,23156,22770,-386,-1.667,28,-414,5,3,H1
"Ashley County, AR",2005-2006,22770,22501,-269,-1.181,37,-306,5,3,H1
"Ashley County, AR",2006-2007,22501,22229,-272,-1.209,53,-325,5,3,H1
"Ashley County, AR",2007-2008,22229,22148,-81,-0.364,37,-118,5,3,H1
"Ashley County, AR",2008-2009,22148,21920,-228,-1.029,38,-266,5,3,H1
"Ashley County, AR",2009-2010,21920,21835,-85,-0.388,50,-135,5,3,H1
"Ashley County, AR",2010-2011,21835,21655,-180,-0.824,19,-199,5,3,H1
"Ashley County, AR",2011-2012,21655,21497,-158,-0.73,44,-202,5,3,H1
"Ashley County, AR",2012-2013,21497,21252,-245,-1.14,31,-276,5,3,H1
"Ashley County, AR",2013-2014,21252,20948,-304,-1.43,16,-320,5,3,H1
"Ashley County, AR",2014-2015,20926,20838,-88,-0.421,-8,-80,5,3,H1
"Ashley County, AR",2015-2016,20838,20498,-340,-1.632,-43,-297,5,3,H1
"Ashley County, AR",2016-2017,20498,20283,-215,-1.049,-36,-179,5,3,H1
"Baxter County, AR",2000-2001,38446,38331,-115,-0.299,-288,173,5,5,H1
"Baxter County, AR",2001-2002,38331,38506,175,0.457,-272,447,5,5,H1
"Baxter County, AR",2002-2003,38506,38772,266,0.691,-261,527,5,5,H1
"Baxter County, AR",2003-2004,38772,39334,562,1.449,-344,906,5,5,H1
"Baxter County, AR",2004-2005,39334,39992,658,1.673,-306,964,5,5,H1
"Baxter County, AR",2005-2006,39992,40867,875,2.188,-235,1110,5,5,H1
"Baxter County, AR",2006-2007,40867,41491,624,1.527,-259,883,5,5,H1
"Baxter County, AR",2007-2008,41491,41519,28,0.067,-286,314,5,5,H1
"Baxter County, AR",2008-2009,41519,41561,42,0.101,-282,324,5,5,H1
"Baxter County, AR",2009-2010,41561,41551,-10,-0.024,-254,244,5,5,H1
"Baxter County, AR",2010-2011,41551,41287,-264,-0.635,-341,77,5,5,H1
"Baxter County, AR",2011-2012,41287,41077,-210,-0.509,-345,135,5,5,H1
"Baxter County, AR",2012-2013,41077,40996,-81,-0.197,-297,216,5,5,H1
"Baxter County, AR",2013-2014,40996,40857,-139,-0.339,-332,193,5,5,H1
"Baxter County, AR",2014-2015,40842,41053,211,0.517,-301,512,5,5,H1
"Baxter County, AR",2015-2016,41053,41145,92,0.224,-312,404,5,5,H1
"Baxter County, AR",2016-2017,41145,41355,210,0.51,-306,516,5,5,H1
"Benton County, AR",2000-2001,154744,159258,4514,2.917,1122,3392,5,7,H1
"Benton County, AR",2001-2002,159258,164926,5668,3.559,1253,4415,5,7,H1
"Benton County, AR",2002-2003,164926,171742,6816,4.133,1326,5490,5,7,H1
"Benton County, AR",2003-2004,171742,179010,7268,4.232,1473,5795,5,7,H1
"Benton County, AR",2004-2005,179010,186756,7746,4.327,1759,5987,5,7,H1
"Benton County, AR",2005-2006,186756,195569,8813,4.719,1793,7020,5,7,H1
"Benton County, AR",2006-2007,195569,203664,8095,4.139,2008,6087,5,7,H1
"Benton County, AR",2007-2008,203664,210807,7143,3.507,1970,5173,5,7,H1
"Benton County, AR",2008-2009,210807,216620,5813,2.757,2079,3734,5,7,H1
"Benton County, AR",2009-2010,216620,222923,6303,2.91,2115,4188,5,7,H1
"Benton County, AR",2010-2011,222923,227769,4846,2.174,1671,3175,5,7,H1
"Benton County, AR",2011-2012,227769,232739,4970,2.182,1668,3302,5,7,H1
"Benton County, AR",2012-2013,232739,237301,4562,1.96,1706,2856,5,7,H1
"Benton County, AR",2013-2014,237301,242321,5020,2.115,1745,3275,5,7,H1
"Benton County, AR",2014-2015,242868,249672,6804,2.802,1774,5030,5,7,H1
"Benton County, AR",2015-2016,249672,258704,9032,3.618,1957,7075,5,7,H1
"Benton County, AR",2016-2017,258704,266300,7596,2.936,1991,5605,5,7,H1
"Boone County, AR",2000-2001,34051,34258,207,0.608,21,186,5,9,H1
"Boone County, AR",2001-2002,34258,34448,190,0.555,56,134,5,9,H1
"Boone County, AR",2002-2003,34448,34554,106,0.308,20,86,5,9,H1
"Boone County, AR",2003-2004,34554,34900,346,1.001,41,305,5,9,H1
"Boone County, AR",2004-2005,34900,35492,592,1.696,49,543,5,9,H1
"Boone County, AR",2005-2006,35492,36056,564,1.589,20,544,5,9,H1
"Boone County, AR",2006-2007,36056,36759,703,1.95,74,629,5,9,H1
"Boone County, AR",2007-2008,36759,36974,215,0.585,73,142,5,9,H1
"Boone County, AR",2008-2009,36974,36844,-130,-0.352,17,-147,5,9,H1
"Boone County, AR",2009-2010,36844,36888,44,0.119,12,32,5,9,H1
"Boone County, AR",2010-2011,36888,37040,152,0.412,17,135,5,9,H1
"Boone County, AR",2011-2012,37040,37333,293,0.791,69,224,5,9,H1
"Boone County, AR",2012-2013,37333,37389,56,0.15,31,25,5,9,H1
"Boone County, AR",2013-2014,37389,37196,-193,-0.516,27,-220,5,9,H1
"Boone County, AR",2014-2015,37152,37222,70,0.188,22,48,5,9,H1
"Boone County, AR",2015-2016,37222,37191,-31,-0.083,-40,9,5,9,H1
"Boone County, AR",2016-2017,37191,37381,190,0.511,-7,197,5,9,H1
"Bradley County, AR",2000-2001,12597,12427,-170,-1.35,-63,-107,5,11,H1
"Bradley County, AR",2001-2002,12427,12340,-87,-0.7,-17,-70,5,11,H1
"Bradley County, AR",2002-2003,12340,12263,-77,-0.624,0,-77,5,11,H1
"Bradley County, AR",2003-2004,12263,12107,-156,-1.272,0,-156,5,11,H1
"Bradley County, AR",2004-2005,12107,12012,-95,-0.785,22,-117,5,11,H1
"Bradley County, AR",2005-2006,12012,11778,-234,-1.948,5,-239,5,11,H1
"Bradley County, AR",2006-2007,11778,11737,-41,-0.348,32,-73,5,11,H1
"Bradley County, AR",2007-2008,11737,11643,-94,-0.801,44,-138,5,11,H1
"Bradley County, AR",2008-2009,11643,11538,-105,-0.902,19,-124,5,11,H1
"Bradley County, AR",2009-2010,11538,11489,-49,-0.425,20,-69,5,11,H1
"Bradley County, AR",2010-2011,11489,11453,-36,-0.313,-3,-33,5,11,H1
"Bradley County, AR",2011-2012,11453,11298,-155,-1.353,-18,-137,5,11,H1
"Bradley County, AR",2012-2013,11298,11192,-106,-0.938,-4,-102,5,11,H1
"Bradley County, AR",2013-2014,11192,11148,-44,-0.393,-12,-32,5,11,H1
"Bradley County, AR",2014-2015,11061,11094,33,0.298,5,28,5,11,H1
"Bradley County, AR",2015-2016,11094,10979,-115,-1.037,10,-125,5,11,H1
"Bradley County, AR",2016-2017,10979,10864,-115,-1.047,1,-116,5,11,H1
"Calhoun County, AR",2000-2001,5709,5599,-110,-1.927,-28,-82,5,13,H1
"Calhoun County, AR",2001-2002,5599,5655,56,1,-12,68,5,13,H1
"Calhoun County, AR",2002-2003,5655,5646,-9,-0.159,-17,8,5,13,H1
"Calhoun County, AR",2003-2004,5646,5591,-55,-0.974,5,-60,5,13,H1
"Calhoun County, AR",2004-2005,5591,5675,84,1.502,-3,87,5,13,H1
"Calhoun County, AR",2005-2006,5675,5693,18,0.317,12,6,5,13,H1
"Calhoun County, AR",2006-2007,5693,5659,-34,-0.597,16,-50,5,13,H1
"Calhoun County, AR",2007-2008,5659,5528,-131,-2.315,8,-139,5,13,H1
"Calhoun County, AR",2008-2009,5528,5421,-107,-1.936,-2,-105,5,13,H1
"Calhoun County, AR",2009-2010,5421,5330,-91,-1.679,-10,-81,5,13,H1
"Calhoun County, AR",2010-2011,5330,5280,-50,-0.938,-15,-35,5,13,H1
"Calhoun County, AR",2011-2012,5280,5299,19,0.36,-2,21,5,13,H1
"Calhoun County, AR",2012-2013,5299,5219,-80,-1.51,-7,-73,5,13,H1
"Calhoun County, AR",2013-2014,5219,5202,-17,-0.326,4,-21,5,13,H1
"Calhoun County, AR",2014-2015,5188,5229,41,0.79,5,36,5,13,H1
"Calhoun County, AR",2015-2016,5229,5162,-67,-1.281,-4,-63,5,13,H1
"Calhoun County, AR",2016-2017,5162,5247,85,1.647,-3,88,5,13,H1
"Carroll County, AR",2000-2001,25369,25559,190,0.749,116,74,5,15,H1
"Carroll County, AR",2001-2002,25559,25796,237,0.927,84,153,5,15,H1
"Carroll County, AR",2002-2003,25796,26033,237,0.919,75,162,5,15,H1
"Carroll County, AR",2003-2004,26033,26052,19,0.073,91,-72,5,15,H1
"Carroll County, AR",2004-2005,26052,26435,383,1.47,90,293,5,15,H1
"Carroll County, AR",2005-2006,26435,26615,180,0.681,77,103,5,15,H1
"Carroll County, AR",2006-2007,26615,26699,84,0.316,115,-31,5,15,H1
"Carroll County, AR",2007-2008,26699,26822,123,0.461,44,79,5,15,H1
"Carroll County, AR",2008-2009,26822,27158,336,1.253,67,269,5,15,H1
"Carroll County, AR",2009-2010,27158,27560,402,1.48,88,314,5,15,H1
"Carroll County, AR",2010-2011,27560,27470,-90,-0.327,6,-96,5,15,H1
"Carroll County, AR",2011-2012,27470,27598,128,0.466,-10,138,5,15,H1
"Carroll County, AR",2012-2013,27598,27760,162,0.587,21,141,5,15,H1
"Carroll County, AR",2013-2014,27760,27744,-16,-0.058,25,-41,5,15,H1
"Carroll County, AR",2014-2015,27722,27704,-18,-0.065,14,-32,5,15,H1
"Carroll County, AR",2015-2016,27704,27728,24,0.087,32,-8,5,15,H1
"Carroll County, AR",2016-2017,27728,27944,216,0.779,28,188,5,15,H1
"Chicot County, AR",2000-2001,14062,13758,-304,-2.162,9,-313,5,17,H1
"Chicot County, AR",2001-2002,13758,13382,-376,-2.733,17,-393,5,17,H1
"Chicot County, AR",2002-2003,13382,13173,-209,-1.562,-3,-206,5,17,H1
"Chicot County, AR",2003-2004,13173,12879,-294,-2.232,-20,-274,5,17,H1
"Chicot County, AR",2004-2005,12879,12729,-150,-1.165,15,-165,5,17,H1
"Chicot County, AR",2005-2006,12729,12516,-213,-1.673,14,-227,5,17,H1
"Chicot County, AR",2006-2007,12516,12313,-203,-1.622,28,-231,5,17,H1
"Chicot County, AR",2007-2008,12313,12050,-263,-2.136,54,-317,5,17,H1
"Chicot County, AR",2008-2009,12050,11851,-199,-1.651,-5,-194,5,17,H1
"Chicot County, AR",2009-2010,11851,11794,-57,-0.481,-10,-47,5,17,H1
"Chicot County, AR",2010-2011,11794,11673,-121,-1.026,-12,-109,5,17,H1
"Chicot County, AR",2011-2012,11673,11458,-215,-1.842,10,-225,5,17,H1
"Chicot County, AR",2012-2013,11458,11338,-120,-1.047,8,-128,5,17,H1
"Chicot County, AR",2013-2014,11338,11180,-158,-1.394,-20,-138,5,17,H1
"Chicot County, AR",2014-2015,11217,11027,-190,-1.694,-32,-158,5,17,H1
"Chicot County, AR",2015-2016,11027,10912,-115,-1.043,-10,-105,5,17,H1
"Chicot County, AR",2016-2017,10912,10636,-276,-2.529,-41,-235,5,17,H1
"Clark County, AR",2000-2001,23474,23516,42,0.179,19,23,5,19,H1
"Clark County, AR",2001-2002,23516,23334,-182,-0.774,24,-206,5,19,H1
"Clark County, AR",2002-2003,23334,23032,-302,-1.294,-4,-298,5,19,H1
"Clark County, AR",2003-2004,23032,22904,-128,-0.556,23,-151,5,19,H1
"Clark County, AR",2004-2005,22904,22800,-104,-0.454,45,-149,5,19,H1
"Clark County, AR",2005-2006,22800,22924,124,0.544,22,102,5,19,H1
"Clark County, AR",2006-2007,22924,23139,215,0.938,73,142,5,19,H1
"Clark County, AR",2007-2008,23139,23272,133,0.575,69,64,5,19,H1
"Clark County, AR",2008-2009,23272,23100,-172,-0.739,57,-229,5,19,H1
"Clark County, AR",2009-2010,23100,22950,-150,-0.649,63,-213,5,19,H1
"Clark County, AR",2010-2011,22950,22953,3,0.013,-27,30,5,19,H1
"Clark County, AR",2011-2012,22953,22822,-131,-0.571,6,-137,5,19,H1
"Clark County, AR",2012-2013,22822,22697,-125,-0.548,-13,-112,5,19,H1
"Clark County, AR",2013-2014,22697,22576,-121,-0.533,-22,-99,5,19,H1
"Clark County, AR",2014-2015,22699,22633,-66,-0.291,6,-72,5,19,H1
"Clark County, AR",2015-2016,22633,22550,-83,-0.367,-7,-76,5,19,H1
"Clark County, AR",2016-2017,22550,22293,-257,-1.14,-30,-227,5,19,H1
"Clay County, AR",2000-2001,17537,17307,-230,-1.312,-81,-149,5,21,H1
"Clay County, AR",2001-2002,17307,17083,-224,-1.294,-70,-154,5,21,H1
"Clay County, AR",2002-2003,17083,16951,-132,-0.773,-66,-66,5,21,H1
"Clay County, AR",2003-2004,16951,16827,-124,-0.732,-46,-78,5,21,H1
"Clay County, AR",2004-2005,16827,16790,-37,-0.22,-18,-19,5,21,H1
"Clay County, AR",2005-2006,16790,16679,-111,-0.661,-47,-64,5,21,H1
"Clay County, AR",2006-2007,16679,16464,-215,-1.289,-31,-184,5,21,H1
"Clay County, AR",2007-2008,16464,16209,-255,-1.549,-58,-197,5,21,H1
"Clay County, AR",2008-2009,16209,16056,-153,-0.944,-46,-107,5,21,H1
"Clay County, AR",2009-2010,16056,16057,1,0.006,-57,58,5,21,H1
"Clay County, AR",2010-2011,16057,15836,-221,-1.376,-127,-94,5,21,H1
"Clay County, AR",2011-2012,15836,15580,-256,-1.617,-166,-90,5,21,H1
"Clay County, AR",2012-2013,15580,15294,-286,-1.836,-164,-122,5,21,H1
"Clay County, AR",2013-2014,15294,15118,-176,-1.151,-82,-94,5,21,H1
"Clay County, AR",2014-2015,15176,15109,-67,-0.441,-24,-43,5,21,H1
"Clay County, AR",2015-2016,15109,15057,-52,-0.344,-54,2,5,21,H1
"Clay County, AR",2016-2017,15057,14920,-137,-0.91,-34,-103,5,21,H1
"Cleburne County, AR",2000-2001,24100,24204,104,0.432,-24,128,5,23,H1
"Cleburne County, AR",2001-2002,24204,24375,171,0.706,-71,242,5,23,H1
"Cleburne County, AR",2002-2003,24375,24711,336,1.378,-67,403,5,23,H1
"Cleburne County, AR",2003-2004,24711,25018,307,1.242,-69,376,5,23,H1
"Cleburne County, AR",2004-2005,25018,25274,256,1.023,-46,302,5,23,H1
"Cleburne County, AR",2005-2006,25274,25430,156,0.617,-42,198,5,23,H1
"Cleburne County, AR",2006-2007,25430,25545,115,0.452,-67,182,5,23,H1
"Cleburne County, AR",2007-2008,25545,25623,78,0.305,-39,117,5,23,H1
"Cleburne County, AR",2008-2009,25623,25870,247,0.964,-40,287,5,23,H1
"Cleburne County, AR",2009-2010,25870,25989,119,0.46,-73,192,5,23,H1
"Cleburne County, AR",2010-2011,25989,25908,-81,-0.312,-95,14,5,23,H1
"Cleburne County, AR",2011-2012,25908,25778,-130,-0.502,-125,-5,5,23,H1
"Cleburne County, AR",2012-2013,25778,25656,-122,-0.473,-104,-18,5,23,H1
"Cleburne County, AR",2013-2014,25656,25634,-22,-0.086,-132,110,5,23,H1
"Cleburne County, AR",2014-2015,25664,25467,-197,-0.768,-119,-78,5,23,H1
"Cleburne County, AR",2015-2016,25467,25159,-308,-1.209,-163,-145,5,23,H1
"Cleburne County, AR",2016-2017,25159,25048,-111,-0.441,-155,44,5,23,H1
"Cleveland County, AR",2000-2001,8536,8637,101,1.183,22,79,5,25,H1
"Cleveland County, AR",2001-2002,8637,8634,-3,-0.035,49,-52,5,25,H1
"Cleveland County, AR",2002-2003,8634,8694,60,0.695,3,57,5,25,H1
"Cleveland County, AR",2003-2004,8694,8744,50,0.575,17,33,5,25,H1
"Cleveland County, AR",2004-2005,8744,8859,115,1.315,19,96,5,25,H1
"Cleveland County, AR",2005-2006,8859,8829,-30,-0.339,23,-53,5,25,H1
"Cleveland County, AR",2006-2007,8829,8896,67,0.759,18,49,5,25,H1
"Cleveland County, AR",2007-2008,8896,8775,-121,-1.36,18,-139,5,25,H1
"Cleveland County, AR",2008-2009,8775,8649,-126,-1.436,17,-143,5,25,H1
"Cleveland County, AR",2009-2010,8649,8690,41,0.474,11,30,5,25,H1
"Cleveland County, AR",2010-2011,8690,8668,-22,-0.253,-5,-17,5,25,H1
"Cleveland County, AR",2011-2012,8668,8615,-53,-0.611,14,-67,5,25,H1
"Cleveland County, AR",2012-2013,8615,8562,-53,-0.615,0,-53,5,25,H1
"Cleveland County, AR",2013-2014,8562,8449,-113,-1.32,2,-115,5,25,H1
"Cleveland County, AR",2014-2015,8424,8311,-113,-1.341,-2,-111,5,25,H1
"Cleveland County, AR",2015-2016,8311,8260,-51,-0.614,-29,-22,5,25,H1
"Cleveland County, AR",2016-2017,8260,8202,-58,-0.702,-12,-46,5,25,H1
"Columbia County, AR",2000-2001,25599,25424,-175,-0.684,10,-185,5,27,H1
"Columbia County, AR",2001-2002,25424,25362,-62,-0.244,-15,-47,5,27,H1
"Columbia County, AR",2002-2003,25362,25106,-256,-1.009,-18,-238,5,27,H1
"Columbia County, AR",2003-2004,25106,25154,48,0.191,-8,56,5,27,H1
"Columbia County, AR",2004-2005,25154,25025,-129,-0.513,38,-167,5,27,H1
"Columbia County, AR",2005-2006,25025,25133,108,0.432,13,95,5,27,H1
"Columbia County, AR",2006-2007,25133,24847,-286,-1.138,42,-328,5,27,H1
"Columbia County, AR",2007-2008,24847,24666,-181,-0.728,81,-262,5,27,H1
"Columbia County, AR",2008-2009,24666,24622,-44,-0.178,35,-79,5,27,H1
"Columbia County, AR",2009-2010,24622,24729,107,0.435,47,60,5,27,H1
"Columbia County, AR",2010-2011,24729,24670,-59,-0.239,-27,-32,5,27,H1
"Columbia County, AR",2011-2012,24670,24401,-269,-1.09,-20,-249,5,27,H1
"Columbia County, AR",2012-2013,24401,24266,-135,-0.553,-5,-130,5,27,H1
"Columbia County, AR",2013-2014,24266,23933,-333,-1.372,-5,-328,5,27,H1
"Columbia County, AR",2014-2015,24102,24114,12,0.05,11,1,5,27,H1
"Columbia County, AR",2015-2016,24114,23983,-131,-0.543,-39,-92,5,27,H1
"Columbia County, AR",2016-2017,23983,23627,-356,-1.484,-7,-349,5,27,H1
"Conway County, AR",2000-2001,20312,20362,50,0.246,16,34,5,29,H1
"Conway County, AR",2001-2002,20362,20366,4,0.02,33,-29,5,29,H1
"Conway County, AR",2002-2003,20366,20461,95,0.466,3,92,5,29,H1
"Conway County, AR",2003-2004,20461,20519,58,0.283,47,11,5,29,H1
"Conway County, AR",2004-2005,20519,20683,164,0.799,40,124,5,29,H1
"Conway County, AR",2005-2006,20683,20753,70,0.338,-19,89,5,29,H1
"Conway County, AR",2006-2007,20753,20992,239,1.152,29,210,5,29,H1
"Conway County, AR",2007-2008,20992,21025,33,0.157,42,-9,5,29,H1
"Conway County, AR",2008-2009,21025,21257,232,1.103,53,179,5,29,H1
"Conway County, AR",2009-2010,21257,21248,-9,-0.042,76,-85,5,29,H1
"Conway County, AR",2010-2011,21248,21151,-97,-0.457,18,-115,5,29,H1
"Conway County, AR",2011-2012,21151,21216,65,0.307,18,47,5,29,H1
"Conway County, AR",2012-2013,21216,21176,-40,-0.189,42,-82,5,29,H1
"Conway County, AR",2013-2014,21176,21083,-93,-0.439,45,-138,5,29,H1
"Conway County, AR",2014-2015,21030,21019,-11,-0.052,37,-48,5,29,H1
"Conway County, AR",2015-2016,21019,20895,-124,-0.59,20,-144,5,29,H1
"Conway County, AR",2016-2017,20895,20916,21,0.101,27,-6,5,29,H1
"Craighead County, AR",2000-2001,82519,83276,757,0.917,464,293,5,31,H1
"Craighead County, AR",2001-2002,83276,83978,702,0.843,328,374,5,31,H1
"Craighead County, AR",2002-2003,83978,8.50E+04,1022,1.217,395,627,5,31,H1
"Craighead County, AR",2003-2004,8.50E+04,86331,1331,1.566,421,910,5,31,H1
"Craighead County, AR",2004-2005,86331,87512,1181,1.368,448,733,5,31,H1
"Craighead County, AR",2005-2006,87512,89725,2213,2.529,457,1756,5,31,H1
"Craighead County, AR",2006-2007,89725,91350,1625,1.811,563,1062,5,31,H1
"Craighead County, AR",2007-2008,91350,93316,1966,2.152,634,1332,5,31,H1
"Craighead County, AR",2008-2009,93316,95482,2166,2.321,594,1572,5,31,H1
"Craighead County, AR",2009-2010,95482,96726,1244,1.303,549,695,5,31,H1
"Craighead County, AR",2010-2011,96726,98381,1655,1.711,509,1146,5,31,H1
"Craighead County, AR",2011-2012,98381,99903,1522,1.547,537,985,5,31,H1
"Craighead County, AR",2012-2013,99903,101647,1744,1.746,615,1129,5,31,H1
"Craighead County, AR",2013-2014,101647,102518,871,0.857,542,329,5,31,H1
"Craighead County, AR",2014-2015,102671,104354,1683,1.639,516,1167,5,31,H1
"Craighead County, AR",2015-2016,104354,105781,1427,1.367,679,748,5,31,H1
"Craighead County, AR",2016-2017,105781,107115,1334,1.261,587,747,5,31,H1
"Crawford County, AR",2000-2001,53404,54273,869,1.627,306,563,5,33,H1
"Crawford County, AR",2001-2002,54273,55026,753,1.387,274,479,5,33,H1
"Crawford County, AR",2002-2003,55026,55836,810,1.472,249,561,5,33,H1
"Crawford County, AR",2003-2004,55836,56832,996,1.784,245,751,5,33,H1
"Crawford County, AR",2004-2005,56832,57779,947,1.666,230,717,5,33,H1
"Crawford County, AR",2005-2006,57779,59126,1347,2.331,273,1074,5,33,H1
"Crawford County, AR",2006-2007,59126,60210,1084,1.833,401,683,5,33,H1
"Crawford County, AR",2007-2008,60210,60933,723,1.201,209,514,5,33,H1
"Crawford County, AR",2008-2009,60933,61595,662,1.086,226,436,5,33,H1
"Crawford County, AR",2009-2010,61595,61987,392,0.636,260,132,5,33,H1
"Crawford County, AR",2010-2011,61987,61848,-139,-0.224,127,-266,5,33,H1
"Crawford County, AR",2011-2012,61848,61933,85,0.137,179,-94,5,33,H1
"Crawford County, AR",2012-2013,61933,61658,-275,-0.444,200,-475,5,33,H1
"Crawford County, AR",2013-2014,61658,61697,39,0.063,198,-159,5,33,H1
"Crawford County, AR",2014-2015,61670,61703,33,0.054,194,-161,5,33,H1
"Crawford County, AR",2015-2016,61703,62259,556,0.901,138,418,5,33,H1
"Crawford County, AR",2016-2017,62259,62996,737,1.184,147,590,5,33,H1
"Crittenden County, AR",2000-2001,50915,50919,4,0.008,360,-356,5,35,H1
"Crittenden County, AR",2001-2002,50919,50622,-297,-0.583,374,-671,5,35,H1
"Crittenden County, AR",2002-2003,50622,50252,-370,-0.731,356,-726,5,35,H1
"Crittenden County, AR",2003-2004,50252,50266,14,0.028,403,-389,5,35,H1
"Crittenden County, AR",2004-2005,50266,50244,-22,-0.044,390,-412,5,35,H1
"Crittenden County, AR",2005-2006,50244,50360,116,0.231,360,-244,5,35,H1
"Crittenden County, AR",2006-2007,50360,50438,78,0.155,473,-395,5,35,H1
"Crittenden County, AR",2007-2008,50438,50699,261,0.517,437,-176,5,35,H1
"Crittenden County, AR",2008-2009,50699,50929,230,0.454,395,-165,5,35,H1
"Crittenden County, AR",2009-2010,50929,50954,25,0.049,379,-354,5,35,H1
"Crittenden County, AR",2010-2011,50954,50528,-426,-0.836,312,-738,5,35,H1
"Crittenden County, AR",2011-2012,50528,50070,-458,-0.906,337,-795,5,35,H1
"Crittenden County, AR",2012-2013,50070,49758,-312,-0.623,343,-655,5,35,H1
"Crittenden County, AR",2013-2014,49758,49548,-210,-0.422,278,-488,5,35,H1
"Crittenden County, AR",2014-2015,49558,48963,-595,-1.201,304,-899,5,35,H1
"Crittenden County, AR",2015-2016,48963,49320,357,0.729,330,27,5,35,H1
"Crittenden County, AR",2016-2017,49320,48750,-570,-1.156,306,-876,5,35,H1
"Cross County, AR",2000-2001,19458,19382,-76,-0.391,40,-116,5,37,H1
"Cross County, AR",2001-2002,19382,19106,-276,-1.424,-5,-271,5,37,H1
"Cross County, AR",2002-2003,19106,18896,-210,-1.099,17,-227,5,37,H1
"Cross County, AR",2003-2004,18896,18782,-114,-0.603,86,-200,5,37,H1
"Cross County, AR",2004-2005,18782,18883,101,0.538,64,37,5,37,H1
"Cross County, AR",2005-2006,18883,18525,-358,-1.896,31,-389,5,37,H1
"Cross County, AR",2006-2007,18525,18172,-353,-1.906,41,-394,5,37,H1
"Cross County, AR",2007-2008,18172,18200,28,0.154,17,11,5,37,H1
"Cross County, AR",2008-2009,18200,17971,-229,-1.258,43,-272,5,37,H1
"Cross County, AR",2009-2010,17971,17841,-130,-0.723,38,-168,5,37,H1
"Cross County, AR",2010-2011,17841,17747,-94,-0.527,5,-99,5,37,H1
"Cross County, AR",2011-2012,17747,17654,-93,-0.524,5,-98,5,37,H1
"Cross County, AR",2012-2013,17654,17504,-150,-0.85,36,-186,5,37,H1
"Cross County, AR",2013-2014,17504,17227,-277,-1.582,39,-316,5,37,H1
"Cross County, AR",2014-2015,17187,17284,97,0.564,6,91,5,37,H1
"Cross County, AR",2015-2016,17284,17037,-247,-1.429,39,-286,5,37,H1
"Cross County, AR",2016-2017,17037,16863,-174,-1.021,12,-186,5,37,H1
"Dallas County, AR",2000-2001,9146,9005,-141,-1.542,-33,-108,5,39,H1
"Dallas County, AR",2001-2002,9005,8826,-179,-1.988,-22,-157,5,39,H1
"Dallas County, AR",2002-2003,8826,8740,-86,-0.974,-47,-39,5,39,H1
"Dallas County, AR",2003-2004,8740,8740,0,0,-10,10,5,39,H1
"Dallas County, AR",2004-2005,8740,8589,-151,-1.728,-10,-141,5,39,H1
"Dallas County, AR",2005-2006,8589,8477,-112,-1.304,-40,-72,5,39,H1
"Dallas County, AR",2006-2007,8477,8367,-110,-1.298,-22,-88,5,39,H1
"Dallas County, AR",2007-2008,8367,8282,-85,-1.016,17,-102,5,39,H1
"Dallas County, AR",2008-2009,8282,8188,-94,-1.135,5,-99,5,39,H1
"Dallas County, AR",2009-2010,8188,8061,-127,-1.551,-9,-118,5,39,H1
"Dallas County, AR",2010-2011,8061,8069,8,0.099,-1,9,5,39,H1
"Dallas County, AR",2011-2012,8069,7965,-104,-1.289,-40,-64,5,39,H1
"Dallas County, AR",2012-2013,7965,7921,-44,-0.552,-2,-42,5,39,H1
"Dallas County, AR",2013-2014,7921,7755,-166,-2.096,-15,-151,5,39,H1
"Dallas County, AR",2014-2015,7757,7604,-153,-1.972,-9,-144,5,39,H1
"Dallas County, AR",2015-2016,7604,7430,-174,-2.288,2,-176,5,39,H1
"Dallas County, AR",2016-2017,7430,7393,-37,-0.498,-6,-31,5,39,H1
"Desha County, AR",2000-2001,15302,14958,-344,-2.248,33,-377,5,41,H1
"Desha County, AR",2001-2002,14958,14583,-375,-2.507,54,-429,5,41,H1
"Desha County, AR",2002-2003,14583,14405,-178,-1.221,58,-236,5,41,H1
"Desha County, AR",2003-2004,14405,14270,-135,-0.937,56,-191,5,41,H1
"Desha County, AR",2004-2005,14270,13992,-278,-1.948,30,-308,5,41,H1
"Desha County, AR",2005-2006,13992,13870,-122,-0.872,57,-179,5,41,H1
"Desha County, AR",2006-2007,13870,13523,-347,-2.502,57,-404,5,41,H1
"Desha County, AR",2007-2008,13523,13273,-250,-1.849,40,-290,5,41,H1
"Desha County, AR",2008-2009,13273,13108,-165,-1.243,22,-187,5,41,H1
"Desha County, AR",2009-2010,13108,12970,-138,-1.053,53,-191,5,41,H1
"Desha County, AR",2010-2011,12970,12711,-259,-1.997,48,-307,5,41,H1
"Desha County, AR",2011-2012,12711,12574,-137,-1.078,23,-160,5,41,H1
"Desha County, AR",2012-2013,12574,12492,-82,-0.652,45,-127,5,41,H1
"Desha County, AR",2013-2014,12492,12264,-228,-1.825,6,-234,5,41,H1
"Desha County, AR",2014-2015,12215,11965,-250,-2.047,-18,-232,5,41,H1
"Desha County, AR",2015-2016,11965,11920,-45,-0.376,-3,-42,5,41,H1
"Desha County, AR",2016-2017,11920,11764,-156,-1.309,-16,-140,5,41,H1
"Drew County, AR",2000-2001,18670,18660,-10,-0.054,26,-36,5,43,H1
"Drew County, AR",2001-2002,18660,18410,-250,-1.34,30,-280,5,43,H1
"Drew County, AR",2002-2003,18410,18537,127,0.69,39,88,5,43,H1
"Drew County, AR",2003-2004,18537,18595,58,0.313,68,-10,5,43,H1
"Drew County, AR",2004-2005,18595,18618,23,0.124,64,-41,5,43,H1
"Drew County, AR",2005-2006,18618,18705,87,0.467,82,5,5,43,H1
"Drew County, AR",2006-2007,18705,18535,-170,-0.909,90,-260,5,43,H1
"Drew County, AR",2007-2008,18535,18481,-54,-0.291,85,-139,5,43,H1
"Drew County, AR",2008-2009,18481,18495,14,0.076,81,-67,5,43,H1
"Drew County, AR",2009-2010,18495,18673,178,0.962,51,127,5,43,H1
"Drew County, AR",2010-2011,18673,18729,56,0.3,55,1,5,43,H1
"Drew County, AR",2011-2012,18729,18775,46,0.246,64,-18,5,43,H1
"Drew County, AR",2012-2013,18775,18728,-47,-0.25,59,-106,5,43,H1
"Drew County, AR",2013-2014,18728,18622,-106,-0.566,44,-150,5,43,H1
"Drew County, AR",2014-2015,18729,18778,49,0.262,49,0,5,43,H1
"Drew County, AR",2015-2016,18778,18628,-150,-0.799,62,-212,5,43,H1
"Drew County, AR",2016-2017,18628,18547,-81,-0.435,43,-124,5,43,H1
"Faulkner County, AR",2000-2001,86501,88830,2329,2.692,653,1676,5,45,H1
"Faulkner County, AR",2001-2002,88830,90624,1794,2.02,620,1174,5,45,H1
"Faulkner County, AR",2002-2003,90624,93618,2994,3.304,639,2355,5,45,H1
"Faulkner County, AR",2003-2004,93618,96162,2544,2.717,607,1937,5,45,H1
"Faulkner County, AR",2004-2005,96162,99192,3030,3.151,706,2324,5,45,H1
"Faulkner County, AR",2005-2006,99192,102969,3777,3.808,737,3040,5,45,H1
"Faulkner County, AR",2006-2007,102969,105637,2668,2.591,781,1887,5,45,H1
"Faulkner County, AR",2007-2008,105637,108477,2840,2.688,767,2073,5,45,H1
"Faulkner County, AR",2008-2009,108477,110813,2336,2.153,798,1538,5,45,H1
"Faulkner County, AR",2009-2010,110813,114039,3226,2.911,801,2425,5,45,H1
"Faulkner County, AR",2010-2011,114039,116293,2254,1.977,779,1475,5,45,H1
"Faulkner County, AR",2011-2012,116293,118529,2236,1.923,743,1493,5,45,H1
"Faulkner County, AR",2012-2013,118529,119390,861,0.726,696,165,5,45,H1
"Faulkner County, AR",2013-2014,119390,120768,1378,1.154,708,670,5,45,H1
"Faulkner County, AR",2014-2015,120878,121552,674,0.558,713,-39,5,45,H1
"Faulkner County, AR",2015-2016,121552,122083,531,0.437,642,-111,5,45,H1
"Faulkner County, AR",2016-2017,122083,123654,1571,1.287,663,908,5,45,H1
"Franklin County, AR",2000-2001,17737,17830,93,0.524,29,64,5,47,H1
"Franklin County, AR",2001-2002,17830,17856,26,0.146,55,-29,5,47,H1
"Franklin County, AR",2002-2003,17856,17913,57,0.319,13,44,5,47,H1
"Franklin County, AR",2003-2004,17913,17955,42,0.234,5,37,5,47,H1
"Franklin County, AR",2004-2005,17955,18073,118,0.657,16,102,5,47,H1
"Franklin County, AR",2005-2006,18073,18151,78,0.432,43,35,5,47,H1
"Franklin County, AR",2006-2007,18151,18237,86,0.474,37,49,5,47,H1
"Franklin County, AR",2007-2008,18237,18229,-8,-0.044,8,-16,5,47,H1
"Franklin County, AR",2008-2009,18229,18145,-84,-0.461,7,-91,5,47,H1
"Franklin County, AR",2009-2010,18145,18121,-24,-0.132,17,-41,5,47,H1
"Franklin County, AR",2010-2011,18121,17986,-135,-0.745,-33,-102,5,47,H1
"Franklin County, AR",2011-2012,17986,17942,-44,-0.245,-40,-4,5,47,H1
"Franklin County, AR",2012-2013,17942,17945,3,0.017,-4,7,5,47,H1
"Franklin County, AR",2013-2014,17945,17805,-140,-0.78,7,-147,5,47,H1
"Franklin County, AR",2014-2015,17766,17702,-64,-0.36,-15,-49,5,47,H1
"Franklin County, AR",2015-2016,17702,17671,-31,-0.175,-27,-4,5,47,H1
"Franklin County, AR",2016-2017,17671,17890,219,1.239,5,214,5,47,H1
"Fulton County, AR",2000-2001,11656,11676,20,0.172,-66,86,5,49,H1
"Fulton County, AR",2001-2002,11676,11737,61,0.522,-27,88,5,49,H1
"Fulton County, AR",2002-2003,11737,11831,94,0.801,-19,113,5,49,H1
"Fulton County, AR",2003-2004,11831,12079,248,2.096,-53,301,5,49,H1
"Fulton County, AR",2004-2005,12079,12127,48,0.397,-55,103,5,49,H1
"Fulton County, AR",2005-2006,12127,12119,-8,-0.066,-55,47,5,49,H1
"Fulton County, AR",2006-2007,12119,12354,235,1.939,-44,279,5,49,H1
"Fulton County, AR",2007-2008,12354,12382,28,0.227,-66,94,5,49,H1
"Fulton County, AR",2008-2009,12382,12231,-151,-1.22,-44,-107,5,49,H1
"Fulton County, AR",2009-2010,12231,12212,-19,-0.155,-23,4,5,49,H1
"Fulton County, AR",2010-2011,12212,12285,73,0.598,-69,142,5,49,H1
"Fulton County, AR",2011-2012,12285,12241,-44,-0.358,-38,-6,5,49,H1
"Fulton County, AR",2012-2013,12241,12227,-14,-0.114,-53,39,5,49,H1
"Fulton County, AR",2013-2014,12227,12125,-102,-0.834,-72,-30,5,49,H1
"Fulton County, AR",2014-2015,12139,12204,65,0.535,-66,131,5,49,H1
"Fulton County, AR",2015-2016,12204,12039,-165,-1.352,-90,-75,5,49,H1
"Fulton County, AR",2016-2017,12039,12055,16,0.133,-77,93,5,49,H1
"Garland County, AR",2000-2001,88311,89032,721,0.816,-225,946,5,51,H1
"Garland County, AR",2001-2002,89032,89630,598,0.672,-312,910,5,51,H1
"Garland County, AR",2002-2003,89630,90483,853,0.952,-204,1057,5,51,H1
"Garland County, AR",2003-2004,90483,91084,601,0.664,-167,768,5,51,H1
"Garland County, AR",2004-2005,91084,92096,1012,1.111,-229,1241,5,51,H1
"Garland County, AR",2005-2006,92096,94077,1981,2.151,-7,1988,5,51,H1
"Garland County, AR",2006-2007,94077,94753,676,0.719,-103,779,5,51,H1
"Garland County, AR",2007-2008,94753,95636,883,0.932,-65,948,5,51,H1
"Garland County, AR",2008-2009,95636,95840,204,0.213,-173,377,5,51,H1
"Garland County, AR",2009-2010,95840,96156,316,0.33,-236,552,5,51,H1
"Garland County, AR",2010-2011,96156,96641,485,0.504,-183,668,5,51,H1
"Garland County, AR",2011-2012,96641,96837,196,0.203,-261,457,5,51,H1
"Garland County, AR",2012-2013,96837,97065,228,0.235,-199,427,5,51,H1
"Garland County, AR",2013-2014,97065,97322,257,0.265,-147,404,5,51,H1
"Garland County, AR",2014-2015,97185,97177,-8,-0.008,-226,218,5,51,H1
"Garland County, AR",2015-2016,97177,98231,1054,1.085,-200,1254,5,51,H1
"Garland County, AR",2016-2017,98231,98658,427,0.435,-173,600,5,51,H1
"Grant County, AR",2000-2001,16476,16608,132,0.801,28,104,5,53,H1
"Grant County, AR",2001-2002,16608,16637,29,0.175,23,6,5,53,H1
"Grant County, AR",2002-2003,16637,16731,94,0.565,1,93,5,53,H1
"Grant County, AR",2003-2004,16731,17026,295,1.763,-7,302,5,53,H1
"Grant County, AR",2004-2005,17026,17244,218,1.28,23,195,5,53,H1
"Grant County, AR",2005-2006,17244,17442,198,1.148,73,125,5,53,H1
"Grant County, AR",2006-2007,17442,17483,41,0.235,67,-26,5,53,H1
"Grant County, AR",2007-2008,17483,17718,235,1.344,19,216,5,53,H1
"Grant County, AR",2008-2009,17718,17751,33,0.186,35,-2,5,53,H1
"Grant County, AR",2009-2010,17751,17887,136,0.766,35,101,5,53,H1
"Grant County, AR",2010-2011,17887,17957,70,0.391,-3,73,5,53,H1
"Grant County, AR",2011-2012,17957,18035,78,0.434,19,59,5,53,H1
"Grant County, AR",2012-2013,18035,18046,11,0.061,35,-24,5,53,H1
"Grant County, AR",2013-2014,18046,18144,98,0.543,55,43,5,53,H1
"Grant County, AR",2014-2015,18115,18102,-13,-0.072,16,-29,5,53,H1
"Grant County, AR",2015-2016,18102,18094,-8,-0.044,6,-14,5,53,H1
"Grant County, AR",2016-2017,18094,18165,71,0.392,15,56,5,53,H1
"Greene County, AR",2000-2001,37563,37934,371,0.988,137,234,5,55,H1
"Greene County, AR",2001-2002,37934,38229,295,0.778,162,133,5,55,H1
"Greene County, AR",2002-2003,38229,38604,375,0.981,162,213,5,55,H1
"Greene County, AR",2003-2004,38604,39046,442,1.145,110,332,5,55,H1
"Greene County, AR",2004-2005,39046,39599,553,1.416,136,417,5,55,H1
"Greene County, AR",2005-2006,39599,40469,870,2.197,169,701,5,55,H1
"Greene County, AR",2006-2007,40469,40918,449,1.109,115,334,5,55,H1
"Greene County, AR",2007-2008,40918,41286,368,0.899,167,201,5,55,H1
"Greene County, AR",2008-2009,41286,41723,437,1.058,148,289,5,55,H1
"Greene County, AR",2009-2010,41723,42193,470,1.126,155,315,5,55,H1
"Greene County, AR",2010-2011,42193,42731,538,1.275,81,457,5,55,H1
"Greene County, AR",2011-2012,42731,43158,427,0.999,116,311,5,55,H1
"Greene County, AR",2012-2013,43158,43072,-86,-0.199,69,-155,5,55,H1
"Greene County, AR",2013-2014,43072,43694,622,1.444,80,542,5,55,H1
"Greene County, AR",2014-2015,43729,44196,467,1.068,120,347,5,55,H1
"Greene County, AR",2015-2016,44196,44715,519,1.174,65,454,5,55,H1
"Greene County, AR",2016-2017,44715,45053,338,0.756,115,223,5,55,H1
"Hempstead County, AR",2000-2001,23620,23318,-302,-1.279,80,-382,5,57,H1
"Hempstead County, AR",2001-2002,23318,23199,-119,-0.51,52,-171,5,57,H1
"Hempstead County, AR",2002-2003,23199,23090,-109,-0.47,72,-181,5,57,H1
"Hempstead County, AR",2003-2004,23090,22971,-119,-0.515,23,-142,5,57,H1
"Hempstead County, AR",2004-2005,22971,22924,-47,-0.205,79,-126,5,57,H1
"Hempstead County, AR",2005-2006,22924,22957,33,0.144,121,-88,5,57,H1
"Hempstead County, AR",2006-2007,22957,22918,-39,-0.17,140,-179,5,57,H1
"Hempstead County, AR",2007-2008,22918,22624,-294,-1.283,138,-432,5,57,H1
"Hempstead County, AR",2008-2009,22624,22615,-9,-0.04,136,-145,5,57,H1
"Hempstead County, AR",2009-2010,22615,22566,-49,-0.217,103,-152,5,57,H1
"Hempstead County, AR",2010-2011,22566,22477,-89,-0.394,69,-158,5,57,H1
"Hempstead County, AR",2011-2012,22477,22325,-152,-0.676,96,-248,5,57,H1
"Hempstead County, AR",2012-2013,22325,22398,73,0.327,112,-39,5,57,H1
"Hempstead County, AR",2013-2014,22398,22327,-71,-0.317,109,-180,5,57,H1
"Hempstead County, AR",2014-2015,22317,22084,-233,-1.044,98,-331,5,57,H1
"Hempstead County, AR",2015-2016,22084,22026,-58,-0.263,65,-123,5,57,H1
"Hempstead County, AR",2016-2017,22026,21861,-165,-0.749,66,-231,5,57,H1
"Hot Spring County, AR",2000-2001,30480,30615,135,0.443,-8,143,5,59,H1
"Hot Spring County, AR",2001-2002,30615,30877,262,0.856,53,209,5,59,H1
"Hot Spring County, AR",2002-2003,30877,30821,-56,-0.181,3,-59,5,59,H1
"Hot Spring County, AR",2003-2004,30821,31071,250,0.811,50,200,5,59,H1
"Hot Spring County, AR",2004-2005,31071,31565,494,1.59,42,452,5,59,H1
"Hot Spring County, AR",2005-2006,31565,32248,683,2.164,1,682,5,59,H1
"Hot Spring County, AR",2006-2007,32248,32631,383,1.188,46,337,5,59,H1
"Hot Spring County, AR",2007-2008,32631,32737,106,0.325,64,42,5,59,H1
"Hot Spring County, AR",2008-2009,32737,32797,60,0.183,31,29,5,59,H1
"Hot Spring County, AR",2009-2010,32797,33145,348,1.061,60,288,5,59,H1
"Hot Spring County, AR",2010-2011,33145,33047,-98,-0.296,27,-125,5,59,H1
"Hot Spring County, AR",2011-2012,33047,33386,339,1.026,-50,389,5,59,H1
"Hot Spring County, AR",2012-2013,33386,33440,54,0.162,-21,75,5,59,H1
"Hot Spring County, AR",2013-2014,33440,33368,-72,-0.215,-10,-62,5,59,H1
"Hot Spring County, AR",2014-2015,33333,33426,93,0.279,-5,98,5,59,H1
"Hot Spring County, AR",2015-2016,33426,33446,20,0.06,-27,47,5,59,H1
"Hot Spring County, AR",2016-2017,33446,33574,128,0.383,-34,162,5,59,H1
"Howard County, AR",2000-2001,14233,14146,-87,-0.611,43,-130,5,61,H1
"Howard County, AR",2001-2002,14146,14070,-76,-0.537,56,-132,5,61,H1
"Howard County, AR",2002-2003,14070,14098,28,0.199,25,3,5,61,H1
"Howard County, AR",2003-2004,14098,13991,-107,-0.759,18,-125,5,61,H1
"Howard County, AR",2004-2005,13991,14025,34,0.243,53,-19,5,61,H1
"Howard County, AR",2005-2006,14025,13843,-182,-1.298,39,-221,5,61,H1
"Howard County, AR",2006-2007,13843,13680,-163,-1.177,16,-179,5,61,H1
"Howard County, AR",2007-2008,13680,13804,124,0.906,81,43,5,61,H1
"Howard County, AR",2008-2009,13804,13741,-63,-0.456,71,-134,5,61,H1
"Howard County, AR",2009-2010,13741,13827,86,0.626,55,31,5,61,H1
"Howard County, AR",2010-2011,13827,13844,17,0.123,26,-9,5,61,H1
"Howard County, AR",2011-2012,13844,13710,-134,-0.968,31,-165,5,61,H1
"Howard County, AR",2012-2013,13710,13544,-166,-1.211,41,-207,5,61,H1
"Howard County, AR",2013-2014,13544,13500,-44,-0.325,46,-90,5,61,H1
"Howard County, AR",2014-2015,13460,13300,-160,-1.189,31,-191,5,61,H1
"Howard County, AR",2015-2016,13300,13438,138,1.038,53,85,5,61,H1
"Howard County, AR",2016-2017,13438,13478,40,0.298,40,0,5,61,H1
"Independence County, AR",2000-2001,34333,34374,41,0.119,9,32,5,63,H1
"Independence County, AR",2001-2002,34374,34512,138,0.401,75,63,5,63,H1
"Independence County, AR",2002-2003,34512,34652,140,0.406,66,74,5,63,H1
"Independence County, AR",2003-2004,34652,34989,337,0.973,100,237,5,63,H1
"Independence County, AR",2004-2005,34989,35155,166,0.474,122,44,5,63,H1
"Independence County, AR",2005-2006,35155,35426,271,0.771,77,194,5,63,H1
"Independence County, AR",2006-2007,35426,35690,264,0.745,163,101,5,63,H1
"Independence County, AR",2007-2008,35690,35859,169,0.474,72,97,5,63,H1
"Independence County, AR",2008-2009,35859,36259,400,1.115,94,306,5,63,H1
"Independence County, AR",2009-2010,36259,36795,536,1.478,99,437,5,63,H1
"Independence County, AR",2010-2011,36795,36803,8,0.022,67,-59,5,63,H1
"Independence County, AR",2011-2012,36803,36905,102,0.277,82,20,5,63,H1
"Independence County, AR",2012-2013,36905,36843,-62,-0.168,71,-133,5,63,H1
"Independence County, AR",2013-2014,36843,36959,116,0.315,69,47,5,63,H1
"Independence County, AR",2014-2015,37061,37052,-9,-0.024,23,-32,5,63,H1
"Independence County, AR",2015-2016,37052,37094,42,0.113,58,-16,5,63,H1
"Independence County, AR",2016-2017,37094,37504,410,1.105,73,337,5,63,H1
"Izard County, AR",2000-2001,13298,13289,-9,-0.068,-85,76,5,65,H1
"Izard County, AR",2001-2002,13289,13273,-16,-0.12,-56,40,5,65,H1
"Izard County, AR",2002-2003,13273,13467,194,1.462,-37,231,5,65,H1
"Izard County, AR",2003-2004,13467,13512,45,0.334,-51,96,5,65,H1
"Izard County, AR",2004-2005,13512,13524,12,0.089,-32,44,5,65,H1
"Izard County, AR",2005-2006,13524,13583,59,0.436,-50,109,5,65,H1
"Izard County, AR",2006-2007,13583,13552,-31,-0.228,-57,26,5,65,H1
"Izard County, AR",2007-2008,13552,13681,129,0.952,-68,197,5,65,H1
"Izard County, AR",2008-2009,13681,13679,-2,-0.015,-41,39,5,65,H1
"Izard County, AR",2009-2010,13679,13681,2,0.015,-46,48,5,65,H1
"Izard County, AR",2010-2011,13681,13573,-108,-0.789,-80,-28,5,65,H1
"Izard County, AR",2011-2012,13573,13506,-67,-0.494,-58,-9,5,65,H1
"Izard County, AR",2012-2013,13506,13364,-142,-1.051,-65,-77,5,65,H1
"Izard County, AR",2013-2014,13364,13486,122,0.913,-62,184,5,65,H1
"Izard County, AR",2014-2015,13488,13445,-43,-0.319,-71,28,5,65,H1
"Izard County, AR",2015-2016,13445,13490,45,0.335,-59,104,5,65,H1
"Izard County, AR",2016-2017,13490,13686,196,1.453,-83,279,5,65,H1
"Jackson County, AR",2000-2001,18403,18029,-374,-2.032,-69,-305,5,67,H1
"Jackson County, AR",2001-2002,18029,18054,25,0.139,-49,74,5,67,H1
"Jackson County, AR",2002-2003,18054,17914,-140,-0.775,-34,-106,5,67,H1
"Jackson County, AR",2003-2004,17914,18159,245,1.368,-17,262,5,67,H1
"Jackson County, AR",2004-2005,18159,18269,110,0.606,33,77,5,67,H1
"Jackson County, AR",2005-2006,18269,18092,-177,-0.969,-31,-146,5,67,H1
"Jackson County, AR",2006-2007,18092,18098,6,0.033,-14,20,5,67,H1
"Jackson County, AR",2007-2008,18098,17966,-132,-0.729,-1,-131,5,67,H1
"Jackson County, AR",2008-2009,17966,17945,-21,-0.117,27,-48,5,67,H1
"Jackson County, AR",2009-2010,17945,18048,103,0.574,28,75,5,67,H1
"Jackson County, AR",2010-2011,18048,17842,-206,-1.141,-48,-158,5,67,H1
"Jackson County, AR",2011-2012,17842,17640,-202,-1.132,-26,-176,5,67,H1
"Jackson County, AR",2012-2013,17640,17664,24,0.136,-10,34,5,67,H1
"Jackson County, AR",2013-2014,17664,17534,-130,-0.736,-3,-127,5,67,H1
"Jackson County, AR",2014-2015,17503,17338,-165,-0.943,-19,-146,5,67,H1
"Jackson County, AR",2015-2016,17338,17309,-29,-0.167,-1,-28,5,67,H1
"Jackson County, AR",2016-2017,17309,17135,-174,-1.005,-4,-170,5,67,H1
"Jefferson County, AR",2000-2001,84171,83322,-849,-1.009,346,-1195,5,69,H1
"Jefferson County, AR",2001-2002,83322,82760,-562,-0.674,286,-848,5,69,H1
"Jefferson County, AR",2002-2003,82760,82193,-567,-0.685,219,-786,5,69,H1
"Jefferson County, AR",2003-2004,82193,81455,-738,-0.898,266,-1004,5,69,H1
"Jefferson County, AR",2004-2005,81455,80562,-893,-1.096,271,-1164,5,69,H1
"Jefferson County, AR",2005-2006,80562,79977,-585,-0.726,372,-957,5,69,H1
"Jefferson County, AR",2006-2007,79977,78788,-1189,-1.487,252,-1441,5,69,H1
"Jefferson County, AR",2007-2008,78788,78354,-434,-0.551,281,-715,5,69,H1
"Jefferson County, AR",2008-2009,78354,77759,-595,-0.759,232,-827,5,69,H1
"Jefferson County, AR",2009-2010,77759,77311,-448,-0.576,259,-707,5,69,H1
"Jefferson County, AR",2010-2011,77311,76004,-1307,-1.691,199,-1506,5,69,H1
"Jefferson County, AR",2011-2012,76004,74580,-1424,-1.874,58,-1482,5,69,H1
"Jefferson County, AR",2012-2013,74580,73084,-1496,-2.006,109,-1605,5,69,H1
"Jefferson County, AR",2013-2014,73084,72297,-787,-1.077,72,-859,5,69,H1
"Jefferson County, AR",2014-2015,72377,71565,-812,-1.122,112,-924,5,69,H1
"Jefferson County, AR",2015-2016,71565,70342,-1223,-1.709,7,-1230,5,69,H1
"Jefferson County, AR",2016-2017,70342,69115,-1227,-1.744,9,-1236,5,69,H1
"Johnson County, AR",2000-2001,22813,22977,164,0.719,79,85,5,71,H1
"Johnson County, AR",2001-2002,22977,23293,316,1.375,113,203,5,71,H1
"Johnson County, AR",2002-2003,23293,23587,294,1.262,137,157,5,71,H1
"Johnson County, AR",2003-2004,23587,23850,263,1.115,107,156,5,71,H1
"Johnson County, AR",2004-2005,23850,24173,323,1.354,129,194,5,71,H1
"Johnson County, AR",2005-2006,24173,24596,423,1.75,95,328,5,71,H1
"Johnson County, AR",2006-2007,24596,25109,513,2.086,140,373,5,71,H1
"Johnson County, AR",2007-2008,25109,25236,127,0.506,108,19,5,71,H1
"Johnson County, AR",2008-2009,25236,25374,138,0.547,120,18,5,71,H1
"Johnson County, AR",2009-2010,25374,25536,162,0.638,133,29,5,71,H1
"Johnson County, AR",2010-2011,25536,25663,127,0.497,72,55,5,71,H1
"Johnson County, AR",2011-2012,25663,25864,201,0.783,119,82,5,71,H1
"Johnson County, AR",2012-2013,25864,25887,23,0.089,118,-95,5,71,H1
"Johnson County, AR",2013-2014,25887,26005,118,0.456,133,-15,5,71,H1
"Johnson County, AR",2014-2015,26013,26141,128,0.492,89,39,5,71,H1
"Johnson County, AR",2015-2016,26141,26225,84,0.321,129,-45,5,71,H1
"Johnson County, AR",2016-2017,26225,26552,327,1.247,116,211,5,71,H1
"Lafayette County, AR",2000-2001,8539,8374,-165,-1.932,3,-168,5,73,H1
"Lafayette County, AR",2001-2002,8374,8240,-134,-1.6,-7,-127,5,73,H1
"Lafayette County, AR",2002-2003,8240,8244,4,0.049,-27,31,5,73,H1
"Lafayette County, AR",2003-2004,8244,8153,-91,-1.104,-16,-75,5,73,H1
"Lafayette County, AR",2004-2005,8153,8042,-111,-1.361,-39,-72,5,73,H1
"Lafayette County, AR",2005-2006,8042,7879,-163,-2.027,-18,-145,5,73,H1
"Lafayette County, AR",2006-2007,7879,7845,-34,-0.432,-1,-33,5,73,H1
"Lafayette County, AR",2007-2008,7845,7806,-39,-0.497,48,-87,5,73,H1
"Lafayette County, AR",2008-2009,7806,7654,-152,-1.947,8,-160,5,73,H1
"Lafayette County, AR",2009-2010,7654,7633,-21,-0.274,-10,-11,5,73,H1
"Lafayette County, AR",2010-2011,7633,7536,-97,-1.271,-49,-48,5,73,H1
"Lafayette County, AR",2011-2012,7536,7431,-105,-1.393,-26,-79,5,73,H1
"Lafayette County, AR",2012-2013,7431,7245,-186,-2.503,-25,-161,5,73,H1
"Lafayette County, AR",2013-2014,7245,7111,-134,-1.85,-23,-111,5,73,H1
"Lafayette County, AR",2014-2015,7128,6996,-132,-1.852,-15,-117,5,73,H1
"Lafayette County, AR",2015-2016,6996,6928,-68,-0.972,20,-88,5,73,H1
"Lafayette County, AR",2016-2017,6928,6862,-66,-0.953,-23,-43,5,73,H1
"Lawrence County, AR",2000-2001,17672,17749,77,0.436,19,58,5,75,H1
"Lawrence County, AR",2001-2002,17749,17688,-61,-0.344,-53,-8,5,75,H1
"Lawrence County, AR",2002-2003,17688,17605,-83,-0.469,-5,-78,5,75,H1
"Lawrence County, AR",2003-2004,17605,17541,-64,-0.364,-6,-58,5,75,H1
"Lawrence County, AR",2004-2005,17541,17343,-198,-1.129,12,-210,5,75,H1
"Lawrence County, AR",2005-2006,17343,17193,-150,-0.865,11,-161,5,75,H1
"Lawrence County, AR",2006-2007,17193,17286,93,0.541,12,81,5,75,H1
"Lawrence County, AR",2007-2008,17286,17460,174,1.007,-9,183,5,75,H1
"Lawrence County, AR",2008-2009,17460,17336,-124,-0.71,-2,-122,5,75,H1
"Lawrence County, AR",2009-2010,17336,17499,163,0.94,-25,188,5,75,H1
"Lawrence County, AR",2010-2011,17499,17285,-214,-1.223,-65,-149,5,75,H1
"Lawrence County, AR",2011-2012,17285,17039,-246,-1.423,-56,-190,5,75,H1
"Lawrence County, AR",2012-2013,17039,17061,22,0.129,-25,47,5,75,H1
"Lawrence County, AR",2013-2014,17061,16931,-130,-0.762,-56,-74,5,75,H1
"Lawrence County, AR",2014-2015,16985,16779,-206,-1.213,-50,-156,5,75,H1
"Lawrence County, AR",2015-2016,16779,16639,-140,-0.834,-65,-75,5,75,H1
"Lawrence County, AR",2016-2017,16639,16525,-114,-0.685,-85,-29,5,75,H1
"Lee County, AR",2000-2001,12527,12358,-169,-1.349,11,-180,5,77,H1
"Lee County, AR",2001-2002,12358,12151,-207,-1.675,27,-234,5,77,H1
"Lee County, AR",2002-2003,12151,11732,-419,-3.448,25,-444,5,77,H1
"Lee County, AR",2003-2004,11732,11512,-220,-1.875,-26,-194,5,77,H1
"Lee County, AR",2004-2005,11512,11370,-142,-1.233,-6,-136,5,77,H1
"Lee County, AR",2005-2006,11370,11067,-303,-2.665,5,-308,5,77,H1
"Lee County, AR",2006-2007,11067,10823,-244,-2.205,11,-255,5,77,H1
"Lee County, AR",2007-2008,10823,10786,-37,-0.342,18,-55,5,77,H1
"Lee County, AR",2008-2009,10786,10458,-328,-3.041,-6,-322,5,77,H1
"Lee County, AR",2009-2010,10458,10376,-82,-0.784,-9,-73,5,77,H1
"Lee County, AR",2010-2011,10376,10289,-87,-0.838,-5,-82,5,77,H1
"Lee County, AR",2011-2012,10289,10190,-99,-0.962,-27,-72,5,77,H1
"Lee County, AR",2012-2013,10190,10041,-149,-1.462,-9,-140,5,77,H1
"Lee County, AR",2013-2014,10041,9860,-181,-1.803,-17,-164,5,77,H1
"Lee County, AR",2014-2015,9787,9650,-137,-1.4,-6,-131,5,77,H1
"Lee County, AR",2015-2016,9650,9360,-290,-3.005,5,-295,5,77,H1
"Lee County, AR",2016-2017,9360,9176,-184,-1.966,-14,-170,5,77,H1
"Lincoln County, AR",2000-2001,14477,14505,28,0.193,24,4,5,79,H1
"Lincoln County, AR",2001-2002,14505,14571,66,0.455,30,36,5,79,H1
"Lincoln County, AR",2002-2003,14571,14578,7,0.048,26,-19,5,79,H1
"Lincoln County, AR",2003-2004,14578,14466,-112,-0.768,17,-129,5,79,H1
"Lincoln County, AR",2004-2005,14466,14496,30,0.207,0,30,5,79,H1
"Lincoln County, AR",2005-2006,14496,14315,-181,-1.249,13,-194,5,79,H1
"Lincoln County, AR",2006-2007,14315,14237,-78,-0.545,-1,-77,5,79,H1
"Lincoln County, AR",2007-2008,14237,14176,-61,-0.428,28,-89,5,79,H1
"Lincoln County, AR",2008-2009,14176,14185,9,0.063,32,-23,5,79,H1
"Lincoln County, AR",2009-2010,14185,14075,-110,-0.775,23,-133,5,79,H1
"Lincoln County, AR",2010-2011,14075,14329,254,1.805,8,246,5,79,H1
"Lincoln County, AR",2011-2012,14329,14149,-180,-1.256,22,-202,5,79,H1
"Lincoln County, AR",2012-2013,14149,14043,-106,-0.749,-12,-94,5,79,H1
"Lincoln County, AR",2013-2014,14043,13970,-73,-0.52,-30,-43,5,79,H1
"Lincoln County, AR",2014-2015,13982,13820,-162,-1.159,-11,-151,5,79,H1
"Lincoln County, AR",2015-2016,13820,13810,-10,-0.072,65,-75,5,79,H1
"Lincoln County, AR",2016-2017,13810,13646,-164,-1.188,2,-166,5,79,H1
"Little River County, AR",2000-2001,13613,13334,-279,-2.05,-37,-242,5,81,H1
"Little River County, AR",2001-2002,13334,13413,79,0.592,4,75,5,81,H1
"Little River County, AR",2002-2003,13413,13361,-52,-0.388,18,-70,5,81,H1
"Little River County, AR",2003-2004,13361,13176,-185,-1.385,-7,-178,5,81,H1
"Little River County, AR",2004-2005,13176,13114,-62,-0.471,-40,-22,5,81,H1
"Little River County, AR",2005-2006,13114,13147,33,0.252,-17,50,5,81,H1
"Little River County, AR",2006-2007,13147,13107,-40,-0.304,25,-65,5,81,H1
"Little River County, AR",2007-2008,13107,13099,-8,-0.061,68,-76,5,81,H1
"Little River County, AR",2008-2009,13099,13228,129,0.985,42,87,5,81,H1
"Little River County, AR",2009-2010,13228,13133,-95,-0.718,27,-122,5,81,H1
"Little River County, AR",2010-2011,13133,12950,-183,-1.393,-46,-137,5,81,H1
"Little River County, AR",2011-2012,12950,12905,-45,-0.347,-20,-25,5,81,H1
"Little River County, AR",2012-2013,12905,12741,-164,-1.271,28,-192,5,81,H1
"Little River County, AR",2013-2014,12741,12532,-209,-1.64,-3,-206,5,81,H1
"Little River County, AR",2014-2015,12531,12472,-59,-0.471,-13,-46,5,81,H1
"Little River County, AR",2015-2016,12472,12430,-42,-0.337,-37,-5,5,81,H1
"Little River County, AR",2016-2017,12430,12359,-71,-0.571,-51,-20,5,81,H1
"Logan County, AR",2000-2001,22500,22385,-115,-0.511,31,-146,5,83,H1
"Logan County, AR",2001-2002,22385,22454,69,0.308,29,40,5,83,H1
"Logan County, AR",2002-2003,22454,22707,253,1.127,41,212,5,83,H1
"Logan County, AR",2003-2004,22707,22682,-25,-0.11,-34,9,5,83,H1
"Logan County, AR",2004-2005,22682,22661,-21,-0.093,-9,-12,5,83,H1
"Logan County, AR",2005-2006,22661,22689,28,0.124,-1,29,5,83,H1
"Logan County, AR",2006-2007,22689,22758,69,0.304,44,25,5,83,H1
"Logan County, AR",2007-2008,22758,22699,-59,-0.259,-14,-45,5,83,H1
"Logan County, AR",2008-2009,22699,22429,-270,-1.189,-17,-253,5,83,H1
"Logan County, AR",2009-2010,22429,22319,-110,-0.49,-2,-108,5,83,H1
"Logan County, AR",2010-2011,22319,22286,-33,-0.148,-4,-29,5,83,H1
"Logan County, AR",2011-2012,22286,22005,-281,-1.261,10,-291,5,83,H1
"Logan County, AR",2012-2013,22005,22076,71,0.323,-24,95,5,83,H1
"Logan County, AR",2013-2014,22076,21958,-118,-0.535,-29,-89,5,83,H1
"Logan County, AR",2014-2015,21919,21714,-205,-0.935,-35,-170,5,83,H1
"Logan County, AR",2015-2016,21714,21713,-1,-0.005,-25,24,5,83,H1
"Logan County, AR",2016-2017,21713,21722,9,0.041,-22,31,5,83,H1
"Lonoke County, AR",2000-2001,53153,54043,890,1.674,254,636,5,85,H1
"Lonoke County, AR",2001-2002,54043,55184,1141,2.111,270,871,5,85,H1
"Lonoke County, AR",2002-2003,55184,56452,1268,2.298,303,965,5,85,H1
"Lonoke County, AR",2003-2004,56452,58449,1997,3.538,364,1633,5,85,H1
"Lonoke County, AR",2004-2005,58449,60225,1776,3.039,318,1458,5,85,H1
"Lonoke County, AR",2005-2006,60225,62648,2423,4.023,434,1989,5,85,H1
"Lonoke County, AR",2006-2007,62648,64379,1731,2.763,416,1315,5,85,H1
"Lonoke County, AR",2007-2008,64379,66086,1707,2.651,410,1297,5,85,H1
"Lonoke County, AR",2008-2009,66086,67481,1395,2.111,400,995,5,85,H1
"Lonoke County, AR",2009-2010,67481,68701,1220,1.808,401,819,5,85,H1
"Lonoke County, AR",2010-2011,68701,69410,709,1.032,377,332,5,85,H1
"Lonoke County, AR",2011-2012,69410,70087,677,0.975,358,319,5,85,H1
"Lonoke County, AR",2012-2013,70087,70834,747,1.066,363,384,5,85,H1
"Lonoke County, AR",2013-2014,70834,71557,723,1.021,357,366,5,85,H1
"Lonoke County, AR",2014-2015,71488,71645,157,0.22,353,-196,5,85,H1
"Lonoke County, AR",2015-2016,71645,71757,112,0.156,292,-180,5,85,H1
"Lonoke County, AR",2016-2017,71757,72898,1141,1.59,312,829,5,85,H1
"Madison County, AR",2000-2001,14272,14253,-19,-0.133,21,-40,5,87,H1
"Madison County, AR",2001-2002,14253,14137,-116,-0.814,41,-157,5,87,H1
"Madison County, AR",2002-2003,14137,14186,49,0.347,9,40,5,87,H1
"Madison County, AR",2003-2004,14186,14437,251,1.769,40,211,5,87,H1
"Madison County, AR",2004-2005,14437,14714,277,1.919,34,243,5,87,H1
"Madison County, AR",2005-2006,14714,15156,442,3.004,29,413,5,87,H1
"Madison County, AR",2006-2007,15156,15353,197,1.3,72,125,5,87,H1
"Madison County, AR",2007-2008,15353,15619,266,1.733,34,232,5,87,H1
"Madison County, AR",2008-2009,15619,15673,54,0.346,40,14,5,87,H1
"Madison County, AR",2009-2010,15673,15692,19,0.121,24,-5,5,87,H1
"Madison County, AR",2010-2011,15692,15690,-2,-0.013,-13,11,5,87,H1
"Madison County, AR",2011-2012,15690,15636,-54,-0.344,39,-93,5,87,H1
"Madison County, AR",2012-2013,15636,15721,85,0.544,57,28,5,87,H1
"Madison County, AR",2013-2014,15721,15740,19,0.121,55,-36,5,87,H1
"Madison County, AR",2014-2015,15722,15767,45,0.286,58,-13,5,87,H1
"Madison County, AR",2015-2016,15767,16105,338,2.144,52,286,5,87,H1
"Madison County, AR",2016-2017,16105,16339,234,1.453,65,169,5,87,H1
"Marion County, AR",2000-2001,16162,16232,70,0.433,-65,135,5,89,H1
"Marion County, AR",2001-2002,16232,16149,-83,-0.511,-56,-27,5,89,H1
"Marion County, AR",2002-2003,16149,16133,-16,-0.099,-47,31,5,89,H1
"Marion County, AR",2003-2004,16133,16293,160,0.992,-36,196,5,89,H1
"Marion County, AR",2004-2005,16293,16464,171,1.05,-42,213,5,89,H1
"Marion County, AR",2005-2006,16464,16759,295,1.792,-40,335,5,89,H1
"Marion County, AR",2006-2007,16759,16795,36,0.215,-70,106,5,89,H1
"Marion County, AR",2007-2008,16795,16996,201,1.197,-63,264,5,89,H1
"Marion County, AR",2008-2009,16996,16721,-275,-1.618,-43,-232,5,89,H1
"Marion County, AR",2009-2010,16721,16645,-76,-0.455,-60,-16,5,89,H1
"Marion County, AR",2010-2011,16645,16635,-10,-0.06,-78,68,5,89,H1
"Marion County, AR",2011-2012,16635,16595,-40,-0.24,-71,31,5,89,H1
"Marion County, AR",2012-2013,16595,16427,-168,-1.012,-105,-63,5,89,H1
"Marion County, AR",2013-2014,16427,16367,-60,-0.365,-111,51,5,89,H1
"Marion County, AR",2014-2015,16401,16185,-216,-1.317,-108,-108,5,89,H1
"Marion County, AR",2015-2016,16185,16369,184,1.137,-83,267,5,89,H1
"Marion County, AR",2016-2017,16369,16428,59,0.36,-101,160,5,89,H1
"Miller County, AR",2000-2001,40436,40606,170,0.42,207,-37,5,91,H1
"Miller County, AR",2001-2002,40606,40923,317,0.781,227,90,5,91,H1
"Miller County, AR",2002-2003,40923,41382,459,1.122,216,243,5,91,H1
"Miller County, AR",2003-2004,41382,41765,383,0.926,87,296,5,91,H1
"Miller County, AR",2004-2005,41765,42181,416,0.996,188,228,5,91,H1
"Miller County, AR",2005-2006,42181,42669,488,1.157,200,288,5,91,H1
"Miller County, AR",2006-2007,42669,42710,41,0.096,344,-303,5,91,H1
"Miller County, AR",2007-2008,42710,43047,337,0.789,439,-102,5,91,H1
"Miller County, AR",2008-2009,43047,43284,237,0.551,272,-35,5,91,H1
"Miller County, AR",2009-2010,43284,43526,242,0.559,231,11,5,91,H1
"Miller County, AR",2010-2011,43526,43732,206,0.473,191,15,5,91,H1
"Miller County, AR",2011-2012,43732,43617,-115,-0.263,165,-280,5,91,H1
"Miller County, AR",2012-2013,43617,43380,-237,-0.543,107,-344,5,91,H1
"Miller County, AR",2013-2014,43380,43428,48,0.111,137,-89,5,91,H1
"Miller County, AR",2014-2015,43537,43908,371,0.852,160,211,5,91,H1
"Miller County, AR",2015-2016,43908,43874,-34,-0.077,108,-142,5,91,H1
"Miller County, AR",2016-2017,43874,43984,110,0.251,159,-49,5,91,H1
"Mississippi County, AR",2000-2001,51849,51017,-832,-1.605,343,-1175,5,93,H1
"Mississippi County, AR",2001-2002,51017,49957,-1060,-2.078,266,-1326,5,93,H1
"Mississippi County, AR",2002-2003,49957,48554,-1403,-2.808,161,-1564,5,93,H1
"Mississippi County, AR",2003-2004,48554,47777,-777,-1.6,181,-958,5,93,H1
"Mississippi County, AR",2004-2005,47777,47399,-378,-0.791,251,-629,5,93,H1
"Mississippi County, AR",2005-2006,47399,46983,-416,-0.878,245,-661,5,93,H1
"Mississippi County, AR",2006-2007,46983,46850,-133,-0.283,259,-392,5,93,H1
"Mississippi County, AR",2007-2008,46850,47037,187,0.399,231,-44,5,93,H1
"Mississippi County, AR",2008-2009,47037,46857,-180,-0.383,204,-384,5,93,H1
"Mississippi County, AR",2009-2010,46857,46371,-486,-1.037,173,-659,5,93,H1
"Mississippi County, AR",2010-2011,46371,46035,-336,-0.725,127,-463,5,93,H1
"Mississippi County, AR",2011-2012,46035,45550,-485,-1.054,166,-651,5,93,H1
"Mississippi County, AR",2012-2013,45550,44734,-816,-1.791,107,-923,5,93,H1
"Mississippi County, AR",2013-2014,44734,44235,-499,-1.115,108,-607,5,93,H1
"Mississippi County, AR",2014-2015,44282,43738,-544,-1.228,156,-700,5,93,H1
"Mississippi County, AR",2015-2016,43738,42885,-853,-1.95,132,-985,5,93,H1
"Mississippi County, AR",2016-2017,42885,42159,-726,-1.693,125,-851,5,93,H1
"Monroe County, AR",2000-2001,10182,9947,-235,-2.308,-21,-214,5,95,H1
"Monroe County, AR",2001-2002,9947,9700,-247,-2.483,-13,-234,5,95,H1
"Monroe County, AR",2002-2003,9700,9579,-121,-1.247,-14,-107,5,95,H1
"Monroe County, AR",2003-2004,9579,9287,-292,-3.048,17,-309,5,95,H1
"Monroe County, AR",2004-2005,9287,9176,-111,-1.195,-16,-95,5,95,H1
"Monroe County, AR",2005-2006,9176,8949,-227,-2.474,-17,-210,5,95,H1
"Monroe County, AR",2006-2007,8949,8670,-279,-3.118,-21,-258,5,95,H1
"Monroe County, AR",2007-2008,8670,8456,-214,-2.468,3,-217,5,95,H1
"Monroe County, AR",2008-2009,8456,8286,-170,-2.01,-13,-157,5,95,H1
"Monroe County, AR",2009-2010,8286,8122,-164,-1.979,-16,-148,5,95,H1
"Monroe County, AR",2010-2011,8122,8066,-56,-0.689,3,-59,5,95,H1
"Monroe County, AR",2011-2012,8066,7840,-226,-2.802,-25,-201,5,95,H1
"Monroe County, AR",2012-2013,7840,7667,-173,-2.207,-18,-155,5,95,H1
"Monroe County, AR",2013-2014,7667,7582,-85,-1.109,-37,-48,5,95,H1
"Monroe County, AR",2014-2015,7598,7399,-199,-2.619,-20,-179,5,95,H1
"Monroe County, AR",2015-2016,7399,7235,-164,-2.217,2,-166,5,95,H1
"Monroe County, AR",2016-2017,7235,7085,-150,-2.073,-17,-133,5,95,H1
"Montgomery County, AR",2000-2001,9263,9221,-42,-0.453,-44,2,5,97,H1
"Montgomery County, AR",2001-2002,9221,9150,-71,-0.77,-27,-44,5,97,H1
"Montgomery County, AR",2002-2003,9150,9239,89,0.973,-19,108,5,97,H1
"Montgomery County, AR",2003-2004,9239,9334,95,1.028,-12,107,5,97,H1
"Montgomery County, AR",2004-2005,9334,9358,24,0.257,-20,44,5,97,H1
"Montgomery County, AR",2005-2006,9358,9437,79,0.844,3,76,5,97,H1
"Montgomery County, AR",2006-2007,9437,9478,41,0.434,-23,64,5,97,H1
"Montgomery County, AR",2007-2008,9478,9573,95,1.002,-18,113,5,97,H1
"Montgomery County, AR",2008-2009,9573,9490,-83,-0.867,-14,-69,5,97,H1
"Montgomery County, AR",2009-2010,9490,9485,-5,-0.053,-2,-3,5,97,H1
"Montgomery County, AR",2010-2011,9485,9381,-104,-1.096,-37,-67,5,97,H1
"Montgomery County, AR",2011-2012,9381,9315,-66,-0.704,-65,-1,5,97,H1
"Montgomery County, AR",2012-2013,9315,9216,-99,-1.063,-18,-81,5,97,H1
"Montgomery County, AR",2013-2014,9216,9082,-134,-1.454,-56,-78,5,97,H1
"Montgomery County, AR",2014-2015,9089,8970,-119,-1.309,-48,-71,5,97,H1
"Montgomery County, AR",2015-2016,8970,8949,-21,-0.234,-45,24,5,97,H1
"Montgomery County, AR",2016-2017,8949,8919,-30,-0.335,-59,29,5,97,H1
"Nevada County, AR",2000-2001,9895,9774,-121,-1.223,-15,-106,5,99,H1
"Nevada County, AR",2001-2002,9774,9652,-122,-1.248,8,-130,5,99,H1
"Nevada County, AR",2002-2003,9652,9590,-62,-0.642,0,-62,5,99,H1
"Nevada County, AR",2003-2004,9590,9535,-55,-0.574,24,-79,5,99,H1
"Nevada County, AR",2004-2005,9535,9479,-56,-0.587,22,-78,5,99,H1
"Nevada County, AR",2005-2006,9479,9383,-96,-1.013,34,-130,5,99,H1
"Nevada County, AR",2006-2007,9383,9267,-116,-1.236,7,-123,5,99,H1
"Nevada County, AR",2007-2008,9267,9062,-205,-2.212,30,-235,5,99,H1
"Nevada County, AR",2008-2009,9062,9058,-4,-0.044,29,-33,5,99,H1
"Nevada County, AR",2009-2010,9058,8967,-91,-1.005,13,-104,5,99,H1
"Nevada County, AR",2010-2011,8967,9001,34,0.379,-3,37,5,99,H1
"Nevada County, AR",2011-2012,9001,8903,-98,-1.089,-19,-79,5,99,H1
"Nevada County, AR",2012-2013,8903,8789,-114,-1.28,36,-150,5,99,H1
"Nevada County, AR",2013-2014,8789,8723,-66,-0.751,-5,-61,5,99,H1
"Nevada County, AR",2014-2015,8703,8558,-145,-1.666,-11,-134,5,99,H1
"Nevada County, AR",2015-2016,8558,8374,-184,-2.15,-21,-163,5,99,H1
"Nevada County, AR",2016-2017,8374,8327,-47,-0.561,-10,-37,5,99,H1
"Newton County, AR",2000-2001,8642,8534,-108,-1.25,15,-123,5,101,H1
"Newton County, AR",2001-2002,8534,8534,0,0,-8,8,5,101,H1
"Newton County, AR",2002-2003,8534,8613,79,0.926,-6,85,5,101,H1
"Newton County, AR",2003-2004,8613,8503,-110,-1.277,6,-116,5,101,H1
"Newton County, AR",2004-2005,8503,8467,-36,-0.423,-5,-31,5,101,H1
"Newton County, AR",2005-2006,8467,8474,7,0.083,-20,27,5,101,H1
"Newton County, AR",2006-2007,8474,8428,-46,-0.543,-14,-32,5,101,H1
"Newton County, AR",2007-2008,8428,8423,-5,-0.059,9,-14,5,101,H1
"Newton County, AR",2008-2009,8423,8311,-112,-1.33,-1,-111,5,101,H1
"Newton County, AR",2009-2010,8311,8325,14,0.168,-15,29,5,101,H1
"Newton County, AR",2010-2011,8325,8274,-51,-0.613,-6,-45,5,101,H1
"Newton County, AR",2011-2012,8274,8084,-190,-2.296,-22,-168,5,101,H1
"Newton County, AR",2012-2013,8084,8068,-16,-0.198,-17,1,5,101,H1
"Newton County, AR",2013-2014,8068,7904,-164,-2.033,-26,-138,5,101,H1
"Newton County, AR",2014-2015,7910,7913,3,0.038,-27,30,5,101,H1
"Newton County, AR",2015-2016,7913,7869,-44,-0.556,-4,-40,5,101,H1
"Newton County, AR",2016-2017,7869,7828,-41,-0.521,-19,-22,5,101,H1
"Ouachita County, AR",2000-2001,28677,28088,-589,-2.054,-47,-542,5,103,H1
"Ouachita County, AR",2001-2002,28088,27701,-387,-1.378,1,-388,5,103,H1
"Ouachita County, AR",2002-2003,27701,27488,-213,-0.769,-71,-142,5,103,H1
"Ouachita County, AR",2003-2004,27488,27107,-381,-1.386,-52,-329,5,103,H1
"Ouachita County, AR",2004-2005,27107,26934,-173,-0.638,14,-187,5,103,H1
"Ouachita County, AR",2005-2006,26934,26656,-278,-1.032,9,-287,5,103,H1
"Ouachita County, AR",2006-2007,26656,26448,-208,-0.78,0,-208,5,103,H1
"Ouachita County, AR",2007-2008,26448,26202,-246,-0.93,-21,-225,5,103,H1
"Ouachita County, AR",2008-2009,26202,26024,-178,-0.679,-6,-172,5,103,H1
"Ouachita County, AR",2009-2010,26024,26109,85,0.327,1,84,5,103,H1
"Ouachita County, AR",2010-2011,26109,25746,-363,-1.39,-25,-338,5,103,H1
"Ouachita County, AR",2011-2012,25746,25411,-335,-1.301,-35,-300,5,103,H1
"Ouachita County, AR",2012-2013,25411,25013,-398,-1.566,-50,-348,5,103,H1
"Ouachita County, AR",2013-2014,25013,24828,-185,-0.74,-47,-138,5,103,H1
"Ouachita County, AR",2014-2015,24789,24358,-431,-1.739,-53,-378,5,103,H1
"Ouachita County, AR",2015-2016,24358,24019,-339,-1.392,-64,-275,5,103,H1
"Ouachita County, AR",2016-2017,24019,23868,-151,-0.629,-62,-89,5,103,H1
"Perry County, AR",2000-2001,10223,10306,83,0.812,24,59,5,105,H1
"Perry County, AR",2001-2002,10306,10363,57,0.553,13,44,5,105,H1
"Perry County, AR",2002-2003,10363,10346,-17,-0.164,-4,-13,5,105,H1
"Perry County, AR",2003-2004,10346,10352,6,0.058,0,6,5,105,H1
"Perry County, AR",2004-2005,10352,10356,4,0.039,13,-9,5,105,H1
"Perry County, AR",2005-2006,10356,10352,-4,-0.039,-3,-1,5,105,H1
"Perry County, AR",2006-2007,10352,10496,144,1.391,0,144,5,105,H1
"Perry County, AR",2007-2008,10496,10441,-55,-0.524,6,-61,5,105,H1
"Perry County, AR",2008-2009,10441,10443,2,0.019,-11,13,5,105,H1
"Perry County, AR",2009-2010,10443,10447,4,0.038,-2,6,5,105,H1
"Perry County, AR",2010-2011,10447,10386,-61,-0.584,14,-75,5,105,H1
"Perry County, AR",2011-2012,10386,10326,-60,-0.578,-24,-36,5,105,H1
"Perry County, AR",2012-2013,10326,10344,18,0.174,-21,39,5,105,H1
"Perry County, AR",2013-2014,10344,10245,-99,-0.957,-24,-75,5,105,H1
"Perry County, AR",2014-2015,10239,10189,-50,-0.488,-11,-39,5,105,H1
"Perry County, AR",2015-2016,10189,10273,84,0.824,-19,103,5,105,H1
"Perry County, AR",2016-2017,10273,10348,75,0.73,-1,76,5,105,H1
"Phillips County, AR",2000-2001,26290,25821,-469,-1.784,137,-606,5,107,H1
"Phillips County, AR",2001-2002,25821,25067,-754,-2.92,103,-857,5,107,H1
"Phillips County, AR",2002-2003,25067,24520,-547,-2.182,92,-639,5,107,H1
"Phillips County, AR",2003-2004,24520,24174,-346,-1.411,96,-442,5,107,H1
"Phillips County, AR",2004-2005,24174,23946,-228,-0.943,113,-341,5,107,H1
"Phillips County, AR",2005-2006,23946,23244,-702,-2.932,66,-768,5,107,H1
"Phillips County, AR",2006-2007,23244,22775,-469,-2.018,124,-593,5,107,H1
"Phillips County, AR",2007-2008,22775,22411,-364,-1.598,55,-419,5,107,H1
"Phillips County, AR",2008-2009,22411,21976,-435,-1.941,82,-517,5,107,H1
"Phillips County, AR",2009-2010,21976,21686,-290,-1.32,112,-402,5,107,H1
"Phillips County, AR",2010-2011,21686,21419,-267,-1.231,46,-313,5,107,H1
"Phillips County, AR",2011-2012,21419,20772,-647,-3.021,-3,-644,5,107,H1
"Phillips County, AR",2012-2013,20772,20426,-346,-1.666,51,-397,5,107,H1
"Phillips County, AR",2013-2014,20426,19930,-496,-2.428,55,-551,5,107,H1
"Phillips County, AR",2014-2015,19901,19513,-388,-1.95,40,-428,5,107,H1
"Phillips County, AR",2015-2016,19513,19050,-463,-2.373,14,-477,5,107,H1
"Phillips County, AR",2016-2017,19050,18572,-478,-2.509,25,-503,5,107,H1
"Pike County, AR",2000-2001,11332,11306,-26,-0.229,-17,-9,5,109,H1
"Pike County, AR",2001-2002,11306,11321,15,0.133,-7,22,5,109,H1
"Pike County, AR",2002-2003,11321,11243,-78,-0.689,-48,-30,5,109,H1
"Pike County, AR",2003-2004,11243,11246,3,0.027,-14,17,5,109,H1
"Pike County, AR",2004-2005,11246,11216,-30,-0.267,-69,39,5,109,H1
"Pike County, AR",2005-2006,11216,11262,46,0.41,-13,59,5,109,H1
"Pike County, AR",2006-2007,11262,11342,80,0.71,-1,81,5,109,H1
"Pike County, AR",2007-2008,11342,11283,-59,-0.52,-5,-54,5,109,H1
"Pike County, AR",2008-2009,11283,11260,-23,-0.204,-7,-16,5,109,H1
"Pike County, AR",2009-2010,11260,11277,17,0.151,-12,29,5,109,H1
"Pike County, AR",2010-2011,11277,11243,-34,-0.301,14,-48,5,109,H1
"Pike County, AR",2011-2012,11243,11266,23,0.205,-12,35,5,109,H1
"Pike County, AR",2012-2013,11266,11126,-140,-1.243,-44,-96,5,109,H1
"Pike County, AR",2013-2014,11126,11024,-102,-0.917,-23,-79,5,109,H1
"Pike County, AR",2014-2015,10995,10824,-171,-1.555,-27,-144,5,109,H1
"Pike County, AR",2015-2016,10824,10817,-7,-0.065,-6,-1,5,109,H1
"Pike County, AR",2016-2017,10817,10726,-91,-0.841,-7,-84,5,109,H1
"Poinsett County, AR",2000-2001,25617,25498,-119,-0.465,64,-183,5,111,H1
"Poinsett County, AR",2001-2002,25498,25213,-285,-1.118,32,-317,5,111,H1
"Poinsett County, AR",2002-2003,25213,25177,-36,-0.143,35,-71,5,111,H1
"Poinsett County, AR",2003-2004,25177,25039,-138,-0.548,15,-153,5,111,H1
"Poinsett County, AR",2004-2005,25039,25058,19,0.076,48,-29,5,111,H1
"Poinsett County, AR",2005-2006,25058,24904,-154,-0.615,28,-182,5,111,H1
"Poinsett County, AR",2006-2007,24904,24813,-91,-0.365,49,-140,5,111,H1
"Poinsett County, AR",2007-2008,24813,24599,-214,-0.862,49,-263,5,111,H1
"Poinsett County, AR",2008-2009,24599,24632,33,0.134,32,1,5,111,H1
"Poinsett County, AR",2009-2010,24632,24544,-88,-0.357,41,-129,5,111,H1
"Poinsett County, AR",2010-2011,24544,24459,-85,-0.346,-24,-61,5,111,H1
"Poinsett County, AR",2011-2012,24459,24325,-134,-0.548,-7,-127,5,111,H1
"Poinsett County, AR",2012-2013,24325,24222,-103,-0.423,-19,-84,5,111,H1
"Poinsett County, AR",2013-2014,24222,24246,24,0.099,-8,32,5,111,H1
"Poinsett County, AR",2014-2015,24150,24040,-110,-0.455,-38,-72,5,111,H1
"Poinsett County, AR",2015-2016,24040,24008,-32,-0.133,-2,-30,5,111,H1
"Poinsett County, AR",2016-2017,24008,24154,146,0.608,5,141,5,111,H1
"Polk County, AR",2000-2001,20268,20189,-79,-0.39,34,-113,5,113,H1
"Polk County, AR",2001-2002,20189,20243,54,0.267,1,53,5,113,H1
"Polk County, AR",2002-2003,20243,20199,-44,-0.217,17,-61,5,113,H1
"Polk County, AR",2003-2004,20199,20057,-142,-0.703,7,-149,5,113,H1
"Polk County, AR",2004-2005,20057,20203,146,0.728,27,119,5,113,H1
"Polk County, AR",2005-2006,20203,20422,219,1.084,-5,224,5,113,H1
"Polk County, AR",2006-2007,20422,20377,-45,-0.22,17,-62,5,113,H1
"Polk County, AR",2007-2008,20377,20388,11,0.054,-22,33,5,113,H1
"Polk County, AR",2008-2009,20388,20583,195,0.956,3,192,5,113,H1
"Polk County, AR",2009-2010,20583,20679,96,0.466,33,63,5,113,H1
"Polk County, AR",2010-2011,20679,20570,-109,-0.527,-52,-57,5,113,H1
"Polk County, AR",2011-2012,20570,20440,-130,-0.632,-2,-128,5,113,H1
"Polk County, AR",2012-2013,20440,20354,-86,-0.421,-32,-54,5,113,H1
"Polk County, AR",2013-2014,20354,20225,-129,-0.634,-41,-88,5,113,H1
"Polk County, AR",2014-2015,20254,20216,-38,-0.188,-21,-17,5,113,H1
"Polk County, AR",2015-2016,20216,20141,-75,-0.371,-50,-25,5,113,H1
"Polk County, AR",2016-2017,20141,20118,-23,-0.114,-63,40,5,113,H1
"Pope County, AR",2000-2001,54541,54986,445,0.816,217,228,5,115,H1
"Pope County, AR",2001-2002,54986,55405,419,0.762,166,253,5,115,H1
"Pope County, AR",2002-2003,55405,55622,217,0.392,221,-4,5,115,H1
"Pope County, AR",2003-2004,55622,56606,984,1.769,270,714,5,115,H1
"Pope County, AR",2004-2005,56606,57535,929,1.641,275,654,5,115,H1
"Pope County, AR",2005-2006,57535,58809,1274,2.214,244,1030,5,115,H1
"Pope County, AR",2006-2007,58809,59793,984,1.673,368,616,5,115,H1
"Pope County, AR",2007-2008,59793,60528,735,1.229,321,414,5,115,H1
"Pope County, AR",2008-2009,60528,61302,774,1.279,294,480,5,115,H1
"Pope County, AR",2009-2010,61302,62110,808,1.318,247,561,5,115,H1
"Pope County, AR",2010-2011,62110,62662,552,0.889,249,303,5,115,H1
"Pope County, AR",2011-2012,62662,62717,55,0.088,169,-114,5,115,H1
"Pope County, AR",2012-2013,62717,62747,30,0.048,196,-166,5,115,H1
"Pope County, AR",2013-2014,62747,63201,454,0.724,204,250,5,115,H1
"Pope County, AR",2014-2015,63047,63390,343,0.544,243,100,5,115,H1
"Pope County, AR",2015-2016,63390,63852,462,0.729,240,222,5,115,H1
"Pope County, AR",2016-2017,63852,63835,-17,-0.027,251,-268,5,115,H1
"Prairie County, AR",2000-2001,9491,9505,14,0.148,-16,30,5,117,H1
"Prairie County, AR",2001-2002,9505,9406,-99,-1.042,5,-104,5,117,H1
"Prairie County, AR",2002-2003,9406,9303,-103,-1.095,-11,-92,5,117,H1
"Prairie County, AR",2003-2004,9303,9111,-192,-2.064,-30,-162,5,117,H1
"Prairie County, AR",2004-2005,9111,9046,-65,-0.713,-30,-35,5,117,H1
"Prairie County, AR",2005-2006,9046,8989,-57,-0.63,-10,-47,5,117,H1
"Prairie County, AR",2006-2007,8989,8951,-38,-0.423,-16,-22,5,117,H1
"Prairie County, AR",2007-2008,8951,8806,-145,-1.62,-18,-127,5,117,H1
"Prairie County, AR",2008-2009,8806,8754,-52,-0.591,-25,-27,5,117,H1
"Prairie County, AR",2009-2010,8754,8701,-53,-0.605,-14,-39,5,117,H1
"Prairie County, AR",2010-2011,8701,8565,-136,-1.563,-20,-116,5,117,H1
"Prairie County, AR",2011-2012,8565,8446,-119,-1.389,-21,-98,5,117,H1
"Prairie County, AR",2012-2013,8446,8360,-86,-1.018,-2,-84,5,117,H1
"Prairie County, AR",2013-2014,8360,8304,-56,-0.67,-19,-37,5,117,H1
"Prairie County, AR",2014-2015,8315,8291,-24,-0.289,-18,-6,5,117,H1
"Prairie County, AR",2015-2016,8291,8271,-20,-0.241,-25,5,5,117,H1
"Prairie County, AR",2016-2017,8271,8248,-23,-0.278,-37,14,5,117,H1
"Pulaski County, AR",2000-2001,361876,362866,990,0.274,2398,-1408,5,119,H1
"Pulaski County, AR",2001-2002,362866,364327,1461,0.403,2374,-913,5,119,H1
"Pulaski County, AR",2002-2003,364327,365258,931,0.256,2499,-1568,5,119,H1
"Pulaski County, AR",2003-2004,365258,366608,1350,0.37,2303,-953,5,119,H1
"Pulaski County, AR",2004-2005,366608,368274,1666,0.454,2533,-867,5,119,H1
"Pulaski County, AR",2005-2006,368274,371647,3373,0.916,2423,950,5,119,H1
"Pulaski County, AR",2006-2007,371647,373403,1756,0.472,2690,-934,5,119,H1
"Pulaski County, AR",2007-2008,373403,376567,3164,0.847,2848,316,5,119,H1
"Pulaski County, AR",2008-2009,376567,380053,3486,0.926,2616,870,5,119,H1
"Pulaski County, AR",2009-2010,380053,383600,3547,0.933,2574,973,5,119,H1
"Pulaski County, AR",2010-2011,383600,386862,3262,0.85,2408,854,5,119,H1
"Pulaski County, AR",2011-2012,386862,389058,2196,0.568,2244,-48,5,119,H1
"Pulaski County, AR",2012-2013,389058,391536,2478,0.637,2089,389,5,119,H1
"Pulaski County, AR",2013-2014,391536,392702,1166,0.298,2074,-908,5,119,H1
"Pulaski County, AR",2014-2015,392490,392664,174,0.044,1969,-1795,5,119,H1
"Pulaski County, AR",2015-2016,392664,393677,1013,0.258,1696,-683,5,119,H1
"Pulaski County, AR",2016-2017,393677,393956,279,0.071,1729,-1450,5,119,H1
"Randolph County, AR",2000-2001,18155,18177,22,0.121,-26,48,5,121,H1
"Randolph County, AR",2001-2002,18177,18115,-62,-0.341,19,-81,5,121,H1
"Randolph County, AR",2002-2003,18115,18005,-110,-0.607,-3,-107,5,121,H1
"Randolph County, AR",2003-2004,18005,18207,202,1.122,7,195,5,121,H1
"Randolph County, AR",2004-2005,18207,18086,-121,-0.665,8,-129,5,121,H1
"Randolph County, AR",2005-2006,18086,18185,99,0.547,-7,106,5,121,H1
"Randolph County, AR",2006-2007,18185,18054,-131,-0.72,-2,-129,5,121,H1
"Randolph County, AR",2007-2008,18054,18072,18,0.1,18,0,5,121,H1
"Randolph County, AR",2008-2009,18072,17964,-108,-0.598,2,-110,5,121,H1
"Randolph County, AR",2009-2010,17964,17950,-14,-0.078,3,-17,5,121,H1
"Randolph County, AR",2010-2011,17950,17966,16,0.089,-23,39,5,121,H1
"Randolph County, AR",2011-2012,17966,17851,-115,-0.64,-44,-71,5,121,H1
"Randolph County, AR",2012-2013,17851,17634,-217,-1.216,-45,-172,5,121,H1
"Randolph County, AR",2013-2014,17634,17571,-63,-0.357,-34,-29,5,121,H1
"Randolph County, AR",2014-2015,17550,17469,-81,-0.462,-39,-42,5,121,H1
"Randolph County, AR",2015-2016,17469,17408,-61,-0.349,-48,-13,5,121,H1
"Randolph County, AR",2016-2017,17408,17557,149,0.856,-62,211,5,121,H1
"St. Francis County, AR",2000-2001,29325,29072,-253,-0.863,85,-338,5,123,H1
"St. Francis County, AR",2001-2002,29072,29023,-49,-0.169,145,-194,5,123,H1
"St. Francis County, AR",2002-2003,29023,29170,147,0.506,109,38,5,123,H1
"St. Francis County, AR",2003-2004,29170,28905,-265,-0.908,133,-398,5,123,H1
"St. Francis County, AR",2004-2005,28905,28639,-266,-0.92,117,-383,5,123,H1
"St. Francis County, AR",2005-2006,28639,28496,-143,-0.499,141,-284,5,123,H1
"St. Francis County, AR",2006-2007,28496,28394,-102,-0.358,69,-171,5,123,H1
"St. Francis County, AR",2007-2008,28394,28110,-284,-1,134,-418,5,123,H1
"St. Francis County, AR",2008-2009,28110,28336,226,0.804,115,111,5,123,H1
"St. Francis County, AR",2009-2010,28336,28172,-164,-0.579,78,-242,5,123,H1
"St. Francis County, AR",2010-2011,28172,27952,-220,-0.781,82,-302,5,123,H1
"St. Francis County, AR",2011-2012,27952,27883,-69,-0.247,110,-179,5,123,H1
"St. Francis County, AR",2012-2013,27883,27302,-581,-2.084,48,-629,5,123,H1
"St. Francis County, AR",2013-2014,27302,26899,-403,-1.476,26,-429,5,123,H1
"St. Francis County, AR",2014-2015,26977,26589,-388,-1.438,68,-456,5,123,H1
"St. Francis County, AR",2015-2016,26589,26304,-285,-1.072,58,-343,5,123,H1
"St. Francis County, AR",2016-2017,26304,25930,-374,-1.422,31,-405,5,123,H1
"Saline County, AR",2000-2001,84084,85473,1389,1.652,169,1220,5,125,H1
"Saline County, AR",2001-2002,85473,87031,1558,1.823,299,1259,5,125,H1
"Saline County, AR",2002-2003,87031,88627,1596,1.834,251,1345,5,125,H1
"Saline County, AR",2003-2004,88627,90961,2334,2.634,238,2096,5,125,H1
"Saline County, AR",2004-2005,90961,93493,2532,2.784,260,2272,5,125,H1
"Saline County, AR",2005-2006,93493,96661,3168,3.388,248,2920,5,125,H1
"Saline County, AR",2006-2007,96661,100043,3382,3.499,384,2998,5,125,H1
"Saline County, AR",2007-2008,100043,102599,2556,2.555,355,2201,5,125,H1
"Saline County, AR",2008-2009,102599,105362,2763,2.693,423,2340,5,125,H1
"Saline County, AR",2009-2010,105362,107631,2269,2.154,416,1853,5,125,H1
"Saline County, AR",2010-2011,107631,109851,2220,2.063,399,1821,5,125,H1
"Saline County, AR",2011-2012,109851,111668,1817,1.654,414,1403,5,125,H1
"Saline County, AR",2012-2013,111668,114185,2517,2.254,366,2151,5,125,H1
"Saline County, AR",2013-2014,114185,115719,1534,1.343,403,1131,5,125,H1
"Saline County, AR",2014-2015,115750,117460,1710,1.477,361,1349,5,125,H1
"Saline County, AR",2015-2016,117460,117577,117,0.1,246,-129,5,125,H1
"Saline County, AR",2016-2017,117577,119323,1746,1.485,279,1467,5,125,H1
"Scott County, AR",2000-2001,10980,10950,-30,-0.273,23,-53,5,127,H1
"Scott County, AR",2001-2002,10950,10930,-20,-0.183,7,-27,5,127,H1
"Scott County, AR",2002-2003,10930,10936,6,0.055,30,-24,5,127,H1
"Scott County, AR",2003-2004,10936,10872,-64,-0.585,5,-69,5,127,H1
"Scott County, AR",2004-2005,10872,10976,104,0.957,9,95,5,127,H1
"Scott County, AR",2005-2006,10976,11239,263,2.396,30,233,5,127,H1
"Scott County, AR",2006-2007,11239,11287,48,0.427,41,7,5,127,H1
"Scott County, AR",2007-2008,11287,11227,-60,-0.532,-5,-55,5,127,H1
"Scott County, AR",2008-2009,11227,11097,-130,-1.158,19,-149,5,127,H1
"Scott County, AR",2009-2010,11097,11267,170,1.532,34,136,5,127,H1
"Scott County, AR",2010-2011,11267,11239,-28,-0.249,7,-35,5,127,H1
"Scott County, AR",2011-2012,11239,11007,-232,-2.064,26,-258,5,127,H1
"Scott County, AR",2012-2013,11007,10914,-93,-0.845,-12,-81,5,127,H1
"Scott County, AR",2013-2014,10914,10693,-221,-2.025,-4,-217,5,127,H1
"Scott County, AR",2014-2015,10683,10513,-170,-1.591,-5,-165,5,127,H1
"Scott County, AR",2015-2016,10513,10360,-153,-1.455,22,-175,5,127,H1
"Scott County, AR",2016-2017,10360,10445,85,0.82,12,73,5,127,H1
"Searcy County, AR",2000-2001,8246,8220,-26,-0.315,-14,-12,5,129,H1
"Searcy County, AR",2001-2002,8220,8150,-70,-0.852,-24,-46,5,129,H1
"Searcy County, AR",2002-2003,8150,7996,-154,-1.89,-26,-128,5,129,H1
"Searcy County, AR",2003-2004,7996,8046,50,0.625,-14,64,5,129,H1
"Searcy County, AR",2004-2005,8046,8110,64,0.795,-20,84,5,129,H1
"Searcy County, AR",2005-2006,8110,8210,100,1.233,-5,105,5,129,H1
"Searcy County, AR",2006-2007,8210,8275,65,0.792,-11,76,5,129,H1
"Searcy County, AR",2007-2008,8275,8274,-1,-0.012,-10,9,5,129,H1
"Searcy County, AR",2008-2009,8274,8190,-84,-1.015,-23,-61,5,129,H1
"Searcy County, AR",2009-2010,8190,8189,-1,-0.012,-30,29,5,129,H1
"Searcy County, AR",2010-2011,8189,8077,-112,-1.368,-26,-86,5,129,H1
"Searcy County, AR",2011-2012,8077,7995,-82,-1.015,-42,-40,5,129,H1
"Searcy County, AR",2012-2013,7995,7990,-5,-0.063,-30,25,5,129,H1
"Searcy County, AR",2013-2014,7990,7929,-61,-0.763,-28,-33,5,129,H1
"Searcy County, AR",2014-2015,7916,7869,-47,-0.594,-22,-25,5,129,H1
"Searcy County, AR",2015-2016,7869,7965,96,1.22,-29,125,5,129,H1
"Searcy County, AR",2016-2017,7965,7938,-27,-0.339,-31,4,5,129,H1
"Sebastian County, AR",2000-2001,115578,116488,910,0.787,668,242,5,131,H1
"Sebastian County, AR",2001-2002,116488,117200,712,0.611,709,3,5,131,H1
"Sebastian County, AR",2002-2003,117200,117725,525,0.448,740,-215,5,131,H1
"Sebastian County, AR",2003-2004,117725,118168,443,0.376,640,-197,5,131,H1
"Sebastian County, AR",2004-2005,118168,119426,1258,1.065,737,521,5,131,H1
"Sebastian County, AR",2005-2006,119426,121492,2066,1.73,774,1292,5,131,H1
"Sebastian County, AR",2006-2007,121492,122946,1454,1.197,909,545,5,131,H1
"Sebastian County, AR",2007-2008,122946,123762,816,0.664,742,74,5,131,H1
"Sebastian County, AR",2008-2009,123762,125116,1354,1.094,761,593,5,131,H1
"Sebastian County, AR",2009-2010,125116,125824,708,0.566,826,-118,5,131,H1
"Sebastian County, AR",2010-2011,125824,126916,1092,0.868,555,537,5,131,H1
"Sebastian County, AR",2011-2012,126916,127370,454,0.358,524,-70,5,131,H1
"Sebastian County, AR",2012-2013,127370,127118,-252,-0.198,447,-699,5,131,H1
"Sebastian County, AR",2013-2014,127118,126776,-342,-0.269,478,-820,5,131,H1
"Sebastian County, AR",2014-2015,126990,127780,790,0.622,430,360,5,131,H1
"Sebastian County, AR",2015-2016,127780,127567,-213,-0.167,493,-706,5,131,H1
"Sebastian County, AR",2016-2017,127567,128107,540,0.423,486,54,5,131,H1
"Sevier County, AR",2000-2001,15747,15586,-161,-1.022,90,-251,5,133,H1
"Sevier County, AR",2001-2002,15586,15702,116,0.744,156,-40,5,133,H1
"Sevier County, AR",2002-2003,15702,15824,122,0.777,146,-24,5,133,H1
"Sevier County, AR",2003-2004,15824,16041,217,1.371,127,90,5,133,H1
"Sevier County, AR",2004-2005,16041,16298,257,1.602,104,153,5,133,H1
"Sevier County, AR",2005-2006,16298,16273,-25,-0.153,142,-167,5,133,H1
"Sevier County, AR",2006-2007,16273,16347,74,0.455,115,-41,5,133,H1
"Sevier County, AR",2007-2008,16347,16606,259,1.584,225,34,5,133,H1
"Sevier County, AR",2008-2009,16606,16812,206,1.241,197,9,5,133,H1
"Sevier County, AR",2009-2010,16812,17138,326,1.939,159,167,5,133,H1
"Sevier County, AR",2010-2011,17138,17170,32,0.187,101,-69,5,133,H1
"Sevier County, AR",2011-2012,17170,17174,4,0.023,117,-113,5,133,H1
"Sevier County, AR",2012-2013,17174,17342,168,0.978,129,39,5,133,H1
"Sevier County, AR",2013-2014,17342,17426,84,0.484,122,-38,5,133,H1
"Sevier County, AR",2014-2015,17388,17290,-98,-0.564,128,-226,5,133,H1
"Sevier County, AR",2015-2016,17290,16955,-335,-1.938,78,-413,5,133,H1
"Sevier County, AR",2016-2017,16955,17115,160,0.944,88,72,5,133,H1
"Sharp County, AR",2000-2001,17138,17244,106,0.619,-83,189,5,135,H1
"Sharp County, AR",2001-2002,17244,17276,32,0.186,-84,116,5,135,H1
"Sharp County, AR",2002-2003,17276,17381,105,0.608,-64,169,5,135,H1
"Sharp County, AR",2003-2004,17381,17353,-28,-0.161,-74,46,5,135,H1
"Sharp County, AR",2004-2005,17353,17391,38,0.219,-65,103,5,135,H1
"Sharp County, AR",2005-2006,17391,17629,238,1.369,-66,304,5,135,H1
"Sharp County, AR",2006-2007,17629,17506,-123,-0.698,-41,-82,5,135,H1
"Sharp County, AR",2007-2008,17506,17416,-90,-0.514,-65,-25,5,135,H1
"Sharp County, AR",2008-2009,17416,17373,-43,-0.247,-64,21,5,135,H1
"Sharp County, AR",2009-2010,17373,17281,-92,-0.53,-66,-26,5,135,H1
"Sharp County, AR",2010-2011,17281,17275,-6,-0.035,-102,96,5,135,H1
"Sharp County, AR",2011-2012,17275,17053,-222,-1.285,-92,-130,5,135,H1
"Sharp County, AR",2012-2013,17053,17068,15,0.088,-67,82,5,135,H1
"Sharp County, AR",2013-2014,17068,16906,-162,-0.949,-46,-116,5,135,H1
"Sharp County, AR",2014-2015,16923,16912,-11,-0.065,-67,56,5,135,H1
"Sharp County, AR",2015-2016,16912,17138,226,1.336,42,184,5,135,H1
"Sharp County, AR",2016-2017,17138,17393,255,1.488,21,234,5,135,H1
"Stone County, AR",2000-2001,11519,11484,-35,-0.304,-16,-19,5,137,H1
"Stone County, AR",2001-2002,11484,11607,123,1.071,-24,147,5,137,H1
"Stone County, AR",2002-2003,11607,11704,97,0.836,-18,115,5,137,H1
"Stone County, AR",2003-2004,11704,11768,64,0.547,-29,93,5,137,H1
"Stone County, AR",2004-2005,11768,11909,141,1.198,-37,178,5,137,H1
"Stone County, AR",2005-2006,11909,12262,353,2.964,-6,359,5,137,H1
"Stone County, AR",2006-2007,12262,12230,-32,-0.261,-40,8,5,137,H1
"Stone County, AR",2007-2008,12230,12370,140,1.145,-2,142,5,137,H1
"Stone County, AR",2008-2009,12370,12340,-30,-0.243,-4,-26,5,137,H1
"Stone County, AR",2009-2010,12340,12416,76,0.616,-24,100,5,137,H1
"Stone County, AR",2010-2011,12416,12585,169,1.361,-43,212,5,137,H1
"Stone County, AR",2011-2012,12585,12628,43,0.342,-43,86,5,137,H1
"Stone County, AR",2012-2013,12628,12533,-95,-0.752,-31,-64,5,137,H1
"Stone County, AR",2013-2014,12533,12494,-39,-0.311,-48,9,5,137,H1
"Stone County, AR",2014-2015,12450,12456,6,0.048,-37,43,5,137,H1
"Stone County, AR",2015-2016,12456,12500,44,0.353,-43,87,5,137,H1
"Stone County, AR",2016-2017,12500,12537,37,0.296,-39,76,5,137,H1
"Union County, AR",2000-2001,45532,44894,-638,-1.401,-36,-602,5,139,H1
"Union County, AR",2001-2002,44894,44769,-125,-0.278,23,-148,5,139,H1
"Union County, AR",2002-2003,44769,44281,-488,-1.09,45,-533,5,139,H1
"Union County, AR",2003-2004,44281,43747,-534,-1.206,21,-555,5,139,H1
"Union County, AR",2004-2005,43747,43134,-613,-1.401,-13,-600,5,139,H1
"Union County, AR",2005-2006,43134,42914,-220,-0.51,24,-244,5,139,H1
"Union County, AR",2006-2007,42914,42267,-647,-1.508,11,-658,5,139,H1
"Union County, AR",2007-2008,42267,42222,-45,-0.106,83,-128,5,139,H1
"Union County, AR",2008-2009,42222,41944,-278,-0.658,43,-321,5,139,H1
"Union County, AR",2009-2010,41944,41580,-364,-0.868,33,-397,5,139,H1
"Union County, AR",2010-2011,41580,41386,-194,-0.467,-53,-141,5,139,H1
"Union County, AR",2011-2012,41386,40904,-482,-1.165,53,-535,5,139,H1
"Union County, AR",2012-2013,40904,40675,-229,-0.56,-24,-205,5,139,H1
"Union County, AR",2013-2014,40675,40227,-448,-1.101,-39,-409,5,139,H1
"Union County, AR",2014-2015,40175,40144,-31,-0.077,-45,14,5,139,H1
"Union County, AR",2015-2016,40144,39867,-277,-0.69,50,-327,5,139,H1
"Union County, AR",2016-2017,39867,39449,-418,-1.048,30,-448,5,139,H1
"Van Buren County, AR",2000-2001,16221,16332,111,0.684,-89,200,5,141,H1
"Van Buren County, AR",2001-2002,16332,16322,-10,-0.061,-40,30,5,141,H1
"Van Buren County, AR",2002-2003,16322,16506,184,1.127,-28,212,5,141,H1
"Van Buren County, AR",2003-2004,16506,16664,158,0.957,-51,209,5,141,H1
"Van Buren County, AR",2004-2005,16664,16869,205,1.23,-28,233,5,141,H1
"Van Buren County, AR",2005-2006,16869,17027,158,0.937,-84,242,5,141,H1
"Van Buren County, AR",2006-2007,17027,17226,199,1.169,-42,241,5,141,H1
"Van Buren County, AR",2007-2008,17226,17373,147,0.853,-34,181,5,141,H1
"Van Buren County, AR",2008-2009,17373,17293,-80,-0.46,-45,-35,5,141,H1
"Van Buren County, AR",2009-2010,17293,17296,3,0.017,-67,70,5,141,H1
"Van Buren County, AR",2010-2011,17296,17184,-112,-0.648,-2,-110,5,141,H1
"Van Buren County, AR",2011-2012,17184,17155,-29,-0.169,-31,2,5,141,H1
"Van Buren County, AR",2012-2013,17155,16965,-190,-1.108,-105,-85,5,141,H1
"Van Buren County, AR",2013-2014,16965,16851,-114,-0.672,-83,-31,5,141,H1
"Van Buren County, AR",2014-2015,16880,16771,-109,-0.646,-65,-44,5,141,H1
"Van Buren County, AR",2015-2016,16771,16622,-149,-0.888,-78,-71,5,141,H1
"Van Buren County, AR",2016-2017,16622,16506,-116,-0.698,-93,-23,5,141,H1
"Washington County, AR",2000-2001,158851,163151,4300,2.707,1421,2879,5,143,H1
"Washington County, AR",2001-2002,163151,166859,3708,2.273,1519,2189,5,143,H1
"Washington County, AR",2002-2003,166859,171424,4565,2.736,1686,2879,5,143,H1
"Washington County, AR",2003-2004,171424,176837,5413,3.158,1686,3727,5,143,H1
"Washington County, AR",2004-2005,176837,183799,6962,3.937,1878,5084,5,143,H1
"Washington County, AR",2005-2006,183799,190314,6515,3.545,2158,4357,5,143,H1
"Washington County, AR",2006-2007,190314,194526,4212,2.213,2299,1913,5,143,H1
"Washington County, AR",2007-2008,194526,197223,2697,1.386,2056,641,5,143,H1
"Washington County, AR",2008-2009,197223,199774,2551,1.293,2025,526,5,143,H1
"Washington County, AR",2009-2010,199774,204019,4245,2.125,2018,2227,5,143,H1
"Washington County, AR",2010-2011,204019,207893,3874,1.899,1884,1990,5,143,H1
"Washington County, AR",2011-2012,207893,211734,3841,1.848,1894,1947,5,143,H1
"Washington County, AR",2012-2013,211734,216753,5019,2.37,1946,3073,5,143,H1
"Washington County, AR",2013-2014,216753,220792,4039,1.863,1988,2051,5,143,H1
"Washington County, AR",2014-2015,220682,225477,4795,2.173,1788,3007,5,143,H1
"Washington County, AR",2015-2016,225477,227600,2123,0.942,1639,484,5,143,H1
"Washington County, AR",2016-2017,227600,231996,4396,1.931,1709,2687,5,143,H1
"White County, AR",2000-2001,67382,68273,891,1.322,167,724,5,145,H1
"White County, AR",2001-2002,68273,68796,523,0.766,171,352,5,145,H1
"White County, AR",2002-2003,68796,69389,593,0.862,213,380,5,145,H1
"White County, AR",2003-2004,69389,70403,1014,1.461,149,865,5,145,H1
"White County, AR",2004-2005,70403,71355,952,1.352,228,724,5,145,H1
"White County, AR",2005-2006,71355,72728,1373,1.924,353,1020,5,145,H1
"White County, AR",2006-2007,72728,73573,845,1.162,307,538,5,145,H1
"White County, AR",2007-2008,73573,74848,1275,1.733,316,959,5,145,H1
"White County, AR",2008-2009,74848,76284,1436,1.919,294,1142,5,145,H1
"White County, AR",2009-2010,76284,77339,1055,1.383,259,796,5,145,H1
"White County, AR",2010-2011,77339,78132,793,1.025,140,653,5,145,H1
"White County, AR",2011-2012,78132,78652,520,0.666,166,354,5,145,H1
"White County, AR",2012-2013,78652,78661,9,0.011,263,-254,5,145,H1
"White County, AR",2013-2014,78661,78592,-69,-0.088,229,-298,5,145,H1
"White County, AR",2014-2015,78643,79161,518,0.659,217,301,5,145,H1
"White County, AR",2015-2016,79161,78838,-323,-0.408,64,-387,5,145,H1
"White County, AR",2016-2017,78838,79016,178,0.226,93,85,5,145,H1
"Woodruff County, AR",2000-2001,8686,8675,-11,-0.127,-61,50,5,147,H1
"Woodruff County, AR",2001-2002,8675,8446,-229,-2.64,-19,-210,5,147,H1
"Woodruff County, AR",2002-2003,8446,8284,-162,-1.918,-43,-119,5,147,H1
"Woodruff County, AR",2003-2004,8284,8102,-182,-2.197,-21,-161,5,147,H1
"Woodruff County, AR",2004-2005,8102,8023,-79,-0.975,-5,-74,5,147,H1
"Woodruff County, AR",2005-2006,8023,7877,-146,-1.82,-22,-124,5,147,H1
"Woodruff County, AR",2006-2007,7877,7648,-229,-2.907,3,-232,5,147,H1
"Woodruff County, AR",2007-2008,7648,7458,-190,-2.484,-43,-147,5,147,H1
"Woodruff County, AR",2008-2009,7458,7294,-164,-2.199,-40,-124,5,147,H1
"Woodruff County, AR",2009-2010,7294,7243,-51,-0.699,1,-52,5,147,H1
"Woodruff County, AR",2010-2011,7243,7192,-51,-0.704,-26,-25,5,147,H1
"Woodruff County, AR",2011-2012,7192,7071,-121,-1.682,-11,-110,5,147,H1
"Woodruff County, AR",2012-2013,7071,7052,-19,-0.269,-2,-17,5,147,H1
"Woodruff County, AR",2013-2014,7052,6910,-142,-2.014,-17,-125,5,147,H1
"Woodruff County, AR",2014-2015,6884,6741,-143,-2.077,-35,-108,5,147,H1
"Woodruff County, AR",2015-2016,6741,6623,-118,-1.75,-23,-95,5,147,H1
"Woodruff County, AR",2016-2017,6623,6571,-52,-0.785,-42,-10,5,147,H1
"Yell County, AR",2000-2001,21147,21145,-2,-0.009,105,-107,5,149,H1
"Yell County, AR",2001-2002,21145,21147,2,0.009,108,-106,5,149,H1
"Yell County, AR",2002-2003,21147,21197,50,0.236,60,-10,5,149,H1
"Yell County, AR",2003-2004,21197,21074,-123,-0.58,80,-203,5,149,H1
"Yell County, AR",2004-2005,21074,21141,67,0.318,46,21,5,149,H1
"Yell County, AR",2005-2006,21141,21556,415,1.963,102,313,5,149,H1
"Yell County, AR",2006-2007,21556,21633,77,0.357,153,-76,5,149,H1
"Yell County, AR",2007-2008,21633,21935,302,1.396,133,169,5,149,H1
"Yell County, AR",2008-2009,21935,22145,210,0.957,127,83,5,149,H1
"Yell County, AR",2009-2010,22145,22159,14,0.063,110,-96,5,149,H1
"Yell County, AR",2010-2011,22159,21942,-217,-0.979,105,-322,5,149,H1
"Yell County, AR",2011-2012,21942,21811,-131,-0.597,11,-142,5,149,H1
"Yell County, AR",2012-2013,21811,21807,-4,-0.018,54,-58,5,149,H1
"Yell County, AR",2013-2014,21807,21951,144,0.66,67,77,5,149,H1
"Yell County, AR",2014-2015,21916,21713,-203,-0.926,34,-237,5,149,H1
"Yell County, AR",2015-2016,21713,21486,-227,-1.045,15,-242,5,149,H1
"Yell County, AR",2016-2017,21486,21523,37,0.172,27,10,5,149,H1
California,2000-2001,33987977,34479458,491481,1.446,297381,194100,6,0,STATE
California,2001-2002,34479458,34871843,392385,1.138,292763,99622,6,0,STATE
California,2002-2003,34871843,35253159,381316,1.093,303689,77627,6,0,STATE
California,2003-2004,35253159,35574576,321417,0.912,300690,20727,6,0,STATE
California,2004-2005,35574576,35827943,253367,0.712,316355,-62988,6,0,STATE
California,2005-2006,35827943,36021202,193259,0.539,314697,-121438,6,0,STATE
California,2006-2007,36021202,36250311,229109,0.636,332306,-103197,6,0,STATE
California,2007-2008,36250311,36604337,354026,0.977,328355,25671,6,0,STATE
California,2008-2009,36604337,36961229,356892,0.975,317179,39713,6,0,STATE
California,2009-2010,36961229,37334079,372850,1.009,282471,90379,6,0,STATE
California,2010-2011,37334079,37700034,365955,0.98,271301,94654,6,0,STATE
California,2011-2012,37700034,38056055,356021,0.944,257791,98230,6,0,STATE
California,2012-2013,38056055,38414128,358073,0.941,251763,106310,6,0,STATE
California,2013-2014,38414128,38792291,378163,0.984,242274,135889,6,0,STATE
California,2014-2015,38792291,39144818,352527,0.909,243225,109302,6,0,STATE
California,2015-2016,39144818,39296476,151658,0.387,217866,-66208,6,0,STATE
California,2016-2017,39296476,39536653,240177,0.611,213939,26238,6,0,STATE
"Alameda County, CA",2000-2001,1449840,1469484,19644,1.355,12228,7416,6,1,H1
"Alameda County, CA",2001-2002,1469484,1462106,-7378,-0.502,12307,-19685,6,1,H1
"Alameda County, CA",2002-2003,1462106,1454163,-7943,-0.543,12121,-20064,6,1,H1
"Alameda County, CA",2003-2004,1454163,1445721,-8442,-0.581,11861,-20303,6,1,H1
"Alameda County, CA",2004-2005,1445721,1441545,-4176,-0.289,11332,-15508,6,1,H1
"Alameda County, CA",2005-2006,1441545,1444484,2939,0.204,11569,-8630,6,1,H1
"Alameda County, CA",2006-2007,1444484,1455715,11231,0.778,12233,-1002,6,1,H1
"Alameda County, CA",2007-2008,1455715,1477208,21493,1.476,12184,9309,6,1,H1
"Alameda County, CA",2008-2009,1477208,1498539,21331,1.444,11366,9965,6,1,H1
"Alameda County, CA",2009-2010,1498539,1513625,15086,1.007,10775,4311,6,1,H1
"Alameda County, CA",2010-2011,1513625,1532518,18893,1.248,10151,8742,6,1,H1
"Alameda County, CA",2011-2012,1532518,1556249,23731,1.548,9759,13972,6,1,H1
"Alameda County, CA",2012-2013,1556249,1583226,26977,1.733,10071,16906,6,1,H1
"Alameda County, CA",2013-2014,1583226,1610921,27695,1.749,9962,17733,6,1,H1
"Alameda County, CA",2014-2015,1612850,1638215,25365,1.573,9735,15630,6,1,H1
"Alameda County, CA",2015-2016,1638215,1653236,15021,0.917,9133,5888,6,1,H1
"Alameda County, CA",2016-2017,1653236,1663190,9954,0.602,8697,1257,6,1,H1
"Alpine County, CA",2000-2001,1209,1196,-13,-1.075,6,-19,6,3,H1
"Alpine County, CA",2001-2002,1196,1237,41,3.428,5,36,6,3,H1
"Alpine County, CA",2002-2003,1237,1233,-4,-0.323,-2,-2,6,3,H1
"Alpine County, CA",2003-2004,1233,1263,30,2.433,4,26,6,3,H1
"Alpine County, CA",2004-2005,1263,1219,-44,-3.484,2,-46,6,3,H1
"Alpine County, CA",2005-2006,1219,1276,57,4.676,7,50,6,3,H1
"Alpine County, CA",2006-2007,1276,1274,-2,-0.157,18,-20,6,3,H1
"Alpine County, CA",2007-2008,1274,1202,-72,-5.651,6,-78,6,3,H1
"Alpine County, CA",2008-2009,1202,1197,-5,-0.416,9,-14,6,3,H1
"Alpine County, CA",2009-2010,1197,1158,-39,-3.258,2,-41,6,3,H1
"Alpine County, CA",2010-2011,1158,1111,-47,-4.059,-1,-46,6,3,H1
"Alpine County, CA",2011-2012,1111,1127,16,1.44,0,16,6,3,H1
"Alpine County, CA",2012-2013,1127,1150,23,2.041,2,21,6,3,H1
"Alpine County, CA",2013-2014,1150,1116,-34,-2.957,6,-40,6,3,H1
"Alpine County, CA",2014-2015,1107,1110,3,0.271,-3,6,6,3,H1
"Alpine County, CA",2015-2016,1110,1057,-53,-4.775,-3,-50,6,3,H1
"Alpine County, CA",2016-2017,1057,1120,63,5.96,-3,66,6,3,H1
"Amador County, CA",2000-2001,35153,35697,544,1.548,-168,712,6,5,H1
"Amador County, CA",2001-2002,35697,36561,864,2.42,-104,968,6,5,H1
"Amador County, CA",2002-2003,36561,36994,433,1.184,-77,510,6,5,H1
"Amador County, CA",2003-2004,36994,37400,406,1.097,-160,566,6,5,H1
"Amador County, CA",2004-2005,37400,38040,640,1.711,-79,719,6,5,H1
"Amador County, CA",2005-2006,38040,38353,313,0.823,-126,439,6,5,H1
"Amador County, CA",2006-2007,38353,38756,403,1.051,-111,514,6,5,H1
"Amador County, CA",2007-2008,38756,38248,-508,-1.311,-124,-384,6,5,H1
"Amador County, CA",2008-2009,38248,38238,-10,-0.026,-96,86,6,5,H1
"Amador County, CA",2009-2010,38238,37860,-378,-0.989,-141,-237,6,5,H1
"Amador County, CA",2010-2011,37860,37520,-340,-0.898,-176,-164,6,5,H1
"Amador County, CA",2011-2012,37520,37072,-448,-1.194,-146,-302,6,5,H1
"Amador County, CA",2012-2013,37072,36602,-470,-1.268,-124,-346,6,5,H1
"Amador County, CA",2013-2014,36602,36742,140,0.382,-106,246,6,5,H1
"Amador County, CA",2014-2015,36744,37001,257,0.699,-129,386,6,5,H1
"Amador County, CA",2015-2016,37001,37473,472,1.276,-111,583,6,5,H1
"Amador County, CA",2016-2017,37473,38626,1153,3.077,-99,1252,6,5,H1
"Butte County, CA",2000-2001,203807,206193,2386,1.171,58,2328,6,7,H1
"Butte County, CA",2001-2002,206193,209120,2927,1.42,-9,2936,6,7,H1
"Butte County, CA",2002-2003,209120,211481,2361,1.129,144,2217,6,7,H1
"Butte County, CA",2003-2004,211481,213065,1584,0.749,237,1347,6,7,H1
"Butte County, CA",2004-2005,213065,214752,1687,0.792,168,1519,6,7,H1
"Butte County, CA",2005-2006,214752,216824,2072,0.965,237,1835,6,7,H1
"Butte County, CA",2006-2007,216824,217469,645,0.297,261,384,6,7,H1
"Butte County, CA",2007-2008,217469,219034,1565,0.72,421,1144,6,7,H1
"Butte County, CA",2008-2009,219034,219777,743,0.339,542,201,6,7,H1
"Butte County, CA",2009-2010,219777,219924,147,0.067,305,-158,6,7,H1
"Butte County, CA",2010-2011,219924,220025,101,0.046,260,-159,6,7,H1
"Butte County, CA",2011-2012,220025,221279,1254,0.57,154,1100,6,7,H1
"Butte County, CA",2012-2013,221279,222420,1141,0.516,102,1039,6,7,H1
"Butte County, CA",2013-2014,222420,224241,1821,0.819,122,1699,6,7,H1
"Butte County, CA",2014-2015,224033,225411,1378,0.615,189,1189,6,7,H1
"Butte County, CA",2015-2016,225411,226525,1114,0.494,68,1046,6,7,H1
"Butte County, CA",2016-2017,226525,229294,2769,1.222,100,2669,6,7,H1
"Calaveras County, CA",2000-2001,40645,41304,659,1.621,-69,728,6,9,H1
"Calaveras County, CA",2001-2002,41304,42380,1076,2.605,-88,1164,6,9,H1
"Calaveras County, CA",2002-2003,42380,43755,1375,3.244,-35,1410,6,9,H1
"Calaveras County, CA",2003-2004,43755,44530,775,1.771,-129,904,6,9,H1
"Calaveras County, CA",2004-2005,44530,45295,765,1.718,-43,808,6,9,H1
"Calaveras County, CA",2005-2006,45295,46045,750,1.656,-39,789,6,9,H1
"Calaveras County, CA",2006-2007,46045,46268,223,0.484,-62,285,6,9,H1
"Calaveras County, CA",2007-2008,46268,46265,-3,-0.006,-30,27,6,9,H1
"Calaveras County, CA",2008-2009,46265,45900,-365,-0.789,-4,-361,6,9,H1
"Calaveras County, CA",2009-2010,45900,45475,-425,-0.926,-108,-317,6,9,H1
"Calaveras County, CA",2010-2011,45475,45117,-358,-0.787,-111,-247,6,9,H1
"Calaveras County, CA",2011-2012,45117,44774,-343,-0.76,-81,-262,6,9,H1
"Calaveras County, CA",2012-2013,44774,44614,-160,-0.357,-153,-7,6,9,H1
"Calaveras County, CA",2013-2014,44614,44624,10,0.022,-133,143,6,9,H1
"Calaveras County, CA",2014-2015,44575,44828,253,0.568,-146,399,6,9,H1
"Calaveras County, CA",2015-2016,44828,45315,487,1.086,-133,620,6,9,H1
"Calaveras County, CA",2016-2017,45315,45670,355,0.783,-128,483,6,9,H1
"Colusa County, CA",2000-2001,18817,19022,205,1.089,199,6,6,11,H1
"Colusa County, CA",2001-2002,19022,19232,210,1.104,187,23,6,11,H1
"Colusa County, CA",2002-2003,19232,19568,336,1.747,197,139,6,11,H1
"Colusa County, CA",2003-2004,19568,20207,639,3.266,191,448,6,11,H1
"Colusa County, CA",2004-2005,20207,20540,333,1.648,215,118,6,11,H1
"Colusa County, CA",2005-2006,20540,20890,350,1.704,246,104,6,11,H1
"Colusa County, CA",2006-2007,20890,21075,185,0.886,268,-83,6,11,H1
"Colusa County, CA",2007-2008,21075,21134,59,0.28,244,-185,6,11,H1
"Colusa County, CA",2008-2009,21134,21250,116,0.549,251,-135,6,11,H1
"Colusa County, CA",2009-2010,21250,21459,209,0.984,226,-17,6,11,H1
"Colusa County, CA",2010-2011,21459,21415,-44,-0.205,161,-205,6,11,H1
"Colusa County, CA",2011-2012,21415,21397,-18,-0.084,158,-176,6,11,H1
"Colusa County, CA",2012-2013,21397,21432,35,0.164,206,-171,6,11,H1
"Colusa County, CA",2013-2014,21432,21419,-13,-0.061,200,-213,6,11,H1
"Colusa County, CA",2014-2015,21351,21482,131,0.614,203,-72,6,11,H1
"Colusa County, CA",2015-2016,21482,21645,163,0.759,177,-14,6,11,H1
"Colusa County, CA",2016-2017,21645,21805,160,0.739,186,-26,6,11,H1
"Contra Costa County, CA",2000-2001,952810,970952,18142,1.904,6447,11695,6,13,H1
"Contra Costa County, CA",2001-2002,970952,979862,8910,0.918,6143,2767,6,13,H1
"Contra Costa County, CA",2002-2003,979862,987531,7669,0.783,6358,1311,6,13,H1
"Contra Costa County, CA",2003-2004,987531,992424,4893,0.495,6308,-1415,6,13,H1
"Contra Costa County, CA",2004-2005,992424,999013,6589,0.664,6498,91,6,13,H1
"Contra Costa County, CA",2005-2006,999013,1000834,1821,0.182,6376,-4555,6,13,H1
"Contra Costa County, CA",2006-2007,1000834,1009152,8318,0.831,6871,1447,6,13,H1
"Contra Costa County, CA",2007-2008,1009152,1023344,14192,1.406,6462,7730,6,13,H1
"Contra Costa County, CA",2008-2009,1023344,1037890,14546,1.421,6413,8133,6,13,H1
"Contra Costa County, CA",2009-2010,1037890,1052894,15004,1.446,5243,9761,6,13,H1
"Contra Costa County, CA",2010-2011,1052894,1066587,13693,1.301,5072,8621,6,13,H1
"Contra Costa County, CA",2011-2012,1066587,1079358,12771,1.197,4963,7808,6,13,H1
"Contra Costa County, CA",2012-2013,1079358,1095980,16622,1.54,4612,12010,6,13,H1
"Contra Costa County, CA",2013-2014,1095980,1111339,15359,1.401,4477,10882,6,13,H1
"Contra Costa County, CA",2014-2015,1111710,1126745,15035,1.352,4632,10403,6,13,H1
"Contra Costa County, CA",2015-2016,1126745,1138645,11900,1.056,4353,7547,6,13,H1
"Contra Costa County, CA",2016-2017,1138645,1147439,8794,0.772,4281,4513,6,13,H1
"Del Norte County, CA",2000-2001,27440,27292,-148,-0.539,-19,-129,6,15,H1
"Del Norte County, CA",2001-2002,27292,27397,105,0.385,63,42,6,15,H1
"Del Norte County, CA",2002-2003,27397,27601,204,0.745,38,166,6,15,H1
"Del Norte County, CA",2003-2004,27601,27950,349,1.264,8,341,6,15,H1
"Del Norte County, CA",2004-2005,27950,28281,331,1.184,51,280,6,15,H1
"Del Norte County, CA",2005-2006,28281,28211,-70,-0.248,60,-130,6,15,H1
"Del Norte County, CA",2006-2007,28211,28415,204,0.723,116,88,6,15,H1
"Del Norte County, CA",2007-2008,28415,28496,81,0.285,63,18,6,15,H1
"Del Norte County, CA",2008-2009,28496,28599,103,0.361,79,24,6,15,H1
"Del Norte County, CA",2009-2010,28599,28580,-19,-0.066,26,-45,6,15,H1
"Del Norte County, CA",2010-2011,28580,28485,-95,-0.332,40,-135,6,15,H1
"Del Norte County, CA",2011-2012,28485,28226,-259,-0.909,40,-299,6,15,H1
"Del Norte County, CA",2012-2013,28226,27827,-399,-1.414,67,-466,6,15,H1
"Del Norte County, CA",2013-2014,27827,27212,-615,-2.21,48,-663,6,15,H1
"Del Norte County, CA",2014-2015,27194,27254,60,0.221,60,0,6,15,H1
"Del Norte County, CA",2015-2016,27254,27450,196,0.719,38,158,6,15,H1
"Del Norte County, CA",2016-2017,27450,27470,20,0.073,42,-22,6,15,H1
"El Dorado County, CA",2000-2001,157162,161101,3939,2.506,540,3399,6,17,H1
"El Dorado County, CA",2001-2002,161101,165195,4094,2.541,549,3545,6,17,H1
"El Dorado County, CA",2002-2003,165195,168331,3136,1.898,606,2530,6,17,H1
"El Dorado County, CA",2003-2004,168331,171653,3322,1.973,582,2740,6,17,H1
"El Dorado County, CA",2004-2005,171653,175003,3350,1.952,618,2732,6,17,H1
"El Dorado County, CA",2005-2006,175003,176773,1770,1.011,759,1011,6,17,H1
"El Dorado County, CA",2006-2007,176773,177694,921,0.521,714,207,6,17,H1
"El Dorado County, CA",2007-2008,177694,179150,1456,0.819,661,795,6,17,H1
"El Dorado County, CA",2008-2009,179150,180455,1305,0.728,824,481,6,17,H1
"El Dorado County, CA",2009-2010,180455,181163,708,0.392,439,269,6,17,H1
"El Dorado County, CA",2010-2011,181163,180926,-237,-0.131,316,-553,6,17,H1
"El Dorado County, CA",2011-2012,180926,180605,-321,-0.177,164,-485,6,17,H1
"El Dorado County, CA",2012-2013,180605,181542,937,0.519,66,871,6,17,H1
"El Dorado County, CA",2013-2014,181542,183087,1545,0.851,40,1505,6,17,H1
"El Dorado County, CA",2014-2015,183050,184452,1402,0.766,57,1345,6,17,H1
"El Dorado County, CA",2015-2016,184452,186272,1820,0.987,-8,1828,6,17,H1
"El Dorado County, CA",2016-2017,186272,188987,2715,1.458,-48,2763,6,17,H1
"Fresno County, CA",2000-2001,801288,813021,11733,1.464,8748,2985,6,19,H1
"Fresno County, CA",2001-2002,813021,829762,16741,2.059,8688,8053,6,19,H1
"Fresno County, CA",2002-2003,829762,847193,17431,2.101,9512,7919,6,19,H1
"Fresno County, CA",2003-2004,847193,861035,13842,1.634,9580,4262,6,19,H1
"Fresno County, CA",2004-2005,861035,872470,11435,1.328,10157,1278,6,19,H1
"Fresno County, CA",2005-2006,872470,883862,11392,1.306,10378,1014,6,19,H1
"Fresno County, CA",2006-2007,883862,895933,12071,1.366,11025,1046,6,19,H1
"Fresno County, CA",2007-2008,895933,909630,13697,1.529,11283,2414,6,19,H1
"Fresno County, CA",2008-2009,909630,921478,11848,1.303,11148,700,6,19,H1
"Fresno County, CA",2009-2010,921478,932642,11164,1.212,10150,1014,6,19,H1
"Fresno County, CA",2010-2011,932642,941260,8618,0.924,10321,-1703,6,19,H1
"Fresno County, CA",2011-2012,941260,948240,6980,0.742,9668,-2688,6,19,H1
"Fresno County, CA",2012-2013,948240,956102,7862,0.829,9292,-1430,6,19,H1
"Fresno County, CA",2013-2014,956102,965974,9872,1.033,9256,616,6,19,H1
"Fresno County, CA",2014-2015,964983,974861,9878,1.024,9195,683,6,19,H1
"Fresno County, CA",2015-2016,974861,979534,4673,0.479,8305,-3632,6,19,H1
"Fresno County, CA",2016-2017,979534,989255,9721,0.992,8108,1613,6,19,H1
"Glenn County, CA",2000-2001,26416,26450,34,0.129,171,-137,6,21,H1
"Glenn County, CA",2001-2002,26450,26651,201,0.76,161,40,6,21,H1
"Glenn County, CA",2002-2003,26651,27016,365,1.37,206,159,6,21,H1
"Glenn County, CA",2003-2004,27016,27122,106,0.392,161,-55,6,21,H1
"Glenn County, CA",2004-2005,27122,27393,271,0.999,193,78,6,21,H1
"Glenn County, CA",2005-2006,27393,27652,259,0.945,200,59,6,21,H1
"Glenn County, CA",2006-2007,27652,27775,123,0.445,175,-52,6,21,H1
"Glenn County, CA",2007-2008,27775,28019,244,0.878,239,5,6,21,H1
"Glenn County, CA",2008-2009,28019,28100,81,0.289,294,-213,6,21,H1
"Glenn County, CA",2009-2010,28100,28101,1,0.004,219,-218,6,21,H1
"Glenn County, CA",2010-2011,28101,28185,84,0.299,189,-105,6,21,H1
"Glenn County, CA",2011-2012,28185,27938,-247,-0.876,133,-380,6,21,H1
"Glenn County, CA",2012-2013,27938,27914,-24,-0.086,171,-195,6,21,H1
"Glenn County, CA",2013-2014,27914,27955,41,0.147,146,-105,6,21,H1
"Glenn County, CA",2014-2015,28030,28017,-13,-0.046,197,-210,6,21,H1
"Glenn County, CA",2015-2016,28017,27967,-50,-0.178,149,-199,6,21,H1
"Glenn County, CA",2016-2017,27967,28094,127,0.454,148,-21,6,21,H1
"Humboldt County, CA",2000-2001,126462,127520,1058,0.837,182,876,6,23,H1
"Humboldt County, CA",2001-2002,127520,128780,1260,0.988,226,1034,6,23,H1
"Humboldt County, CA",2002-2003,128780,129754,974,0.756,199,775,6,23,H1
"Humboldt County, CA",2003-2004,129754,130702,948,0.731,208,740,6,23,H1
"Humboldt County, CA",2004-2005,130702,131497,795,0.608,340,455,6,23,H1
"Humboldt County, CA",2005-2006,131497,132093,596,0.453,417,179,6,23,H1
"Humboldt County, CA",2006-2007,132093,132001,-92,-0.07,398,-490,6,23,H1
"Humboldt County, CA",2007-2008,132001,132657,656,0.497,403,253,6,23,H1
"Humboldt County, CA",2008-2009,132657,133744,1087,0.819,475,612,6,23,H1
"Humboldt County, CA",2009-2010,133744,135022,1278,0.956,352,926,6,23,H1
"Humboldt County, CA",2010-2011,135022,135250,228,0.169,358,-130,6,23,H1
"Humboldt County, CA",2011-2012,135250,134680,-570,-0.421,156,-726,6,23,H1
"Humboldt County, CA",2012-2013,134680,134620,-60,-0.045,200,-260,6,23,H1
"Humboldt County, CA",2013-2014,134620,134809,189,0.14,184,5,6,23,H1
"Humboldt County, CA",2014-2015,134831,135727,896,0.665,257,639,6,23,H1
"Humboldt County, CA",2015-2016,135727,136449,722,0.532,131,591,6,23,H1
"Humboldt County, CA",2016-2017,136449,136754,305,0.224,114,191,6,23,H1
"Imperial County, CA",2000-2001,142410,143707,1297,0.911,1708,-411,6,25,H1
"Imperial County, CA",2001-2002,143707,145640,1933,1.345,1691,242,6,25,H1
"Imperial County, CA",2002-2003,145640,148984,3344,2.296,1888,1456,6,25,H1
"Imperial County, CA",2003-2004,148984,152259,3275,2.198,1999,1276,6,25,H1
"Imperial County, CA",2004-2005,152259,156113,3854,2.531,2127,1727,6,25,H1
"Imperial County, CA",2005-2006,156113,160505,4392,2.813,2035,2357,6,25,H1
"Imperial County, CA",2006-2007,160505,164596,4091,2.549,2234,1857,6,25,H1
"Imperial County, CA",2007-2008,164596,167917,3321,2.018,2303,1018,6,25,H1
"Imperial County, CA",2008-2009,167917,172008,4091,2.436,2376,1715,6,25,H1
"Imperial County, CA",2009-2010,172008,174779,2771,1.611,2126,645,6,25,H1
"Imperial County, CA",2010-2011,174779,176300,1521,0.87,2147,-626,6,25,H1
"Imperial County, CA",2011-2012,176300,177443,1143,0.648,2064,-921,6,25,H1
"Imperial County, CA",2012-2013,177443,177517,74,0.042,2144,-2070,6,25,H1
"Imperial County, CA",2013-2014,177517,179091,1574,0.887,2093,-519,6,25,H1
"Imperial County, CA",2014-2015,179332,180191,859,0.479,2160,-1301,6,25,H1
"Imperial County, CA",2015-2016,180191,180980,789,0.438,2115,-1326,6,25,H1
"Imperial County, CA",2016-2017,180980,182830,1850,1.022,2076,-226,6,25,H1
"Inyo County, CA",2000-2001,17955,18117,162,0.902,-45,207,6,27,H1
"Inyo County, CA",2001-2002,18117,18394,277,1.529,-13,290,6,27,H1
"Inyo County, CA",2002-2003,18394,18593,199,1.082,-55,254,6,27,H1
"Inyo County, CA",2003-2004,18593,18578,-15,-0.081,-32,17,6,27,H1
"Inyo County, CA",2004-2005,18578,18478,-100,-0.538,10,-110,6,27,H1
"Inyo County, CA",2005-2006,18478,18370,-108,-0.584,9,-117,6,27,H1
"Inyo County, CA",2006-2007,18370,18426,56,0.305,34,22,6,27,H1
"Inyo County, CA",2007-2008,18426,18318,-108,-0.586,36,-144,6,27,H1
"Inyo County, CA",2008-2009,18318,18544,226,1.234,64,162,6,27,H1
"Inyo County, CA",2009-2010,18544,18532,-12,-0.065,49,-61,6,27,H1
"Inyo County, CA",2010-2011,18532,18413,-119,-0.642,-6,-113,6,27,H1
"Inyo County, CA",2011-2012,18413,18416,3,0.016,24,-21,6,27,H1
"Inyo County, CA",2012-2013,18416,18423,7,0.038,21,-14,6,27,H1
"Inyo County, CA",2013-2014,18423,18410,-13,-0.071,36,-49,6,27,H1
"Inyo County, CA",2014-2015,18396,18260,-136,-0.739,42,-178,6,27,H1
"Inyo County, CA",2015-2016,18260,18034,-226,-1.238,30,-256,6,27,H1
"Inyo County, CA",2016-2017,18034,18026,-8,-0.044,-1,-7,6,27,H1
"Kern County, CA",2000-2001,663803,676574,12771,1.924,6803,5968,6,29,H1
"Kern County, CA",2001-2002,676574,694059,17485,2.584,6971,10514,6,29,H1
"Kern County, CA",2002-2003,694059,714272,20213,2.912,7284,12929,6,29,H1
"Kern County, CA",2003-2004,714272,736296,22024,3.083,7716,14308,6,29,H1
"Kern County, CA",2004-2005,736296,760726,24430,3.318,8514,15916,6,29,H1
"Kern County, CA",2005-2006,760726,784511,23785,3.127,9147,14638,6,29,H1
"Kern County, CA",2006-2007,784511,803281,18770,2.393,9950,8820,6,29,H1
"Kern County, CA",2007-2008,803281,818327,15046,1.873,10176,4870,6,29,H1
"Kern County, CA",2008-2009,818327,830137,11810,1.443,10115,1695,6,29,H1
"Kern County, CA",2009-2010,830137,841762,11625,1.4,8834,2791,6,29,H1
"Kern County, CA",2010-2011,841762,849872,8110,0.963,8997,-887,6,29,H1
"Kern County, CA",2011-2012,849872,856502,6630,0.78,8956,-2326,6,29,H1
"Kern County, CA",2012-2013,856502,865923,9421,1.1,9014,407,6,29,H1
"Kern County, CA",2013-2014,865923,874589,8666,1.001,9.00E+03,-334,6,29,H1
"Kern County, CA",2014-2015,874190,882176,7986,0.914,8599,-613,6,29,H1
"Kern County, CA",2015-2016,882176,885086,2910,0.33,7781,-4871,6,29,H1
"Kern County, CA",2016-2017,885086,893119,8033,0.908,7593,440,6,29,H1
"Kings County, CA",2000-2001,129835,132881,3046,2.346,1508,1538,6,31,H1
"Kings County, CA",2001-2002,132881,135369,2488,1.872,1489,999,6,31,H1
"Kings County, CA",2002-2003,135369,139393,4024,2.973,1550,2474,6,31,H1
"Kings County, CA",2003-2004,139393,143601,4208,3.019,1563,2645,6,31,H1
"Kings County, CA",2004-2005,143601,145147,1546,1.077,1867,-321,6,31,H1
"Kings County, CA",2005-2006,145147,147712,2565,1.767,1776,789,6,31,H1
"Kings County, CA",2006-2007,147712,150420,2708,1.833,1952,756,6,31,H1
"Kings County, CA",2007-2008,150420,152027,1607,1.068,1983,-376,6,31,H1
"Kings County, CA",2008-2009,152027,152278,251,0.165,1900,-1649,6,31,H1
"Kings County, CA",2009-2010,152278,152418,140,0.092,1752,-1612,6,31,H1
"Kings County, CA",2010-2011,152418,152063,-355,-0.233,1833,-2188,6,31,H1
"Kings County, CA",2011-2012,152063,151340,-723,-0.475,1591,-2314,6,31,H1
"Kings County, CA",2012-2013,151340,150862,-478,-0.316,1608,-2086,6,31,H1
"Kings County, CA",2013-2014,150862,150269,-593,-0.393,1527,-2120,6,31,H1
"Kings County, CA",2014-2015,150108,150965,857,0.571,1597,-740,6,31,H1
"Kings County, CA",2015-2016,150965,149797,-1168,-0.774,1433,-2601,6,31,H1
"Kings County, CA",2016-2017,149797,150101,304,0.203,1355,-1051,6,31,H1
"Lake County, CA",2000-2001,58538,60219,1681,2.872,-193,1874,6,33,H1
"Lake County, CA",2001-2002,60219,61513,1294,2.149,-203,1497,6,33,H1
"Lake County, CA",2002-2003,61513,62496,983,1.598,-73,1056,6,33,H1
"Lake County, CA",2003-2004,62496,63116,620,0.992,-188,808,6,33,H1
"Lake County, CA",2004-2005,63116,63811,695,1.101,-65,760,6,33,H1
"Lake County, CA",2005-2006,63811,64202,391,0.613,-66,457,6,33,H1
"Lake County, CA",2006-2007,64202,64077,-125,-0.195,-24,-101,6,33,H1
"Lake County, CA",2007-2008,64077,64392,315,0.492,-18,333,6,33,H1
"Lake County, CA",2008-2009,64392,64413,21,0.033,41,-20,6,33,H1
"Lake County, CA",2009-2010,64413,64757,344,0.534,-56,400,6,33,H1
"Lake County, CA",2010-2011,64757,64279,-478,-0.738,-55,-423,6,33,H1
"Lake County, CA",2011-2012,64279,63984,-295,-0.459,-114,-181,6,33,H1
"Lake County, CA",2012-2013,63984,63843,-141,-0.22,-49,-92,6,33,H1
"Lake County, CA",2013-2014,63843,64184,341,0.534,-38,379,6,33,H1
"Lake County, CA",2014-2015,64156,64591,435,0.678,-9,444,6,33,H1
"Lake County, CA",2015-2016,64591,63950,-641,-0.992,-128,-513,6,33,H1
"Lake County, CA",2016-2017,63950,64246,296,0.463,-96,392,6,33,H1
"Lassen County, CA",2000-2001,33719,33548,-171,-0.507,45,-216,6,35,H1
"Lassen County, CA",2001-2002,33548,33430,-118,-0.352,52,-170,6,35,H1
"Lassen County, CA",2002-2003,33430,33930,500,1.496,124,376,6,35,H1
"Lassen County, CA",2003-2004,33930,34458,528,1.556,69,459,6,35,H1
"Lassen County, CA",2004-2005,34458,34488,30,0.087,57,-27,6,35,H1
"Lassen County, CA",2005-2006,34488,34605,117,0.339,73,44,6,35,H1
"Lassen County, CA",2006-2007,34605,35615,1010,2.919,54,956,6,35,H1
"Lassen County, CA",2007-2008,35615,35221,-394,-1.106,77,-471,6,35,H1
"Lassen County, CA",2008-2009,35221,35160,-61,-0.173,134,-195,6,35,H1
"Lassen County, CA",2009-2010,35160,34841,-319,-0.907,100,-419,6,35,H1
"Lassen County, CA",2010-2011,34841,34297,-544,-1.561,100,-644,6,35,H1
"Lassen County, CA",2011-2012,34297,33679,-618,-1.802,34,-652,6,35,H1
"Lassen County, CA",2012-2013,33679,32212,-1467,-4.356,93,-1560,6,35,H1
"Lassen County, CA",2013-2014,32212,31749,-463,-1.437,75,-538,6,35,H1
"Lassen County, CA",2014-2015,31732,31345,-387,-1.22,70,-457,6,35,H1
"Lassen County, CA",2015-2016,31345,30944,-401,-1.279,108,-509,6,35,H1
"Lassen County, CA",2016-2017,30944,31163,219,0.708,86,133,6,35,H1
"Los Angeles County, CA",2000-2001,9538191,9626034,87843,0.921,95704,-7861,6,37,H1
"Los Angeles County, CA",2001-2002,9626034,9705913,79879,0.83,91646,-11767,6,37,H1
"Los Angeles County, CA",2002-2003,9705913,9767145,61232,0.631,92956,-31724,6,37,H1
"Los Angeles County, CA",2003-2004,9767145,9793263,26118,0.267,90162,-64044,6,37,H1
"Los Angeles County, CA",2004-2005,9793263,9786373,-6890,-0.07,92865,-99755,6,37,H1
"Los Angeles County, CA",2005-2006,9786373,9737955,-48418,-0.495,89823,-138241,6,37,H1
"Los Angeles County, CA",2006-2007,9737955,9700359,-37596,-0.386,92951,-130547,6,37,H1
"Los Angeles County, CA",2007-2008,9700359,9735147,34788,0.359,92350,-57562,6,37,H1
"Los Angeles County, CA",2008-2009,9735147,9787400,52253,0.537,86785,-34532,6,37,H1
"Los Angeles County, CA",2009-2010,9787400,9827231,39831,0.407,79796,-39965,6,37,H1
"Los Angeles County, CA",2010-2011,9827231,9898214,70983,0.722,74419,-3436,6,37,H1
"Los Angeles County, CA",2011-2012,9898214,9974868,76654,0.774,71120,5534,6,37,H1
"Los Angeles County, CA",2012-2013,9974868,10053995,79127,0.793,71096,8031,6,37,H1
"Los Angeles County, CA",2013-2014,10053995,10116705,62710,0.624,68605,-5895,6,37,H1
"Los Angeles County, CA",2014-2015,10109436,10170292,60856,0.602,65858,-5002,6,37,H1
"Los Angeles County, CA",2015-2016,10170292,10150558,-19734,-0.194,57094,-76828,6,37,H1
"Los Angeles County, CA",2016-2017,10150558,10163507,12949,0.128,55672,-42723,6,37,H1
"Madera County, CA",2000-2001,123587,125581,1994,1.613,1253,741,6,39,H1
"Madera County, CA",2001-2002,125581,128369,2788,2.22,1194,1594,6,39,H1
"Madera County, CA",2002-2003,128369,132738,4369,3.403,1305,3064,6,39,H1
"Madera County, CA",2003-2004,132738,137106,4368,3.291,1387,2981,6,39,H1
"Madera County, CA",2004-2005,137106,140313,3207,2.339,1445,1762,6,39,H1
"Madera County, CA",2005-2006,140313,143622,3309,2.358,1527,1782,6,39,H1
"Madera County, CA",2006-2007,143622,146067,2445,1.702,1644,801,6,39,H1
"Madera County, CA",2007-2008,146067,148359,2292,1.569,1629,663,6,39,H1
"Madera County, CA",2008-2009,148359,149234,875,0.59,1694,-819,6,39,H1
"Madera County, CA",2009-2010,149234,151154,1920,1.287,1467,453,6,39,H1
"Madera County, CA",2010-2011,151154,152148,994,0.658,1434,-440,6,39,H1
"Madera County, CA",2011-2012,152148,152244,96,0.063,1335,-1239,6,39,H1
"Madera County, CA",2012-2013,152244,152165,-79,-0.052,1250,-1329,6,39,H1
"Madera County, CA",2013-2014,152165,154548,2383,1.566,1264,1119,6,39,H1
"Madera County, CA",2014-2015,154562,154998,436,0.282,1432,-996,6,39,H1
"Madera County, CA",2015-2016,154998,154966,-32,-0.021,1176,-1208,6,39,H1
"Madera County, CA",2016-2017,154966,156890,1924,1.242,1177,747,6,39,H1
"Marin County, CA",2000-2001,247520,247866,346,0.14,1029,-683,6,41,H1
"Marin County, CA",2001-2002,247866,246225,-1641,-0.662,940,-2581,6,41,H1
"Marin County, CA",2002-2003,246225,245054,-1171,-0.476,981,-2152,6,41,H1
"Marin County, CA",2003-2004,245054,243769,-1285,-0.524,1024,-2309,6,41,H1
"Marin County, CA",2004-2005,243769,244206,437,0.179,1018,-581,6,41,H1
"Marin County, CA",2005-2006,244206,244580,374,0.153,918,-544,6,41,H1
"Marin County, CA",2006-2007,244580,246248,1668,0.682,971,697,6,41,H1
"Marin County, CA",2007-2008,246248,248398,2150,0.873,1002,1148,6,41,H1
"Marin County, CA",2008-2009,248398,250862,2464,0.992,772,1692,6,41,H1
"Marin County, CA",2009-2010,250862,252884,2022,0.806,463,1559,6,41,H1
"Marin County, CA",2010-2011,252884,255413,2529,1,552,1977,6,41,H1
"Marin County, CA",2011-2012,255413,256143,730,0.286,453,277,6,41,H1
"Marin County, CA",2012-2013,256143,258821,2678,1.046,448,2230,6,41,H1
"Marin County, CA",2013-2014,258821,260750,1929,0.745,423,1506,6,41,H1
"Marin County, CA",2014-2015,260550,261221,671,0.258,428,243,6,41,H1
"Marin County, CA",2015-2016,261221,261532,311,0.119,329,-18,6,41,H1
"Marin County, CA",2016-2017,261532,260955,-577,-0.221,258,-835,6,41,H1
"Mariposa County, CA",2000-2001,17101,17099,-2,-0.012,-18,16,6,43,H1
"Mariposa County, CA",2001-2002,17099,17243,144,0.842,-36,180,6,43,H1
"Mariposa County, CA",2002-2003,17243,17707,464,2.691,-25,489,6,43,H1
"Mariposa County, CA",2003-2004,17707,17844,137,0.774,-53,190,6,43,H1
"Mariposa County, CA",2004-2005,17844,17972,128,0.717,-9,137,6,43,H1
"Mariposa County, CA",2005-2006,17972,18219,247,1.374,-29,276,6,43,H1
"Mariposa County, CA",2006-2007,18219,18366,147,0.807,-36,183,6,43,H1
"Mariposa County, CA",2007-2008,18366,18412,46,0.25,-32,78,6,43,H1
"Mariposa County, CA",2008-2009,18412,18212,-200,-1.086,-20,-180,6,43,H1
"Mariposa County, CA",2009-2010,18212,18261,49,0.269,-26,75,6,43,H1
"Mariposa County, CA",2010-2011,18261,18184,-77,-0.422,-8,-69,6,43,H1
"Mariposa County, CA",2011-2012,18184,17845,-339,-1.864,-14,-325,6,43,H1
"Mariposa County, CA",2012-2013,17845,17758,-87,-0.488,-27,-60,6,43,H1
"Mariposa County, CA",2013-2014,17758,17682,-76,-0.428,5,-81,6,43,H1
"Mariposa County, CA",2014-2015,17636,17531,-105,-0.595,-23,-82,6,43,H1
"Mariposa County, CA",2015-2016,17531,17524,-7,-0.04,-10,3,6,43,H1
"Mariposa County, CA",2016-2017,17524,17569,45,0.257,2,43,6,43,H1
"Mendocino County, CA",2000-2001,86407,86841,434,0.502,257,177,6,45,H1
"Mendocino County, CA",2001-2002,86841,87364,523,0.602,191,332,6,45,H1
"Mendocino County, CA",2002-2003,87364,88140,776,0.888,310,466,6,45,H1
"Mendocino County, CA",2003-2004,88140,88030,-110,-0.125,204,-314,6,45,H1
"Mendocino County, CA",2004-2005,88030,87981,-49,-0.056,328,-377,6,45,H1
"Mendocino County, CA",2005-2006,87981,87345,-636,-0.723,300,-936,6,45,H1
"Mendocino County, CA",2006-2007,87345,87071,-274,-0.314,384,-658,6,45,H1
"Mendocino County, CA",2007-2008,87071,87468,397,0.456,399,-2,6,45,H1
"Mendocino County, CA",2008-2009,87468,87722,254,0.29,376,-122,6,45,H1
"Mendocino County, CA",2009-2010,87722,87761,39,0.044,239,-200,6,45,H1
"Mendocino County, CA",2010-2011,87761,87460,-301,-0.343,173,-474,6,45,H1
"Mendocino County, CA",2011-2012,87460,87497,37,0.042,310,-273,6,45,H1
"Mendocino County, CA",2012-2013,87497,87471,-26,-0.03,357,-383,6,45,H1
"Mendocino County, CA",2013-2014,87471,87869,398,0.455,321,77,6,45,H1
"Mendocino County, CA",2014-2015,87683,87649,-34,-0.039,186,-220,6,45,H1
"Mendocino County, CA",2015-2016,87649,87609,-40,-0.046,173,-213,6,45,H1
"Mendocino County, CA",2016-2017,87609,88018,409,0.467,174,235,6,45,H1
"Merced County, CA",2000-2001,212258,218816,6558,3.09,2561,3997,6,47,H1
"Merced County, CA",2001-2002,218816,225351,6535,2.987,2546,3989,6,47,H1
"Merced County, CA",2002-2003,225351,231735,6384,2.833,2740,3644,6,47,H1
"Merced County, CA",2003-2004,231735,237180,5445,2.35,2777,2668,6,47,H1
"Merced County, CA",2004-2005,237180,242554,5374,2.266,2954,2420,6,47,H1
"Merced County, CA",2005-2006,242554,245338,2784,1.148,3076,-292,6,47,H1
"Merced County, CA",2006-2007,245338,248540,3202,1.305,3351,-149,6,47,H1
"Merced County, CA",2007-2008,248540,250538,1998,0.804,3055,-1057,6,47,H1
"Merced County, CA",2008-2009,250538,252302,1764,0.704,3001,-1237,6,47,H1
"Merced County, CA",2009-2010,252302,256731,4429,1.755,2696,1733,6,47,H1
"Merced County, CA",2010-2011,256731,259698,2967,1.156,2841,126,6,47,H1
"Merced County, CA",2011-2012,259698,261783,2085,0.803,2733,-648,6,47,H1
"Merced County, CA",2012-2013,261783,263481,1698,0.649,2643,-945,6,47,H1
"Merced County, CA",2013-2014,263481,266353,2872,1.09,2642,230,6,47,H1
"Merced County, CA",2014-2015,266087,268455,2368,0.89,2561,-193,6,47,H1
"Merced County, CA",2015-2016,268455,268878,423,0.158,2377,-1954,6,47,H1
"Merced County, CA",2016-2017,268878,272673,3795,1.411,2370,1425,6,47,H1
"Modoc County, CA",2000-2001,9406,9350,-56,-0.595,-13,-43,6,49,H1
"Modoc County, CA",2001-2002,9350,9362,12,0.128,-46,58,6,49,H1
"Modoc County, CA",2002-2003,9362,9501,139,1.485,-27,166,6,49,H1
"Modoc County, CA",2003-2004,9501,9605,104,1.095,-34,138,6,49,H1
"Modoc County, CA",2004-2005,9605,9565,-40,-0.416,-25,-15,6,49,H1
"Modoc County, CA",2005-2006,9565,9617,52,0.544,-22,74,6,49,H1
"Modoc County, CA",2006-2007,9617,9525,-92,-0.957,-30,-62,6,49,H1
"Modoc County, CA",2007-2008,9525,9551,26,0.273,-28,54,6,49,H1
"Modoc County, CA",2008-2009,9551,9646,95,0.995,-8,103,6,49,H1
"Modoc County, CA",2009-2010,9646,9708,62,0.643,-23,85,6,49,H1
"Modoc County, CA",2010-2011,9708,9499,-209,-2.153,2,-211,6,49,H1
"Modoc County, CA",2011-2012,9499,9332,-167,-1.758,-44,-123,6,49,H1
"Modoc County, CA",2012-2013,9332,9112,-220,-2.357,-25,-195,6,49,H1
"Modoc County, CA",2013-2014,9112,9023,-89,-0.977,-34,-55,6,49,H1
"Modoc County, CA",2014-2015,9015,8965,-50,-0.555,-40,-10,6,49,H1
"Modoc County, CA",2015-2016,8965,8941,-24,-0.268,-42,18,6,49,H1
"Modoc County, CA",2016-2017,8941,8859,-82,-0.917,-26,-56,6,49,H1
"Mono County, CA",2000-2001,12921,13224,303,2.345,79,224,6,51,H1
"Mono County, CA",2001-2002,13224,13404,180,1.361,116,64,6,51,H1
"Mono County, CA",2002-2003,13404,13352,-52,-0.388,90,-142,6,51,H1
"Mono County, CA",2003-2004,13352,13360,8,0.06,108,-100,6,51,H1
"Mono County, CA",2004-2005,13360,13474,114,0.853,126,-12,6,51,H1
"Mono County, CA",2005-2006,13474,13743,269,1.996,134,135,6,51,H1
"Mono County, CA",2006-2007,13743,13678,-65,-0.473,117,-182,6,51,H1
"Mono County, CA",2007-2008,13678,13862,184,1.345,118,66,6,51,H1
"Mono County, CA",2008-2009,13862,14008,146,1.053,102,44,6,51,H1
"Mono County, CA",2009-2010,14008,14249,241,1.72,61,180,6,51,H1
"Mono County, CA",2010-2011,14249,14398,149,1.046,114,35,6,51,H1
"Mono County, CA",2011-2012,14398,14306,-92,-0.639,96,-188,6,51,H1
"Mono County, CA",2012-2013,14306,14016,-290,-2.027,91,-381,6,51,H1
"Mono County, CA",2013-2014,14016,13997,-19,-0.136,84,-103,6,51,H1
"Mono County, CA",2014-2015,14057,13909,-148,-1.053,104,-252,6,51,H1
"Mono County, CA",2015-2016,13909,14101,192,1.38,85,107,6,51,H1
"Mono County, CA",2016-2017,14101,14168,67,0.475,101,-34,6,51,H1
"Monterey County, CA",2000-2001,402990,407082,4092,1.015,4528,-436,6,53,H1
"Monterey County, CA",2001-2002,407082,408977,1895,0.466,4908,-3013,6,53,H1
"Monterey County, CA",2002-2003,408977,409725,748,0.183,4889,-4141,6,53,H1
"Monterey County, CA",2003-2004,409725,408731,-994,-0.243,4942,-5936,6,53,H1
"Monterey County, CA",2004-2005,408731,405139,-3592,-0.879,5199,-8791,6,53,H1
"Monterey County, CA",2005-2006,405139,401831,-3308,-0.817,5055,-8363,6,53,H1
"Monterey County, CA",2006-2007,401831,402376,545,0.136,5211,-4666,6,53,H1
"Monterey County, CA",2007-2008,402376,406022,3646,0.906,5202,-1556,6,53,H1
"Monterey County, CA",2008-2009,406022,410263,4241,1.045,5178,-937,6,53,H1
"Monterey County, CA",2009-2010,410263,416364,6101,1.487,4768,1333,6,53,H1
"Monterey County, CA",2010-2011,416364,421393,5029,1.208,4554,475,6,53,H1
"Monterey County, CA",2011-2012,421393,426411,5018,1.191,4452,566,6,53,H1
"Monterey County, CA",2012-2013,426411,429123,2712,0.636,4142,-1430,6,53,H1
"Monterey County, CA",2013-2014,429123,431344,2221,0.518,4163,-1942,6,53,H1
"Monterey County, CA",2014-2015,431293,433898,2605,0.604,4134,-1529,6,53,H1
"Monterey County, CA",2015-2016,433898,436363,2465,0.568,3756,-1291,6,53,H1
"Monterey County, CA",2016-2017,436363,437907,1544,0.354,3716,-2172,6,53,H1
"Napa County, CA",2000-2001,124565,126818,2253,1.809,257,1996,6,55,H1
"Napa County, CA",2001-2002,126818,128744,1926,1.519,300,1626,6,55,H1
"Napa County, CA",2002-2003,128744,130138,1394,1.083,364,1030,6,55,H1
"Napa County, CA",2003-2004,130138,130387,249,0.191,366,-117,6,55,H1
"Napa County, CA",2004-2005,130387,130381,-6,-0.005,325,-331,6,55,H1
"Napa County, CA",2005-2006,130381,131440,1059,0.812,536,523,6,55,H1
"Napa County, CA",2006-2007,131440,132583,1143,0.87,521,622,6,55,H1
"Napa County, CA",2007-2008,132583,134093,1510,1.139,473,1037,6,55,H1
"Napa County, CA",2008-2009,134093,135280,1187,0.885,510,677,6,55,H1
"Napa County, CA",2009-2010,135280,136829,1549,1.145,414,1135,6,55,H1
"Napa County, CA",2010-2011,136829,138056,1227,0.897,345,882,6,55,H1
"Napa County, CA",2011-2012,138056,139135,1079,0.782,396,683,6,55,H1
"Napa County, CA",2012-2013,139135,140580,1445,1.039,176,1269,6,55,H1
"Napa County, CA",2013-2014,140580,141667,1087,0.773,205,882,6,55,H1
"Napa County, CA",2014-2015,141551,142456,905,0.639,244,661,6,55,H1
"Napa County, CA",2015-2016,142456,141649,-807,-0.566,194,-1001,6,55,H1
"Napa County, CA",2016-2017,141649,140973,-676,-0.477,132,-808,6,55,H1
"Nevada County, CA",2000-2001,92520,93715,1195,1.292,-122,1317,6,57,H1
"Nevada County, CA",2001-2002,93715,94647,932,0.995,-127,1059,6,57,H1
"Nevada County, CA",2002-2003,94647,95606,959,1.013,-101,1060,6,57,H1
"Nevada County, CA",2003-2004,95606,96512,906,0.948,-220,1126,6,57,H1
"Nevada County, CA",2004-2005,96512,97250,738,0.765,-105,843,6,57,H1
"Nevada County, CA",2005-2006,97250,97549,299,0.307,-46,345,6,57,H1
"Nevada County, CA",2006-2007,97549,97794,245,0.251,-45,290,6,57,H1
"Nevada County, CA",2007-2008,97794,98200,406,0.415,-63,469,6,57,H1
"Nevada County, CA",2008-2009,98200,98591,391,0.398,-58,449,6,57,H1
"Nevada County, CA",2009-2010,98591,98752,161,0.163,-249,410,6,57,H1
"Nevada County, CA",2010-2011,98752,98788,36,0.036,-154,190,6,57,H1
"Nevada County, CA",2011-2012,98788,98333,-455,-0.461,-140,-315,6,57,H1
"Nevada County, CA",2012-2013,98333,98262,-71,-0.072,-102,31,6,57,H1
"Nevada County, CA",2013-2014,98262,98893,631,0.642,-62,693,6,57,H1
"Nevada County, CA",2014-2015,98763,98877,114,0.115,-40,154,6,57,H1
"Nevada County, CA",2015-2016,98877,99053,176,0.178,-61,237,6,57,H1
"Nevada County, CA",2016-2017,99053,99814,761,0.768,-64,825,6,57,H1
"Orange County, CA",2000-2001,2854513,2885457,30944,1.084,29451,1493,6,59,H1
"Orange County, CA",2001-2002,2885457,2908245,22788,0.79,28314,-5526,6,59,H1
"Orange County, CA",2002-2003,2908245,2929376,21131,0.727,28309,-7178,6,59,H1
"Orange County, CA",2003-2004,2929376,2941711,12335,0.421,27456,-15121,6,59,H1
"Orange County, CA",2004-2005,2941711,2940055,-1656,-0.056,28179,-29835,6,59,H1
"Orange County, CA",2005-2006,2940055,2932261,-7794,-0.265,26940,-34734,6,59,H1
"Orange County, CA",2006-2007,2932261,2931629,-632,-0.022,26921,-27553,6,59,H1
"Orange County, CA",2007-2008,2931629,2957593,25964,0.886,26543,-579,6,59,H1
"Orange County, CA",2008-2009,2957593,2987177,29584,1,25248,4336,6,59,H1
"Orange County, CA",2009-2010,2987177,3018080,30903,1.035,22959,7944,6,59,H1
"Orange County, CA",2010-2011,3018080,3056311,38231,1.267,20565,17666,6,59,H1
"Orange County, CA",2011-2012,3056311,3089893,33582,1.099,20021,13561,6,59,H1
"Orange County, CA",2012-2013,3089893,3121854,31961,1.034,19490,12471,6,59,H1
"Orange County, CA",2013-2014,3121854,3145515,23661,0.758,19222,4439,6,59,H1
"Orange County, CA",2014-2015,3144961,3169776,24815,0.789,18296,6519,6,59,H1
"Orange County, CA",2015-2016,3169776,3177703,7927,0.25,16810,-8883,6,59,H1
"Orange County, CA",2016-2017,3177703,3190400,12697,0.4,16485,-3788,6,59,H1
"Placer County, CA",2000-2001,251012,263615,12603,5.021,1116,11487,6,61,H1
"Placer County, CA",2001-2002,263615,276907,13292,5.042,1192,12100,6,61,H1
"Placer County, CA",2002-2003,276907,290726,13819,4.99,1377,12442,6,61,H1
"Placer County, CA",2003-2004,290726,302841,12115,4.167,1441,10674,6,61,H1
"Placer County, CA",2004-2005,302841,312762,9921,3.276,1510,8411,6,61,H1
"Placer County, CA",2005-2006,312762,321934,9172,2.933,1427,7745,6,61,H1
"Placer County, CA",2006-2007,321934,329023,7089,2.202,1549,5540,6,61,H1
"Placer County, CA",2007-2008,329023,337568,8545,2.597,1433,7112,6,61,H1
"Placer County, CA",2008-2009,337568,343810,6242,1.849,1593,4649,6,61,H1
"Placer County, CA",2009-2010,343810,350214,6404,1.863,873,5531,6,61,H1
"Placer County, CA",2010-2011,350214,356897,6683,1.908,1037,5646,6,61,H1
"Placer County, CA",2011-2012,356897,361446,4549,1.275,894,3655,6,61,H1
"Placer County, CA",2012-2013,361446,367339,5893,1.63,821,5072,6,61,H1
"Placer County, CA",2013-2014,367339,371694,4355,1.186,784,3571,6,61,H1
"Placer County, CA",2014-2015,371105,375391,4286,1.155,725,3561,6,61,H1
"Placer County, CA",2015-2016,375391,379742,4351,1.159,497,3854,6,61,H1
"Placer County, CA",2016-2017,379742,386166,6424,1.692,507,5917,6,61,H1
"Plumas County, CA",2000-2001,20754,20820,66,0.318,-41,107,6,63,H1
"Plumas County, CA",2001-2002,20820,20866,46,0.221,-54,100,6,63,H1
"Plumas County, CA",2002-2003,20866,20957,91,0.436,-39,130,6,63,H1
"Plumas County, CA",2003-2004,20957,2.10E+04,43,0.205,-63,106,6,63,H1
"Plumas County, CA",2004-2005,2.10E+04,21010,10,0.048,-58,68,6,63,H1
"Plumas County, CA",2005-2006,21010,20762,-248,-1.18,-23,-225,6,63,H1
"Plumas County, CA",2006-2007,20762,20667,-95,-0.458,-14,-81,6,63,H1
"Plumas County, CA",2007-2008,20667,20410,-257,-1.244,-39,-218,6,63,H1
"Plumas County, CA",2008-2009,20410,20169,-241,-1.181,-35,-206,6,63,H1
"Plumas County, CA",2009-2010,20169,19918,-251,-1.244,-82,-169,6,63,H1
"Plumas County, CA",2010-2011,19918,19690,-228,-1.145,-57,-171,6,63,H1
"Plumas County, CA",2011-2012,19690,19341,-349,-1.772,-48,-301,6,63,H1
"Plumas County, CA",2012-2013,19341,18877,-464,-2.399,-76,-388,6,63,H1
"Plumas County, CA",2013-2014,18877,18606,-271,-1.436,-64,-207,6,63,H1
"Plumas County, CA",2014-2015,18570,18409,-161,-0.867,-57,-104,6,63,H1
"Plumas County, CA",2015-2016,18409,18787,378,2.053,-40,418,6,63,H1
"Plumas County, CA",2016-2017,18787,18742,-45,-0.24,-64,19,6,63,H1
"Riverside County, CA",2000-2001,1558985,1616634,57649,3.698,12555,45094,6,65,H1
"Riverside County, CA",2001-2002,1616634,1687147,70513,4.362,12723,57790,6,65,H1
"Riverside County, CA",2002-2003,1687147,1771656,84509,5.009,14701,69808,6,65,H1
"Riverside County, CA",2003-2004,1771656,1856542,84886,4.791,14909,69977,6,65,H1
"Riverside County, CA",2004-2005,1856542,1931785,75243,4.053,16923,58320,6,65,H1
"Riverside County, CA",2005-2006,1931785,2012370,80585,4.172,18351,62234,6,65,H1
"Riverside County, CA",2006-2007,2012370,2075183,62813,3.121,20543,42270,6,65,H1
"Riverside County, CA",2007-2008,2075183,2109712,34529,1.664,20015,14514,6,65,H1
"Riverside County, CA",2008-2009,2109712,2146725,37013,1.754,19823,17190,6,65,H1
"Riverside County, CA",2009-2010,2146725,2202553,55828,2.601,16629,39199,6,65,H1
"Riverside County, CA",2010-2011,2202553,2237696,35143,1.596,16538,18605,6,65,H1
"Riverside County, CA",2011-2012,2237696,2268019,30323,1.355,15481,14842,6,65,H1
"Riverside County, CA",2012-2013,2268019,2296956,28937,1.276,15121,13816,6,65,H1
"Riverside County, CA",2013-2014,2296956,2329271,32315,1.407,14988,17327,6,65,H1
"Riverside County, CA",2014-2015,2328329,2361026,32697,1.404,14720,17977,6,65,H1
"Riverside County, CA",2015-2016,2361026,2386522,25496,1.08,13459,12037,6,65,H1
"Riverside County, CA",2016-2017,2386522,2423266,36744,1.54,13377,23367,6,65,H1
"Sacramento County, CA",2000-2001,1229940,1266257,36317,2.953,9291,27026,6,67,H1
"Sacramento County, CA",2001-2002,1266257,1301079,34822,2.75,9587,25235,6,67,H1
"Sacramento County, CA",2002-2003,1301079,1328531,27452,2.11,10220,17232,6,67,H1
"Sacramento County, CA",2003-2004,1328531,1348932,20401,1.536,10703,9698,6,67,H1
"Sacramento County, CA",2004-2005,1348932,1360816,11884,0.881,11409,475,6,67,H1
"Sacramento County, CA",2005-2006,1360816,1369563,8747,0.643,11503,-2756,6,67,H1
"Sacramento County, CA",2006-2007,1369563,1381161,11598,0.847,12110,-512,6,67,H1
"Sacramento County, CA",2007-2008,1381161,1394438,13277,0.961,12168,1109,6,67,H1
"Sacramento County, CA",2008-2009,1394438,1408601,14163,1.016,11602,2561,6,67,H1
"Sacramento County, CA",2009-2010,1408601,1421838,13237,0.94,9952,3285,6,67,H1
"Sacramento County, CA",2010-2011,1421838,1435601,13763,0.968,10006,3757,6,67,H1
"Sacramento County, CA",2011-2012,1435601,1448771,13170,0.917,9078,4092,6,67,H1
"Sacramento County, CA",2012-2013,1448771,1463149,14378,0.992,9009,5369,6,67,H1
"Sacramento County, CA",2013-2014,1463149,1482026,18877,1.29,8735,10142,6,67,H1
"Sacramento County, CA",2014-2015,1481474,1501335,19861,1.341,8593,11268,6,67,H1
"Sacramento County, CA",2015-2016,1501335,1513260,11925,0.794,7422,4503,6,67,H1
"Sacramento County, CA",2016-2017,1513260,1530615,17355,1.147,7542,9813,6,67,H1
"San Benito County, CA",2000-2001,53781,54644,863,1.605,630,233,6,69,H1
"San Benito County, CA",2001-2002,54644,55056,412,0.754,707,-295,6,69,H1
"San Benito County, CA",2002-2003,55056,55198,142,0.258,635,-493,6,69,H1
"San Benito County, CA",2003-2004,55198,54849,-349,-0.632,594,-943,6,69,H1
"San Benito County, CA",2004-2005,54849,54647,-202,-0.368,645,-847,6,69,H1
"San Benito County, CA",2005-2006,54647,54124,-523,-0.957,650,-1173,6,69,H1
"San Benito County, CA",2006-2007,54124,54072,-52,-0.096,649,-701,6,69,H1
"San Benito County, CA",2007-2008,54072,54267,195,0.361,580,-385,6,69,H1
"San Benito County, CA",2008-2009,54267,54436,169,0.311,568,-399,6,69,H1
"San Benito County, CA",2009-2010,54436,55532,1096,2.013,525,571,6,69,H1
"San Benito County, CA",2010-2011,55532,56174,642,1.156,493,149,6,69,H1
"San Benito County, CA",2011-2012,56174,56871,697,1.241,439,258,6,69,H1
"San Benito County, CA",2012-2013,56871,57594,723,1.271,420,303,6,69,H1
"San Benito County, CA",2013-2014,57594,58267,673,1.169,426,247,6,69,H1
"San Benito County, CA",2014-2015,58308,58792,484,0.83,466,18,6,69,H1
"San Benito County, CA",2015-2016,58792,59335,543,0.924,379,164,6,69,H1
"San Benito County, CA",2016-2017,59335,60310,975,1.643,395,580,6,69,H1
"San Bernardino County, CA",2000-2001,1718037,1760731,42694,2.485,17515,25179,6,71,H1
"San Bernardino County, CA",2001-2002,1760731,1799791,39060,2.218,17770,21290,6,71,H1
"San Bernardino County, CA",2002-2003,1799791,1846115,46324,2.574,18774,27550,6,71,H1
"San Bernardino County, CA",2003-2004,1846115,1899065,52950,2.868,18808,34142,6,71,H1
"San Bernardino County, CA",2004-2005,1899065,1943924,44859,2.362,20683,24176,6,71,H1
"San Bernardino County, CA",2005-2006,1943924,1974140,30216,1.554,21280,8936,6,71,H1
"San Bernardino County, CA",2006-2007,1974140,1992161,18021,0.913,22955,-4934,6,71,H1
"San Bernardino County, CA",2007-2008,1992161,2003735,11574,0.581,22627,-11053,6,71,H1
"San Bernardino County, CA",2008-2009,2003735,2013960,10225,0.51,22413,-12188,6,71,H1
"San Bernardino County, CA",2009-2010,2013960,2041689,27729,1.377,19025,8704,6,71,H1
"San Bernardino County, CA",2010-2011,2041689,2064663,22974,1.125,19230,3744,6,71,H1
"San Bernardino County, CA",2011-2012,2064663,2080651,15988,0.774,18056,-2068,6,71,H1
"San Bernardino County, CA",2012-2013,2080651,2093306,12655,0.608,17581,-4926,6,71,H1
"San Bernardino County, CA",2013-2014,2093306,2112619,19313,0.923,17247,2066,6,71,H1
"San Bernardino County, CA",2014-2015,2110386,2128133,17747,0.841,17048,699,6,71,H1
"San Bernardino County, CA",2015-2016,2128133,2137131,8998,0.423,15851,-6853,6,71,H1
"San Bernardino County, CA",2016-2017,2137131,2157404,20273,0.949,15706,4567,6,71,H1
"San Diego County, CA",2000-2001,2827366,2869672,42306,1.496,24209,18097,6,73,H1
"San Diego County, CA",2001-2002,2869672,2900355,30683,1.069,24174,6509,6,73,H1
"San Diego County, CA",2002-2003,2900355,2914702,14347,0.495,25506,-11159,6,73,H1
"San Diego County, CA",2003-2004,2914702,2930007,15305,0.525,24755,-9450,6,73,H1
"San Diego County, CA",2004-2005,2930007,2938375,8368,0.286,26969,-18601,6,73,H1
"San Diego County, CA",2005-2006,2938375,2947289,8914,0.303,26467,-17553,6,73,H1
"San Diego County, CA",2006-2007,2947289,2975742,28453,0.965,28254,199,6,73,H1
"San Diego County, CA",2007-2008,2975742,3022116,46374,1.558,28299,18075,6,73,H1
"San Diego County, CA",2008-2009,3022116,3061203,39087,1.293,27156,11931,6,73,H1
"San Diego County, CA",2009-2010,3061203,3104543,43340,1.416,24969,18371,6,73,H1
"San Diego County, CA",2010-2011,3104543,3141768,37225,1.199,25011,12214,6,73,H1
"San Diego County, CA",2011-2012,3141768,3183413,41645,1.326,23953,17692,6,73,H1
"San Diego County, CA",2012-2013,3183413,3222558,39145,1.23,23539,15606,6,73,H1
"San Diego County, CA",2013-2014,3222558,3263431,40873,1.268,23732,17141,6,73,H1
"San Diego County, CA",2014-2015,3265700,3299521,33821,1.036,22981,10840,6,73,H1
"San Diego County, CA",2015-2016,3299521,3317200,17679,0.536,21459,-3780,6,73,H1
"San Diego County, CA",2016-2017,3317200,3337685,20485,0.618,20937,-452,6,73,H1
"San Francisco County, CA",2000-2001,777885,780865,2980,0.383,1996,984,6,75,H6
"San Francisco County, CA",2001-2002,780865,772723,-8142,-1.043,1773,-9915,6,75,H6
"San Francisco County, CA",2002-2003,772723,766160,-6563,-0.849,2463,-9026,6,75,H6
"San Francisco County, CA",2003-2004,766160,761325,-4835,-0.631,2390,-7225,6,75,H6
"San Francisco County, CA",2004-2005,761325,763016,1691,0.222,2700,-1009,6,75,H6
"San Francisco County, CA",2005-2006,763016,768650,5634,0.738,2484,3150,6,75,H6
"San Francisco County, CA",2006-2007,768650,778673,10023,1.304,3170,6853,6,75,H6
"San Francisco County, CA",2007-2008,778673,791152,12479,1.603,2985,9494,6,75,H6
"San Francisco County, CA",2008-2009,791152,801922,10770,1.361,2377,8393,6,75,H6
"San Francisco County, CA",2009-2010,801922,805825,3903,0.487,2436,1467,6,75,H6
"San Francisco County, CA",2010-2011,805825,816239,10414,1.292,3143,7271,6,75,H6
"San Francisco County, CA",2011-2012,816239,829691,13452,1.648,3222,10230,6,75,H6
"San Francisco County, CA",2012-2013,829691,841138,11447,1.38,3291,8156,6,75,H6
"San Francisco County, CA",2013-2014,841138,852469,11331,1.347,3142,8189,6,75,H6
"San Francisco County, CA",2014-2015,852537,864816,12279,1.44,2980,9299,6,75,H6
"San Francisco County, CA",2015-2016,864816,876103,11287,1.305,2798,8489,6,75,H6
"San Francisco County, CA",2016-2017,876103,884363,8260,0.943,2733,5527,6,75,H6
"San Joaquin County, CA",2000-2001,567885,591207,23322,4.107,5409,17913,6,77,H1
"San Joaquin County, CA",2001-2002,591207,609041,17834,3.017,5609,12225,6,77,H1
"San Joaquin County, CA",2002-2003,609041,626778,17737,2.912,5517,12220,6,77,H1
"San Joaquin County, CA",2003-2004,626778,642898,16120,2.572,6212,9908,6,77,H1
"San Joaquin County, CA",2004-2005,642898,656985,14087,2.191,6586,7501,6,77,H1
"San Joaquin County, CA",2005-2006,656985,662812,5827,0.887,6894,-1067,6,77,H1
"San Joaquin County, CA",2006-2007,662812,668080,5268,0.795,7313,-2045,6,77,H1
"San Joaquin County, CA",2007-2008,668080,671692,3612,0.541,6758,-3146,6,77,H1
"San Joaquin County, CA",2008-2009,671692,677736,6044,0.9,6638,-594,6,77,H1
"San Joaquin County, CA",2009-2010,677736,687513,9777,1.443,5835,3942,6,77,H1
"San Joaquin County, CA",2010-2011,687513,695479,7966,1.159,5795,2171,6,77,H1
"San Joaquin County, CA",2011-2012,695479,701635,6156,0.885,5110,1046,6,77,H1
"San Joaquin County, CA",2012-2013,701635,705027,3392,0.483,5147,-1755,6,77,H1
"San Joaquin County, CA",2013-2014,705027,715597,10570,1.499,5004,5566,6,77,H1
"San Joaquin County, CA",2014-2015,715114,726106,10992,1.537,4873,6119,6,77,H1
"San Joaquin County, CA",2015-2016,726106,734294,8188,1.128,4535,3653,6,77,H1
"San Joaquin County, CA",2016-2017,734294,745424,11130,1.516,4610,6520,6,77,H1
"San Luis Obispo County, CA",2000-2001,247839,251462,3623,1.462,368,3255,6,79,H1
"San Luis Obispo County, CA",2001-2002,251462,253083,1621,0.645,321,1300,6,79,H1
"San Luis Obispo County, CA",2002-2003,253083,254674,1591,0.629,518,1073,6,79,H1
"San Luis Obispo County, CA",2003-2004,254674,256842,2168,0.851,575,1593,6,79,H1
"San Luis Obispo County, CA",2004-2005,256842,258615,1773,0.69,734,1039,6,79,H1
"San Luis Obispo County, CA",2005-2006,258615,260498,1883,0.728,544,1339,6,79,H1
"San Luis Obispo County, CA",2006-2007,260498,262770,2272,0.872,745,1527,6,79,H1
"San Luis Obispo County, CA",2007-2008,262770,266358,3588,1.365,694,2894,6,79,H1
"San Luis Obispo County, CA",2008-2009,266358,268145,1787,0.671,806,981,6,79,H1
"San Luis Obispo County, CA",2009-2010,268145,269860,1715,0.64,538,1177,6,79,H1
"San Luis Obispo County, CA",2010-2011,269860,271165,1305,0.484,392,913,6,79,H1
"San Luis Obispo County, CA",2011-2012,271165,274528,3363,1.24,362,3001,6,79,H1
"San Luis Obispo County, CA",2012-2013,274528,276284,1756,0.64,376,1380,6,79,H1
"San Luis Obispo County, CA",2013-2014,276284,279083,2799,1.013,411,2388,6,79,H1
"San Luis Obispo County, CA",2014-2015,279116,281401,2285,0.819,485,1800,6,79,H1
"San Luis Obispo County, CA",2015-2016,281401,282282,881,0.313,308,573,6,79,H1
"San Luis Obispo County, CA",2016-2017,282282,283405,1123,0.398,285,838,6,79,H1
"San Mateo County, CA",2000-2001,707820,705621,-2199,-0.311,5569,-7768,6,81,H1
"San Mateo County, CA",2001-2002,705621,697628,-7993,-1.133,5584,-13577,6,81,H1
"San Mateo County, CA",2002-2003,697628,693057,-4571,-0.655,5436,-10007,6,81,H1
"San Mateo County, CA",2003-2004,693057,690161,-2896,-0.418,5332,-8228,6,81,H1
"San Mateo County, CA",2004-2005,690161,690078,-83,-0.012,5358,-5441,6,81,H1
"San Mateo County, CA",2005-2006,690078,690176,98,0.014,5237,-5139,6,81,H1
"San Mateo County, CA",2006-2007,690176,693849,3673,0.532,5328,-1655,6,81,H1
"San Mateo County, CA",2007-2008,693849,703830,9981,1.438,5310,4671,6,81,H1
"San Mateo County, CA",2008-2009,703830,713617,9787,1.391,4999,4788,6,81,H1
"San Mateo County, CA",2009-2010,713617,719951,6334,0.888,4971,1363,6,81,H1
"San Mateo County, CA",2010-2011,719951,729425,9474,1.316,4576,4898,6,81,H1
"San Mateo County, CA",2011-2012,729425,740738,11313,1.551,4345,6968,6,81,H1
"San Mateo County, CA",2012-2013,740738,750489,9751,1.316,4407,5344,6,81,H1
"San Mateo County, CA",2013-2014,750489,758581,8092,1.078,4369,3723,6,81,H1
"San Mateo County, CA",2014-2015,758333,765135,6802,0.897,4058,2744,6,81,H1
"San Mateo County, CA",2015-2016,765135,769561,4426,0.578,3865,561,6,81,H1
"San Mateo County, CA",2016-2017,769561,771410,1849,0.24,3840,-1991,6,81,H1
"Santa Barbara County, CA",2000-2001,399990,403164,3174,0.794,2825,349,6,83,H1
"Santa Barbara County, CA",2001-2002,403164,405178,2014,0.5,2663,-649,6,83,H1
"Santa Barbara County, CA",2002-2003,405178,406810,1632,0.403,2859,-1227,6,83,H1
"Santa Barbara County, CA",2003-2004,406810,407284,474,0.117,3047,-2573,6,83,H1
"Santa Barbara County, CA",2004-2005,407284,408079,795,0.195,3358,-2563,6,83,H1
"Santa Barbara County, CA",2005-2006,408079,408085,6,0.001,3318,-3312,6,83,H1
"Santa Barbara County, CA",2006-2007,408085,411243,3158,0.774,3515,-357,6,83,H1
"Santa Barbara County, CA",2007-2008,411243,415859,4616,1.122,3496,1120,6,83,H1
"Santa Barbara County, CA",2008-2009,415859,420356,4497,1.081,3369,1128,6,83,H1
"Santa Barbara County, CA",2009-2010,420356,424331,3975,0.946,3070,905,6,83,H1
"Santa Barbara County, CA",2010-2011,424331,425974,1643,0.387,2875,-1232,6,83,H1
"Santa Barbara County, CA",2011-2012,425974,430728,4754,1.116,2777,1977,6,83,H1
"Santa Barbara County, CA",2012-2013,430728,436076,5348,1.242,2671,2677,6,83,H1
"Santa Barbara County, CA",2013-2014,436076,440668,4592,1.053,2623,1969,6,83,H1
"Santa Barbara County, CA",2014-2015,441228,444769,3541,0.803,2838,703,6,83,H1
"Santa Barbara County, CA",2015-2016,444769,446296,1527,0.343,2490,-963,6,83,H1
"Santa Barbara County, CA",2016-2017,446296,448150,1854,0.415,2480,-626,6,83,H1
"Santa Clara County, CA",2000-2001,1684947,1688082,3135,0.186,18791,-15656,6,85,H1
"Santa Clara County, CA",2001-2002,1688082,1669348,-18734,-1.11,18278,-37012,6,85,H1
"Santa Clara County, CA",2002-2003,1669348,1663592,-5756,-0.345,18439,-24195,6,85,H1
"Santa Clara County, CA",2003-2004,1663592,1663167,-425,-0.026,18301,-18726,6,85,H1
"Santa Clara County, CA",2004-2005,1663167,1675312,12145,0.73,17780,-5635,6,85,H1
"Santa Clara County, CA",2005-2006,1675312,1691159,15847,0.946,17726,-1879,6,85,H1
"Santa Clara County, CA",2006-2007,1691159,1712026,20867,1.234,18512,2355,6,85,H1
"Santa Clara County, CA",2007-2008,1712026,1740964,28938,1.69,18389,10549,6,85,H1
"Santa Clara County, CA",2008-2009,1740964,1765137,24173,1.388,17745,6428,6,85,H1
"Santa Clara County, CA",2009-2010,1765137,1786930,21793,1.235,16605,5188,6,85,H1
"Santa Clara County, CA",2010-2011,1786930,1814105,27175,1.521,14862,12313,6,85,H1
"Santa Clara County, CA",2011-2012,1814105,1841098,26993,1.488,14093,12900,6,85,H1
"Santa Clara County, CA",2012-2013,1841098,1871107,30009,1.63,14729,15280,6,85,H1
"Santa Clara County, CA",2013-2014,1871107,1894605,23498,1.256,14114,9384,6,85,H1
"Santa Clara County, CA",2014-2015,1896040,1918044,22004,1.161,13155,8849,6,85,H1
"Santa Clara County, CA",2015-2016,1918044,1931575,13531,0.705,12393,1138,6,85,H1
"Santa Clara County, CA",2016-2017,1931575,1938153,6578,0.341,12071,-5493,6,85,H1
"Santa Cruz County, CA",2000-2001,255835,256045,210,0.082,1813,-1603,6,87,H1
"Santa Cruz County, CA",2001-2002,256045,254531,-1514,-0.591,1782,-3296,6,87,H1
"Santa Cruz County, CA",2002-2003,254531,253021,-1510,-0.593,1600,-3110,6,87,H1
"Santa Cruz County, CA",2003-2004,253021,252356,-665,-0.263,1811,-2476,6,87,H1
"Santa Cruz County, CA",2004-2005,252356,251377,-979,-0.388,1847,-2826,6,87,H1
"Santa Cruz County, CA",2005-2006,251377,251616,239,0.095,1895,-1656,6,87,H1
"Santa Cruz County, CA",2006-2007,251616,253304,1688,0.671,2116,-428,6,87,H1
"Santa Cruz County, CA",2007-2008,253304,256520,3216,1.27,1953,1263,6,87,H1
"Santa Cruz County, CA",2008-2009,256520,260009,3489,1.36,1837,1652,6,87,H1
"Santa Cruz County, CA",2009-2010,260009,263213,3204,1.232,1708,1496,6,87,H1
"Santa Cruz County, CA",2010-2011,263213,264923,1710,0.65,1537,173,6,87,H1
"Santa Cruz County, CA",2011-2012,264923,266632,1709,0.645,1475,234,6,87,H1
"Santa Cruz County, CA",2012-2013,266632,269444,2812,1.055,1319,1493,6,87,H1
"Santa Cruz County, CA",2013-2014,269444,271804,2360,0.876,1301,1059,6,87,H1
"Santa Cruz County, CA",2014-2015,271401,274146,2745,1.011,1098,1647,6,87,H1
"Santa Cruz County, CA",2015-2016,274146,275196,1050,0.383,951,99,6,87,H1
"Santa Cruz County, CA",2016-2017,275196,275897,701,0.255,885,-184,6,87,H1
"Shasta County, CA",2000-2001,163615,166408,2793,1.707,99,2694,6,89,H1
"Shasta County, CA",2001-2002,166408,170198,3790,2.278,154,3636,6,89,H1
"Shasta County, CA",2002-2003,170198,173202,3004,1.765,120,2884,6,89,H1
"Shasta County, CA",2003-2004,173202,174867,1665,0.961,247,1418,6,89,H1
"Shasta County, CA",2004-2005,174867,175615,748,0.428,168,580,6,89,H1
"Shasta County, CA",2005-2006,175615,176166,551,0.314,179,372,6,89,H1
"Shasta County, CA",2006-2007,176166,176548,382,0.217,245,137,6,89,H1
"Shasta County, CA",2007-2008,176548,177247,699,0.396,325,374,6,89,H1
"Shasta County, CA",2008-2009,177247,177279,32,0.018,455,-423,6,89,H1
"Shasta County, CA",2009-2010,177279,177286,7,0.004,134,-127,6,89,H1
"Shasta County, CA",2010-2011,177286,177950,664,0.375,30,634,6,89,H1
"Shasta County, CA",2011-2012,177950,178421,471,0.265,-9,480,6,89,H1
"Shasta County, CA",2012-2013,178421,179137,716,0.401,56,660,6,89,H1
"Shasta County, CA",2013-2014,179137,179804,667,0.372,49,618,6,89,H1
"Shasta County, CA",2014-2015,179747,179533,-214,-0.119,77,-291,6,89,H1
"Shasta County, CA",2015-2016,179533,178774,-759,-0.423,-93,-666,6,89,H1
"Shasta County, CA",2016-2017,178774,179921,1147,0.642,-102,1249,6,89,H1
"Sierra County, CA",2000-2001,3574,3518,-56,-1.567,-21,-35,6,91,H1
"Sierra County, CA",2001-2002,3518,3482,-36,-1.023,-18,-18,6,91,H1
"Sierra County, CA",2002-2003,3482,3511,29,0.833,-18,47,6,91,H1
"Sierra County, CA",2003-2004,3511,3430,-81,-2.307,-10,-71,6,91,H1
"Sierra County, CA",2004-2005,3430,3378,-52,-1.516,-13,-39,6,91,H1
"Sierra County, CA",2005-2006,3378,3424,46,1.362,-2,48,6,91,H1
"Sierra County, CA",2006-2007,3424,3373,-51,-1.489,-17,-34,6,91,H1
"Sierra County, CA",2007-2008,3373,3320,-53,-1.571,-8,-45,6,91,H1
"Sierra County, CA",2008-2009,3320,3248,-72,-2.169,1,-73,6,91,H1
"Sierra County, CA",2009-2010,3248,3221,-27,-0.831,-8,-19,6,91,H1
"Sierra County, CA",2010-2011,3221,3104,-117,-3.632,-18,-99,6,91,H1
"Sierra County, CA",2011-2012,3104,3076,-28,-0.902,-10,-18,6,91,H1
"Sierra County, CA",2012-2013,3076,3040,-36,-1.17,-19,-17,6,91,H1
"Sierra County, CA",2013-2014,3040,3003,-37,-1.217,-18,-19,6,91,H1
"Sierra County, CA",2014-2015,2979,2967,-12,-0.403,-29,17,6,91,H1
"Sierra County, CA",2015-2016,2967,2964,-3,-0.101,3,-6,6,91,H1
"Sierra County, CA",2016-2017,2964,2999,35,1.181,-13,48,6,91,H1
"Siskiyou County, CA",2000-2001,44218,43908,-310,-0.701,-64,-246,6,93,H1
"Siskiyou County, CA",2001-2002,43908,43965,57,0.13,-101,158,6,93,H1
"Siskiyou County, CA",2002-2003,43965,44287,322,0.732,-91,413,6,93,H1
"Siskiyou County, CA",2003-2004,44287,44394,107,0.242,-60,167,6,93,H1
"Siskiyou County, CA",2004-2005,44394,44641,247,0.556,-12,259,6,93,H1
"Siskiyou County, CA",2005-2006,44641,44487,-154,-0.345,-75,-79,6,93,H1
"Siskiyou County, CA",2006-2007,44487,44465,-22,-0.049,29,-51,6,93,H1
"Siskiyou County, CA",2007-2008,44465,44780,315,0.708,-37,352,6,93,H1
"Siskiyou County, CA",2008-2009,44780,44788,8,0.018,25,-17,6,93,H1
"Siskiyou County, CA",2009-2010,44788,44971,183,0.409,-48,231,6,93,H1
"Siskiyou County, CA",2010-2011,44971,44719,-252,-0.56,-83,-169,6,93,H1
"Siskiyou County, CA",2011-2012,44719,44214,-505,-1.129,-38,-467,6,93,H1
"Siskiyou County, CA",2012-2013,44214,43773,-441,-0.997,-40,-401,6,93,H1
"Siskiyou County, CA",2013-2014,43773,43628,-145,-0.331,-57,-88,6,93,H1
"Siskiyou County, CA",2014-2015,43465,43554,89,0.205,-79,168,6,93,H1
"Siskiyou County, CA",2015-2016,43554,43511,-43,-0.099,-121,78,6,93,H1
"Siskiyou County, CA",2016-2017,43511,43853,342,0.786,-95,437,6,93,H1
"Solano County, CA",2000-2001,396974,404209,7235,1.823,3308,3927,6,95,H1
"Solano County, CA",2001-2002,404209,408226,4017,0.994,3274,743,6,95,H1
"Solano County, CA",2002-2003,408226,408409,183,0.045,3150,-2967,6,95,H1
"Solano County, CA",2003-2004,408409,409301,892,0.218,3063,-2171,6,95,H1
"Solano County, CA",2004-2005,409301,408181,-1120,-0.274,2924,-4044,6,95,H1
"Solano County, CA",2005-2006,408181,408402,221,0.054,3067,-2846,6,95,H1
"Solano County, CA",2006-2007,408402,408243,-159,-0.039,3191,-3350,6,95,H1
"Solano County, CA",2007-2008,408243,408972,729,0.179,2954,-2225,6,95,H1
"Solano County, CA",2008-2009,408972,410290,1318,0.322,2827,-1509,6,95,H1
"Solano County, CA",2009-2010,410290,414101,3811,0.929,2490,1321,6,95,H1
"Solano County, CA",2010-2011,414101,416945,2844,0.687,2304,540,6,95,H1
"Solano County, CA",2011-2012,416945,420724,3779,0.906,2149,1630,6,95,H1
"Solano County, CA",2012-2013,420724,425219,4495,1.068,2010,2485,6,95,H1
"Solano County, CA",2013-2014,425219,431131,5912,1.39,1976,3936,6,95,H1
"Solano County, CA",2014-2015,430791,436092,5301,1.231,2180,3121,6,95,H1
"Solano County, CA",2015-2016,436092,440318,4226,0.969,1602,2624,6,95,H1
"Solano County, CA",2016-2017,440318,445458,5140,1.167,1649,3491,6,95,H1
"Sonoma County, CA",2000-2001,460421,465293,4872,1.058,1716,3156,6,97,H1
"Sonoma County, CA",2001-2002,465293,465298,5,0.001,1782,-1777,6,97,H1
"Sonoma County, CA",2002-2003,465298,466489,1191,0.256,1997,-806,6,97,H1
"Sonoma County, CA",2003-2004,466489,466809,320,0.069,2036,-1716,6,97,H1
"Sonoma County, CA",2004-2005,466809,465938,-871,-0.187,2101,-2972,6,97,H1
"Sonoma County, CA",2005-2006,465938,465188,-750,-0.161,1984,-2734,6,97,H1
"Sonoma County, CA",2006-2007,465188,467356,2168,0.466,2163,5,6,97,H1
"Sonoma County, CA",2007-2008,467356,473091,5735,1.227,2125,3610,6,97,H1
"Sonoma County, CA",2008-2009,473091,479479,6388,1.35,2127,4261,6,97,H1
"Sonoma County, CA",2009-2010,479479,484666,5187,1.082,1750,3437,6,97,H1
"Sonoma County, CA",2010-2011,484666,487722,3056,0.631,1441,1615,6,97,H1
"Sonoma County, CA",2011-2012,487722,490838,3116,0.639,1193,1923,6,97,H1
"Sonoma County, CA",2012-2013,490838,495432,4594,0.936,1188,3406,6,97,H1
"Sonoma County, CA",2013-2014,495432,500292,4860,0.981,1081,3779,6,97,H1
"Sonoma County, CA",2014-2015,499674,502146,2472,0.495,942,1530,6,97,H1
"Sonoma County, CA",2015-2016,502146,503833,1687,0.336,707,980,6,97,H1
"Sonoma County, CA",2016-2017,503833,504217,384,0.076,594,-210,6,97,H1
"Stanislaus County, CA",2000-2001,449471,463761,14290,3.179,3820,10470,6,99,H1
"Stanislaus County, CA",2001-2002,463761,477469,13708,2.956,4119,9589,6,99,H1
"Stanislaus County, CA",2002-2003,477469,487357,9888,2.071,4348,5540,6,99,H1
"Stanislaus County, CA",2003-2004,487357,492613,5256,1.078,4258,998,6,99,H1
"Stanislaus County, CA",2004-2005,492613,500020,7407,1.504,4827,2580,6,99,H1
"Stanislaus County, CA",2005-2006,500020,504651,4631,0.926,4713,-82,6,99,H1
"Stanislaus County, CA",2006-2007,504651,507834,3183,0.631,5262,-2079,6,99,H1
"Stanislaus County, CA",2007-2008,507834,509032,1198,0.236,5074,-3876,6,99,H1
"Stanislaus County, CA",2008-2009,509032,511536,2504,0.492,4872,-2368,6,99,H1
"Stanislaus County, CA",2009-2010,511536,515283,3747,0.732,4054,-307,6,99,H1
"Stanislaus County, CA",2010-2011,515283,518270,2987,0.58,4111,-1124,6,99,H1
"Stanislaus County, CA",2011-2012,518270,522134,3864,0.746,3889,-25,6,99,H1
"Stanislaus County, CA",2012-2013,522134,526286,4152,0.795,3752,400,6,99,H1
"Stanislaus County, CA",2013-2014,526286,531997,5711,1.085,3803,1908,6,99,H1
"Stanislaus County, CA",2014-2015,531951,538388,6437,1.21,3910,2527,6,99,H1
"Stanislaus County, CA",2015-2016,538388,541353,2965,0.551,3476,-511,6,99,H1
"Stanislaus County, CA",2016-2017,541353,547899,6546,1.209,3753,2793,6,99,H1
"Sutter County, CA",2000-2001,79192,80138,946,1.195,457,489,6,101,H1
"Sutter County, CA",2001-2002,80138,82162,2024,2.526,560,1464,6,101,H1
"Sutter County, CA",2002-2003,82162,84671,2509,3.054,625,1884,6,101,H1
"Sutter County, CA",2003-2004,84671,86484,1813,2.141,599,1214,6,101,H1
"Sutter County, CA",2004-2005,86484,88764,2280,2.636,749,1531,6,101,H1
"Sutter County, CA",2005-2006,88764,91112,2348,2.645,766,1582,6,101,H1
"Sutter County, CA",2006-2007,91112,92959,1847,2.027,916,931,6,101,H1
"Sutter County, CA",2007-2008,92959,93855,896,0.964,784,112,6,101,H1
"Sutter County, CA",2008-2009,93855,94366,511,0.544,778,-267,6,101,H1
"Sutter County, CA",2009-2010,94366,94814,448,0.475,610,-162,6,101,H1
"Sutter County, CA",2010-2011,94814,94750,-64,-0.068,604,-668,6,101,H1
"Sutter County, CA",2011-2012,94750,94637,-113,-0.119,587,-700,6,101,H1
"Sutter County, CA",2012-2013,94637,95287,650,0.687,480,170,6,101,H1
"Sutter County, CA",2013-2014,95287,95847,560,0.588,531,29,6,101,H1
"Sutter County, CA",2014-2015,95604,96463,859,0.898,558,301,6,101,H1
"Sutter County, CA",2015-2016,96463,96058,-405,-0.42,497,-902,6,101,H1
"Sutter County, CA",2016-2017,96058,96648,590,0.614,471,119,6,101,H1
"Tehama County, CA",2000-2001,56170,56685,515,0.917,26,489,6,103,H1
"Tehama County, CA",2001-2002,56685,57380,695,1.226,93,602,6,103,H1
"Tehama County, CA",2002-2003,57380,58528,1148,2.001,97,1051,6,103,H1
"Tehama County, CA",2003-2004,58528,59571,1043,1.782,129,914,6,103,H1
"Tehama County, CA",2004-2005,59571,60602,1031,1.731,189,842,6,103,H1
"Tehama County, CA",2005-2006,60602,61587,985,1.625,254,731,6,103,H1
"Tehama County, CA",2006-2007,61587,62147,560,0.909,192,368,6,103,H1
"Tehama County, CA",2007-2008,62147,62648,501,0.806,234,267,6,103,H1
"Tehama County, CA",2008-2009,62648,62891,243,0.388,276,-33,6,103,H1
"Tehama County, CA",2009-2010,62891,63638,747,1.188,186,561,6,103,H1
"Tehama County, CA",2010-2011,63638,63321,-317,-0.498,135,-452,6,103,H1
"Tehama County, CA",2011-2012,63321,63263,-58,-0.092,161,-219,6,103,H1
"Tehama County, CA",2012-2013,63263,63130,-133,-0.21,200,-333,6,103,H1
"Tehama County, CA",2013-2014,63130,63067,-63,-0.1,181,-244,6,103,H1
"Tehama County, CA",2014-2015,62961,63308,347,0.551,157,190,6,103,H1
"Tehama County, CA",2015-2016,63308,63444,136,0.215,193,-57,6,103,H1
"Tehama County, CA",2016-2017,63444,63926,482,0.76,200,282,6,103,H1
"Trinity County, CA",2000-2001,12980,12859,-121,-0.932,-40,-81,6,105,H1
"Trinity County, CA",2001-2002,12859,13064,205,1.594,-46,251,6,105,H1
"Trinity County, CA",2002-2003,13064,13210,146,1.118,-29,175,6,105,H1
"Trinity County, CA",2003-2004,13210,13159,-51,-0.386,-49,-2,6,105,H1
"Trinity County, CA",2004-2005,13159,13440,281,2.135,-28,309,6,105,H1
"Trinity County, CA",2005-2006,13440,13634,194,1.443,-29,223,6,105,H1
"Trinity County, CA",2006-2007,13634,13648,14,0.103,-32,46,6,105,H1
"Trinity County, CA",2007-2008,13648,13656,8,0.059,-50,58,6,105,H1
"Trinity County, CA",2008-2009,13656,13762,106,0.776,-50,156,6,105,H1
"Trinity County, CA",2009-2010,13762,13755,-7,-0.051,-91,84,6,105,H1
"Trinity County, CA",2010-2011,13755,13712,-43,-0.313,-49,6,6,105,H1
"Trinity County, CA",2011-2012,13712,13495,-217,-1.583,-32,-185,6,105,H1
"Trinity County, CA",2012-2013,13495,13444,-51,-0.378,-22,-29,6,105,H1
"Trinity County, CA",2013-2014,13444,13170,-274,-2.038,-36,-238,6,105,H1
"Trinity County, CA",2014-2015,13128,13069,-59,-0.449,-62,3,6,105,H1
"Trinity County, CA",2015-2016,13069,12839,-230,-1.76,-67,-163,6,105,H1
"Trinity County, CA",2016-2017,12839,12709,-130,-1.013,-65,-65,6,105,H1
"Tulare County, CA",2000-2001,368627,373171,4544,1.233,4589,-45,6,107,H1
"Tulare County, CA",2001-2002,373171,379568,6397,1.714,4605,1792,6,107,H1
"Tulare County, CA",2002-2003,379568,388743,9175,2.417,4867,4308,6,107,H1
"Tulare County, CA",2003-2004,388743,398226,9483,2.439,5075,4408,6,107,H1
"Tulare County, CA",2004-2005,398226,407970,9744,2.447,5508,4236,6,107,H1
"Tulare County, CA",2005-2006,407970,414921,6951,1.704,5327,1624,6,107,H1
"Tulare County, CA",2006-2007,414921,422140,7219,1.74,5751,1468,6,107,H1
"Tulare County, CA",2007-2008,422140,429283,7143,1.692,5820,1323,6,107,H1
"Tulare County, CA",2008-2009,429283,436987,7704,1.795,6041,1663,6,107,H1
"Tulare County, CA",2009-2010,436987,443292,6305,1.443,5495,810,6,107,H1
"Tulare County, CA",2010-2011,443292,447824,4532,1.022,5332,-800,6,107,H1
"Tulare County, CA",2011-2012,447824,451499,3675,0.821,5228,-1553,6,107,H1
"Tulare County, CA",2012-2013,451499,454725,3226,0.715,5106,-1880,6,107,H1
"Tulare County, CA",2013-2014,454725,458198,3473,0.764,5157,-1684,6,107,H1
"Tulare County, CA",2014-2015,457260,459863,2603,0.569,4843,-2240,6,107,H1
"Tulare County, CA",2015-2016,459863,460835,972,0.211,4398,-3426,6,107,H1
"Tulare County, CA",2016-2017,460835,464493,3658,0.794,4309,-651,6,107,H1
"Tuolumne County, CA",2000-2001,54658,55253,595,1.089,-159,754,6,109,H1
"Tuolumne County, CA",2001-2002,55253,55850,597,1.08,-186,783,6,109,H1
"Tuolumne County, CA",2002-2003,55850,56513,663,1.187,-136,799,6,109,H1
"Tuolumne County, CA",2003-2004,56513,56602,89,0.157,-161,250,6,109,H1
"Tuolumne County, CA",2004-2005,56602,56788,186,0.329,-98,284,6,109,H1
"Tuolumne County, CA",2005-2006,56788,56680,-108,-0.19,-115,7,6,109,H1
"Tuolumne County, CA",2006-2007,56680,56339,-341,-0.602,-118,-223,6,109,H1
"Tuolumne County, CA",2007-2008,56339,56320,-19,-0.034,-105,86,6,109,H1
"Tuolumne County, CA",2008-2009,56320,55845,-475,-0.843,-102,-373,6,109,H1
"Tuolumne County, CA",2009-2010,55845,55168,-677,-1.212,-181,-496,6,109,H1
"Tuolumne County, CA",2010-2011,55168,54724,-444,-0.805,-170,-274,6,109,H1
"Tuolumne County, CA",2011-2012,54724,54100,-624,-1.14,-169,-455,6,109,H1
"Tuolumne County, CA",2012-2013,54100,53911,-189,-0.349,-105,-84,6,109,H1
"Tuolumne County, CA",2013-2014,53911,53831,-80,-0.148,-90,10,6,109,H1
"Tuolumne County, CA",2014-2015,53872,53709,-163,-0.303,-64,-99,6,109,H1
"Tuolumne County, CA",2015-2016,53709,53787,78,0.145,-219,297,6,109,H1
"Tuolumne County, CA",2016-2017,53787,54248,461,0.857,-66,527,6,109,H1
"Ventura County, CA",2000-2001,756506,766689,10183,1.346,6844,3339,6,111,H1
"Ventura County, CA",2001-2002,766689,779489,12800,1.67,6658,6142,6,111,H1
"Ventura County, CA",2002-2003,779489,788070,8581,1.101,7042,1539,6,111,H1
"Ventura County, CA",2003-2004,788070,793994,5924,0.752,6750,-826,6,111,H1
"Ventura County, CA",2004-2005,793994,794197,203,0.026,7429,-7226,6,111,H1
"Ventura County, CA",2005-2006,794197,798183,3986,0.502,7398,-3412,6,111,H1
"Ventura County, CA",2006-2007,798183,800027,1844,0.231,7569,-5725,6,111,H1
"Ventura County, CA",2007-2008,800027,806353,6326,0.791,7294,-968,6,111,H1
"Ventura County, CA",2008-2009,806353,815130,8777,1.088,7115,1662,6,111,H1
"Ventura County, CA",2009-2010,815130,825353,10223,1.254,6173,4050,6,111,H1
"Ventura County, CA",2010-2011,825353,830973,5620,0.681,5920,-300,6,111,H1
"Ventura County, CA",2011-2012,830973,835476,4503,0.542,5522,-1019,6,111,H1
"Ventura County, CA",2012-2013,835476,840972,5496,0.658,5150,346,6,111,H1
"Ventura County, CA",2013-2014,840972,846178,5206,0.619,5005,201,6,111,H1
"Ventura County, CA",2014-2015,846119,850536,4417,0.522,4923,-506,6,111,H1
"Ventura County, CA",2015-2016,850536,851096,560,0.066,4170,-3610,6,111,H1
"Ventura County, CA",2016-2017,851096,854223,3127,0.367,3886,-759,6,111,H1
"Yolo County, CA",2000-2001,169835,175337,5502,3.24,1117,4385,6,113,H1
"Yolo County, CA",2001-2002,175337,180327,4990,2.846,1218,3772,6,113,H1
"Yolo County, CA",2002-2003,180327,182954,2627,1.457,1264,1363,6,113,H1
"Yolo County, CA",2003-2004,182954,185237,2283,1.248,1285,998,6,113,H1
"Yolo County, CA",2004-2005,185237,186269,1032,0.557,1216,-184,6,113,H1
"Yolo County, CA",2005-2006,186269,189615,3346,1.796,1403,1943,6,113,H1
"Yolo County, CA",2006-2007,189615,194339,4724,2.491,1485,3239,6,113,H1
"Yolo County, CA",2007-2008,194339,197154,2815,1.448,1419,1396,6,113,H1
"Yolo County, CA",2008-2009,197154,199791,2637,1.338,1526,1111,6,113,H1
"Yolo County, CA",2009-2010,199791,201167,1376,0.689,1250,126,6,113,H1
"Yolo County, CA",2010-2011,201167,202303,1136,0.565,1190,-54,6,113,H1
"Yolo County, CA",2011-2012,202303,204265,1962,0.97,1136,826,6,113,H1
"Yolo County, CA",2012-2013,204265,205485,1220,0.597,1308,-88,6,113,H1
"Yolo County, CA",2013-2014,205485,207590,2105,1.024,1254,851,6,113,H1
"Yolo County, CA",2014-2015,209250,213016,3766,1.8,1333,2433,6,113,H1
"Yolo County, CA",2015-2016,213016,215959,2943,1.382,1050,1893,6,113,H1
"Yolo County, CA",2016-2017,215959,219116,3157,1.462,1066,2091,6,113,H1
"Yuba County, CA",2000-2001,60372,61249,877,1.453,528,349,6,115,H1
"Yuba County, CA",2001-2002,61249,62100,851,1.389,481,370,6,115,H1
"Yuba County, CA",2002-2003,62100,62733,633,1.019,671,-38,6,115,H1
"Yuba County, CA",2003-2004,62733,63742,1009,1.608,616,393,6,115,H1
"Yuba County, CA",2004-2005,63742,66285,2543,3.99,689,1854,6,115,H1
"Yuba County, CA",2005-2006,66285,69272,2987,4.506,804,2183,6,115,H1
"Yuba County, CA",2006-2007,69272,70761,1489,2.149,859,630,6,115,H1
"Yuba County, CA",2007-2008,70761,71773,1012,1.43,841,171,6,115,H1
"Yuba County, CA",2008-2009,71773,71607,-166,-0.231,886,-1052,6,115,H1
"Yuba County, CA",2009-2010,71607,72390,783,1.093,745,38,6,115,H1
"Yuba County, CA",2010-2011,72390,72600,210,0.29,695,-485,6,115,H1
"Yuba County, CA",2011-2012,72600,72977,377,0.519,684,-307,6,115,H1
"Yuba County, CA",2012-2013,72977,73361,384,0.526,752,-368,6,115,H1
"Yuba County, CA",2013-2014,73361,73966,605,0.825,735,-130,6,115,H1
"Yuba County, CA",2014-2015,73883,74492,609,0.824,727,-118,6,115,H1
"Yuba County, CA",2015-2016,74492,75185,693,0.93,584,109,6,115,H1
"Yuba County, CA",2016-2017,75185,77031,1846,2.455,640,1206,6,115,H1
Colorado,2000-2001,4326921,4425687,98766,2.283,38571,60195,8,0,STATE
Colorado,2001-2002,4425687,4490406,64719,1.462,38516,26203,8,0,STATE
Colorado,2002-2003,4490406,4528732,38326,0.854,39620,-1294,8,0,STATE
Colorado,2003-2004,4528732,4575013,46281,1.022,39404,6877,8,0,STATE
Colorado,2004-2005,4575013,4631888,56875,1.243,39955,16920,8,0,STATE
Colorado,2005-2006,4631888,4720423,88535,1.911,40298,48237,8,0,STATE
Colorado,2006-2007,4720423,4803868,83445,1.768,41351,42094,8,0,STATE
Colorado,2007-2008,4803868,4889730,85862,1.787,40499,45363,8,0,STATE
Colorado,2008-2009,4889730,4972195,82465,1.686,40858,41607,8,0,STATE
Colorado,2009-2010,4972195,5048254,76059,1.53,39336,36723,8,0,STATE
Colorado,2010-2011,5048254,5119480,71226,1.411,33911,37315,8,0,STATE
Colorado,2011-2012,5119480,5191731,72251,1.411,32034,40217,8,0,STATE
Colorado,2012-2013,5191731,5271132,79401,1.529,31161,48240,8,0,STATE
Colorado,2013-2014,5271132,5355588,84456,1.602,31563,52893,8,0,STATE
Colorado,2014-2015,5355588,5456574,100986,1.886,31931,69055,8,0,STATE
Colorado,2015-2016,5456574,5530105,73531,1.348,29978,43553,8,0,STATE
Colorado,2016-2017,5530105,5607154,77049,1.393,30211,46838,8,0,STATE
"Adams County, CO",2000-2001,350888,359816,8928,2.544,3867,5061,8,1,H1
"Adams County, CO",2001-2002,359816,370753,10937,3.04,4318,6619,8,1,H1
"Adams County, CO",2002-2003,370753,377464,6711,1.81,4805,1906,8,1,H1
"Adams County, CO",2003-2004,377464,384809,7345,1.946,5163,2182,8,1,H1
"Adams County, CO",2004-2005,384809,395146,10337,2.686,5269,5068,8,1,H1
"Adams County, CO",2005-2006,395146,406575,11429,2.892,5463,5966,8,1,H1
"Adams County, CO",2006-2007,406575,415746,9171,2.256,5580,3591,8,1,H1
"Adams County, CO",2007-2008,415746,424913,9167,2.205,5484,3683,8,1,H1
"Adams County, CO",2008-2009,424913,435700,10787,2.539,4919,5868,8,1,H1
"Adams County, CO",2009-2010,435700,443668,7968,1.829,4801,3167,8,1,H1
"Adams County, CO",2010-2011,443668,452202,8534,1.924,4823,3711,8,1,H1
"Adams County, CO",2011-2012,452202,460653,8451,1.869,4192,4259,8,1,H1
"Adams County, CO",2012-2013,460653,470547,9894,2.148,4367,5527,8,1,H1
"Adams County, CO",2013-2014,470547,480718,10171,2.162,4176,5995,8,1,H1
"Adams County, CO",2014-2015,481169,491337,10168,2.113,4200,5968,8,1,H1
"Adams County, CO",2015-2016,491337,497395,6058,1.233,4167,1891,8,1,H1
"Adams County, CO",2016-2017,497395,503167,5772,1.16,3968,1804,8,1,H1
"Alamosa County, CO",2000-2001,14954,14956,2,0.013,140,-138,8,3,H1
"Alamosa County, CO",2001-2002,14956,15114,158,1.056,110,48,8,3,H1
"Alamosa County, CO",2002-2003,15114,15067,-47,-0.311,89,-136,8,3,H1
"Alamosa County, CO",2003-2004,15067,15217,150,0.996,169,-19,8,3,H1
"Alamosa County, CO",2004-2005,15217,15236,19,0.125,145,-126,8,3,H1
"Alamosa County, CO",2005-2006,15236,15196,-40,-0.263,130,-170,8,3,H1
"Alamosa County, CO",2006-2007,15196,15180,-16,-0.105,153,-169,8,3,H1
"Alamosa County, CO",2007-2008,15180,15300,120,0.791,179,-59,8,3,H1
"Alamosa County, CO",2008-2009,15300,15289,-11,-0.072,149,-160,8,3,H1
"Alamosa County, CO",2009-2010,15289,15901,612,4.003,145,467,8,3,H1
"Alamosa County, CO",2010-2011,15901,16107,206,1.296,102,104,8,3,H1
"Alamosa County, CO",2011-2012,16107,16113,6,0.037,86,-80,8,3,H1
"Alamosa County, CO",2012-2013,16113,16256,143,0.887,104,39,8,3,H1
"Alamosa County, CO",2013-2014,16256,16177,-79,-0.486,115,-194,8,3,H1
"Alamosa County, CO",2014-2015,16318,16496,178,1.091,129,49,8,3,H1
"Alamosa County, CO",2015-2016,16496,16456,-40,-0.242,59,-99,8,3,H1
"Alamosa County, CO",2016-2017,16456,16551,95,0.577,86,9,8,3,H1
"Arapahoe County, CO",2000-2001,491482,502393,10911,2.22,4511,6400,8,5,H1
"Arapahoe County, CO",2001-2002,502393,508936,6543,1.302,4600,1943,8,5,H1
"Arapahoe County, CO",2002-2003,508936,513690,4754,0.934,5134,-380,8,5,H1
"Arapahoe County, CO",2003-2004,513690,518971,5281,1.028,5158,123,8,5,H1
"Arapahoe County, CO",2004-2005,518971,524466,5495,1.059,5059,436,8,5,H1
"Arapahoe County, CO",2005-2006,524466,531619,7153,1.364,5068,2085,8,5,H1
"Arapahoe County, CO",2006-2007,531619,542039,10420,1.96,5174,5246,8,5,H1
"Arapahoe County, CO",2007-2008,542039,552461,10422,1.923,5045,5377,8,5,H1
"Arapahoe County, CO",2008-2009,552461,563161,10700,1.937,4802,5898,8,5,H1
"Arapahoe County, CO",2009-2010,563161,574577,11416,2.027,4623,6793,8,5,H1
"Arapahoe County, CO",2010-2011,574577,585845,11268,1.961,4286,6982,8,5,H1
"Arapahoe County, CO",2011-2012,585845,596051,10206,1.742,4353,5853,8,5,H1
"Arapahoe County, CO",2012-2013,596051,608128,12077,2.026,4381,7696,8,5,H1
"Arapahoe County, CO",2013-2014,608128,618821,10693,1.758,4179,6514,8,5,H1
"Arapahoe County, CO",2014-2015,619634,631096,11462,1.85,4140,7322,8,5,H1
"Arapahoe County, CO",2015-2016,631096,636949,5853,0.927,4037,1816,8,5,H1
"Arapahoe County, CO",2016-2017,636949,643052,6103,0.958,4015,2088,8,5,H1
"Archuleta County, CO",2000-2001,10020,10454,434,4.331,55,379,8,7,H1
"Archuleta County, CO",2001-2002,10454,10885,431,4.123,66,365,8,7,H1
"Archuleta County, CO",2002-2003,10885,11089,204,1.874,59,145,8,7,H1
"Archuleta County, CO",2003-2004,11089,11266,177,1.596,66,111,8,7,H1
"Archuleta County, CO",2004-2005,11266,11496,230,2.042,46,184,8,7,H1
"Archuleta County, CO",2005-2006,11496,11937,441,3.836,38,403,8,7,H1
"Archuleta County, CO",2006-2007,11937,12262,325,2.723,75,250,8,7,H1
"Archuleta County, CO",2007-2008,12262,12250,-12,-0.098,49,-61,8,7,H1
"Archuleta County, CO",2008-2009,12250,12169,-81,-0.661,67,-148,8,7,H1
"Archuleta County, CO",2009-2010,12169,12065,-104,-0.855,31,-135,8,7,H1
"Archuleta County, CO",2010-2011,12065,12022,-43,-0.356,57,-100,8,7,H1
"Archuleta County, CO",2011-2012,12022,12129,107,0.89,43,64,8,7,H1
"Archuleta County, CO",2012-2013,12129,12202,73,0.602,29,44,8,7,H1
"Archuleta County, CO",2013-2014,12202,12244,42,0.344,23,19,8,7,H1
"Archuleta County, CO",2014-2015,12210,12352,142,1.163,18,124,8,7,H1
"Archuleta County, CO",2015-2016,12352,12836,484,3.918,42,442,8,7,H1
"Archuleta County, CO",2016-2017,12836,13315,479,3.732,31,448,8,7,H1
"Baca County, CO",2000-2001,4501,4471,-30,-0.667,-28,-2,8,9,H1
"Baca County, CO",2001-2002,4471,4336,-135,-3.019,-24,-111,8,9,H1
"Baca County, CO",2002-2003,4336,4117,-219,-5.051,-30,-189,8,9,H1
"Baca County, CO",2003-2004,4117,4064,-53,-1.287,-28,-25,8,9,H1
"Baca County, CO",2004-2005,4064,3997,-67,-1.649,-20,-47,8,9,H1
"Baca County, CO",2005-2006,3997,3933,-64,-1.601,-23,-41,8,9,H1
"Baca County, CO",2006-2007,3933,3866,-67,-1.704,-28,-39,8,9,H1
"Baca County, CO",2007-2008,3866,3806,-60,-1.552,-10,-50,8,9,H1
"Baca County, CO",2008-2009,3806,3767,-39,-1.025,-19,-20,8,9,H1
"Baca County, CO",2009-2010,3767,3787,20,0.531,-17,37,8,9,H1
"Baca County, CO",2010-2011,3787,3807,20,0.528,-36,56,8,9,H1
"Baca County, CO",2011-2012,3807,3756,-51,-1.34,-17,-34,8,9,H1
"Baca County, CO",2012-2013,3756,3679,-77,-2.05,8,-85,8,9,H1
"Baca County, CO",2013-2014,3679,3645,-34,-0.924,5,-39,8,9,H1
"Baca County, CO",2014-2015,3635,3615,-20,-0.55,-15,-5,8,9,H1
"Baca County, CO",2015-2016,3615,3548,-67,-1.853,-7,-60,8,9,H1
"Baca County, CO",2016-2017,3548,3562,14,0.395,-9,23,8,9,H1
"Bent County, CO",2000-2001,5954,5841,-113,-1.898,4,-117,8,11,H1
"Bent County, CO",2001-2002,5841,5973,132,2.26,-12,144,8,11,H1
"Bent County, CO",2002-2003,5973,6166,193,3.231,-6,199,8,11,H1
"Bent County, CO",2003-2004,6166,6180,14,0.227,-3,17,8,11,H1
"Bent County, CO",2004-2005,6180,6118,-62,-1.003,13,-75,8,11,H1
"Bent County, CO",2005-2006,6118,6012,-106,-1.733,-15,-91,8,11,H1
"Bent County, CO",2006-2007,6012,5715,-297,-4.94,11,-308,8,11,H1
"Bent County, CO",2007-2008,5715,5962,247,4.322,6,241,8,11,H1
"Bent County, CO",2008-2009,5962,6425,463,7.766,9,454,8,11,H1
"Bent County, CO",2009-2010,6425,6509,84,1.307,10,74,8,11,H1
"Bent County, CO",2010-2011,6509,6322,-187,-2.873,-19,-168,8,11,H1
"Bent County, CO",2011-2012,6322,5807,-515,-8.146,-3,-512,8,11,H1
"Bent County, CO",2012-2013,5807,5734,-73,-1.257,-5,-68,8,11,H1
"Bent County, CO",2013-2014,5734,5630,-104,-1.814,7,-111,8,11,H1
"Bent County, CO",2014-2015,5773,5830,57,0.987,-10,67,8,11,H1
"Bent County, CO",2015-2016,5830,5681,-149,-2.556,-13,-136,8,11,H1
"Bent County, CO",2016-2017,5681,5938,257,4.524,-13,270,8,11,H1
"Boulder County, CO",2000-2001,271574,277597,6023,2.218,2203,3820,8,13,H1
"Boulder County, CO",2001-2002,277597,279468,1871,0.674,2275,-404,8,13,H1
"Boulder County, CO",2002-2003,279468,278768,-700,-0.25,2075,-2775,8,13,H1
"Boulder County, CO",2003-2004,278768,279728,960,0.344,2129,-1169,8,13,H1
"Boulder County, CO",2004-2005,279728,280241,513,0.183,2125,-1612,8,13,H1
"Boulder County, CO",2005-2006,280241,284243,4002,1.428,2042,1960,8,13,H1
"Boulder County, CO",2006-2007,284243,287428,3185,1.121,1934,1251,8,13,H1
"Boulder County, CO",2007-2008,287428,290859,3431,1.194,1831,1600,8,13,H1
"Boulder County, CO",2008-2009,290859,293190,2331,0.801,1921,410,8,13,H1
"Boulder County, CO",2009-2010,293190,295967,2777,0.947,1857,920,8,13,H1
"Boulder County, CO",2010-2011,295967,300650,4683,1.582,1491,3192,8,13,H1
"Boulder County, CO",2011-2012,300650,305483,4833,1.608,1388,3445,8,13,H1
"Boulder County, CO",2012-2013,305483,310396,4913,1.608,1285,3628,8,13,H1
"Boulder County, CO",2013-2014,310396,313333,2937,0.946,1303,1634,8,13,H1
"Boulder County, CO",2014-2015,313864,319372,5508,1.755,1178,4330,8,13,H1
"Boulder County, CO",2015-2016,319372,321173,1801,0.564,1047,754,8,13,H1
"Boulder County, CO",2016-2017,321173,322514,1341,0.418,987,354,8,13,H1
"Broomfield County, CO",2000-2001,39679,41055,1376,3.468,366,1010,8,14,H6
"Broomfield County, CO",2001-2002,41055,41800,745,1.815,407,338,8,14,H6
"Broomfield County, CO",2002-2003,41800,43805,2005,4.797,453,1552,8,14,H6
"Broomfield County, CO",2003-2004,43805,44867,1062,2.424,396,666,8,14,H6
"Broomfield County, CO",2004-2005,44867,46313,1446,3.223,449,997,8,14,H6
"Broomfield County, CO",2005-2006,46313,48729,2416,5.217,443,1973,8,14,H6
"Broomfield County, CO",2006-2007,48729,51526,2797,5.74,483,2314,8,14,H6
"Broomfield County, CO",2007-2008,51526,53181,1655,3.212,512,1143,8,14,H6
"Broomfield County, CO",2008-2009,53181,54789,1608,3.024,586,1022,8,14,H6
"Broomfield County, CO",2009-2010,54789,56266,1477,2.696,526,951,8,14,H6
"Broomfield County, CO",2010-2011,56266,57433,1167,2.074,380,787,8,14,H6
"Broomfield County, CO",2011-2012,57433,58992,1559,2.714,358,1201,8,14,H6
"Broomfield County, CO",2012-2013,58992,60306,1314,2.227,387,927,8,14,H6
"Broomfield County, CO",2013-2014,60306,62138,1832,3.038,400,1432,8,14,H6
"Broomfield County, CO",2014-2015,61875,65065,3190,5.156,375,2815,8,14,H6
"Broomfield County, CO",2015-2016,65065,66509,1444,2.219,385,1059,8,14,H6
"Broomfield County, CO",2016-2017,66509,68341,1832,2.755,383,1449,8,14,H6
"Chaffee County, CO",2000-2001,16337,16488,151,0.924,11,140,8,15,H1
"Chaffee County, CO",2001-2002,16488,16844,356,2.159,-24,380,8,15,H1
"Chaffee County, CO",2002-2003,16844,16921,77,0.457,-3,80,8,15,H1
"Chaffee County, CO",2003-2004,16921,17047,126,0.745,0,126,8,15,H1
"Chaffee County, CO",2004-2005,17047,17105,58,0.34,13,45,8,15,H1
"Chaffee County, CO",2005-2006,17105,17087,-18,-0.105,-28,10,8,15,H1
"Chaffee County, CO",2006-2007,17087,17377,290,1.697,-15,305,8,15,H1
"Chaffee County, CO",2007-2008,17377,17573,196,1.128,-28,224,8,15,H1
"Chaffee County, CO",2008-2009,17573,17852,279,1.588,-16,295,8,15,H1
"Chaffee County, CO",2009-2010,17852,17803,-49,-0.274,-3,-46,8,15,H1
"Chaffee County, CO",2010-2011,17803,18001,198,1.112,-8,206,8,15,H1
"Chaffee County, CO",2011-2012,18001,18103,102,0.567,-8,110,8,15,H1
"Chaffee County, CO",2012-2013,18103,18335,232,1.282,-50,282,8,15,H1
"Chaffee County, CO",2013-2014,18335,18363,28,0.153,-17,45,8,15,H1
"Chaffee County, CO",2014-2015,18459,18658,199,1.078,-7,206,8,15,H1
"Chaffee County, CO",2015-2016,18658,19082,424,2.272,-40,464,8,15,H1
"Chaffee County, CO",2016-2017,19082,19638,556,2.914,-23,579,8,15,H1
"Cheyenne County, CO",2000-2001,2209,2179,-30,-1.358,2,-32,8,17,H1
"Cheyenne County, CO",2001-2002,2179,2119,-60,-2.754,9,-69,8,17,H1
"Cheyenne County, CO",2002-2003,2119,2021,-98,-4.625,-12,-86,8,17,H1
"Cheyenne County, CO",2003-2004,2021,1981,-40,-1.979,-10,-30,8,17,H1
"Cheyenne County, CO",2004-2005,1981,1939,-42,-2.12,-4,-38,8,17,H1
"Cheyenne County, CO",2005-2006,1939,1912,-27,-1.392,-3,-24,8,17,H1
"Cheyenne County, CO",2006-2007,1912,1863,-49,-2.563,14,-63,8,17,H1
"Cheyenne County, CO",2007-2008,1863,1881,18,0.966,3,15,8,17,H1
"Cheyenne County, CO",2008-2009,1881,1843,-38,-2.02,9,-47,8,17,H1
"Cheyenne County, CO",2009-2010,1843,1835,-8,-0.434,4,-12,8,17,H1
"Cheyenne County, CO",2010-2011,1835,1869,34,1.853,0,34,8,17,H1
"Cheyenne County, CO",2011-2012,1869,1887,18,0.963,11,7,8,17,H1
"Cheyenne County, CO",2012-2013,1887,1898,11,0.583,12,-1,8,17,H1
"Cheyenne County, CO",2013-2014,1898,1871,-27,-1.423,18,-45,8,17,H1
"Cheyenne County, CO",2014-2015,1854,1829,-25,-1.348,10,-35,8,17,H1
"Cheyenne County, CO",2015-2016,1829,1834,5,0.273,8,-3,8,17,H1
"Cheyenne County, CO",2016-2017,1834,1845,11,0.6,12,-1,8,17,H1
"Clear Creek County, CO",2000-2001,9255,9383,128,1.383,72,56,8,19,H1
"Clear Creek County, CO",2001-2002,9383,9514,131,1.396,59,72,8,19,H1
"Clear Creek County, CO",2002-2003,9514,9402,-112,-1.177,44,-156,8,19,H1
"Clear Creek County, CO",2003-2004,9402,9148,-254,-2.702,57,-311,8,19,H1
"Clear Creek County, CO",2004-2005,9148,9150,2,0.022,36,-34,8,19,H1
"Clear Creek County, CO",2005-2006,9150,9042,-108,-1.18,81,-189,8,19,H1
"Clear Creek County, CO",2006-2007,9042,9152,110,1.217,24,86,8,19,H1
"Clear Creek County, CO",2007-2008,9152,9138,-14,-0.153,60,-74,8,19,H1
"Clear Creek County, CO",2008-2009,9138,8994,-144,-1.576,39,-183,8,19,H1
"Clear Creek County, CO",2009-2010,8994,9105,111,1.234,31,80,8,19,H1
"Clear Creek County, CO",2010-2011,9105,9077,-28,-0.308,12,-40,8,19,H1
"Clear Creek County, CO",2011-2012,9077,9091,14,0.154,26,-12,8,19,H1
"Clear Creek County, CO",2012-2013,9091,9110,19,0.209,21,-2,8,19,H1
"Clear Creek County, CO",2013-2014,9110,9187,77,0.845,8,69,8,19,H1
"Clear Creek County, CO",2014-2015,9171,9303,132,1.439,9,123,8,19,H1
"Clear Creek County, CO",2015-2016,9303,9361,58,0.623,28,30,8,19,H1
"Clear Creek County, CO",2016-2017,9361,9574,213,2.275,8,205,8,19,H1
"Conejos County, CO",2000-2001,8401,8350,-51,-0.607,58,-109,8,21,H1
"Conejos County, CO",2001-2002,8350,8358,8,0.096,32,-24,8,21,H1
"Conejos County, CO",2002-2003,8358,8310,-48,-0.574,36,-84,8,21,H1
"Conejos County, CO",2003-2004,8310,8353,43,0.517,47,-4,8,21,H1
"Conejos County, CO",2004-2005,8353,8337,-16,-0.192,50,-66,8,21,H1
"Conejos County, CO",2005-2006,8337,8256,-81,-0.972,66,-147,8,21,H1
"Conejos County, CO",2006-2007,8256,8217,-39,-0.472,20,-59,8,21,H1
"Conejos County, CO",2007-2008,8217,8200,-17,-0.207,76,-93,8,21,H1
"Conejos County, CO",2008-2009,8200,8140,-60,-0.732,65,-125,8,21,H1
"Conejos County, CO",2009-2010,8140,8277,137,1.683,76,61,8,21,H1
"Conejos County, CO",2010-2011,8277,8308,31,0.375,17,14,8,21,H1
"Conejos County, CO",2011-2012,8308,8273,-35,-0.421,41,-76,8,21,H1
"Conejos County, CO",2012-2013,8273,8258,-15,-0.181,31,-46,8,21,H1
"Conejos County, CO",2013-2014,8258,8265,7,0.085,49,-42,8,21,H1
"Conejos County, CO",2014-2015,8268,8130,-138,-1.669,53,-191,8,21,H1
"Conejos County, CO",2015-2016,8130,8072,-58,-0.713,35,-93,8,21,H1
"Conejos County, CO",2016-2017,8072,8184,112,1.388,37,75,8,21,H1
"Costilla County, CO",2000-2001,3675,3619,-56,-1.524,9,-65,8,23,H1
"Costilla County, CO",2001-2002,3619,3639,20,0.553,11,9,8,23,H1
"Costilla County, CO",2002-2003,3639,3645,6,0.165,2,4,8,23,H1
"Costilla County, CO",2003-2004,3645,3656,11,0.302,-23,34,8,23,H1
"Costilla County, CO",2004-2005,3656,3562,-94,-2.571,8,-102,8,23,H1
"Costilla County, CO",2005-2006,3562,3571,9,0.253,-1,10,8,23,H1
"Costilla County, CO",2006-2007,3571,3567,-4,-0.112,-5,1,8,23,H1
"Costilla County, CO",2007-2008,3567,3532,-35,-0.981,11,-46,8,23,H1
"Costilla County, CO",2008-2009,3532,3481,-51,-1.444,13,-64,8,23,H1
"Costilla County, CO",2009-2010,3481,3528,47,1.35,16,31,8,23,H1
"Costilla County, CO",2010-2011,3528,3649,121,3.43,4,117,8,23,H1
"Costilla County, CO",2011-2012,3649,3605,-44,-1.206,-11,-33,8,23,H1
"Costilla County, CO",2012-2013,3605,3539,-66,-1.831,-1,-65,8,23,H1
"Costilla County, CO",2013-2014,3539,3568,29,0.819,3,26,8,23,H1
"Costilla County, CO",2014-2015,3552,3584,32,0.901,1,31,8,23,H1
"Costilla County, CO",2015-2016,3584,3705,121,3.376,-4,125,8,23,H1
"Costilla County, CO",2016-2017,3705,3776,71,1.916,4,67,8,23,H1
"Crowley County, CO",2000-2001,5509,5614,105,1.906,2,103,8,25,H1
"Crowley County, CO",2001-2002,5614,5666,52,0.926,-8,60,8,25,H1
"Crowley County, CO",2002-2003,5666,5464,-202,-3.565,-6,-196,8,25,H1
"Crowley County, CO",2003-2004,5464,5720,256,4.685,1,255,8,25,H1
"Crowley County, CO",2004-2005,5720,5677,-43,-0.752,-10,-33,8,25,H1
"Crowley County, CO",2005-2006,5677,5886,209,3.682,-14,223,8,25,H1
"Crowley County, CO",2006-2007,5886,6015,129,2.192,-16,145,8,25,H1
"Crowley County, CO",2007-2008,6015,5947,-68,-1.131,6,-74,8,25,H1
"Crowley County, CO",2008-2009,5947,5797,-150,-2.522,0,-150,8,25,H1
"Crowley County, CO",2009-2010,5797,5845,48,0.828,6,42,8,25,H1
"Crowley County, CO",2010-2011,5845,5842,-3,-0.051,-3,0,8,25,H1
"Crowley County, CO",2011-2012,5842,5412,-430,-7.36,-5,-425,8,25,H1
"Crowley County, CO",2012-2013,5412,5333,-79,-1.46,13,-92,8,25,H1
"Crowley County, CO",2013-2014,5333,5360,27,0.506,8,19,8,25,H1
"Crowley County, CO",2014-2015,5613,5562,-51,-0.909,8,-59,8,25,H1
"Crowley County, CO",2015-2016,5562,5254,-308,-5.538,-6,-302,8,25,H1
"Crowley County, CO",2016-2017,5254,5810,556,10.582,1,555,8,25,H1
"Custer County, CO",2000-2001,3523,3664,141,4.002,13,128,8,27,H1
"Custer County, CO",2001-2002,3664,3714,50,1.365,5,45,8,27,H1
"Custer County, CO",2002-2003,3714,3865,151,4.066,-3,154,8,27,H1
"Custer County, CO",2003-2004,3865,3911,46,1.19,15,31,8,27,H1
"Custer County, CO",2004-2005,3911,3989,78,1.994,-7,85,8,27,H1
"Custer County, CO",2005-2006,3989,3994,5,0.125,-14,19,8,27,H1
"Custer County, CO",2006-2007,3994,4112,118,2.954,-2,120,8,27,H1
"Custer County, CO",2007-2008,4112,4107,-5,-0.122,1,-6,8,27,H1
"Custer County, CO",2008-2009,4107,4190,83,2.021,-2,85,8,27,H1
"Custer County, CO",2009-2010,4190,4276,86,2.053,-7,93,8,27,H1
"Custer County, CO",2010-2011,4276,4224,-52,-1.216,-8,-44,8,27,H1
"Custer County, CO",2011-2012,4224,4240,16,0.379,-10,26,8,27,H1
"Custer County, CO",2012-2013,4240,4271,31,0.731,-6,37,8,27,H1
"Custer County, CO",2013-2014,4271,4361,90,2.107,-13,103,8,27,H1
"Custer County, CO",2014-2015,4347,4445,98,2.254,-5,103,8,27,H1
"Custer County, CO",2015-2016,4445,4601,156,3.51,-21,177,8,27,H1
"Custer County, CO",2016-2017,4601,4874,273,5.933,-14,287,8,27,H1
"Delta County, CO",2000-2001,27877,28069,192,0.689,10,182,8,29,H1
"Delta County, CO",2001-2002,28069,28677,608,2.166,-19,627,8,29,H1
"Delta County, CO",2002-2003,28677,28929,252,0.879,13,239,8,29,H1
"Delta County, CO",2003-2004,28929,29305,376,1.3,26,350,8,29,H1
"Delta County, CO",2004-2005,29305,29389,84,0.287,-2,86,8,29,H1
"Delta County, CO",2005-2006,29389,29789,400,1.361,29,371,8,29,H1
"Delta County, CO",2006-2007,29789,30121,332,1.115,23,309,8,29,H1
"Delta County, CO",2007-2008,30121,30712,591,1.962,4,587,8,29,H1
"Delta County, CO",2008-2009,30712,31156,444,1.446,43,401,8,29,H1
"Delta County, CO",2009-2010,31156,30870,-286,-0.918,40,-326,8,29,H1
"Delta County, CO",2010-2011,30870,30377,-493,-1.597,-17,-476,8,29,H1
"Delta County, CO",2011-2012,30377,30449,72,0.237,24,48,8,29,H1
"Delta County, CO",2012-2013,30449,30326,-123,-0.404,-22,-101,8,29,H1
"Delta County, CO",2013-2014,30326,29870,-456,-1.504,-43,-413,8,29,H1
"Delta County, CO",2014-2015,29955,29979,24,0.08,-63,87,8,29,H1
"Delta County, CO",2015-2016,29979,30346,367,1.224,-76,443,8,29,H1
"Delta County, CO",2016-2017,30346,30568,222,0.732,-72,294,8,29,H1
"Denver County, CO",2000-2001,555651,561976,6325,1.138,6883,-558,8,31,H6
"Denver County, CO",2001-2002,561976,556790,-5186,-0.923,6243,-11429,8,31,H6
"Denver County, CO",2002-2003,556790,552588,-4202,-0.755,6169,-10371,8,31,H6
"Denver County, CO",2003-2004,552588,550756,-1832,-0.332,5969,-7801,8,31,H6
"Denver County, CO",2004-2005,550756,551691,935,0.17,6119,-5184,8,31,H6
"Denver County, CO",2005-2006,551691,556895,5204,0.943,6051,-847,8,31,H6
"Denver County, CO",2006-2007,556895,564395,7500,1.347,6024,1476,8,31,H6
"Denver County, CO",2007-2008,564395,575721,11326,2.007,6111,5215,8,31,H6
"Denver County, CO",2008-2009,575721,589011,13290,2.308,6776,6514,8,31,H6
"Denver County, CO",2009-2010,589011,603365,14354,2.437,7483,6871,8,31,H6
"Denver County, CO",2010-2011,603365,619390,16025,2.656,5463,10562,8,31,H6
"Denver County, CO",2011-2012,619390,633868,14478,2.337,5097,9381,8,31,H6
"Denver County, CO",2012-2013,633868,648401,14533,2.293,5127,9406,8,31,H6
"Denver County, CO",2013-2014,648401,663862,15461,2.384,5421,10040,8,31,H6
"Denver County, CO",2014-2015,663963,682545,18582,2.799,5456,13126,8,31,H6
"Denver County, CO",2015-2016,682545,694777,12232,1.792,4844,7388,8,31,H6
"Denver County, CO",2016-2017,694777,704621,9844,1.417,5073,4771,8,31,H6
"Dolores County, CO",2000-2001,1847,1849,2,0.108,3,-1,8,33,H1
"Dolores County, CO",2001-2002,1849,1870,21,1.136,2,19,8,33,H1
"Dolores County, CO",2002-2003,1870,1842,-28,-1.497,-5,-23,8,33,H1
"Dolores County, CO",2003-2004,1842,1850,8,0.434,7,1,8,33,H1
"Dolores County, CO",2004-2005,1850,1869,19,1.027,11,8,8,33,H1
"Dolores County, CO",2005-2006,1869,1973,104,5.564,0,104,8,33,H1
"Dolores County, CO",2006-2007,1973,1980,7,0.355,4,3,8,33,H1
"Dolores County, CO",2007-2008,1980,2061,81,4.091,14,67,8,33,H1
"Dolores County, CO",2008-2009,2061,2057,-4,-0.194,26,-30,8,33,H1
"Dolores County, CO",2009-2010,2057,2062,5,0.243,10,-5,8,33,H1
"Dolores County, CO",2010-2011,2062,2029,-33,-1.6,0,-33,8,33,H1
"Dolores County, CO",2011-2012,2029,1991,-38,-1.873,6,-44,8,33,H1
"Dolores County, CO",2012-2013,1991,2025,34,1.708,-2,36,8,33,H1
"Dolores County, CO",2013-2014,2025,1978,-47,-2.321,15,-62,8,33,H1
"Dolores County, CO",2014-2015,1975,1978,3,0.152,6,-3,8,33,H1
"Dolores County, CO",2015-2016,1978,2062,84,4.247,6,78,8,33,H1
"Dolores County, CO",2016-2017,2062,2067,5,0.242,6,-1,8,33,H1
"Douglas County, CO",2000-2001,180121,196783,16662,9.25,3171,13491,8,35,H1
"Douglas County, CO",2001-2002,196783,208911,12128,6.163,3256,8872,8,35,H1
"Douglas County, CO",2002-2003,208911,220352,11441,5.476,3462,7979,8,35,H1
"Douglas County, CO",2003-2004,220352,232508,12156,5.517,3392,8764,8,35,H1
"Douglas County, CO",2004-2005,232508,243112,10604,4.561,3591,7013,8,35,H1
"Douglas County, CO",2005-2006,243112,256136,13024,5.357,3461,9563,8,35,H1
"Douglas County, CO",2006-2007,256136,267177,11041,4.311,3468,7573,8,35,H1
"Douglas County, CO",2007-2008,267177,275500,8323,3.115,3191,5132,8,35,H1
"Douglas County, CO",2008-2009,275500,281386,5886,2.136,3530,2356,8,35,H1
"Douglas County, CO",2009-2010,281386,286920,5534,1.967,2904,2630,8,35,H1
"Douglas County, CO",2010-2011,286920,292538,5618,1.958,2647,2971,8,35,H1
"Douglas County, CO",2011-2012,292538,298576,6038,2.064,2443,3595,8,35,H1
"Douglas County, CO",2012-2013,298576,306297,7721,2.586,2437,5284,8,35,H1
"Douglas County, CO",2013-2014,306297,314638,8341,2.723,2354,5987,8,35,H1
"Douglas County, CO",2014-2015,314850,322387,7537,2.394,2381,5156,8,35,H1
"Douglas County, CO",2015-2016,322387,327722,5335,1.655,2198,3137,8,35,H1
"Douglas County, CO",2016-2017,327722,335299,7577,2.312,2082,5495,8,35,H1
"Eagle County, CO",2000-2001,41961,43238,1277,3.043,721,556,8,37,H1
"Eagle County, CO",2001-2002,43238,44227,989,2.287,689,300,8,37,H1
"Eagle County, CO",2002-2003,44227,44995,768,1.736,744,24,8,37,H1
"Eagle County, CO",2003-2004,44995,45893,898,1.996,707,191,8,37,H1
"Eagle County, CO",2004-2005,45893,47205,1312,2.859,681,631,8,37,H1
"Eagle County, CO",2005-2006,47205,48476,1271,2.693,758,513,8,37,H1
"Eagle County, CO",2006-2007,48476,49803,1327,2.737,797,530,8,37,H1
"Eagle County, CO",2007-2008,49803,51049,1246,2.502,798,448,8,37,H1
"Eagle County, CO",2008-2009,51049,52513,1464,2.868,774,690,8,37,H1
"Eagle County, CO",2009-2010,52513,52099,-414,-0.788,700,-1114,8,37,H1
"Eagle County, CO",2010-2011,52099,51755,-344,-0.66,572,-916,8,37,H1
"Eagle County, CO",2011-2012,51755,51951,196,0.379,599,-403,8,37,H1
"Eagle County, CO",2012-2013,51951,52441,490,0.943,511,-21,8,37,H1
"Eagle County, CO",2013-2014,52441,52921,480,0.915,537,-57,8,37,H1
"Eagle County, CO",2014-2015,53026,53605,579,1.092,535,44,8,37,H1
"Eagle County, CO",2015-2016,53605,54364,759,1.416,556,203,8,37,H1
"Eagle County, CO",2016-2017,54364,54772,408,0.75,521,-113,8,37,H1
"Elbert County, CO",2000-2001,20060,21094,1034,5.155,165,869,8,39,H1
"Elbert County, CO",2001-2002,21094,21678,584,2.769,145,439,8,39,H1
"Elbert County, CO",2002-2003,21678,21834,156,0.72,128,28,8,39,H1
"Elbert County, CO",2003-2004,21834,21977,143,0.655,109,34,8,39,H1
"Elbert County, CO",2004-2005,21977,22182,205,0.933,111,94,8,39,H1
"Elbert County, CO",2005-2006,22182,22423,241,1.086,110,131,8,39,H1
"Elbert County, CO",2006-2007,22423,22402,-21,-0.094,116,-137,8,39,H1
"Elbert County, CO",2007-2008,22402,22634,232,1.036,22,210,8,39,H1
"Elbert County, CO",2008-2009,22634,22965,331,1.462,92,239,8,39,H1
"Elbert County, CO",2009-2010,22965,23107,142,0.618,74,68,8,39,H1
"Elbert County, CO",2010-2011,23107,23280,173,0.749,72,101,8,39,H1
"Elbert County, CO",2011-2012,23280,23432,152,0.653,42,110,8,39,H1
"Elbert County, CO",2012-2013,23432,23713,281,1.199,27,254,8,39,H1
"Elbert County, CO",2013-2014,23713,24195,482,2.033,49,433,8,39,H1
"Elbert County, CO",2014-2015,24170,24735,565,2.338,58,507,8,39,H1
"Elbert County, CO",2015-2016,24735,25041,306,1.237,83,223,8,39,H1
"Elbert County, CO",2016-2017,25041,25642,601,2.4,80,521,8,39,H1
"El Paso County, CO",2000-2001,519938,535864,15926,3.063,5335,10591,8,41,H1
"El Paso County, CO",2001-2002,535864,544145,8281,1.545,5577,2704,8,41,H1
"El Paso County, CO",2002-2003,544145,547549,3404,0.626,5223,-1819,8,41,H1
"El Paso County, CO",2003-2004,547549,556667,9118,1.665,4863,4255,8,41,H1
"El Paso County, CO",2004-2005,556667,565800,9133,1.641,5309,3824,8,41,H1
"El Paso County, CO",2005-2006,565800,580251,14451,2.554,5221,9230,8,41,H1
"El Paso County, CO",2006-2007,580251,586783,6532,1.126,5624,908,8,41,H1
"El Paso County, CO",2007-2008,586783,597919,11136,1.898,5569,5567,8,41,H1
"El Paso County, CO",2008-2009,597919,608061,10142,1.696,5256,4886,8,41,H1
"El Paso County, CO",2009-2010,608061,626895,18834,3.097,5047,13787,8,41,H1
"El Paso County, CO",2010-2011,626895,636944,10049,1.603,5557,4492,8,41,H1
"El Paso County, CO",2011-2012,636944,645724,8780,1.378,5395,3385,8,41,H1
"El Paso County, CO",2012-2013,645724,655453,9729,1.507,5004,4725,8,41,H1
"El Paso County, CO",2013-2014,655453,663519,8066,1.231,5127,2939,8,41,H1
"El Paso County, CO",2014-2015,662874,674471,11597,1.75,5229,6368,8,41,H1
"El Paso County, CO",2015-2016,674471,686706,12235,1.814,5029,7206,8,41,H1
"El Paso County, CO",2016-2017,686706,699232,12526,1.824,5055,7471,8,41,H1
"Fremont County, CO",2000-2001,46245,46633,388,0.839,-30,418,8,43,H1
"Fremont County, CO",2001-2002,46633,47019,386,0.828,-66,452,8,43,H1
"Fremont County, CO",2002-2003,47019,46901,-118,-0.251,-112,-6,8,43,H1
"Fremont County, CO",2003-2004,46901,46605,-296,-0.631,-99,-197,8,43,H1
"Fremont County, CO",2004-2005,46605,46641,36,0.077,-95,131,8,43,H1
"Fremont County, CO",2005-2006,46641,46873,232,0.497,-37,269,8,43,H1
"Fremont County, CO",2006-2007,46873,46959,86,0.183,-91,177,8,43,H1
"Fremont County, CO",2007-2008,46959,47166,207,0.441,-9,216,8,43,H1
"Fremont County, CO",2008-2009,47166,46871,-295,-0.625,-87,-208,8,43,H1
"Fremont County, CO",2009-2010,46871,46885,14,0.03,-145,159,8,43,H1
"Fremont County, CO",2010-2011,46885,47431,546,1.165,-151,697,8,43,H1
"Fremont County, CO",2011-2012,47431,47114,-317,-0.668,-109,-208,8,43,H1
"Fremont County, CO",2012-2013,47114,46463,-651,-1.382,-176,-475,8,43,H1
"Fremont County, CO",2013-2014,46463,46502,39,0.084,-191,230,8,43,H1
"Fremont County, CO",2014-2015,46381,46692,311,0.671,-171,482,8,43,H1
"Fremont County, CO",2015-2016,46692,46906,214,0.458,-155,369,8,43,H1
"Fremont County, CO",2016-2017,46906,47559,653,1.392,-156,809,8,43,H1
"Garfield County, CO",2000-2001,44257,45636,1379,3.116,532,847,8,45,H1
"Garfield County, CO",2001-2002,45636,46925,1289,2.825,528,761,8,45,H1
"Garfield County, CO",2002-2003,46925,47622,697,1.485,579,118,8,45,H1
"Garfield County, CO",2003-2004,47622,48193,571,1.199,526,45,8,45,H1
"Garfield County, CO",2004-2005,48193,49579,1386,2.876,564,822,8,45,H1
"Garfield County, CO",2005-2006,49579,51594,2015,4.064,621,1394,8,45,H1
"Garfield County, CO",2006-2007,51594,53534,1940,3.76,680,1260,8,45,H1
"Garfield County, CO",2007-2008,53534,55449,1915,3.577,712,1203,8,45,H1
"Garfield County, CO",2008-2009,55449,57089,1640,2.958,720,920,8,45,H1
"Garfield County, CO",2009-2010,57089,56077,-1012,-1.773,654,-1666,8,45,H1
"Garfield County, CO",2010-2011,56077,56003,-74,-0.132,566,-640,8,45,H1
"Garfield County, CO",2011-2012,56003,56777,774,1.382,533,241,8,45,H1
"Garfield County, CO",2012-2013,56777,57102,325,0.572,540,-215,8,45,H1
"Garfield County, CO",2013-2014,57102,57461,359,0.629,496,-137,8,45,H1
"Garfield County, CO",2014-2015,57443,58095,652,1.135,474,178,8,45,H1
"Garfield County, CO",2015-2016,58095,58906,811,1.396,542,269,8,45,H1
"Garfield County, CO",2016-2017,58906,59118,212,0.36,483,-271,8,45,H1
"Gilpin County, CO",2000-2001,4783,4781,-2,-0.042,42,-44,8,47,H1
"Gilpin County, CO",2001-2002,4781,4788,7,0.146,38,-31,8,47,H1
"Gilpin County, CO",2002-2003,4788,4777,-11,-0.23,22,-33,8,47,H1
"Gilpin County, CO",2003-2004,4777,4752,-25,-0.523,32,-57,8,47,H1
"Gilpin County, CO",2004-2005,4752,4810,58,1.221,34,24,8,47,H1
"Gilpin County, CO",2005-2006,4810,4883,73,1.518,43,30,8,47,H1
"Gilpin County, CO",2006-2007,4883,4893,10,0.205,34,-24,8,47,H1
"Gilpin County, CO",2007-2008,4893,5026,133,2.718,39,94,8,47,H1
"Gilpin County, CO",2008-2009,5026,5352,326,6.486,26,300,8,47,H1
"Gilpin County, CO",2009-2010,5352,5463,111,2.074,4,107,8,47,H1
"Gilpin County, CO",2010-2011,5463,5447,-16,-0.293,18,-34,8,47,H1
"Gilpin County, CO",2011-2012,5447,5453,6,0.11,13,-7,8,47,H1
"Gilpin County, CO",2012-2013,5453,5572,119,2.182,29,90,8,47,H1
"Gilpin County, CO",2013-2014,5572,5851,279,5.007,23,256,8,47,H1
"Gilpin County, CO",2014-2015,5722,5828,106,1.852,22,84,8,47,H1
"Gilpin County, CO",2015-2016,5828,5905,77,1.321,17,60,8,47,H1
"Gilpin County, CO",2016-2017,5905,6013,108,1.829,19,89,8,47,H1
"Grand County, CO",2000-2001,12496,12743,247,1.977,89,158,8,49,H1
"Grand County, CO",2001-2002,12743,13158,415,3.257,95,320,8,49,H1
"Grand County, CO",2002-2003,13158,13324,166,1.262,108,58,8,49,H1
"Grand County, CO",2003-2004,13324,13596,272,2.041,103,169,8,49,H1
"Grand County, CO",2004-2005,13596,13627,31,0.228,67,-36,8,49,H1
"Grand County, CO",2005-2006,13627,14003,376,2.759,82,294,8,49,H1
"Grand County, CO",2006-2007,14003,14306,303,2.164,121,182,8,49,H1
"Grand County, CO",2007-2008,14306,14622,316,2.209,105,211,8,49,H1
"Grand County, CO",2008-2009,14622,14902,280,1.915,94,186,8,49,H1
"Grand County, CO",2009-2010,14902,14786,-116,-0.778,90,-206,8,49,H1
"Grand County, CO",2010-2011,14786,14557,-229,-1.549,39,-268,8,49,H1
"Grand County, CO",2011-2012,14557,14182,-375,-2.576,64,-439,8,49,H1
"Grand County, CO",2012-2013,14182,14319,137,0.966,68,69,8,49,H1
"Grand County, CO",2013-2014,14319,14546,227,1.585,69,158,8,49,H1
"Grand County, CO",2014-2015,14477,14615,138,0.953,65,73,8,49,H1
"Grand County, CO",2015-2016,14615,15129,514,3.517,68,446,8,49,H1
"Grand County, CO",2016-2017,15129,15321,192,1.269,81,111,8,49,H1
"Gunnison County, CO",2000-2001,14068,14206,138,0.981,122,16,8,51,H1
"Gunnison County, CO",2001-2002,14206,14322,116,0.817,100,16,8,51,H1
"Gunnison County, CO",2002-2003,14322,14273,-49,-0.342,108,-157,8,51,H1
"Gunnison County, CO",2003-2004,14273,14356,83,0.582,97,-14,8,51,H1
"Gunnison County, CO",2004-2005,14356,14456,100,0.697,95,5,8,51,H1
"Gunnison County, CO",2005-2006,14456,14720,264,1.826,106,158,8,51,H1
"Gunnison County, CO",2006-2007,14720,15043,323,2.194,114,209,8,51,H1
"Gunnison County, CO",2007-2008,15043,15250,207,1.376,124,83,8,51,H1
"Gunnison County, CO",2008-2009,15250,15356,106,0.695,112,-6,8,51,H1
"Gunnison County, CO",2009-2010,15356,15369,13,0.085,93,-80,8,51,H1
"Gunnison County, CO",2010-2011,15369,15451,82,0.534,96,-14,8,51,H1
"Gunnison County, CO",2011-2012,15451,15463,12,0.078,87,-75,8,51,H1
"Gunnison County, CO",2012-2013,15463,15505,42,0.272,78,-36,8,51,H1
"Gunnison County, CO",2013-2014,15505,15725,220,1.419,84,136,8,51,H1
"Gunnison County, CO",2014-2015,15727,16067,340,2.162,79,261,8,51,H1
"Gunnison County, CO",2015-2016,16067,16491,424,2.639,89,335,8,51,H1
"Gunnison County, CO",2016-2017,16491,16939,448,2.717,91,357,8,51,H1
"Hinsdale County, CO",2000-2001,791,817,26,3.287,1,25,8,53,H1
"Hinsdale County, CO",2001-2002,817,798,-19,-2.326,5,-24,8,53,H1
"Hinsdale County, CO",2002-2003,798,779,-19,-2.381,5,-24,8,53,H1
"Hinsdale County, CO",2003-2004,779,810,31,3.979,8,23,8,53,H1
"Hinsdale County, CO",2004-2005,810,794,-16,-1.975,4,-20,8,53,H1
"Hinsdale County, CO",2005-2006,794,815,21,2.645,1,20,8,53,H1
"Hinsdale County, CO",2006-2007,815,835,20,2.454,8,12,8,53,H1
"Hinsdale County, CO",2007-2008,835,818,-17,-2.036,8,-25,8,53,H1
"Hinsdale County, CO",2008-2009,818,834,16,1.956,4,12,8,53,H1
"Hinsdale County, CO",2009-2010,834,847,13,1.559,6,7,8,53,H1
"Hinsdale County, CO",2010-2011,847,831,-16,-1.889,-2,-14,8,53,H1
"Hinsdale County, CO",2011-2012,831,801,-30,-3.61,3,-33,8,53,H1
"Hinsdale County, CO",2012-2013,801,812,11,1.373,8,3,8,53,H1
"Hinsdale County, CO",2013-2014,812,786,-26,-3.202,9,-35,8,53,H1
"Hinsdale County, CO",2014-2015,781,774,-7,-0.896,5,-12,8,53,H1
"Hinsdale County, CO",2015-2016,774,787,13,1.68,-1,14,8,53,H1
"Hinsdale County, CO",2016-2017,787,794,7,0.889,2,5,8,53,H1
"Huerfano County, CO",2000-2001,7771,7635,-136,-1.75,-15,-121,8,55,H1
"Huerfano County, CO",2001-2002,7635,7571,-64,-0.838,-15,-49,8,55,H1
"Huerfano County, CO",2002-2003,7571,7428,-143,-1.889,-36,-107,8,55,H1
"Huerfano County, CO",2003-2004,7428,7193,-235,-3.164,-18,-217,8,55,H1
"Huerfano County, CO",2004-2005,7193,7145,-48,-0.667,-35,-13,8,55,H1
"Huerfano County, CO",2005-2006,7145,7127,-18,-0.252,-34,16,8,55,H1
"Huerfano County, CO",2006-2007,7127,7051,-76,-1.066,-32,-44,8,55,H1
"Huerfano County, CO",2007-2008,7051,7073,22,0.312,-45,67,8,55,H1
"Huerfano County, CO",2008-2009,7073,6824,-249,-3.52,-37,-212,8,55,H1
"Huerfano County, CO",2009-2010,6824,6673,-151,-2.213,-18,-133,8,55,H1
"Huerfano County, CO",2010-2011,6673,6519,-154,-2.308,-61,-93,8,55,H1
"Huerfano County, CO",2011-2012,6519,6588,69,1.058,-46,115,8,55,H1
"Huerfano County, CO",2012-2013,6588,6507,-81,-1.23,-38,-43,8,55,H1
"Huerfano County, CO",2013-2014,6507,6462,-45,-0.692,-38,-7,8,55,H1
"Huerfano County, CO",2014-2015,6433,6492,59,0.917,-37,96,8,55,H1
"Huerfano County, CO",2015-2016,6492,6582,90,1.386,-61,151,8,55,H1
"Huerfano County, CO",2016-2017,6582,6662,80,1.215,-41,121,8,55,H1
"Jackson County, CO",2000-2001,1577,1529,-48,-3.044,-1,-47,8,57,H1
"Jackson County, CO",2001-2002,1529,1532,3,0.196,8,-5,8,57,H1
"Jackson County, CO",2002-2003,1532,1512,-20,-1.305,-1,-19,8,57,H1
"Jackson County, CO",2003-2004,1512,1486,-26,-1.72,3,-29,8,57,H1
"Jackson County, CO",2004-2005,1486,1449,-37,-2.49,-1,-36,8,57,H1
"Jackson County, CO",2005-2006,1449,1415,-34,-2.346,3,-37,8,57,H1
"Jackson County, CO",2006-2007,1415,1407,-8,-0.565,0,-8,8,57,H1
"Jackson County, CO",2007-2008,1407,1378,-29,-2.061,4,-33,8,57,H1
"Jackson County, CO",2008-2009,1378,1408,30,2.177,8,22,8,57,H1
"Jackson County, CO",2009-2010,1408,1383,-25,-1.776,11,-36,8,57,H1
"Jackson County, CO",2010-2011,1383,1381,-2,-0.145,1,-3,8,57,H1
"Jackson County, CO",2011-2012,1381,1347,-34,-2.462,-6,-28,8,57,H1
"Jackson County, CO",2012-2013,1347,1364,17,1.262,6,11,8,57,H1
"Jackson County, CO",2013-2014,1364,1396,32,2.346,1,31,8,57,H1
"Jackson County, CO",2014-2015,1395,1356,-39,-2.796,4,-43,8,57,H1
"Jackson County, CO",2015-2016,1356,1360,4,0.295,3,1,8,57,H1
"Jackson County, CO",2016-2017,1360,1385,25,1.838,8,17,8,57,H1
"Jefferson County, CO",2000-2001,526251,528845,2594,0.493,3476,-882,8,59,H1
"Jefferson County, CO",2001-2002,528845,527851,-994,-0.188,3181,-4175,8,59,H1
"Jefferson County, CO",2002-2003,527851,524940,-2911,-0.551,3165,-6076,8,59,H1
"Jefferson County, CO",2003-2004,524940,520900,-4040,-0.77,2944,-6984,8,59,H1
"Jefferson County, CO",2004-2005,520900,519675,-1225,-0.235,2869,-4094,8,59,H1
"Jefferson County, CO",2005-2006,519675,521662,1987,0.382,2682,-695,8,59,H1
"Jefferson County, CO",2006-2007,521662,524911,3249,0.623,2656,593,8,59,H1
"Jefferson County, CO",2007-2008,524911,529003,4092,0.78,2493,1599,8,59,H1
"Jefferson County, CO",2008-2009,529003,531961,2958,0.559,2502,456,8,59,H1
"Jefferson County, CO",2009-2010,531961,535600,3639,0.684,2333,1306,8,59,H1
"Jefferson County, CO",2010-2011,535600,539540,3940,0.736,1798,2142,8,59,H1
"Jefferson County, CO",2011-2012,539540,545621,6081,1.127,1652,4429,8,59,H1
"Jefferson County, CO",2012-2013,545621,551548,5927,1.086,1627,4300,8,59,H1
"Jefferson County, CO",2013-2014,551548,558503,6955,1.261,1683,5272,8,59,H1
"Jefferson County, CO",2014-2015,559042,565524,6482,1.159,1840,4642,8,59,H1
"Jefferson County, CO",2015-2016,565524,570839,5315,0.94,1601,3714,8,59,H1
"Jefferson County, CO",2016-2017,570839,574613,3774,0.661,1655,2119,8,59,H1
"Kiowa County, CO",2000-2001,1610,1550,-60,-3.727,-10,-50,8,61,H1
"Kiowa County, CO",2001-2002,1550,1519,-31,-2,-3,-28,8,61,H1
"Kiowa County, CO",2002-2003,1519,1501,-18,-1.185,6,-24,8,61,H1
"Kiowa County, CO",2003-2004,1501,1457,-44,-2.931,-10,-34,8,61,H1
"Kiowa County, CO",2004-2005,1457,1467,10,0.686,-5,15,8,61,H1
"Kiowa County, CO",2005-2006,1467,1456,-11,-0.75,-11,0,8,61,H1
"Kiowa County, CO",2006-2007,1456,1410,-46,-3.159,-5,-41,8,61,H1
"Kiowa County, CO",2007-2008,1410,1392,-18,-1.277,0,-18,8,61,H1
"Kiowa County, CO",2008-2009,1392,1378,-14,-1.006,2,-16,8,61,H1
"Kiowa County, CO",2009-2010,1378,1395,17,1.234,4,13,8,61,H1
"Kiowa County, CO",2010-2011,1395,1456,61,4.373,-2,63,8,61,H1
"Kiowa County, CO",2011-2012,1456,1437,-19,-1.305,-13,-6,8,61,H1
"Kiowa County, CO",2012-2013,1437,1420,-17,-1.183,2,-19,8,61,H1
"Kiowa County, CO",2013-2014,1420,1402,-18,-1.268,-2,-16,8,61,H1
"Kiowa County, CO",2014-2015,1411,1423,12,0.85,5,7,8,61,H1
"Kiowa County, CO",2015-2016,1423,1348,-75,-5.271,2,-77,8,61,H1
"Kiowa County, CO",2016-2017,1348,1376,28,2.077,3,25,8,61,H1
"Kit Carson County, CO",2000-2001,7971,7995,24,0.301,39,-15,8,63,H1
"Kit Carson County, CO",2001-2002,7995,8250,255,3.189,-6,261,8,63,H1
"Kit Carson County, CO",2002-2003,8250,8133,-117,-1.418,11,-128,8,63,H1
"Kit Carson County, CO",2003-2004,8133,8157,24,0.295,18,6,8,63,H1
"Kit Carson County, CO",2004-2005,8157,8060,-97,-1.189,40,-137,8,63,H1
"Kit Carson County, CO",2005-2006,8060,8011,-49,-0.608,1,-50,8,63,H1
"Kit Carson County, CO",2006-2007,8011,7954,-57,-0.712,11,-68,8,63,H1
"Kit Carson County, CO",2007-2008,7954,8157,203,2.552,35,168,8,63,H1
"Kit Carson County, CO",2008-2009,8157,8383,226,2.771,17,209,8,63,H1
"Kit Carson County, CO",2009-2010,8383,8238,-145,-1.73,42,-187,8,63,H1
"Kit Carson County, CO",2010-2011,8238,8192,-46,-0.558,20,-66,8,63,H1
"Kit Carson County, CO",2011-2012,8192,8093,-99,-1.208,22,-121,8,63,H1
"Kit Carson County, CO",2012-2013,8093,8016,-77,-0.951,23,-100,8,63,H1
"Kit Carson County, CO",2013-2014,8016,8072,56,0.699,14,42,8,63,H1
"Kit Carson County, CO",2014-2015,7813,7758,-55,-0.704,13,-68,8,63,H1
"Kit Carson County, CO",2015-2016,7758,7628,-130,-1.676,33,-163,8,63,H1
"Kit Carson County, CO",2016-2017,7628,7158,-470,-6.162,26,-496,8,63,H1
"Lake County, CO",2000-2001,7815,7758,-57,-0.729,91,-148,8,65,H1
"Lake County, CO",2001-2002,7758,7676,-82,-1.057,91,-173,8,65,H1
"Lake County, CO",2002-2003,7676,7491,-185,-2.41,82,-267,8,65,H1
"Lake County, CO",2003-2004,7491,7434,-57,-0.761,79,-136,8,65,H1
"Lake County, CO",2004-2005,7434,7331,-103,-1.386,86,-189,8,65,H1
"Lake County, CO",2005-2006,7331,7278,-53,-0.723,85,-138,8,65,H1
"Lake County, CO",2006-2007,7278,7392,114,1.566,66,48,8,65,H1
"Lake County, CO",2007-2008,7392,7450,58,0.785,101,-43,8,65,H1
"Lake County, CO",2008-2009,7450,7426,-24,-0.322,97,-121,8,65,H1
"Lake County, CO",2009-2010,7426,7263,-163,-2.195,100,-263,8,65,H1
"Lake County, CO",2010-2011,7263,7373,110,1.515,62,48,8,65,H1
"Lake County, CO",2011-2012,7373,7274,-99,-1.343,30,-129,8,65,H1
"Lake County, CO",2012-2013,7274,7290,16,0.22,56,-40,8,65,H1
"Lake County, CO",2013-2014,7290,7357,67,0.919,60,7,8,65,H1
"Lake County, CO",2014-2015,7367,7485,118,1.602,58,60,8,65,H1
"Lake County, CO",2015-2016,7485,7606,121,1.617,49,72,8,65,H1
"Lake County, CO",2016-2017,7606,7778,172,2.261,50,122,8,65,H1
"La Plata County, CO",2000-2001,44228,45044,816,1.845,253,563,8,67,H1
"La Plata County, CO",2001-2002,45044,45869,825,1.832,215,610,8,67,H1
"La Plata County, CO",2002-2003,45869,46121,252,0.549,218,34,8,67,H1
"La Plata County, CO",2003-2004,46121,46728,607,1.316,247,360,8,67,H1
"La Plata County, CO",2004-2005,46728,47575,847,1.813,259,588,8,67,H1
"La Plata County, CO",2005-2006,47575,48574,999,2.1,273,726,8,67,H1
"La Plata County, CO",2006-2007,48574,49343,769,1.583,308,461,8,67,H1
"La Plata County, CO",2007-2008,49343,50291,948,1.921,347,601,8,67,H1
"La Plata County, CO",2008-2009,50291,51105,814,1.619,337,477,8,67,H1
"La Plata County, CO",2009-2010,51105,51338,233,0.456,295,-62,8,67,H1
"La Plata County, CO",2010-2011,51338,51770,432,0.841,295,137,8,67,H1
"La Plata County, CO",2011-2012,51770,52305,535,1.033,201,334,8,67,H1
"La Plata County, CO",2012-2013,52305,53334,1029,1.967,204,825,8,67,H1
"La Plata County, CO",2013-2014,53334,53989,655,1.228,213,442,8,67,H1
"La Plata County, CO",2014-2015,53850,54688,838,1.556,214,624,8,67,H1
"La Plata County, CO",2015-2016,54688,55216,528,0.965,214,314,8,67,H1
"La Plata County, CO",2016-2017,55216,55589,373,0.676,207,166,8,67,H1
"Larimer County, CO",2000-2001,253072,260541,7469,2.951,1794,5675,8,69,H1
"Larimer County, CO",2001-2002,260541,265372,4831,1.854,1769,3062,8,69,H1
"Larimer County, CO",2002-2003,265372,268448,3076,1.159,1829,1247,8,69,H1
"Larimer County, CO",2003-2004,268448,271510,3062,1.141,1950,1112,8,69,H1
"Larimer County, CO",2004-2005,271510,275116,3606,1.328,1791,1815,8,69,H1
"Larimer County, CO",2005-2006,275116,280713,5597,2.034,1968,3629,8,69,H1
"Larimer County, CO",2006-2007,280713,286112,5399,1.923,2026,3373,8,69,H1
"Larimer County, CO",2007-2008,286112,291650,5538,1.936,1858,3680,8,69,H1
"Larimer County, CO",2008-2009,291650,296696,5046,1.73,1945,3101,8,69,H1
"Larimer County, CO",2009-2010,296696,300484,3788,1.277,1855,1933,8,69,H1
"Larimer County, CO",2010-2011,300484,305241,4757,1.583,1450,3307,8,69,H1
"Larimer County, CO",2011-2012,305241,310835,5594,1.833,1537,4057,8,69,H1
"Larimer County, CO",2012-2013,310835,316494,5659,1.821,1419,4240,8,69,H1
"Larimer County, CO",2013-2014,316494,324122,7628,2.41,1482,6146,8,69,H1
"Larimer County, CO",2014-2015,324657,333577,8920,2.748,1527,7393,8,69,H1
"Larimer County, CO",2015-2016,333577,338531,4954,1.485,1249,3705,8,69,H1
"Larimer County, CO",2016-2017,338531,343976,5445,1.608,1286,4159,8,69,H1
"Las Animas County, CO",2000-2001,15297,15116,-181,-1.183,-47,-134,8,71,H1
"Las Animas County, CO",2001-2002,15116,15424,308,2.038,-12,320,8,71,H1
"Las Animas County, CO",2002-2003,15424,15706,282,1.828,6,276,8,71,H1
"Las Animas County, CO",2003-2004,15706,15573,-133,-0.847,-7,-126,8,71,H1
"Las Animas County, CO",2004-2005,15573,15582,9,0.058,11,-2,8,71,H1
"Las Animas County, CO",2005-2006,15582,15673,91,0.584,16,75,8,71,H1
"Las Animas County, CO",2006-2007,15673,15734,61,0.389,20,41,8,71,H1
"Las Animas County, CO",2007-2008,15734,15770,36,0.229,25,11,8,71,H1
"Las Animas County, CO",2008-2009,15770,15775,5,0.032,25,-20,8,71,H1
"Las Animas County, CO",2009-2010,15775,15416,-359,-2.276,25,-384,8,71,H1
"Las Animas County, CO",2010-2011,15416,15045,-371,-2.407,-49,-322,8,71,H1
"Las Animas County, CO",2011-2012,15045,14986,-59,-0.392,-14,-45,8,71,H1
"Las Animas County, CO",2012-2013,14986,14444,-542,-3.617,-6,-536,8,71,H1
"Las Animas County, CO",2013-2014,14444,14052,-392,-2.714,-21,-371,8,71,H1
"Las Animas County, CO",2014-2015,14071,14058,-13,-0.092,-31,18,8,71,H1
"Las Animas County, CO",2015-2016,14058,14087,29,0.206,-20,49,8,71,H1
"Las Animas County, CO",2016-2017,14087,14238,151,1.072,-26,177,8,71,H1
"Lincoln County, CO",2000-2001,6070,5912,-158,-2.603,-8,-150,8,73,H1
"Lincoln County, CO",2001-2002,5912,5936,24,0.406,-5,29,8,73,H1
"Lincoln County, CO",2002-2003,5936,5904,-32,-0.539,2,-34,8,73,H1
"Lincoln County, CO",2003-2004,5904,5751,-153,-2.591,16,-169,8,73,H1
"Lincoln County, CO",2004-2005,5751,5644,-107,-1.861,-1,-106,8,73,H1
"Lincoln County, CO",2005-2006,5644,5530,-114,-2.02,31,-145,8,73,H1
"Lincoln County, CO",2006-2007,5530,5484,-46,-0.832,2,-48,8,73,H1
"Lincoln County, CO",2007-2008,5484,5468,-16,-0.292,4,-20,8,73,H1
"Lincoln County, CO",2008-2009,5468,5423,-45,-0.823,13,-58,8,73,H1
"Lincoln County, CO",2009-2010,5423,5472,49,0.904,6,43,8,73,H1
"Lincoln County, CO",2010-2011,5472,5438,-34,-0.621,13,-47,8,73,H1
"Lincoln County, CO",2011-2012,5438,5446,8,0.147,-8,16,8,73,H1
"Lincoln County, CO",2012-2013,5446,5431,-15,-0.275,27,-42,8,73,H1
"Lincoln County, CO",2013-2014,5431,5510,79,1.455,13,66,8,73,H1
"Lincoln County, CO",2014-2015,5508,5557,49,0.89,15,34,8,73,H1
"Lincoln County, CO",2015-2016,5557,5562,5,0.09,1,4,8,73,H1
"Lincoln County, CO",2016-2017,5562,5546,-16,-0.288,8,-24,8,73,H1
"Logan County, CO",2000-2001,20699,21459,760,3.672,68,692,8,75,H1
"Logan County, CO",2001-2002,21459,21548,89,0.415,47,42,8,75,H1
"Logan County, CO",2002-2003,21548,21825,277,1.286,105,172,8,75,H1
"Logan County, CO",2003-2004,21825,21795,-30,-0.137,28,-58,8,75,H1
"Logan County, CO",2004-2005,21795,21694,-101,-0.463,22,-123,8,75,H1
"Logan County, CO",2005-2006,21694,21911,217,1,30,187,8,75,H1
"Logan County, CO",2006-2007,21911,22163,252,1.15,58,194,8,75,H1
"Logan County, CO",2007-2008,22163,22128,-35,-0.158,16,-51,8,75,H1
"Logan County, CO",2008-2009,22128,22451,323,1.46,51,272,8,75,H1
"Logan County, CO",2009-2010,22451,22789,338,1.506,56,282,8,75,H1
"Logan County, CO",2010-2011,22789,22687,-102,-0.448,27,-129,8,75,H1
"Logan County, CO",2011-2012,22687,22613,-74,-0.326,39,-113,8,75,H1
"Logan County, CO",2012-2013,22613,22407,-206,-0.911,39,-245,8,75,H1
"Logan County, CO",2013-2014,22407,22524,117,0.522,41,76,8,75,H1
"Logan County, CO",2014-2015,21954,22036,82,0.374,47,35,8,75,H1
"Logan County, CO",2015-2016,22036,21925,-111,-0.504,0,-111,8,75,H1
"Logan County, CO",2016-2017,21925,21896,-29,-0.132,19,-48,8,75,H1
"Mesa County, CO",2000-2001,117631,119496,1865,1.585,328,1537,8,77,H1
"Mesa County, CO",2001-2002,119496,122440,2944,2.464,364,2580,8,77,H1
"Mesa County, CO",2002-2003,122440,124994,2554,2.086,321,2233,8,77,H1
"Mesa County, CO",2003-2004,124994,127678,2684,2.147,514,2170,8,77,H1
"Mesa County, CO",2004-2005,127678,130194,2516,1.971,514,2002,8,77,H1
"Mesa County, CO",2005-2006,130194,134665,4471,3.434,572,3899,8,77,H1
"Mesa County, CO",2006-2007,134665,139434,4769,3.541,787,3982,8,77,H1
"Mesa County, CO",2007-2008,139434,143155,3721,2.669,740,2981,8,77,H1
"Mesa County, CO",2008-2009,143155,147851,4696,3.28,766,3930,8,77,H1
"Mesa County, CO",2009-2010,147851,146485,-1366,-0.924,787,-2153,8,77,H1
"Mesa County, CO",2010-2011,146485,147380,895,0.611,603,292,8,77,H1
"Mesa County, CO",2011-2012,147380,147724,344,0.233,511,-167,8,77,H1
"Mesa County, CO",2012-2013,147724,147699,-25,-0.017,435,-460,8,77,H1
"Mesa County, CO",2013-2014,147699,148255,556,0.376,469,87,8,77,H1
"Mesa County, CO",2014-2015,147890,148513,623,0.421,437,186,8,77,H1
"Mesa County, CO",2015-2016,148513,149794,1281,0.863,206,1075,8,77,H1
"Mesa County, CO",2016-2017,149794,151616,1822,1.216,311,1511,8,77,H1
"Mineral County, CO",2000-2001,832,796,-36,-4.327,0,-36,8,79,H1
"Mineral County, CO",2001-2002,796,812,16,2.01,-2,18,8,79,H1
"Mineral County, CO",2002-2003,812,828,16,1.97,2,14,8,79,H1
"Mineral County, CO",2003-2004,828,848,20,2.415,4,16,8,79,H1
"Mineral County, CO",2004-2005,848,814,-34,-4.009,-4,-30,8,79,H1
"Mineral County, CO",2005-2006,814,789,-25,-3.071,-4,-21,8,79,H1
"Mineral County, CO",2006-2007,789,807,18,2.281,0,18,8,79,H1
"Mineral County, CO",2007-2008,807,774,-33,-4.089,-2,-31,8,79,H1
"Mineral County, CO",2008-2009,774,732,-42,-5.426,1,-43,8,79,H1
"Mineral County, CO",2009-2010,732,703,-29,-3.962,3,-32,8,79,H1
"Mineral County, CO",2010-2011,703,712,9,1.28,2,7,8,79,H1
"Mineral County, CO",2011-2012,712,709,-3,-0.421,1,-4,8,79,H1
"Mineral County, CO",2012-2013,709,723,14,1.975,4,10,8,79,H1
"Mineral County, CO",2013-2014,723,698,-25,-3.458,3,-28,8,79,H1
"Mineral County, CO",2014-2015,695,726,31,4.46,1,30,8,79,H1
"Mineral County, CO",2015-2016,726,755,29,3.994,3,26,8,79,H1
"Mineral County, CO",2016-2017,755,766,11,1.457,6,5,8,79,H1
"Moffat County, CO",2000-2001,13147,13065,-82,-0.624,98,-180,8,81,H1
"Moffat County, CO",2001-2002,13065,13193,128,0.98,104,24,8,81,H1
"Moffat County, CO",2002-2003,13193,13106,-87,-0.659,74,-161,8,81,H1
"Moffat County, CO",2003-2004,13106,13175,69,0.526,119,-50,8,81,H1
"Moffat County, CO",2004-2005,13175,12956,-219,-1.662,81,-300,8,81,H1
"Moffat County, CO",2005-2006,12956,13115,159,1.227,119,40,8,81,H1
"Moffat County, CO",2006-2007,13115,13348,233,1.777,108,125,8,81,H1
"Moffat County, CO",2007-2008,13348,13585,237,1.776,137,100,8,81,H1
"Moffat County, CO",2008-2009,13585,13728,143,1.053,118,25,8,81,H1
"Moffat County, CO",2009-2010,13728,13802,74,0.539,106,-32,8,81,H1
"Moffat County, CO",2010-2011,13802,13420,-382,-2.768,118,-500,8,81,H1
"Moffat County, CO",2011-2012,13420,13167,-253,-1.885,44,-297,8,81,H1
"Moffat County, CO",2012-2013,13167,13115,-52,-0.395,109,-161,8,81,H1
"Moffat County, CO",2013-2014,13115,12928,-187,-1.426,103,-290,8,81,H1
"Moffat County, CO",2014-2015,12932,12937,5,0.039,93,-88,8,81,H1
"Moffat County, CO",2015-2016,12937,13161,224,1.731,94,130,8,81,H1
"Moffat County, CO",2016-2017,13161,13131,-30,-0.228,102,-132,8,81,H1
"Montezuma County, CO",2000-2001,23847,23692,-155,-0.65,64,-219,8,83,H1
"Montezuma County, CO",2001-2002,23692,23935,243,1.026,54,189,8,83,H1
"Montezuma County, CO",2002-2003,23935,24255,320,1.337,78,242,8,83,H1
"Montezuma County, CO",2003-2004,24255,24456,201,0.829,75,126,8,83,H1
"Montezuma County, CO",2004-2005,24456,24514,58,0.237,45,13,8,83,H1
"Montezuma County, CO",2005-2006,24514,24968,454,1.852,52,402,8,83,H1
"Montezuma County, CO",2006-2007,24968,25157,189,0.757,122,67,8,83,H1
"Montezuma County, CO",2007-2008,25157,25222,65,0.258,51,14,8,83,H1
"Montezuma County, CO",2008-2009,25222,25507,285,1.13,76,209,8,83,H1
"Montezuma County, CO",2009-2010,25507,25537,30,0.118,69,-39,8,83,H1
"Montezuma County, CO",2010-2011,25537,25444,-93,-0.364,18,-111,8,83,H1
"Montezuma County, CO",2011-2012,25444,25424,-20,-0.079,20,-40,8,83,H1
"Montezuma County, CO",2012-2013,25424,25667,243,0.956,58,185,8,83,H1
"Montezuma County, CO",2013-2014,25667,25772,105,0.409,38,67,8,83,H1
"Montezuma County, CO",2014-2015,25799,26168,369,1.43,80,289,8,83,H1
"Montezuma County, CO",2015-2016,26168,25975,-193,-0.738,26,-219,8,83,H1
"Montezuma County, CO",2016-2017,25975,26140,165,0.635,22,143,8,83,H1
"Montrose County, CO",2000-2001,33599,34361,762,2.268,149,613,8,85,H1
"Montrose County, CO",2001-2002,34361,35154,793,2.308,150,643,8,85,H1
"Montrose County, CO",2002-2003,35154,35767,613,1.744,102,511,8,85,H1
"Montrose County, CO",2003-2004,35767,36310,543,1.518,134,409,8,85,H1
"Montrose County, CO",2004-2005,36310,37227,917,2.525,204,713,8,85,H1
"Montrose County, CO",2005-2006,37227,38282,1055,2.834,138,917,8,85,H1
"Montrose County, CO",2006-2007,38282,39673,1391,3.634,141,1250,8,85,H1
"Montrose County, CO",2007-2008,39673,40658,985,2.483,193,792,8,85,H1
"Montrose County, CO",2008-2009,40658,41535,877,2.157,198,679,8,85,H1
"Montrose County, CO",2009-2010,41535,41177,-358,-0.862,136,-494,8,85,H1
"Montrose County, CO",2010-2011,41177,40910,-267,-0.648,99,-366,8,85,H1
"Montrose County, CO",2011-2012,40910,40722,-188,-0.46,-59,-129,8,85,H1
"Montrose County, CO",2012-2013,40722,40744,22,0.054,100,-78,8,85,H1
"Montrose County, CO",2013-2014,40744,40873,129,0.317,51,78,8,85,H1
"Montrose County, CO",2014-2015,40832,40946,114,0.279,37,77,8,85,H1
"Montrose County, CO",2015-2016,40946,41160,214,0.523,28,186,8,85,H1
"Montrose County, CO",2016-2017,41160,41784,624,1.516,13,611,8,85,H1
"Morgan County, CO",2000-2001,27257,27307,50,0.183,200,-150,8,87,H1
"Morgan County, CO",2001-2002,27307,27556,249,0.912,229,20,8,87,H1
"Morgan County, CO",2002-2003,27556,27736,180,0.653,260,-80,8,87,H1
"Morgan County, CO",2003-2004,27736,27736,0,0,192,-192,8,87,H1
"Morgan County, CO",2004-2005,27736,27727,-9,-0.032,198,-207,8,87,H1
"Morgan County, CO",2005-2006,27727,27816,89,0.321,171,-82,8,87,H1
"Morgan County, CO",2006-2007,27816,27745,-71,-0.255,177,-248,8,87,H1
"Morgan County, CO",2007-2008,27745,27701,-44,-0.159,184,-228,8,87,H1
"Morgan County, CO",2008-2009,27701,28099,398,1.437,218,180,8,87,H1
"Morgan County, CO",2009-2010,28099,28141,42,0.149,223,-181,8,87,H1
"Morgan County, CO",2010-2011,28141,28498,357,1.269,182,175,8,87,H1
"Morgan County, CO",2011-2012,28498,28355,-143,-0.502,156,-299,8,87,H1
"Morgan County, CO",2012-2013,28355,28389,34,0.12,208,-174,8,87,H1
"Morgan County, CO",2013-2014,28389,28328,-61,-0.215,209,-270,8,87,H1
"Morgan County, CO",2014-2015,28246,28360,114,0.404,184,-70,8,87,H1
"Morgan County, CO",2015-2016,28360,28063,-297,-1.047,155,-452,8,87,H1
"Morgan County, CO",2016-2017,28063,28192,129,0.46,193,-64,8,87,H1
"Otero County, CO",2000-2001,20242,20012,-230,-1.136,86,-316,8,89,H1
"Otero County, CO",2001-2002,20012,19688,-324,-1.619,76,-400,8,89,H1
"Otero County, CO",2002-2003,19688,19585,-103,-0.523,69,-172,8,89,H1
"Otero County, CO",2003-2004,19585,19436,-149,-0.761,68,-217,8,89,H1
"Otero County, CO",2004-2005,19436,19247,-189,-0.972,58,-247,8,89,H1
"Otero County, CO",2005-2006,19247,19042,-205,-1.065,2,-207,8,89,H1
"Otero County, CO",2006-2007,19042,18783,-259,-1.36,19,-278,8,89,H1
"Otero County, CO",2007-2008,18783,18726,-57,-0.303,27,-84,8,89,H1
"Otero County, CO",2008-2009,18726,18743,17,0.091,36,-19,8,89,H1
"Otero County, CO",2009-2010,18743,18901,158,0.843,39,119,8,89,H1
"Otero County, CO",2010-2011,18901,18889,-12,-0.063,30,-42,8,89,H1
"Otero County, CO",2011-2012,18889,18712,-177,-0.937,4,-181,8,89,H1
"Otero County, CO",2012-2013,18712,18572,-140,-0.748,-26,-114,8,89,H1
"Otero County, CO",2013-2014,18572,18488,-84,-0.452,8,-92,8,89,H1
"Otero County, CO",2014-2015,18430,18343,-87,-0.472,-13,-74,8,89,H1
"Otero County, CO",2015-2016,18343,18239,-104,-0.567,-15,-89,8,89,H1
"Otero County, CO",2016-2017,18239,18326,87,0.477,9,78,8,89,H1
"Ouray County, CO",2000-2001,3775,3787,12,0.318,16,-4,8,91,H1
"Ouray County, CO",2001-2002,3787,3872,85,2.245,16,69,8,91,H1
"Ouray County, CO",2002-2003,3872,3880,8,0.207,6,2,8,91,H1
"Ouray County, CO",2003-2004,3880,4003,123,3.17,9,114,8,91,H1
"Ouray County, CO",2004-2005,4003,4055,52,1.299,11,41,8,91,H1
"Ouray County, CO",2005-2006,4055,4090,35,0.863,13,22,8,91,H1
"Ouray County, CO",2006-2007,4090,4250,160,3.912,9,151,8,91,H1
"Ouray County, CO",2007-2008,4250,4405,155,3.647,25,130,8,91,H1
"Ouray County, CO",2008-2009,4405,4395,-10,-0.227,18,-28,8,91,H1
"Ouray County, CO",2009-2010,4395,4460,65,1.479,0,65,8,91,H1
"Ouray County, CO",2010-2011,4460,4449,-11,-0.247,9,-20,8,91,H1
"Ouray County, CO",2011-2012,4449,4545,96,2.158,14,82,8,91,H1
"Ouray County, CO",2012-2013,4545,4578,33,0.726,-3,36,8,91,H1
"Ouray County, CO",2013-2014,4578,4629,51,1.114,2,49,8,91,H1
"Ouray County, CO",2014-2015,4625,4691,66,1.427,3,63,8,91,H1
"Ouray County, CO",2015-2016,4691,4784,93,1.983,16,77,8,91,H1
"Ouray County, CO",2016-2017,4784,4794,10,0.209,2,8,8,91,H1
"Park County, CO",2000-2001,14670,15255,585,3.988,110,475,8,93,H1
"Park County, CO",2001-2002,15255,15760,505,3.31,101,404,8,93,H1
"Park County, CO",2002-2003,15760,16024,264,1.675,106,158,8,93,H1
"Park County, CO",2003-2004,16024,16130,106,0.662,75,31,8,93,H1
"Park County, CO",2004-2005,16130,16204,74,0.459,106,-32,8,93,H1
"Park County, CO",2005-2006,16204,16230,26,0.16,93,-67,8,93,H1
"Park County, CO",2006-2007,16230,16445,215,1.325,81,134,8,93,H1
"Park County, CO",2007-2008,16445,16394,-51,-0.31,72,-123,8,93,H1
"Park County, CO",2008-2009,16394,16098,-296,-1.806,72,-368,8,93,H1
"Park County, CO",2009-2010,16098,16264,166,1.031,45,121,8,93,H1
"Park County, CO",2010-2011,16264,16091,-173,-1.064,31,-204,8,93,H1
"Park County, CO",2011-2012,16091,16043,-48,-0.298,33,-81,8,93,H1
"Park County, CO",2012-2013,16043,16128,85,0.53,31,54,8,93,H1
"Park County, CO",2013-2014,16128,16345,217,1.345,31,186,8,93,H1
"Park County, CO",2014-2015,16260,16510,250,1.538,14,236,8,93,H1
"Park County, CO",2015-2016,16510,17350,840,5.088,20,820,8,93,H1
"Park County, CO",2016-2017,17350,17905,555,3.199,14,541,8,93,H1
"Phillips County, CO",2000-2001,4455,4456,1,0.022,-2,3,8,95,H1
"Phillips County, CO",2001-2002,4456,4497,41,0.92,1,40,8,95,H1
"Phillips County, CO",2002-2003,4497,4415,-82,-1.823,5,-87,8,95,H1
"Phillips County, CO",2003-2004,4415,4475,60,1.359,4,56,8,95,H1
"Phillips County, CO",2004-2005,4475,4467,-8,-0.179,30,-38,8,95,H1
"Phillips County, CO",2005-2006,4467,4414,-53,-1.186,3,-56,8,95,H1
"Phillips County, CO",2006-2007,4414,4378,-36,-0.816,32,-68,8,95,H1
"Phillips County, CO",2007-2008,4378,4349,-29,-0.662,-3,-26,8,95,H1
"Phillips County, CO",2008-2009,4349,4359,10,0.23,15,-5,8,95,H1
"Phillips County, CO",2009-2010,4359,4460,101,2.317,19,82,8,95,H1
"Phillips County, CO",2010-2011,4460,4371,-89,-1.996,-11,-78,8,95,H1
"Phillips County, CO",2011-2012,4371,4376,5,0.114,6,-1,8,95,H1
"Phillips County, CO",2012-2013,4376,4355,-21,-0.48,5,-26,8,95,H1
"Phillips County, CO",2013-2014,4355,4363,8,0.184,-5,13,8,95,H1
"Phillips County, CO",2014-2015,4391,4349,-42,-0.957,9,-51,8,95,H1
"Phillips County, CO",2015-2016,4349,4281,-68,-1.564,25,-93,8,95,H1
"Phillips County, CO",2016-2017,4281,4292,11,0.257,12,-1,8,95,H1
"Pitkin County, CO",2000-2001,14817,15013,196,1.323,115,81,8,97,H1
"Pitkin County, CO",2001-2002,15013,15098,85,0.566,133,-48,8,97,H1
"Pitkin County, CO",2002-2003,15098,15217,119,0.788,120,-1,8,97,H1
"Pitkin County, CO",2003-2004,15217,15220,3,0.02,117,-114,8,97,H1
"Pitkin County, CO",2004-2005,15220,15399,179,1.176,121,58,8,97,H1
"Pitkin County, CO",2005-2006,15399,15504,105,0.682,119,-14,8,97,H1
"Pitkin County, CO",2006-2007,15504,15814,310,1.999,123,187,8,97,H1
"Pitkin County, CO",2007-2008,15814,16454,640,4.047,138,502,8,97,H1
"Pitkin County, CO",2008-2009,16454,17008,554,3.367,116,438,8,97,H1
"Pitkin County, CO",2009-2010,17008,17149,141,0.829,127,14,8,97,H1
"Pitkin County, CO",2010-2011,17149,17127,-22,-0.128,117,-139,8,97,H1
"Pitkin County, CO",2011-2012,17127,17232,105,0.613,77,28,8,97,H1
"Pitkin County, CO",2012-2013,17232,17381,149,0.865,91,58,8,97,H1
"Pitkin County, CO",2013-2014,17381,17626,245,1.41,86,159,8,97,H1
"Pitkin County, CO",2014-2015,17599,17787,188,1.068,82,106,8,97,H1
"Pitkin County, CO",2015-2016,17787,17894,107,0.602,104,3,8,97,H1
"Pitkin County, CO",2016-2017,17894,17890,-4,-0.022,108,-112,8,97,H1
"Prowers County, CO",2000-2001,14431,14182,-249,-1.725,130,-379,8,99,H1
"Prowers County, CO",2001-2002,14182,14057,-125,-0.881,100,-225,8,99,H1
"Prowers County, CO",2002-2003,14057,13853,-204,-1.451,124,-328,8,99,H1
"Prowers County, CO",2003-2004,13853,13613,-240,-1.732,79,-319,8,99,H1
"Prowers County, CO",2004-2005,13613,13480,-133,-0.977,130,-263,8,99,H1
"Prowers County, CO",2005-2006,13480,13130,-350,-2.596,93,-443,8,99,H1
"Prowers County, CO",2006-2007,13130,12736,-394,-3.001,64,-458,8,99,H1
"Prowers County, CO",2007-2008,12736,12663,-73,-0.573,70,-143,8,99,H1
"Prowers County, CO",2008-2009,12663,12593,-70,-0.553,79,-149,8,99,H1
"Prowers County, CO",2009-2010,12593,12571,-22,-0.175,90,-112,8,99,H1
"Prowers County, CO",2010-2011,12571,12505,-66,-0.525,-7,-59,8,99,H1
"Prowers County, CO",2011-2012,12505,12405,-100,-0.8,55,-155,8,99,H1
"Prowers County, CO",2012-2013,12405,12281,-124,-1,69,-193,8,99,H1
"Prowers County, CO",2013-2014,12281,12034,-247,-2.011,56,-303,8,99,H1
"Prowers County, CO",2014-2015,12049,11954,-95,-0.788,56,-151,8,99,H1
"Prowers County, CO",2015-2016,11954,11989,35,0.293,54,-19,8,99,H1
"Prowers County, CO",2016-2017,11989,12070,81,0.676,53,28,8,99,H1
"Pueblo County, CO",2000-2001,141800,144014,2214,1.561,614,1600,8,101,H1
"Pueblo County, CO",2001-2002,144014,146537,2523,1.752,513,2010,8,101,H1
"Pueblo County, CO",2002-2003,146537,147907,1370,0.935,605,765,8,101,H1
"Pueblo County, CO",2003-2004,147907,148654,747,0.505,414,333,8,101,H1
"Pueblo County, CO",2004-2005,148654,149825,1171,0.788,444,727,8,101,H1
"Pueblo County, CO",2005-2006,149825,152026,2201,1.469,574,1627,8,101,H1
"Pueblo County, CO",2006-2007,152026,155121,3095,2.036,645,2450,8,101,H1
"Pueblo County, CO",2007-2008,155121,156748,1627,1.049,572,1055,8,101,H1
"Pueblo County, CO",2008-2009,156748,157846,1098,0.7,564,534,8,101,H1
"Pueblo County, CO",2009-2010,157846,159536,1690,1.071,545,1145,8,101,H1
"Pueblo County, CO",2010-2011,159536,160213,677,0.424,214,463,8,101,H1
"Pueblo County, CO",2011-2012,160213,160840,627,0.391,294,333,8,101,H1
"Pueblo County, CO",2012-2013,160840,161320,480,0.298,293,187,8,101,H1
"Pueblo County, CO",2013-2014,161320,161875,555,0.344,270,285,8,101,H1
"Pueblo County, CO",2014-2015,161759,163591,1832,1.133,217,1615,8,101,H1
"Pueblo County, CO",2015-2016,163591,164834,1243,0.76,138,1105,8,101,H1
"Pueblo County, CO",2016-2017,164834,166475,1641,0.996,144,1497,8,101,H1
"Rio Blanco County, CO",2000-2001,5986,5868,-118,-1.971,9,-127,8,103,H1
"Rio Blanco County, CO",2001-2002,5868,5951,83,1.414,26,57,8,103,H1
"Rio Blanco County, CO",2002-2003,5951,5923,-28,-0.471,38,-66,8,103,H1
"Rio Blanco County, CO",2003-2004,5923,6007,84,1.418,29,55,8,103,H1
"Rio Blanco County, CO",2004-2005,6007,5945,-62,-1.032,16,-78,8,103,H1
"Rio Blanco County, CO",2005-2006,5945,6176,231,3.886,38,193,8,103,H1
"Rio Blanco County, CO",2006-2007,6176,6373,197,3.19,47,150,8,103,H1
"Rio Blanco County, CO",2007-2008,6373,6522,149,2.338,71,78,8,103,H1
"Rio Blanco County, CO",2008-2009,6522,6779,257,3.941,54,203,8,103,H1
"Rio Blanco County, CO",2009-2010,6779,6660,-119,-1.755,65,-184,8,103,H1
"Rio Blanco County, CO",2010-2011,6660,6774,114,1.712,63,51,8,103,H1
"Rio Blanco County, CO",2011-2012,6774,6793,19,0.28,17,2,8,103,H1
"Rio Blanco County, CO",2012-2013,6793,6759,-34,-0.501,38,-72,8,103,H1
"Rio Blanco County, CO",2013-2014,6759,6707,-52,-0.769,43,-95,8,103,H1
"Rio Blanco County, CO",2014-2015,6681,6571,-110,-1.646,29,-139,8,103,H1
"Rio Blanco County, CO",2015-2016,6571,6483,-88,-1.339,30,-118,8,103,H1
"Rio Blanco County, CO",2016-2017,6483,6420,-63,-0.972,34,-97,8,103,H1
"Rio Grande County, CO",2000-2001,12445,12213,-232,-1.864,40,-272,8,105,H1
"Rio Grande County, CO",2001-2002,12213,12224,11,0.09,38,-27,8,105,H1
"Rio Grande County, CO",2002-2003,12224,12296,72,0.589,44,28,8,105,H1
"Rio Grande County, CO",2003-2004,12296,12328,32,0.26,44,-12,8,105,H1
"Rio Grande County, CO",2004-2005,12328,12208,-120,-0.973,46,-166,8,105,H1
"Rio Grande County, CO",2005-2006,12208,12033,-175,-1.433,74,-249,8,105,H1
"Rio Grande County, CO",2006-2007,12033,11852,-181,-1.504,3,-184,8,105,H1
"Rio Grande County, CO",2007-2008,11852,11860,8,0.067,47,-39,8,105,H1
"Rio Grande County, CO",2008-2009,11860,11872,12,0.101,35,-23,8,105,H1
"Rio Grande County, CO",2009-2010,11872,12020,148,1.247,54,94,8,105,H1
"Rio Grande County, CO",2010-2011,12020,11924,-96,-0.799,17,-113,8,105,H1
"Rio Grande County, CO",2011-2012,11924,11893,-31,-0.26,4,-35,8,105,H1
"Rio Grande County, CO",2012-2013,11893,11755,-138,-1.16,44,-182,8,105,H1
"Rio Grande County, CO",2013-2014,11755,11607,-148,-1.259,24,-172,8,105,H1
"Rio Grande County, CO",2014-2015,11611,11543,-68,-0.586,22,-90,8,105,H1
"Rio Grande County, CO",2015-2016,11543,11338,-205,-1.776,17,-222,8,105,H1
"Rio Grande County, CO",2016-2017,11338,11301,-37,-0.326,9,-46,8,105,H1
"Routt County, CO",2000-2001,19815,20210,395,1.993,121,274,8,107,H1
"Routt County, CO",2001-2002,20210,20469,259,1.282,155,104,8,107,H1
"Routt County, CO",2002-2003,20469,20893,424,2.071,170,254,8,107,H1
"Routt County, CO",2003-2004,20893,21162,269,1.288,167,102,8,107,H1
"Routt County, CO",2004-2005,21162,21398,236,1.115,167,69,8,107,H1
"Routt County, CO",2005-2006,21398,21859,461,2.154,168,293,8,107,H1
"Routt County, CO",2006-2007,21859,22491,632,2.891,168,464,8,107,H1
"Routt County, CO",2007-2008,22491,23135,644,2.863,177,467,8,107,H1
"Routt County, CO",2008-2009,23135,23688,553,2.39,174,379,8,107,H1
"Routt County, CO",2009-2010,23688,23426,-262,-1.106,175,-437,8,107,H1
"Routt County, CO",2010-2011,23426,23182,-244,-1.042,139,-383,8,107,H1
"Routt County, CO",2011-2012,23182,23207,25,0.108,123,-98,8,107,H1
"Routt County, CO",2012-2013,23207,23458,251,1.082,124,127,8,107,H1
"Routt County, CO",2013-2014,23458,23865,407,1.735,94,313,8,107,H1
"Routt County, CO",2014-2015,23917,24130,213,0.891,104,109,8,107,H1
"Routt County, CO",2015-2016,24130,24679,549,2.275,148,401,8,107,H1
"Routt County, CO",2016-2017,24679,25220,541,2.192,114,427,8,107,H1
"Saguache County, CO",2000-2001,5939,6024,85,1.431,34,51,8,109,H1
"Saguache County, CO",2001-2002,6024,6209,185,3.071,48,137,8,109,H1
"Saguache County, CO",2002-2003,6209,6262,53,0.854,57,-4,8,109,H1
"Saguache County, CO",2003-2004,6262,6365,103,1.645,49,54,8,109,H1
"Saguache County, CO",2004-2005,6365,6296,-69,-1.084,38,-107,8,109,H1
"Saguache County, CO",2005-2006,6296,6223,-73,-1.159,59,-132,8,109,H1
"Saguache County, CO",2006-2007,6223,6148,-75,-1.205,42,-117,8,109,H1
"Saguache County, CO",2007-2008,6148,6179,31,0.504,35,-4,8,109,H1
"Saguache County, CO",2008-2009,6179,6134,-45,-0.728,46,-91,8,109,H1
"Saguache County, CO",2009-2010,6134,6131,-3,-0.049,26,-29,8,109,H1
"Saguache County, CO",2010-2011,6131,6185,54,0.881,41,13,8,109,H1
"Saguache County, CO",2011-2012,6185,6319,134,2.167,44,90,8,109,H1
"Saguache County, CO",2012-2013,6319,6226,-93,-1.472,50,-143,8,109,H1
"Saguache County, CO",2013-2014,6226,6196,-30,-0.482,18,-48,8,109,H1
"Saguache County, CO",2014-2015,6199,6251,52,0.839,10,42,8,109,H1
"Saguache County, CO",2015-2016,6251,6407,156,2.496,36,120,8,109,H1
"Saguache County, CO",2016-2017,6407,6626,219,3.418,19,200,8,109,H1
"San Juan County, CO",2000-2001,562,581,19,3.381,0,19,8,111,H1
"San Juan County, CO",2001-2002,581,594,13,2.238,4,9,8,111,H1
"San Juan County, CO",2002-2003,594,610,16,2.694,6,10,8,111,H1
"San Juan County, CO",2003-2004,610,631,21,3.443,4,17,8,111,H1
"San Juan County, CO",2004-2005,631,627,-4,-0.634,1,-5,8,111,H1
"San Juan County, CO",2005-2006,627,649,22,3.509,7,15,8,111,H1
"San Juan County, CO",2006-2007,649,661,12,1.849,4,8,8,111,H1
"San Juan County, CO",2007-2008,661,670,9,1.362,2,7,8,111,H1
"San Juan County, CO",2008-2009,670,657,-13,-1.94,6,-19,8,111,H1
"San Juan County, CO",2009-2010,657,708,51,7.763,2,49,8,111,H1
"San Juan County, CO",2010-2011,708,697,-11,-1.554,0,-11,8,111,H1
"San Juan County, CO",2011-2012,697,695,-2,-0.287,0,-2,8,111,H1
"San Juan County, CO",2012-2013,695,699,4,0.576,-2,6,8,111,H1
"San Juan County, CO",2013-2014,699,720,21,3.004,4,17,8,111,H1
"San Juan County, CO",2014-2015,719,701,-18,-2.503,-1,-17,8,111,H1
"San Juan County, CO",2015-2016,701,689,-12,-1.712,2,-14,8,111,H1
"San Juan County, CO",2016-2017,689,715,26,3.774,3,23,8,111,H1
"San Miguel County, CO",2000-2001,6609,6858,249,3.768,50,199,8,113,H1
"San Miguel County, CO",2001-2002,6858,7111,253,3.689,68,185,8,113,H1
"San Miguel County, CO",2002-2003,7111,7062,-49,-0.689,51,-100,8,113,H1
"San Miguel County, CO",2003-2004,7062,7038,-24,-0.34,62,-86,8,113,H1
"San Miguel County, CO",2004-2005,7038,7097,59,0.838,59,0,8,113,H1
"San Miguel County, CO",2005-2006,7097,7071,-26,-0.366,80,-106,8,113,H1
"San Miguel County, CO",2006-2007,7071,7322,251,3.55,75,176,8,113,H1
"San Miguel County, CO",2007-2008,7322,7366,44,0.601,99,-55,8,113,H1
"San Miguel County, CO",2008-2009,7366,7379,13,0.176,86,-73,8,113,H1
"San Miguel County, CO",2009-2010,7379,7356,-23,-0.312,54,-77,8,113,H1
"San Miguel County, CO",2010-2011,7356,7488,132,1.794,57,75,8,113,H1
"San Miguel County, CO",2011-2012,7488,7604,116,1.549,43,73,8,113,H1
"San Miguel County, CO",2012-2013,7604,7697,93,1.223,50,43,8,113,H1
"San Miguel County, CO",2013-2014,7697,7840,143,1.858,48,95,8,113,H1
"San Miguel County, CO",2014-2015,7782,7879,97,1.246,55,42,8,113,H1
"San Miguel County, CO",2015-2016,7879,7964,85,1.079,50,35,8,113,H1
"San Miguel County, CO",2016-2017,7964,7967,3,0.038,45,-42,8,113,H1
"Sedgwick County, CO",2000-2001,2746,2661,-85,-3.095,-4,-81,8,115,H1
"Sedgwick County, CO",2001-2002,2661,2694,33,1.24,-12,45,8,115,H1
"Sedgwick County, CO",2002-2003,2694,2652,-42,-1.559,-20,-22,8,115,H1
"Sedgwick County, CO",2003-2004,2652,2551,-101,-3.808,-13,-88,8,115,H1
"Sedgwick County, CO",2004-2005,2551,2522,-29,-1.137,-15,-14,8,115,H1
"Sedgwick County, CO",2005-2006,2522,2474,-48,-1.903,-12,-36,8,115,H1
"Sedgwick County, CO",2006-2007,2474,2400,-74,-2.991,-22,-52,8,115,H1
"Sedgwick County, CO",2007-2008,2400,2421,21,0.875,0,21,8,115,H1
"Sedgwick County, CO",2008-2009,2421,2392,-29,-1.198,-1,-28,8,115,H1
"Sedgwick County, CO",2009-2010,2392,2370,-22,-0.92,-13,-9,8,115,H1
"Sedgwick County, CO",2010-2011,2370,2374,4,0.169,-13,17,8,115,H1
"Sedgwick County, CO",2011-2012,2374,2377,3,0.126,-16,19,8,115,H1
"Sedgwick County, CO",2012-2013,2377,2354,-23,-0.968,7,-30,8,115,H1
"Sedgwick County, CO",2013-2014,2354,2348,-6,-0.255,3,-9,8,115,H1
"Sedgwick County, CO",2014-2015,2334,2399,65,2.785,-7,72,8,115,H1
"Sedgwick County, CO",2015-2016,2399,2405,6,0.25,0,6,8,115,H1
"Sedgwick County, CO",2016-2017,2405,2344,-61,-2.536,10,-71,8,115,H1
"Summit County, CO",2000-2001,23700,24716,1016,4.287,286,730,8,117,H1
"Summit County, CO",2001-2002,24716,25006,290,1.173,323,-33,8,117,H1
"Summit County, CO",2002-2003,25006,25408,402,1.608,316,86,8,117,H1
"Summit County, CO",2003-2004,25408,25313,-95,-0.374,306,-401,8,117,H1
"Summit County, CO",2004-2005,25313,25487,174,0.687,292,-118,8,117,H1
"Summit County, CO",2005-2006,25487,26019,532,2.087,320,212,8,117,H1
"Summit County, CO",2006-2007,26019,26603,584,2.245,299,285,8,117,H1
"Summit County, CO",2007-2008,26603,27144,541,2.034,338,203,8,117,H1
"Summit County, CO",2008-2009,27144,27678,534,1.967,334,200,8,117,H1
"Summit County, CO",2009-2010,27678,28063,385,1.391,301,84,8,117,H1
"Summit County, CO",2010-2011,28063,27960,-103,-0.367,252,-355,8,117,H1
"Summit County, CO",2011-2012,27960,28228,268,0.959,253,15,8,117,H1
"Summit County, CO",2012-2013,28228,28755,527,1.867,200,327,8,117,H1
"Summit County, CO",2013-2014,28755,29404,649,2.257,212,437,8,117,H1
"Summit County, CO",2014-2015,29451,30257,806,2.737,219,587,8,117,H1
"Summit County, CO",2015-2016,30257,30332,75,0.248,248,-173,8,117,H1
"Summit County, CO",2016-2017,30332,30585,253,0.834,233,20,8,117,H1
"Teller County, CO",2000-2001,20655,21193,538,2.605,128,410,8,119,H1
"Teller County, CO",2001-2002,21193,21543,350,1.651,154,196,8,119,H1
"Teller County, CO",2002-2003,21543,21682,139,0.645,139,0,8,119,H1
"Teller County, CO",2003-2004,21682,21678,-4,-0.018,123,-127,8,119,H1
"Teller County, CO",2004-2005,21678,21978,300,1.384,106,194,8,119,H1
"Teller County, CO",2005-2006,21978,22281,303,1.379,84,219,8,119,H1
"Teller County, CO",2006-2007,22281,22707,426,1.912,133,293,8,119,H1
"Teller County, CO",2007-2008,22707,22725,18,0.079,55,-37,8,119,H1
"Teller County, CO",2008-2009,22725,22937,212,0.933,83,129,8,119,H1
"Teller County, CO",2009-2010,22937,23456,519,2.263,49,470,8,119,H1
"Teller County, CO",2010-2011,23456,23334,-122,-0.52,91,-213,8,119,H1
"Teller County, CO",2011-2012,23334,23376,42,0.18,10,32,8,119,H1
"Teller County, CO",2012-2013,23376,23258,-118,-0.505,33,-151,8,119,H1
"Teller County, CO",2013-2014,23258,23389,131,0.563,26,105,8,119,H1
"Teller County, CO",2014-2015,23378,23385,7,0.03,26,-19,8,119,H1
"Teller County, CO",2015-2016,23385,24040,655,2.801,19,636,8,119,H1
"Teller County, CO",2016-2017,24040,24646,606,2.521,30,576,8,119,H1
"Washington County, CO",2000-2001,4939,4874,-65,-1.316,4,-69,8,121,H1
"Washington County, CO",2001-2002,4874,5035,161,3.303,-24,185,8,121,H1
"Washington County, CO",2002-2003,5035,5028,-7,-0.139,5,-12,8,121,H1
"Washington County, CO",2003-2004,5028,4923,-105,-2.088,-18,-87,8,121,H1
"Washington County, CO",2004-2005,4923,4912,-11,-0.223,-2,-9,8,121,H1
"Washington County, CO",2005-2006,4912,4907,-5,-0.102,-14,9,8,121,H1
"Washington County, CO",2006-2007,4907,4883,-24,-0.489,5,-29,8,121,H1
"Washington County, CO",2007-2008,4883,4792,-91,-1.864,1,-92,8,121,H1
"Washington County, CO",2008-2009,4792,4800,8,0.167,-12,20,8,121,H1
"Washington County, CO",2009-2010,4800,4805,5,0.104,-29,34,8,121,H1
"Washington County, CO",2010-2011,4805,4808,3,0.062,-12,15,8,121,H1
"Washington County, CO",2011-2012,4808,4736,-72,-1.498,-11,-61,8,121,H1
"Washington County, CO",2012-2013,4736,4774,38,0.802,1,37,8,121,H1
"Washington County, CO",2013-2014,4774,4780,6,0.126,-6,12,8,121,H1
"Washington County, CO",2014-2015,4786,4864,78,1.63,-2,80,8,121,H1
"Washington County, CO",2015-2016,4864,4846,-18,-0.37,-2,-16,8,121,H1
"Washington County, CO",2016-2017,4846,4938,92,1.898,8,84,8,121,H1
"Weld County, CO",2000-2001,182782,192278,9496,5.195,1999,7497,8,123,H1
"Weld County, CO",2001-2002,192278,202234,9956,5.178,2205,7751,8,123,H1
"Weld County, CO",2002-2003,202234,208858,6624,3.275,2417,4207,8,123,H1
"Weld County, CO",2003-2004,208858,215322,6464,3.095,2684,3780,8,123,H1
"Weld County, CO",2004-2005,215322,222879,7557,3.51,2578,4979,8,123,H1
"Weld County, CO",2005-2006,222879,230703,7824,3.51,2786,5038,8,123,H1
"Weld County, CO",2006-2007,230703,237692,6989,3.029,2797,4192,8,123,H1
"Weld County, CO",2007-2008,237692,243442,5750,2.419,2664,3086,8,123,H1
"Weld County, CO",2008-2009,243442,248193,4751,1.952,2868,1883,8,123,H1
"Weld County, CO",2009-2010,248193,254173,5980,2.409,2662,3318,8,123,H1
"Weld County, CO",2010-2011,254173,258737,4564,1.796,2310,2254,8,123,H1
"Weld County, CO",2011-2012,258737,264189,5452,2.107,2335,3117,8,123,H1
"Weld County, CO",2012-2013,264189,270560,6371,2.412,2350,4021,8,123,H1
"Weld County, CO",2013-2014,270560,277670,7110,2.628,2434,4676,8,123,H1
"Weld County, CO",2014-2015,276379,285174,8795,3.182,2407,6388,8,123,H1
"Weld County, CO",2015-2016,285174,294243,9069,3.18,2546,6523,8,123,H1
"Weld County, CO",2016-2017,294243,304633,10390,3.531,2727,7663,8,123,H1
"Yuma County, CO",2000-2001,9823,9822,-1,-0.01,27,-28,8,125,H1
"Yuma County, CO",2001-2002,9822,9762,-60,-0.611,5,-65,8,125,H1
"Yuma County, CO",2002-2003,9762,9923,161,1.649,57,104,8,125,H1
"Yuma County, CO",2003-2004,9923,9791,-132,-1.33,36,-168,8,125,H1
"Yuma County, CO",2004-2005,9791,9765,-26,-0.266,34,-60,8,125,H1
"Yuma County, CO",2005-2006,9765,9784,19,0.195,40,-21,8,125,H1
"Yuma County, CO",2006-2007,9784,9788,4,0.041,58,-54,8,125,H1
"Yuma County, CO",2007-2008,9788,9843,55,0.562,55,0,8,125,H1
"Yuma County, CO",2008-2009,9843,10022,179,1.819,40,139,8,125,H1
"Yuma County, CO",2009-2010,10022,10016,-6,-0.06,33,-39,8,125,H1
"Yuma County, CO",2010-2011,10016,10156,140,1.398,37,103,8,125,H1
"Yuma County, CO",2011-2012,10156,10117,-39,-0.384,43,-82,8,125,H1
"Yuma County, CO",2012-2013,10117,10163,46,0.455,56,-10,8,125,H1
"Yuma County, CO",2013-2014,10163,10202,39,0.384,66,-27,8,125,H1
"Yuma County, CO",2014-2015,10257,10146,-111,-1.082,54,-165,8,125,H1
"Yuma County, CO",2015-2016,10146,10118,-28,-0.276,42,-70,8,125,H1
"Yuma County, CO",2016-2017,10118,10075,-43,-0.425,57,-100,8,125,H1
Connecticut,2000-2001,3411777,3432835,21058,0.617,12427,8631,9,0,STATE
Connecticut,2001-2002,3432835,3458749,25914,0.755,12561,13353,9,0,STATE
Connecticut,2002-2003,3458749,3484336,25587,0.74,12814,12773,9,0,STATE
Connecticut,2003-2004,3484336,3496094,11758,0.337,12827,-1069,9,0,STATE
Connecticut,2004-2005,3496094,3506956,10862,0.311,12213,-1351,9,0,STATE
Connecticut,2005-2006,3506956,3517460,10504,0.3,12328,-1824,9,0,STATE
Connecticut,2006-2007,3517460,3527270,9810,0.279,13160,-3350,9,0,STATE
Connecticut,2007-2008,3527270,3545579,18309,0.519,12466,5843,9,0,STATE
Connecticut,2008-2009,3545579,3561807,16228,0.458,12170,4058,9,0,STATE
Connecticut,2009-2010,3561807,3579717,17910,0.503,10203,7707,9,0,STATE
Connecticut,2010-2011,3579717,3589759,10042,0.281,8315,1727,9,0,STATE
Connecticut,2011-2012,3589759,3593541,3782,0.105,7753,-3971,9,0,STATE
Connecticut,2012-2013,3593541,3597168,3627,0.101,6350,-2723,9,0,STATE
Connecticut,2013-2014,3597168,3594762,-2406,-0.067,6440,-8846,9,0,STATE
Connecticut,2014-2015,3594762,3590886,-3876,-0.108,6631,-10507,9,0,STATE
Connecticut,2015-2016,3590886,3587685,-3201,-0.089,4952,-8153,9,0,STATE
Connecticut,2016-2017,3587685,3588184,499,0.014,4938,-4439,9,0,STATE
"Fairfield County, CT",2000-2001,884364,889063,4699,0.531,5242,-543,9,1,H4
"Fairfield County, CT",2001-2002,889063,892900,3837,0.432,4886,-1049,9,1,H4
"Fairfield County, CT",2002-2003,892900,896342,3442,0.385,5074,-1632,9,1,H4
"Fairfield County, CT",2003-2004,896342,897472,1130,0.126,5260,-4130,9,1,H4
"Fairfield County, CT",2004-2005,897472,897653,181,0.02,5029,-4848,9,1,H4
"Fairfield County, CT",2005-2006,897653,896254,-1399,-0.156,5078,-6477,9,1,H4
"Fairfield County, CT",2006-2007,896254,897498,1244,0.139,5111,-3867,9,1,H4
"Fairfield County, CT",2007-2008,897498,903824,6326,0.705,4664,1662,9,1,H4
"Fairfield County, CT",2008-2009,903824,910421,6597,0.73,4403,2194,9,1,H4
"Fairfield County, CT",2009-2010,910421,919506,9085,0.998,4083,5002,9,1,H4
"Fairfield County, CT",2010-2011,919506,928722,9216,1.002,3934,5282,9,1,H4
"Fairfield County, CT",2011-2012,928722,935290,6568,0.707,3836,2732,9,1,H4
"Fairfield County, CT",2012-2013,935290,942119,6829,0.73,3375,3454,9,1,H4
"Fairfield County, CT",2013-2014,942119,945438,3319,0.352,3508,-189,9,1,H4
"Fairfield County, CT",2014-2015,945816,948053,2237,0.237,3474,-1237,9,1,H4
"Fairfield County, CT",2015-2016,948053,949191,1138,0.12,3221,-2083,9,1,H4
"Fairfield County, CT",2016-2017,949191,949921,730,0.077,3147,-2417,9,1,H4
"Hartford County, CT",2000-2001,858416,862573,4157,0.484,2383,1774,9,3,H4
"Hartford County, CT",2001-2002,862573,867451,4878,0.566,2761,2117,9,3,H4
"Hartford County, CT",2002-2003,867451,873335,5884,0.678,2332,3552,9,3,H4
"Hartford County, CT",2003-2004,873335,874449,1114,0.128,2758,-1644,9,3,H4
"Hartford County, CT",2004-2005,874449,878081,3632,0.415,2451,1181,9,3,H4
"Hartford County, CT",2005-2006,878081,881298,3217,0.366,2391,826,9,3,H4
"Hartford County, CT",2006-2007,881298,884548,3250,0.369,2926,324,9,3,H4
"Hartford County, CT",2007-2008,884548,887891,3343,0.378,2706,637,9,3,H4
"Hartford County, CT",2008-2009,887891,891667,3776,0.425,2872,904,9,3,H4
"Hartford County, CT",2009-2010,891667,895197,3530,0.396,2507,1023,9,3,H4
"Hartford County, CT",2010-2011,895197,897142,1945,0.217,1801,144,9,3,H4
"Hartford County, CT",2011-2012,897142,897698,556,0.062,1739,-1183,9,3,H4
"Hartford County, CT",2012-2013,897698,898848,1150,0.128,1640,-490,9,3,H4
"Hartford County, CT",2013-2014,898848,897985,-863,-0.096,1589,-2452,9,3,H4
"Hartford County, CT",2014-2015,896871,895841,-1030,-0.115,1480,-2510,9,3,H4
"Hartford County, CT",2015-2016,895841,895497,-344,-0.038,1009,-1353,9,3,H4
"Hartford County, CT",2016-2017,895497,895388,-109,-0.012,1044,-1153,9,3,H4
"Litchfield County, CT",2000-2001,182597,184118,1521,0.833,377,1144,9,5,H4
"Litchfield County, CT",2001-2002,184118,185974,1856,1.008,225,1631,9,5,H4
"Litchfield County, CT",2002-2003,185974,187424,1450,0.78,221,1229,9,5,H4
"Litchfield County, CT",2003-2004,187424,188601,1177,0.628,230,947,9,5,H4
"Litchfield County, CT",2004-2005,188601,188912,311,0.165,175,136,9,5,H4
"Litchfield County, CT",2005-2006,188912,189682,770,0.408,151,619,9,5,H4
"Litchfield County, CT",2006-2007,189682,189866,184,0.097,166,18,9,5,H4
"Litchfield County, CT",2007-2008,189866,190175,309,0.163,130,179,9,5,H4
"Litchfield County, CT",2008-2009,190175,190015,-160,-0.084,161,-321,9,5,H4
"Litchfield County, CT",2009-2010,190015,189742,-273,-0.144,-57,-216,9,5,H4
"Litchfield County, CT",2010-2011,189742,188898,-844,-0.445,-116,-728,9,5,H4
"Litchfield County, CT",2011-2012,188898,187415,-1483,-0.785,-281,-1202,9,5,H4
"Litchfield County, CT",2012-2013,187415,186660,-755,-0.403,-365,-390,9,5,H4
"Litchfield County, CT",2013-2014,186660,184993,-1667,-0.893,-335,-1332,9,5,H4
"Litchfield County, CT",2014-2015,184910,183603,-1307,-0.707,-309,-998,9,5,H4
"Litchfield County, CT",2015-2016,183603,183097,-506,-0.276,-348,-158,9,5,H4
"Litchfield County, CT",2016-2017,183097,182177,-920,-0.502,-349,-571,9,5,H4
"Middlesex County, CT",2000-2001,155593,157006,1413,0.908,425,988,9,7,H4
"Middlesex County, CT",2001-2002,157006,159187,2181,1.389,498,1683,9,7,H4
"Middlesex County, CT",2002-2003,159187,160864,1677,1.053,459,1218,9,7,H4
"Middlesex County, CT",2003-2004,160864,161450,586,0.364,420,166,9,7,H4
"Middlesex County, CT",2004-2005,161450,162191,741,0.459,430,311,9,7,H4
"Middlesex County, CT",2005-2006,162191,163473,1282,0.79,385,897,9,7,H4
"Middlesex County, CT",2006-2007,163473,164129,656,0.401,359,297,9,7,H4
"Middlesex County, CT",2007-2008,164129,164962,833,0.508,263,570,9,7,H4
"Middlesex County, CT",2008-2009,164962,165607,645,0.391,291,354,9,7,H4
"Middlesex County, CT",2009-2010,165607,165625,18,0.011,159,-141,9,7,H4
"Middlesex County, CT",2010-2011,165625,166195,570,0.344,76,494,9,7,H4
"Middlesex County, CT",2011-2012,166195,165520,-675,-0.406,50,-725,9,7,H4
"Middlesex County, CT",2012-2013,165520,165389,-131,-0.079,-70,-61,9,7,H4
"Middlesex County, CT",2013-2014,165389,164943,-446,-0.27,4,-450,9,7,H4
"Middlesex County, CT",2014-2015,164757,164063,-694,-0.421,-29,-665,9,7,H4
"Middlesex County, CT",2015-2016,164063,163433,-630,-0.384,-121,-509,9,7,H4
"Middlesex County, CT",2016-2017,163433,163410,-23,-0.014,-126,103,9,7,H4
"New Haven County, CT",2000-2001,824911,829875,4964,0.602,2382,2582,9,9,H4
"New Haven County, CT",2001-2002,829875,835099,5224,0.629,2318,2906,9,9,H4
"New Haven County, CT",2002-2003,835099,841939,6840,0.819,2950,3890,9,9,H4
"New Haven County, CT",2003-2004,841939,844505,2566,0.305,2308,258,9,9,H4
"New Haven County, CT",2004-2005,844505,847162,2657,0.315,2343,314,9,9,H4
"New Haven County, CT",2005-2006,847162,850207,3045,0.359,2553,492,9,9,H4
"New Haven County, CT",2006-2007,850207,853598,3391,0.399,2942,449,9,9,H4
"New Haven County, CT",2007-2008,853598,856622,3024,0.354,2758,266,9,9,H4
"New Haven County, CT",2008-2009,856622,860025,3403,0.397,2693,710,9,9,H4
"New Haven County, CT",2009-2010,860025,863367,3342,0.389,2421,921,9,9,H4
"New Haven County, CT",2010-2011,863367,864049,682,0.079,1696,-1014,9,9,H4
"New Haven County, CT",2011-2012,864049,864031,-18,-0.002,1468,-1486,9,9,H4
"New Haven County, CT",2012-2013,864031,863016,-1015,-0.117,1423,-2438,9,9,H4
"New Haven County, CT",2013-2014,863016,861277,-1739,-0.202,1349,-3088,9,9,H4
"New Haven County, CT",2014-2015,861238,859470,-1768,-0.205,1372,-3140,9,9,H4
"New Haven County, CT",2015-2016,859470,859973,503,0.059,880,-377,9,9,H4
"New Haven County, CT",2016-2017,859973,860435,462,0.054,1015,-553,9,9,H4
"New London County, CT",2000-2001,259848,261396,1548,0.596,764,784,9,11,H4
"New London County, CT",2001-2002,261396,264698,3302,1.263,1038,2264,9,11,H4
"New London County, CT",2002-2003,264698,266584,1886,0.713,934,952,9,11,H4
"New London County, CT",2003-2004,266584,268595,2011,0.754,981,1030,9,11,H4
"New London County, CT",2004-2005,268595,269664,1069,0.398,875,194,9,11,H4
"New London County, CT",2005-2006,269664,270814,1150,0.426,887,263,9,11,H4
"New London County, CT",2006-2007,270814,270669,-145,-0.054,829,-974,9,11,H4
"New London County, CT",2007-2008,270669,272634,1965,0.726,987,978,9,11,H4
"New London County, CT",2008-2009,272634,273630,996,0.365,881,115,9,11,H4
"New London County, CT",2009-2010,273630,274102,472,0.172,581,-109,9,11,H4
"New London County, CT",2010-2011,274102,274056,-46,-0.017,535,-581,9,11,H4
"New London County, CT",2011-2012,274056,274544,488,0.178,552,-64,9,11,H4
"New London County, CT",2012-2013,274544,273976,-568,-0.207,417,-985,9,11,H4
"New London County, CT",2013-2014,273976,273676,-300,-0.109,400,-700,9,11,H4
"New London County, CT",2014-2015,272743,271863,-880,-0.323,328,-1208,9,11,H4
"New London County, CT",2015-2016,271863,269307,-2556,-0.94,161,-2717,9,11,H4
"New London County, CT",2016-2017,269307,269033,-274,-0.102,43,-317,9,11,H4
"Tolland County, CT",2000-2001,136863,138934,2071,1.513,606,1465,9,13,H4
"Tolland County, CT",2001-2002,138934,142362,3428,2.467,609,2819,9,13,H4
"Tolland County, CT",2002-2003,142362,145195,2833,1.99,548,2285,9,13,H4
"Tolland County, CT",2003-2004,145195,146706,1511,1.041,512,999,9,13,H4
"Tolland County, CT",2004-2005,146706,147657,951,0.648,493,458,9,13,H4
"Tolland County, CT",2005-2006,147657,148954,1297,0.878,516,781,9,13,H4
"Tolland County, CT",2006-2007,148954,149718,764,0.513,436,328,9,13,H4
"Tolland County, CT",2007-2008,149718,151583,1865,1.246,483,1382,9,13,H4
"Tolland County, CT",2008-2009,151583,152330,747,0.493,445,302,9,13,H4
"Tolland County, CT",2009-2010,152330,153199,869,0.57,271,598,9,13,H4
"Tolland County, CT",2010-2011,153199,153056,-143,-0.093,173,-316,9,13,H4
"Tolland County, CT",2011-2012,153056,151925,-1131,-0.739,185,-1316,9,13,H4
"Tolland County, CT",2012-2013,151925,151706,-219,-0.144,188,-407,9,13,H4
"Tolland County, CT",2013-2014,151706,151367,-339,-0.223,177,-516,9,13,H4
"Tolland County, CT",2014-2015,151597,151420,-177,-0.117,141,-318,9,13,H4
"Tolland County, CT",2015-2016,151420,151145,-275,-0.182,107,-382,9,13,H4
"Tolland County, CT",2016-2017,151145,151461,316,0.209,115,201,9,13,H4
"Windham County, CT",2000-2001,109185,109870,685,0.627,248,437,9,15,H4
"Windham County, CT",2001-2002,109870,111078,1208,1.099,226,982,9,15,H4
"Windham County, CT",2002-2003,111078,112653,1575,1.418,296,1279,9,15,H4
"Windham County, CT",2003-2004,112653,114316,1663,1.476,358,1305,9,15,H4
"Windham County, CT",2004-2005,114316,115636,1320,1.155,417,903,9,15,H4
"Windham County, CT",2005-2006,115636,116778,1142,0.988,367,775,9,15,H4
"Windham County, CT",2006-2007,116778,117244,466,0.399,391,75,9,15,H4
"Windham County, CT",2007-2008,117244,117888,644,0.549,475,169,9,15,H4
"Windham County, CT",2008-2009,117888,118112,224,0.19,424,-200,9,15,H4
"Windham County, CT",2009-2010,118112,118607,495,0.419,238,257,9,15,H4
"Windham County, CT",2010-2011,118607,118419,-188,-0.159,211,-399,9,15,H4
"Windham County, CT",2011-2012,118419,117939,-480,-0.405,208,-688,9,15,H4
"Windham County, CT",2012-2013,117939,117627,-312,-0.265,273,-585,9,15,H4
"Windham County, CT",2013-2014,117627,116998,-629,-0.535,228,-857,9,15,H4
"Windham County, CT",2014-2015,116830,116573,-257,-0.22,174,-431,9,15,H4
"Windham County, CT",2015-2016,116573,116042,-531,-0.456,43,-574,9,15,H4
"Windham County, CT",2016-2017,116042,116359,317,0.273,49,268,9,15,H4
Delaware,2000-2001,786373,795699,9326,1.186,3863,5463,10,0,STATE
Delaware,2001-2002,795699,806169,10470,1.316,3938,6532,10,0,STATE
Delaware,2002-2003,806169,818003,11834,1.468,4334,7500,10,0,STATE
Delaware,2003-2004,818003,830803,12800,1.565,4183,8617,10,0,STATE
Delaware,2004-2005,830803,845150,14347,1.727,4124,10223,10,0,STATE
Delaware,2005-2006,845150,859268,14118,1.67,4648,9470,10,0,STATE
Delaware,2006-2007,859268,871749,12481,1.453,4887,7594,10,0,STATE
Delaware,2007-2008,871749,883874,12125,1.391,4771,7354,10,0,STATE
Delaware,2008-2009,883874,891730,7856,0.889,4271,3585,10,0,STATE
Delaware,2009-2010,891730,899791,8061,0.904,4104,3957,10,0,STATE
Delaware,2010-2011,899791,907916,8125,0.903,3424,4701,10,0,STATE
Delaware,2011-2012,907916,917099,9183,1.011,3460,5723,10,0,STATE
Delaware,2012-2013,917099,925353,8254,0.9,2792,5462,10,0,STATE
Delaware,2013-2014,925353,935968,10615,1.147,2700,7915,10,0,STATE
Delaware,2014-2015,935968,945934,9966,1.065,2588,7378,10,0,STATE
Delaware,2015-2016,945934,952698,6764,0.715,2357,4407,10,0,STATE
Delaware,2016-2017,952698,961939,9241,0.97,2005,7236,10,0,STATE
"Kent County, DE",2000-2001,127229,129228,1999,1.571,876,1123,10,1,H1
"Kent County, DE",2001-2002,129228,131824,2596,2.009,772,1824,10,1,H1
"Kent County, DE",2002-2003,131824,134605,2781,2.11,837,1944,10,1,H1
"Kent County, DE",2003-2004,134605,139342,4737,3.519,896,3841,10,1,H1
"Kent County, DE",2004-2005,139342,144585,5243,3.763,901,4342,10,1,H1
"Kent County, DE",2005-2006,144585,149704,5119,3.54,1021,4098,10,1,H1
"Kent County, DE",2006-2007,149704,153969,4265,2.849,961,3304,10,1,H1
"Kent County, DE",2007-2008,153969,157925,3956,2.569,1021,2935,10,1,H1
"Kent County, DE",2008-2009,157925,160081,2156,1.365,1009,1147,10,1,H1
"Kent County, DE",2009-2010,160081,162954,2873,1.795,978,1895,10,1,H1
"Kent County, DE",2010-2011,162954,165214,2260,1.387,822,1438,10,1,H1
"Kent County, DE",2011-2012,165214,167666,2452,1.484,792,1660,10,1,H1
"Kent County, DE",2012-2013,167666,169562,1896,1.131,652,1244,10,1,H1
"Kent County, DE",2013-2014,169562,171987,2425,1.43,677,1748,10,1,H1
"Kent County, DE",2014-2015,171773,173533,1760,1.025,611,1149,10,1,H1
"Kent County, DE",2015-2016,173533,174754,1221,0.704,625,596,10,1,H1
"Kent County, DE",2016-2017,174754,176824,2070,1.185,505,1565,10,1,H1
"New Castle County, DE",2000-2001,501837,506026,4189,0.835,2725,1464,10,3,H1
"New Castle County, DE",2001-2002,506026,510158,4132,0.817,2855,1277,10,3,H1
"New Castle County, DE",2002-2003,510158,514769,4611,0.904,3168,1443,10,3,H1
"New Castle County, DE",2003-2004,514769,518944,4175,0.811,3010,1165,10,3,H1
"New Castle County, DE",2004-2005,518944,523343,4399,0.848,2863,1536,10,3,H1
"New Castle County, DE",2005-2006,523343,527174,3831,0.732,3226,605,10,3,H1
"New Castle County, DE",2006-2007,527174,530555,3381,0.641,3309,72,10,3,H1
"New Castle County, DE",2007-2008,530555,533958,3403,0.641,3091,312,10,3,H1
"New Castle County, DE",2008-2009,533958,536898,2940,0.551,2890,50,10,3,H1
"New Castle County, DE",2009-2010,536898,538873,1975,0.368,2930,-955,10,3,H1
"New Castle County, DE",2010-2011,538873,542324,3451,0.64,2480,971,10,3,H1
"New Castle County, DE",2011-2012,542324,546021,3697,0.682,2515,1182,10,3,H1
"New Castle County, DE",2012-2013,546021,549233,3212,0.588,2220,992,10,3,H1
"New Castle County, DE",2013-2014,549233,552778,3545,0.645,2207,1338,10,3,H1
"New Castle County, DE",2014-2015,553347,556779,3432,0.62,2131,1301,10,3,H1
"New Castle County, DE",2015-2016,556779,557851,1072,0.193,1844,-772,10,3,H1
"New Castle County, DE",2016-2017,557851,559793,1942,0.348,1813,129,10,3,H1
"Sussex County, DE",2000-2001,157307,160445,3138,1.995,262,2876,10,5,H1
"Sussex County, DE",2001-2002,160445,164187,3742,2.332,311,3431,10,5,H1
"Sussex County, DE",2002-2003,164187,168629,4442,2.705,329,4113,10,5,H1
"Sussex County, DE",2003-2004,168629,172517,3888,2.306,277,3611,10,5,H1
"Sussex County, DE",2004-2005,172517,177222,4705,2.727,360,4345,10,5,H1
"Sussex County, DE",2005-2006,177222,182390,5168,2.916,401,4767,10,5,H1
"Sussex County, DE",2006-2007,182390,187225,4835,2.651,617,4218,10,5,H1
"Sussex County, DE",2007-2008,187225,191991,4766,2.546,659,4107,10,5,H1
"Sussex County, DE",2008-2009,191991,194751,2760,1.438,372,2388,10,5,H1
"Sussex County, DE",2009-2010,194751,197904,3153,1.619,196,2957,10,5,H1
"Sussex County, DE",2010-2011,197904,200291,2387,1.206,122,2265,10,5,H1
"Sussex County, DE",2011-2012,200291,203194,2903,1.449,151,2752,10,5,H1
"Sussex County, DE",2012-2013,203194,206445,3251,1.6,-11,3262,10,5,H1
"Sussex County, DE",2013-2014,206445,210849,4404,2.133,-28,4432,10,5,H1
"Sussex County, DE",2014-2015,210848,215622,4774,2.264,-154,4928,10,5,H1
"Sussex County, DE",2015-2016,215622,220093,4471,2.074,-112,4583,10,5,H1
"Sussex County, DE",2016-2017,220093,225322,5229,2.376,-313,5542,10,5,H1
District of Columbia,2000-2001,572046,574504,2458,0.43,1699,759,11,0,STATE
District of Columbia,2001-2002,574504,573158,-1346,-0.234,1712,-3058,11,0,STATE
District of Columbia,2002-2003,573158,568502,-4656,-0.812,1802,-6458,11,0,STATE
District of Columbia,2003-2004,568502,567754,-748,-0.132,2268,-3016,11,0,STATE
District of Columbia,2004-2005,567754,567136,-618,-0.109,2445,-3063,11,0,STATE
District of Columbia,2005-2006,567136,570681,3545,0.625,2800,745,11,0,STATE
District of Columbia,2006-2007,570681,574404,3723,0.652,3693,30,11,0,STATE
District of Columbia,2007-2008,574404,580236,5832,1.015,3230,2602,11,0,STATE
District of Columbia,2008-2009,580236,592228,11992,2.067,2980,9012,11,0,STATE
District of Columbia,2009-2010,592228,605126,12898,2.178,2709,10189,11,0,STATE
District of Columbia,2010-2011,605126,620472,15346,2.536,4525,10821,11,0,STATE
District of Columbia,2011-2012,620472,635342,14870,2.397,4697,10173,11,0,STATE
District of Columbia,2012-2013,635342,649540,14198,2.235,4638,9560,11,0,STATE
District of Columbia,2013-2014,649540,659836,10296,1.585,4385,5911,11,0,STATE
District of Columbia,2014-2015,659836,672228,12392,1.878,4375,8017,11,0,STATE
District of Columbia,2015-2016,672228,684336,12108,1.801,4408,7700,11,0,STATE
District of Columbia,2016-2017,684336,693972,9636,1.408,4293,5343,11,0,STATE
"District of Columbia, DC",2000-2001,572046,574504,2458,0.43,1699,759,11,1,H6
"District of Columbia, DC",2001-2002,574504,573158,-1346,-0.234,1712,-3058,11,1,H6
"District of Columbia, DC",2002-2003,573158,568502,-4656,-0.812,1802,-6458,11,1,H6
"District of Columbia, DC",2003-2004,568502,567754,-748,-0.132,2268,-3016,11,1,H6
"District of Columbia, DC",2004-2005,567754,567136,-618,-0.109,2445,-3063,11,1,H6
"District of Columbia, DC",2005-2006,567136,570681,3545,0.625,2800,745,11,1,H6
"District of Columbia, DC",2006-2007,570681,574404,3723,0.652,3693,30,11,1,H6
"District of Columbia, DC",2007-2008,574404,580236,5832,1.015,3230,2602,11,1,H6
"District of Columbia, DC",2008-2009,580236,592228,11992,2.067,2980,9012,11,1,H6
"District of Columbia, DC",2009-2010,592228,605210,12982,2.192,2709,10273,11,1,H6
"District of Columbia, DC",2010-2011,605210,620427,15217,2.514,4521,10696,11,1,H6
"District of Columbia, DC",2011-2012,620427,635040,14613,2.355,4693,9920,11,1,H6
"District of Columbia, DC",2012-2013,635040,649111,14071,2.216,4549,9522,11,1,H6
"District of Columbia, DC",2013-2014,649111,658893,9782,1.507,4419,5363,11,1,H6
"District of Columbia, DC",2014-2015,659836,672228,12392,1.878,4375,8017,11,1,H6
"District of Columbia, DC",2015-2016,672228,684336,12108,1.801,4408,7700,11,1,H6
"District of Columbia, DC",2016-2017,684336,693972,9636,1.408,4293,5343,11,1,H6
Florida,2000-2001,16047515,16356966,309451,1.928,39152,270299,12,0,STATE
Florida,2001-2002,16356966,16689370,332404,2.032,37846,294558,12,0,STATE
Florida,2002-2003,16689370,17004085,314715,1.886,40767,273948,12,0,STATE
Florida,2003-2004,17004085,17415318,411233,2.418,45236,365997,12,0,STATE
Florida,2004-2005,17415318,17842038,426720,2.45,51644,375076,12,0,STATE
Florida,2005-2006,17842038,18166990,324952,1.821,60346,264606,12,0,STATE
Florida,2006-2007,18166990,18367842,200852,1.106,72823,128029,12,0,STATE
Florida,2007-2008,18367842,18527305,159463,0.868,64110,95353,12,0,STATE
Florida,2008-2009,18527305,18652644,125339,0.677,58169,67170,12,0,STATE
Florida,2009-2010,18652644,18849890,197246,1.057,60502,136744,12,0,STATE
Florida,2010-2011,18849890,19105533,255643,1.356,38713,216930,12,0,STATE
Florida,2011-2012,19105533,19352021,246488,1.29,40300,206188,12,0,STATE
Florida,2012-2013,19352021,19594467,242446,1.253,31388,211058,12,0,STATE
Florida,2013-2014,19594467,19905569,311102,1.588,30352,280750,12,0,STATE
Florida,2014-2015,19905569,20271272,365703,1.837,29893,335810,12,0,STATE
Florida,2015-2016,20271272,20656589,385317,1.901,25592,359725,12,0,STATE
Florida,2016-2017,20656589,20984400,327811,1.587,22019,305792,12,0,STATE
"Alachua County, FL",2000-2001,218611,221718,3107,1.421,982,2125,12,1,H1
"Alachua County, FL",2001-2002,221718,224614,2896,1.306,890,2006,12,1,H1
"Alachua County, FL",2002-2003,224614,227022,2408,1.072,869,1539,12,1,H1
"Alachua County, FL",2003-2004,227022,229867,2845,1.253,936,1909,12,1,H1
"Alachua County, FL",2004-2005,229867,233756,3889,1.692,1120,2769,12,1,H1
"Alachua County, FL",2005-2006,233756,239506,5750,2.46,1062,4688,12,1,H1
"Alachua County, FL",2006-2007,239506,242685,3179,1.327,1325,1854,12,1,H1
"Alachua County, FL",2007-2008,242685,244888,2203,0.908,1273,930,12,1,H1
"Alachua County, FL",2008-2009,244888,246657,1769,0.722,1337,432,12,1,H1
"Alachua County, FL",2009-2010,246657,247680,1023,0.415,1281,-258,12,1,H1
"Alachua County, FL",2010-2011,247680,249712,2032,0.82,1062,970,12,1,H1
"Alachua County, FL",2011-2012,249712,251713,2001,0.801,1333,668,12,1,H1
"Alachua County, FL",2012-2013,251713,253309,1596,0.634,1003,593,12,1,H1
"Alachua County, FL",2013-2014,253309,256380,3071,1.212,1009,2062,12,1,H1
"Alachua County, FL",2014-2015,256518,259964,3446,1.343,1029,2417,12,1,H1
"Alachua County, FL",2015-2016,259964,264341,4377,1.684,897,3480,12,1,H1
"Alachua County, FL",2016-2017,264341,266944,2603,0.985,882,1721,12,1,H1
"Baker County, FL",2000-2001,22374,22620,246,1.099,168,78,12,3,H1
"Baker County, FL",2001-2002,22620,23298,678,2.997,149,529,12,3,H1
"Baker County, FL",2002-2003,23298,23555,257,1.103,163,94,12,3,H1
"Baker County, FL",2003-2004,23555,24142,587,2.492,151,436,12,3,H1
"Baker County, FL",2004-2005,24142,24832,690,2.858,216,474,12,3,H1
"Baker County, FL",2005-2006,24832,25571,739,2.976,179,560,12,3,H1
"Baker County, FL",2006-2007,25571,26212,641,2.507,175,466,12,3,H1
"Baker County, FL",2007-2008,26212,26725,513,1.957,190,323,12,3,H1
"Baker County, FL",2008-2009,26725,27124,399,1.493,185,214,12,3,H1
"Baker County, FL",2009-2010,27124,27072,-52,-0.192,150,-202,12,3,H1
"Baker County, FL",2010-2011,27072,27064,-8,-0.03,132,-140,12,3,H1
"Baker County, FL",2011-2012,27064,27041,-23,-0.085,118,-141,12,3,H1
"Baker County, FL",2012-2013,27041,27017,-24,-0.089,113,-137,12,3,H1
"Baker County, FL",2013-2014,27017,27093,76,0.281,119,-43,12,3,H1
"Baker County, FL",2014-2015,27135,27420,285,1.05,135,150,12,3,H1
"Baker County, FL",2015-2016,27420,27915,495,1.805,137,358,12,3,H1
"Baker County, FL",2016-2017,27915,28283,368,1.318,101,267,12,3,H1
"Bay County, FL",2000-2001,148393,150207,1814,1.222,633,1181,12,5,H1
"Bay County, FL",2001-2002,150207,152741,2534,1.687,398,2136,12,5,H1
"Bay County, FL",2002-2003,152741,155044,2303,1.508,587,1716,12,5,H1
"Bay County, FL",2003-2004,155044,158804,3760,2.425,651,3109,12,5,H1
"Bay County, FL",2004-2005,158804,162917,4113,2.59,903,3210,12,5,H1
"Bay County, FL",2005-2006,162917,165644,2727,1.674,819,1908,12,5,H1
"Bay County, FL",2006-2007,165644,165345,-299,-0.181,878,-1177,12,5,H1
"Bay County, FL",2007-2008,165345,166267,922,0.558,823,99,12,5,H1
"Bay County, FL",2008-2009,166267,167464,1197,0.72,828,369,12,5,H1
"Bay County, FL",2009-2010,167464,169294,1830,1.093,846,984,12,5,H1
"Bay County, FL",2010-2011,169294,169700,406,0.24,507,-101,12,5,H1
"Bay County, FL",2011-2012,169700,171994,2294,1.352,713,1581,12,5,H1
"Bay County, FL",2012-2013,171994,174966,2972,1.728,464,2508,12,5,H1
"Bay County, FL",2013-2014,174966,178985,4019,2.297,500,3519,12,5,H1
"Bay County, FL",2014-2015,178703,181635,2932,1.641,478,2454,12,5,H1
"Bay County, FL",2015-2016,181635,182992,1357,0.747,477,880,12,5,H1
"Bay County, FL",2016-2017,182992,183563,571,0.312,417,154,12,5,H1
"Bradford County, FL",2000-2001,26064,26083,19,0.073,58,-39,12,7,H1
"Bradford County, FL",2001-2002,26083,26306,223,0.855,45,178,12,7,H1
"Bradford County, FL",2002-2003,26306,27035,729,2.771,31,698,12,7,H1
"Bradford County, FL",2003-2004,27035,27703,668,2.471,45,623,12,7,H1
"Bradford County, FL",2004-2005,27703,28098,395,1.426,68,327,12,7,H1
"Bradford County, FL",2005-2006,28098,28506,408,1.452,74,334,12,7,H1
"Bradford County, FL",2006-2007,28506,28825,319,1.119,107,212,12,7,H1
"Bradford County, FL",2007-2008,28825,28961,136,0.472,81,55,12,7,H1
"Bradford County, FL",2008-2009,28961,28979,18,0.062,89,-71,12,7,H1
"Bradford County, FL",2009-2010,28979,28544,-435,-1.501,51,-486,12,7,H1
"Bradford County, FL",2010-2011,28544,28476,-68,-0.238,45,-113,12,7,H1
"Bradford County, FL",2011-2012,28476,27132,-1344,-4.72,59,-1403,12,7,H1
"Bradford County, FL",2012-2013,27132,26907,-225,-0.829,38,-263,12,7,H1
"Bradford County, FL",2013-2014,26907,26702,-205,-0.762,-11,-194,12,7,H1
"Bradford County, FL",2014-2015,26681,26928,247,0.926,-17,264,12,7,H1
"Bradford County, FL",2015-2016,26928,26728,-200,-0.743,-1,-199,12,7,H1
"Bradford County, FL",2016-2017,26728,27038,310,1.16,-36,346,12,7,H1
"Brevard County, FL",2000-2001,477819,486429,8610,1.802,-284,8894,12,9,H1
"Brevard County, FL",2001-2002,486429,495425,8996,1.849,-636,9632,12,9,H1
"Brevard County, FL",2002-2003,495425,504847,9422,1.902,-567,9989,12,9,H1
"Brevard County, FL",2003-2004,504847,518722,13875,2.748,-504,14379,12,9,H1
"Brevard County, FL",2004-2005,518722,529907,11185,2.156,-353,11538,12,9,H1
"Brevard County, FL",2005-2006,529907,535138,5231,0.987,-298,5529,12,9,H1
"Brevard County, FL",2006-2007,535138,539719,4581,0.856,88,4493,12,9,H1
"Brevard County, FL",2007-2008,539719,542378,2659,0.493,-52,2711,12,9,H1
"Brevard County, FL",2008-2009,542378,542109,-269,-0.05,-268,-1,12,9,H1
"Brevard County, FL",2009-2010,542109,544029,1920,0.354,-510,2430,12,9,H1
"Brevard County, FL",2010-2011,544029,544431,402,0.074,-1145,1547,12,9,H1
"Brevard County, FL",2011-2012,544431,547669,3238,0.595,-993,4231,12,9,H1
"Brevard County, FL",2012-2013,547669,551440,3771,0.689,-1623,5394,12,9,H1
"Brevard County, FL",2013-2014,551440,556885,5445,0.987,-1469,6914,12,9,H1
"Brevard County, FL",2014-2015,556902,568088,11186,2.009,-1421,12607,12,9,H1
"Brevard County, FL",2015-2016,568088,577899,9811,1.727,-2060,11871,12,9,H1
"Brevard County, FL",2016-2017,577899,589162,11263,1.949,-1899,13162,12,9,H1
"Broward County, FL",2000-2001,1630600,1662848,32248,1.978,6167,26081,12,11,H1
"Broward County, FL",2001-2002,1662848,1690118,27270,1.64,6087,21183,12,11,H1
"Broward County, FL",2002-2003,1690118,1707543,17425,1.031,6247,11178,12,11,H1
"Broward County, FL",2003-2004,1707543,1725461,17918,1.049,6958,10960,12,11,H1
"Broward County, FL",2004-2005,1725461,1746896,21435,1.242,7728,13707,12,11,H1
"Broward County, FL",2005-2006,1746896,1739348,-7548,-0.432,7766,-15314,12,11,H1
"Broward County, FL",2006-2007,1739348,1720825,-18523,-1.065,8442,-26965,12,11,H1
"Broward County, FL",2007-2008,1720825,1723633,2808,0.163,7988,-5180,12,11,H1
"Broward County, FL",2008-2009,1723633,1733310,9677,0.561,7343,2334,12,11,H1
"Broward County, FL",2009-2010,1733310,1753576,20266,1.169,8901,11365,12,11,H1
"Broward County, FL",2010-2011,1753576,1788367,34791,1.984,6658,28133,12,11,H1
"Broward County, FL",2011-2012,1788367,1819773,31406,1.756,6943,24463,12,11,H1
"Broward County, FL",2012-2013,1819773,1845393,25620,1.408,6642,18978,12,11,H1
"Broward County, FL",2013-2014,1845393,1869235,23842,1.292,6285,17557,12,11,H1
"Broward County, FL",2014-2015,1869679,1896425,26746,1.431,6948,19798,12,11,H1
"Broward County, FL",2015-2016,1896425,1917122,20697,1.091,7050,13647,12,11,H1
"Broward County, FL",2016-2017,1917122,1935878,18756,0.978,6387,12369,12,11,H1
"Calhoun County, FL",2000-2001,13040,12847,-193,-1.48,-10,-183,12,13,H1
"Calhoun County, FL",2001-2002,12847,12947,100,0.778,9,91,12,13,H1
"Calhoun County, FL",2002-2003,12947,13293,346,2.672,7,339,12,13,H1
"Calhoun County, FL",2003-2004,13293,13445,152,1.143,0,152,12,13,H1
"Calhoun County, FL",2004-2005,13445,13850,405,3.012,5,400,12,13,H1
"Calhoun County, FL",2005-2006,13850,13997,147,1.061,40,107,12,13,H1
"Calhoun County, FL",2006-2007,13997,14222,225,1.607,5,220,12,13,H1
"Calhoun County, FL",2007-2008,14222,14351,129,0.907,18,111,12,13,H1
"Calhoun County, FL",2008-2009,14351,14692,341,2.376,17,324,12,13,H1
"Calhoun County, FL",2009-2010,14692,14635,-57,-0.388,12,-69,12,13,H1
"Calhoun County, FL",2010-2011,14635,14763,128,0.875,-29,157,12,13,H1
"Calhoun County, FL",2011-2012,14763,14709,-54,-0.366,12,-66,12,13,H1
"Calhoun County, FL",2012-2013,14709,14647,-62,-0.422,9,-71,12,13,H1
"Calhoun County, FL",2013-2014,14647,14532,-115,-0.785,5,-120,12,13,H1
"Calhoun County, FL",2014-2015,14511,14462,-49,-0.338,-24,-25,12,13,H1
"Calhoun County, FL",2015-2016,14462,14361,-101,-0.698,-25,-76,12,13,H1
"Calhoun County, FL",2016-2017,14361,14483,122,0.85,-15,137,12,13,H1
"Charlotte County, FL",2000-2001,142266,146311,4045,2.843,-1100,5145,12,15,H1
"Charlotte County, FL",2001-2002,146311,150123,3812,2.605,-1177,4989,12,15,H1
"Charlotte County, FL",2002-2003,150123,153235,3112,2.073,-1150,4262,12,15,H1
"Charlotte County, FL",2003-2004,153235,157755,4520,2.95,-1283,5803,12,15,H1
"Charlotte County, FL",2004-2005,157755,155262,-2493,-1.58,-1190,-1303,12,15,H1
"Charlotte County, FL",2005-2006,155262,157099,1837,1.183,-924,2761,12,15,H1
"Charlotte County, FL",2006-2007,157099,159742,2643,1.682,-986,3629,12,15,H1
"Charlotte County, FL",2007-2008,159742,160467,725,0.454,-926,1651,12,15,H1
"Charlotte County, FL",2008-2009,160467,159629,-838,-0.522,-1076,238,12,15,H1
"Charlotte County, FL",2009-2010,159629,159927,298,0.187,-1189,1487,12,15,H1
"Charlotte County, FL",2010-2011,159927,159613,-314,-0.196,-1276,962,12,15,H1
"Charlotte County, FL",2011-2012,159613,162792,3179,1.992,-1190,4369,12,15,H1
"Charlotte County, FL",2012-2013,162792,164948,2156,1.324,-1351,3507,12,15,H1
"Charlotte County, FL",2013-2014,164948,168474,3526,2.138,-1383,4909,12,15,H1
"Charlotte County, FL",2014-2015,168437,173115,4678,2.777,-1451,6129,12,15,H1
"Charlotte County, FL",2015-2016,173115,178157,5042,2.913,-1559,6601,12,15,H1
"Charlotte County, FL",2016-2017,178157,182033,3876,2.176,-1618,5494,12,15,H1
"Citrus County, FL",2000-2001,118649,121197,2548,2.148,-1205,3753,12,17,H1
"Citrus County, FL",2001-2002,121197,123491,2294,1.893,-1183,3477,12,17,H1
"Citrus County, FL",2002-2003,123491,126215,2724,2.206,-1268,3992,12,17,H1
"Citrus County, FL",2003-2004,126215,129840,3625,2.872,-1235,4860,12,17,H1
"Citrus County, FL",2004-2005,129840,133791,3951,3.043,-1194,5145,12,17,H1
"Citrus County, FL",2005-2006,133791,137826,4035,3.016,-1195,5230,12,17,H1
"Citrus County, FL",2006-2007,137826,140974,3148,2.284,-1062,4210,12,17,H1
"Citrus County, FL",2007-2008,140974,142122,1148,0.814,-1168,2316,12,17,H1
"Citrus County, FL",2008-2009,142122,141381,-741,-0.521,-1185,444,12,17,H1
"Citrus County, FL",2009-2010,141381,141283,-98,-0.069,-1162,1064,12,17,H1
"Citrus County, FL",2010-2011,141283,139773,-1510,-1.069,-1219,-291,12,17,H1
"Citrus County, FL",2011-2012,139773,139290,-483,-0.346,-1244,761,12,17,H1
"Citrus County, FL",2012-2013,139290,139134,-156,-0.112,-1384,1228,12,17,H1
"Citrus County, FL",2013-2014,139134,139377,243,0.175,-1401,1644,12,17,H1
"Citrus County, FL",2014-2015,139217,141058,1841,1.322,-1466,3307,12,17,H1
"Citrus County, FL",2015-2016,141058,142990,1932,1.37,-1495,3427,12,17,H1
"Citrus County, FL",2016-2017,142990,145647,2657,1.858,-1481,4138,12,17,H1
"Clay County, FL",2000-2001,141629,145685,4056,2.864,722,3334,12,19,H1
"Clay County, FL",2001-2002,145685,150947,5262,3.612,703,4559,12,19,H1
"Clay County, FL",2002-2003,150947,155620,4673,3.096,848,3825,12,19,H1
"Clay County, FL",2003-2004,155620,163238,7618,4.895,916,6702,12,19,H1
"Clay County, FL",2004-2005,163238,169418,6180,3.786,850,5330,12,19,H1
"Clay County, FL",2005-2006,169418,178339,8921,5.266,1027,7894,12,19,H1
"Clay County, FL",2006-2007,178339,184256,5917,3.318,1113,4804,12,19,H1
"Clay County, FL",2007-2008,184256,187289,3033,1.646,1012,2021,12,19,H1
"Clay County, FL",2008-2009,187289,189101,1812,0.967,1093,719,12,19,H1
"Clay County, FL",2009-2010,189101,191423,2322,1.228,931,1391,12,19,H1
"Clay County, FL",2010-2011,191423,192291,868,0.453,624,244,12,19,H1
"Clay County, FL",2011-2012,192291,194294,2003,1.042,597,1406,12,19,H1
"Clay County, FL",2012-2013,194294,196535,2241,1.153,536,1705,12,19,H1
"Clay County, FL",2013-2014,196535,199798,3263,1.66,502,2761,12,19,H1
"Clay County, FL",2014-2015,199876,203967,4091,2.047,509,3582,12,19,H1
"Clay County, FL",2015-2016,203967,207240,3273,1.605,439,2834,12,19,H1
"Clay County, FL",2016-2017,207240,212230,4990,2.408,468,4522,12,19,H1
"Collier County, FL",2000-2001,254015,264240,10225,4.025,921,9304,12,21,H1
"Collier County, FL",2001-2002,264240,275490,11250,4.257,1176,10074,12,21,H1
"Collier County, FL",2002-2003,275490,285321,9831,3.569,1241,8590,12,21,H1
"Collier County, FL",2003-2004,285321,296021,10700,3.75,1329,9371,12,21,H1
"Collier County, FL",2004-2005,296021,307452,11431,3.862,1510,9921,12,21,H1
"Collier County, FL",2005-2006,307452,312621,5169,1.681,1591,3578,12,21,H1
"Collier County, FL",2006-2007,312621,314437,1816,0.581,1677,139,12,21,H1
"Collier County, FL",2007-2008,314437,316641,2204,0.701,1123,1081,12,21,H1
"Collier County, FL",2008-2009,316641,318485,1844,0.582,910,934,12,21,H1
"Collier County, FL",2009-2010,318485,322710,4225,1.327,836,3389,12,21,H1
"Collier County, FL",2010-2011,322710,327903,5193,1.609,430,4763,12,21,H1
"Collier County, FL",2011-2012,327903,332873,4970,1.516,223,4747,12,21,H1
"Collier County, FL",2012-2013,332873,340106,7233,2.173,169,7064,12,21,H1
"Collier County, FL",2013-2014,340106,348777,8671,2.549,31,8640,12,21,H1
"Collier County, FL",2014-2015,348355,357305,8950,2.569,17,8933,12,21,H1
"Collier County, FL",2015-2016,357305,366095,8790,2.46,-29,8819,12,21,H1
"Collier County, FL",2016-2017,366095,372880,6785,1.853,-279,7064,12,21,H1
"Columbia County, FL",2000-2001,56571,57040,469,0.829,126,343,12,23,H1
"Columbia County, FL",2001-2002,57040,57930,890,1.56,147,743,12,23,H1
"Columbia County, FL",2002-2003,57930,59395,1465,2.529,150,1315,12,23,H1
"Columbia County, FL",2003-2004,59395,60804,1409,2.372,70,1339,12,23,H1
"Columbia County, FL",2004-2005,60804,63109,2305,3.791,236,2069,12,23,H1
"Columbia County, FL",2005-2006,63109,65890,2781,4.407,211,2570,12,23,H1
"Columbia County, FL",2006-2007,65890,66604,714,1.084,213,501,12,23,H1
"Columbia County, FL",2007-2008,66604,67318,714,1.072,167,547,12,23,H1
"Columbia County, FL",2008-2009,67318,67412,94,0.14,170,-76,12,23,H1
"Columbia County, FL",2009-2010,67412,67606,194,0.288,95,99,12,23,H1
"Columbia County, FL",2010-2011,67606,67340,-266,-0.393,23,-289,12,23,H1
"Columbia County, FL",2011-2012,67340,67943,603,0.895,53,550,12,23,H1
"Columbia County, FL",2012-2013,67943,67563,-380,-0.559,12,-392,12,23,H1
"Columbia County, FL",2013-2014,67563,67857,294,0.435,1,293,12,23,H1
"Columbia County, FL",2014-2015,67923,68348,425,0.626,45,380,12,23,H1
"Columbia County, FL",2015-2016,68348,69274,926,1.355,11,915,12,23,H1
"Columbia County, FL",2016-2017,69274,69612,338,0.488,-2,340,12,23,H1
"DeSoto County, FL",2000-2001,32196,32402,206,0.64,126,80,12,27,H1
"DeSoto County, FL",2001-2002,32402,32446,44,0.136,170,-126,12,27,H1
"DeSoto County, FL",2002-2003,32446,33271,825,2.543,140,685,12,27,H1
"DeSoto County, FL",2003-2004,33271,33895,624,1.876,154,470,12,27,H1
"DeSoto County, FL",2004-2005,33895,33864,-31,-0.091,175,-206,12,27,H1
"DeSoto County, FL",2005-2006,33864,34300,436,1.288,189,247,12,27,H1
"DeSoto County, FL",2006-2007,34300,34537,237,0.691,241,-4,12,27,H1
"DeSoto County, FL",2007-2008,34537,34374,-163,-0.472,206,-369,12,27,H1
"DeSoto County, FL",2008-2009,34374,34592,218,0.634,190,28,12,27,H1
"DeSoto County, FL",2009-2010,34592,34916,324,0.937,196,128,12,27,H1
"DeSoto County, FL",2010-2011,34916,34636,-280,-0.802,113,-393,12,27,H1
"DeSoto County, FL",2011-2012,34636,34745,109,0.315,104,5,12,27,H1
"DeSoto County, FL",2012-2013,34745,34616,-129,-0.371,77,-206,12,27,H1
"DeSoto County, FL",2013-2014,34616,35012,396,1.144,81,315,12,27,H1
"DeSoto County, FL",2014-2015,35157,35458,301,0.856,106,195,12,27,H1
"DeSoto County, FL",2015-2016,35458,35925,467,1.317,63,404,12,27,H1
"DeSoto County, FL",2016-2017,35925,36862,937,2.608,62,875,12,27,H1
"Dixie County, FL",2000-2001,13758,14033,275,1.999,27,248,12,29,H1
"Dixie County, FL",2001-2002,14033,14234,201,1.432,2,199,12,29,H1
"Dixie County, FL",2002-2003,14234,14364,130,0.913,-45,175,12,29,H1
"Dixie County, FL",2003-2004,14364,14825,461,3.209,-34,495,12,29,H1
"Dixie County, FL",2004-2005,14825,15427,602,4.061,3,599,12,29,H1
"Dixie County, FL",2005-2006,15427,15892,465,3.014,-2,467,12,29,H1
"Dixie County, FL",2006-2007,15892,16083,191,1.202,-7,198,12,29,H1
"Dixie County, FL",2007-2008,16083,16214,131,0.815,-10,141,12,29,H1
"Dixie County, FL",2008-2009,16214,16403,189,1.166,-6,195,12,29,H1
"Dixie County, FL",2009-2010,16403,16409,6,0.037,-21,27,12,29,H1
"Dixie County, FL",2010-2011,16409,16354,-55,-0.335,-52,-3,12,29,H1
"Dixie County, FL",2011-2012,16354,16063,-291,-1.779,-56,-235,12,29,H1
"Dixie County, FL",2012-2013,16063,15954,-109,-0.679,-29,-80,12,29,H1
"Dixie County, FL",2013-2014,15954,15907,-47,-0.295,-40,-7,12,29,H1
"Dixie County, FL",2014-2015,15897,16203,306,1.925,-47,353,12,29,H1
"Dixie County, FL",2015-2016,16203,16477,274,1.691,-52,326,12,29,H1
"Dixie County, FL",2016-2017,16477,16673,196,1.19,-38,234,12,29,H1
"Duval County, FL",2000-2001,779800,790681,10881,1.395,5216,5665,12,31,H6
"Duval County, FL",2001-2002,790681,800532,9851,1.246,5228,4623,12,31,H6
"Duval County, FL",2002-2003,800532,809633,9101,1.137,4763,4338,12,31,H6
"Duval County, FL",2003-2004,809633,820070,10437,1.289,5090,5347,12,31,H6
"Duval County, FL",2004-2005,820070,828988,8918,1.087,5867,3051,12,31,H6
"Duval County, FL",2005-2006,828988,842098,13110,1.581,6413,6697,12,31,H6
"Duval County, FL",2006-2007,842098,851033,8935,1.061,6893,2042,12,31,H6
"Duval County, FL",2007-2008,851033,855437,4404,0.517,6330,-1926,12,31,H6
"Duval County, FL",2008-2009,855437,859795,4358,0.509,6007,-1649,12,31,H6
"Duval County, FL",2009-2010,859795,865842,6047,0.703,6697,-650,12,31,H6
"Duval County, FL",2010-2011,865842,872294,6452,0.745,5534,918,12,31,H6
"Duval County, FL",2011-2012,872294,880595,8301,0.952,5104,3197,12,31,H6
"Duval County, FL",2012-2013,880595,887322,6727,0.764,4593,2134,12,31,H6
"Duval County, FL",2013-2014,887322,897698,10376,1.169,4551,5825,12,31,H6
"Duval County, FL",2014-2015,899353,913010,13657,1.519,4754,8903,12,31,H6
"Duval County, FL",2015-2016,913010,926380,13370,1.464,4961,8409,12,31,H6
"Duval County, FL",2016-2017,926380,937934,11554,1.247,4734,6820,12,31,H6
"Escambia County, FL",2000-2001,294725,297776,3051,1.035,1037,2014,12,33,H1
"Escambia County, FL",2001-2002,297776,297568,-208,-0.07,969,-1177,12,33,H1
"Escambia County, FL",2002-2003,297568,296603,-965,-0.324,1045,-2010,12,33,H1
"Escambia County, FL",2003-2004,296603,298225,1622,0.547,1235,387,12,33,H1
"Escambia County, FL",2004-2005,298225,298339,114,0.038,1099,-985,12,33,H1
"Escambia County, FL",2005-2006,298339,300395,2056,0.689,1393,663,12,33,H1
"Escambia County, FL",2006-2007,300395,297393,-3002,-0.999,1610,-4612,12,33,H1
"Escambia County, FL",2007-2008,297393,296854,-539,-0.181,1315,-1854,12,33,H1
"Escambia County, FL",2008-2009,296854,297015,161,0.054,1278,-1117,12,33,H1
"Escambia County, FL",2009-2010,297015,298110,1095,0.369,1518,-423,12,33,H1
"Escambia County, FL",2010-2011,298110,299642,1532,0.514,801,731,12,33,H1
"Escambia County, FL",2011-2012,299642,304214,4572,1.526,911,3661,12,33,H1
"Escambia County, FL",2012-2013,304214,307871,3657,1.202,580,3077,12,33,H1
"Escambia County, FL",2013-2014,307871,310659,2788,0.906,613,2175,12,33,H1
"Escambia County, FL",2014-2015,309034,311003,1969,0.637,571,1398,12,33,H1
"Escambia County, FL",2015-2016,311003,311711,708,0.228,572,136,12,33,H1
"Escambia County, FL",2016-2017,311711,313512,1801,0.578,505,1296,12,33,H1
"Flagler County, FL",2000-2001,50579,53944,3365,6.653,-231,3596,12,35,H1
"Flagler County, FL",2001-2002,53944,57905,3961,7.343,-199,4160,12,35,H1
"Flagler County, FL",2002-2003,57905,62947,5042,8.707,-169,5211,12,35,H1
"Flagler County, FL",2003-2004,62947,69387,6440,10.231,-210,6650,12,35,H1
"Flagler County, FL",2004-2005,69387,77008,7621,10.983,-88,7709,12,35,H1
"Flagler County, FL",2005-2006,77008,84339,7331,9.52,-59,7390,12,35,H1
"Flagler County, FL",2006-2007,84339,90516,6177,7.324,175,6002,12,35,H1
"Flagler County, FL",2007-2008,90516,93546,3030,3.347,-87,3117,12,35,H1
"Flagler County, FL",2008-2009,93546,94700,1154,1.234,-36,1190,12,35,H1
"Flagler County, FL",2009-2010,94700,96053,1353,1.429,-165,1518,12,35,H1
"Flagler County, FL",2010-2011,96053,97295,1242,1.293,-232,1474,12,35,H1
"Flagler County, FL",2011-2012,97295,98510,1215,1.249,-238,1453,12,35,H1
"Flagler County, FL",2012-2013,98510,99950,1440,1.462,-459,1899,12,35,H1
"Flagler County, FL",2013-2014,99950,102408,2458,2.459,-316,2774,12,35,H1
"Flagler County, FL",2014-2015,102561,105392,2831,2.76,-354,3185,12,35,H1
"Flagler County, FL",2015-2016,105392,107805,2413,2.29,-471,2884,12,35,H1
"Flagler County, FL",2016-2017,107805,110510,2705,2.509,-459,3164,12,35,H1
"Franklin County, FL",2000-2001,9839,9910,71,0.722,-31,102,12,37,H1
"Franklin County, FL",2001-2002,9910,9972,62,0.626,-25,87,12,37,H1
"Franklin County, FL",2002-2003,9972,10025,53,0.531,-19,72,12,37,H1
"Franklin County, FL",2003-2004,10025,10090,65,0.648,7,58,12,37,H1
"Franklin County, FL",2004-2005,10090,10198,108,1.07,15,93,12,37,H1
"Franklin County, FL",2005-2006,10198,11308,1110,10.884,38,1072,12,37,H1
"Franklin County, FL",2006-2007,11308,11491,183,1.618,-5,188,12,37,H1
"Franklin County, FL",2007-2008,11491,11484,-7,-0.061,24,-31,12,37,H1
"Franklin County, FL",2008-2009,11484,11515,31,0.27,9,22,12,37,H1
"Franklin County, FL",2009-2010,11515,11538,23,0.2,11,12,12,37,H1
"Franklin County, FL",2010-2011,11538,11518,-20,-0.173,-22,2,12,37,H1
"Franklin County, FL",2011-2012,11518,11671,153,1.328,-13,166,12,37,H1
"Franklin County, FL",2012-2013,11671,11639,-32,-0.274,-5,-27,12,37,H1
"Franklin County, FL",2013-2014,11639,11815,176,1.512,12,164,12,37,H1
"Franklin County, FL",2014-2015,11699,11761,62,0.53,-7,69,12,37,H1
"Franklin County, FL",2015-2016,11761,11799,38,0.323,-42,80,12,37,H1
"Franklin County, FL",2016-2017,11799,11727,-72,-0.61,-16,-56,12,37,H1
"Gadsden County, FL",2000-2001,44950,45153,203,0.452,280,-77,12,39,H1
"Gadsden County, FL",2001-2002,45153,44762,-391,-0.866,208,-599,12,39,H1
"Gadsden County, FL",2002-2003,44762,44952,190,0.424,256,-66,12,39,H1
"Gadsden County, FL",2003-2004,44952,45129,177,0.394,231,-54,12,39,H1
"Gadsden County, FL",2004-2005,45129,45258,129,0.286,239,-110,12,39,H1
"Gadsden County, FL",2005-2006,45258,45258,0,0,311,-311,12,39,H1
"Gadsden County, FL",2006-2007,45258,45867,609,1.346,283,326,12,39,H1
"Gadsden County, FL",2007-2008,45867,46319,452,0.985,278,174,12,39,H1
"Gadsden County, FL",2008-2009,46319,46264,-55,-0.119,293,-348,12,39,H1
"Gadsden County, FL",2009-2010,46264,47814,1550,3.35,252,1298,12,39,H1
"Gadsden County, FL",2010-2011,47814,47387,-427,-0.893,147,-574,12,39,H1
"Gadsden County, FL",2011-2012,47387,46653,-734,-1.549,135,-869,12,39,H1
"Gadsden County, FL",2012-2013,46653,46191,-462,-0.99,36,-498,12,39,H1
"Gadsden County, FL",2013-2014,46191,46281,90,0.195,32,58,12,39,H1
"Gadsden County, FL",2014-2015,46147,46036,-111,-0.241,71,-182,12,39,H1
"Gadsden County, FL",2015-2016,46036,46155,119,0.258,77,42,12,39,H1
"Gadsden County, FL",2016-2017,46155,46071,-84,-0.182,64,-148,12,39,H1
"Gilchrist County, FL",2000-2001,14443,14283,-160,-1.108,15,-175,12,41,H1
"Gilchrist County, FL",2001-2002,14283,14502,219,1.533,53,166,12,41,H1
"Gilchrist County, FL",2002-2003,14502,15011,509,3.51,33,476,12,41,H1
"Gilchrist County, FL",2003-2004,15011,15271,260,1.732,10,250,12,41,H1
"Gilchrist County, FL",2004-2005,15271,15801,530,3.471,59,471,12,41,H1
"Gilchrist County, FL",2005-2006,15801,16223,422,2.671,-7,429,12,41,H1
"Gilchrist County, FL",2006-2007,16223,16610,387,2.386,37,350,12,41,H1
"Gilchrist County, FL",2007-2008,16610,16797,187,1.126,44,143,12,41,H1
"Gilchrist County, FL",2008-2009,16797,16829,32,0.191,40,-8,12,41,H1
"Gilchrist County, FL",2009-2010,16829,16987,158,0.939,14,144,12,41,H1
"Gilchrist County, FL",2010-2011,16987,16979,-8,-0.047,13,-21,12,41,H1
"Gilchrist County, FL",2011-2012,16979,16872,-107,-0.63,6,-113,12,41,H1
"Gilchrist County, FL",2012-2013,16872,16907,35,0.207,16,19,12,41,H1
"Gilchrist County, FL",2013-2014,16907,16997,90,0.532,30,60,12,41,H1
"Gilchrist County, FL",2014-2015,16977,17199,222,1.308,7,215,12,41,H1
"Gilchrist County, FL",2015-2016,17199,17210,11,0.064,6,5,12,41,H1
"Gilchrist County, FL",2016-2017,17210,17743,533,3.097,27,506,12,41,H1
"Glades County, FL",2000-2001,10579,10948,369,3.488,-15,384,12,43,H1
"Glades County, FL",2001-2002,10948,11284,336,3.069,-11,347,12,43,H1
"Glades County, FL",2002-2003,11284,11514,230,2.038,-37,267,12,43,H1
"Glades County, FL",2003-2004,11514,11901,387,3.361,-35,422,12,43,H1
"Glades County, FL",2004-2005,11901,12284,383,3.218,-28,411,12,43,H1
"Glades County, FL",2005-2006,12284,12297,13,0.106,-17,30,12,43,H1
"Glades County, FL",2006-2007,12297,12357,60,0.488,4,56,12,43,H1
"Glades County, FL",2007-2008,12357,12752,395,3.197,-16,411,12,43,H1
"Glades County, FL",2008-2009,12752,12839,87,0.682,-5,92,12,43,H1
"Glades County, FL",2009-2010,12839,12939,100,0.779,-22,122,12,43,H1
"Glades County, FL",2010-2011,12939,13150,211,1.631,-36,247,12,43,H1
"Glades County, FL",2011-2012,13150,13026,-124,-0.943,-35,-89,12,43,H1
"Glades County, FL",2012-2013,13026,13201,175,1.343,-29,204,12,43,H1
"Glades County, FL",2013-2014,13201,13635,434,3.288,-30,464,12,43,H1
"Glades County, FL",2014-2015,13479,13670,191,1.417,-39,230,12,43,H1
"Glades County, FL",2015-2016,13670,13460,-210,-1.536,-26,-184,12,43,H1
"Glades County, FL",2016-2017,13460,13754,294,2.184,-48,342,12,43,H1
"Gulf County, FL",2000-2001,14566,14868,302,2.073,-31,333,12,45,H1
"Gulf County, FL",2001-2002,14868,14897,29,0.195,-44,73,12,45,H1
"Gulf County, FL",2002-2003,14897,15266,369,2.477,-27,396,12,45,H1
"Gulf County, FL",2003-2004,15266,15455,189,1.238,-49,238,12,45,H1
"Gulf County, FL",2004-2005,15455,15781,326,2.109,-8,334,12,45,H1
"Gulf County, FL",2005-2006,15781,15856,75,0.475,-21,96,12,45,H1
"Gulf County, FL",2006-2007,15856,15908,52,0.328,-8,60,12,45,H1
"Gulf County, FL",2007-2008,15908,15851,-57,-0.358,-31,-26,12,45,H1
"Gulf County, FL",2008-2009,15851,15933,82,0.517,-12,94,12,45,H1
"Gulf County, FL",2009-2010,15933,15817,-116,-0.728,-25,-91,12,45,H1
"Gulf County, FL",2010-2011,15817,15670,-147,-0.929,-28,-119,12,45,H1
"Gulf County, FL",2011-2012,15670,15670,0,0,-38,38,12,45,H1
"Gulf County, FL",2012-2013,15670,15805,135,0.862,-46,181,12,45,H1
"Gulf County, FL",2013-2014,15805,15944,139,0.879,-27,166,12,45,H1
"Gulf County, FL",2014-2015,15932,15871,-61,-0.383,-44,-17,12,45,H1
"Gulf County, FL",2015-2016,15871,16100,229,1.443,-44,273,12,45,H1
"Gulf County, FL",2016-2017,16100,16160,60,0.373,-53,113,12,45,H1
"Hamilton County, FL",2000-2001,13330,13733,403,3.023,33,370,12,47,H1
"Hamilton County, FL",2001-2002,13733,13795,62,0.451,35,27,12,47,H1
"Hamilton County, FL",2002-2003,13795,14010,215,1.559,32,183,12,47,H1
"Hamilton County, FL",2003-2004,14010,14101,91,0.65,47,44,12,47,H1
"Hamilton County, FL",2004-2005,14101,14017,-84,-0.596,56,-140,12,47,H1
"Hamilton County, FL",2005-2006,14017,14430,413,2.946,54,359,12,47,H1
"Hamilton County, FL",2006-2007,14430,14589,159,1.102,47,112,12,47,H1
"Hamilton County, FL",2007-2008,14589,14785,196,1.343,68,128,12,47,H1
"Hamilton County, FL",2008-2009,14785,14930,145,0.981,61,84,12,47,H1
"Hamilton County, FL",2009-2010,14930,14672,-258,-1.728,45,-303,12,47,H1
"Hamilton County, FL",2010-2011,14672,14594,-78,-0.532,56,-134,12,47,H1
"Hamilton County, FL",2011-2012,14594,14699,105,0.719,11,94,12,47,H1
"Hamilton County, FL",2012-2013,14699,14319,-380,-2.585,14,-394,12,47,H1
"Hamilton County, FL",2013-2014,14319,14048,-271,-1.893,35,-306,12,47,H1
"Hamilton County, FL",2014-2015,14051,14295,244,1.737,39,205,12,47,H1
"Hamilton County, FL",2015-2016,14295,14324,29,0.203,32,-3,12,47,H1
"Hamilton County, FL",2016-2017,14324,14184,-140,-0.977,52,-192,12,47,H1
"Hardee County, FL",2000-2001,26769,26378,-391,-1.461,274,-665,12,49,H1
"Hardee County, FL",2001-2002,26378,26787,409,1.551,222,187,12,49,H1
"Hardee County, FL",2002-2003,26787,26765,-22,-0.082,322,-344,12,49,H1
"Hardee County, FL",2003-2004,26765,26847,82,0.306,276,-194,12,49,H1
"Hardee County, FL",2004-2005,26847,26874,27,0.101,255,-228,12,49,H1
"Hardee County, FL",2005-2006,26874,27049,175,0.651,271,-96,12,49,H1
"Hardee County, FL",2006-2007,27049,27489,440,1.627,341,99,12,49,H1
"Hardee County, FL",2007-2008,27489,27603,114,0.415,351,-237,12,49,H1
"Hardee County, FL",2008-2009,27603,27661,58,0.21,323,-265,12,49,H1
"Hardee County, FL",2009-2010,27661,27767,106,0.383,321,-215,12,49,H1
"Hardee County, FL",2010-2011,27767,27684,-83,-0.299,207,-290,12,49,H1
"Hardee County, FL",2011-2012,27684,27414,-270,-0.975,213,-483,12,49,H1
"Hardee County, FL",2012-2013,27414,27410,-4,-0.015,202,-206,12,49,H1
"Hardee County, FL",2013-2014,27410,27469,59,0.215,218,-159,12,49,H1
"Hardee County, FL",2014-2015,27441,27502,61,0.222,212,-151,12,49,H1
"Hardee County, FL",2015-2016,27502,27371,-131,-0.476,196,-327,12,49,H1
"Hardee County, FL",2016-2017,27371,27411,40,0.146,188,-148,12,49,H1
"Hendry County, FL",2000-2001,36255,36029,-226,-0.623,364,-590,12,51,H1
"Hendry County, FL",2001-2002,36029,36035,6,0.017,415,-409,12,51,H1
"Hendry County, FL",2002-2003,36035,36138,103,0.286,394,-291,12,51,H1
"Hendry County, FL",2003-2004,36138,36903,765,2.117,368,397,12,51,H1
"Hendry County, FL",2004-2005,36903,38201,1298,3.517,417,881,12,51,H1
"Hendry County, FL",2005-2006,38201,38776,575,1.505,447,128,12,51,H1
"Hendry County, FL",2006-2007,38776,39006,230,0.593,503,-273,12,51,H1
"Hendry County, FL",2007-2008,39006,39177,171,0.438,465,-294,12,51,H1
"Hendry County, FL",2008-2009,39177,39010,-167,-0.426,417,-584,12,51,H1
"Hendry County, FL",2009-2010,39010,39044,34,0.087,432,-398,12,51,H1
"Hendry County, FL",2010-2011,39044,38816,-228,-0.584,345,-573,12,51,H1
"Hendry County, FL",2011-2012,38816,37686,-1130,-2.911,328,-1458,12,51,H1
"Hendry County, FL",2012-2013,37686,37750,64,0.17,340,-276,12,51,H1
"Hendry County, FL",2013-2014,37750,38505,755,2,312,443,12,51,H1
"Hendry County, FL",2014-2015,38476,39119,643,1.671,298,345,12,51,H1
"Hendry County, FL",2015-2016,39119,39640,521,1.332,339,182,12,51,H1
"Hendry County, FL",2016-2017,39640,40347,707,1.784,283,424,12,51,H1
"Hernando County, FL",2000-2001,131390,134127,2737,2.083,-867,3604,12,53,H1
"Hernando County, FL",2001-2002,134127,137818,3691,2.752,-976,4667,12,53,H1
"Hernando County, FL",2002-2003,137818,142686,4868,3.532,-1025,5893,12,53,H1
"Hernando County, FL",2003-2004,142686,149593,6907,4.841,-962,7869,12,53,H1
"Hernando County, FL",2004-2005,149593,157156,7563,5.056,-744,8307,12,53,H1
"Hernando County, FL",2005-2006,157156,164398,7242,4.608,-721,7963,12,53,H1
"Hernando County, FL",2006-2007,164398,169891,5493,3.341,-678,6171,12,53,H1
"Hernando County, FL",2007-2008,169891,172437,2546,1.499,-823,3369,12,53,H1
"Hernando County, FL",2008-2009,172437,171950,-487,-0.282,-832,345,12,53,H1
"Hernando County, FL",2009-2010,171950,172947,997,0.58,-826,1823,12,53,H1
"Hernando County, FL",2010-2011,172947,172853,-94,-0.054,-963,869,12,53,H1
"Hernando County, FL",2011-2012,172853,173102,249,0.144,-1030,1279,12,53,H1
"Hernando County, FL",2012-2013,173102,174205,1103,0.637,-1083,2186,12,53,H1
"Hernando County, FL",2013-2014,174205,175855,1650,0.947,-1126,2776,12,53,H1
"Hernando County, FL",2014-2015,175704,178439,2735,1.557,-1051,3786,12,53,H1
"Hernando County, FL",2015-2016,178439,182231,3792,2.125,-1129,4921,12,53,H1
"Hernando County, FL",2016-2017,182231,186553,4322,2.372,-1121,5443,12,53,H1
"Highlands County, FL",2000-2001,87417,88510,1093,1.25,-408,1501,12,55,H1
"Highlands County, FL",2001-2002,88510,89939,1429,1.615,-393,1822,12,55,H1
"Highlands County, FL",2002-2003,89939,90943,1004,1.116,-441,1445,12,55,H1
"Highlands County, FL",2003-2004,90943,93079,2136,2.349,-476,2612,12,55,H1
"Highlands County, FL",2004-2005,93079,95614,2535,2.723,-447,2982,12,55,H1
"Highlands County, FL",2005-2006,95614,97788,2174,2.274,-428,2602,12,55,H1
"Highlands County, FL",2006-2007,97788,99023,1235,1.263,-132,1367,12,55,H1
"Highlands County, FL",2007-2008,99023,99568,545,0.55,-183,728,12,55,H1
"Highlands County, FL",2008-2009,99568,98956,-612,-0.615,-369,-243,12,55,H1
"Highlands County, FL",2009-2010,98956,98703,-253,-0.256,-390,137,12,55,H1
"Highlands County, FL",2010-2011,98703,98360,-343,-0.348,-478,135,12,55,H1
"Highlands County, FL",2011-2012,98360,98087,-273,-0.278,-544,271,12,55,H1
"Highlands County, FL",2012-2013,98087,97919,-168,-0.171,-580,412,12,55,H1
"Highlands County, FL",2013-2014,97919,98236,317,0.324,-561,878,12,55,H1
"Highlands County, FL",2014-2015,98104,99491,1387,1.414,-526,1913,12,55,H1
"Highlands County, FL",2015-2016,99491,101558,2067,2.078,-584,2651,12,55,H1
"Highlands County, FL",2016-2017,101558,102883,1325,1.305,-601,1926,12,55,H1
"Hillsborough County, FL",2000-2001,1003435,1028385,24950,2.486,5994,18956,12,57,H1
"Hillsborough County, FL",2001-2002,1028385,1054860,26475,2.574,6099,20376,12,57,H1
"Hillsborough County, FL",2002-2003,1054860,1077462,22602,2.143,6460,16142,12,57,H1
"Hillsborough County, FL",2003-2004,1077462,1108225,30763,2.855,6896,23867,12,57,H1
"Hillsborough County, FL",2004-2005,1108225,1143154,34929,3.152,7467,27462,12,57,H1
"Hillsborough County, FL",2005-2006,1143154,1171826,28672,2.508,7733,20939,12,57,H1
"Hillsborough County, FL",2006-2007,1171826,1184686,12860,1.097,9100,3760,12,57,H1
"Hillsborough County, FL",2007-2008,1184686,1196773,12087,1.02,8646,3441,12,57,H1
"Hillsborough County, FL",2008-2009,1196773,1214050,17277,1.444,8052,9225,12,57,H1
"Hillsborough County, FL",2009-2010,1214050,1234145,20095,1.655,8411,11684,12,57,H1
"Hillsborough County, FL",2010-2011,1234145,1271720,37575,3.045,7439,30136,12,57,H1
"Hillsborough County, FL",2011-2012,1271720,1282032,10312,0.811,7195,3117,12,57,H1
"Hillsborough County, FL",2012-2013,1282032,1294145,12113,0.945,6299,5814,12,57,H1
"Hillsborough County, FL",2013-2014,1294145,1316298,22153,1.712,6108,16045,12,57,H1
"Hillsborough County, FL",2014-2015,1318325,1349050,30725,2.331,6423,24302,12,57,H1
"Hillsborough County, FL",2015-2016,1349050,1381627,32577,2.415,6530,26047,12,57,H1
"Hillsborough County, FL",2016-2017,1381627,1408566,26939,1.95,6304,20635,12,57,H1
"Holmes County, FL",2000-2001,18553,18757,204,1.1,0,204,12,59,H1
"Holmes County, FL",2001-2002,18757,18880,123,0.656,3,120,12,59,H1
"Holmes County, FL",2002-2003,18880,19254,374,1.981,-5,379,12,59,H1
"Holmes County, FL",2003-2004,19254,19319,65,0.338,26,39,12,59,H1
"Holmes County, FL",2004-2005,19319,19523,204,1.056,27,177,12,59,H1
"Holmes County, FL",2005-2006,19523,19824,301,1.542,-13,314,12,59,H1
"Holmes County, FL",2006-2007,19824,19991,167,0.842,-15,182,12,59,H1
"Holmes County, FL",2007-2008,19991,20141,150,0.75,-17,167,12,59,H1
"Holmes County, FL",2008-2009,20141,20147,6,0.03,-7,13,12,59,H1
"Holmes County, FL",2009-2010,20147,19861,-286,-1.42,9,-295,12,59,H1
"Holmes County, FL",2010-2011,19861,19821,-40,-0.201,-63,23,12,59,H1
"Holmes County, FL",2011-2012,19821,19725,-96,-0.484,-47,-49,12,59,H1
"Holmes County, FL",2012-2013,19725,19649,-76,-0.385,-63,-13,12,59,H1
"Holmes County, FL",2013-2014,19649,19650,1,0.005,-54,55,12,59,H1
"Holmes County, FL",2014-2015,19650,19324,-326,-1.659,-44,-282,12,59,H1
"Holmes County, FL",2015-2016,19324,19407,83,0.43,-57,140,12,59,H1
"Holmes County, FL",2016-2017,19407,19558,151,0.778,-37,188,12,59,H1
"Indian River County, FL",2000-2001,113323,115456,2133,1.882,-473,2606,12,61,H1
"Indian River County, FL",2001-2002,115456,118144,2688,2.328,-497,3185,12,61,H1
"Indian River County, FL",2002-2003,118144,120450,2306,1.952,-445,2751,12,61,H1
"Indian River County, FL",2003-2004,120450,125001,4551,3.778,-631,5182,12,61,H1
"Indian River County, FL",2004-2005,125001,127955,2954,2.363,-578,3532,12,61,H1
"Indian River County, FL",2005-2006,127955,131463,3508,2.742,-240,3748,12,61,H1
"Indian River County, FL",2006-2007,131463,134564,3101,2.359,-242,3343,12,61,H1
"Indian River County, FL",2007-2008,134564,136277,1713,1.273,-339,2052,12,61,H1
"Indian River County, FL",2008-2009,136277,137016,739,0.542,-310,1049,12,61,H1
"Indian River County, FL",2009-2010,137016,138235,1219,0.89,-304,1523,12,61,H1
"Indian River County, FL",2010-2011,138235,138973,738,0.534,-420,1158,12,61,H1
"Indian River County, FL",2011-2012,138973,140608,1635,1.176,-468,2103,12,61,H1
"Indian River County, FL",2012-2013,140608,142021,1413,1.005,-630,2043,12,61,H1
"Indian River County, FL",2013-2014,142021,144755,2734,1.925,-631,3365,12,61,H1
"Indian River County, FL",2014-2015,144772,147919,3147,2.174,-725,3872,12,61,H1
"Indian River County, FL",2015-2016,147919,151382,3463,2.341,-763,4226,12,61,H1
"Indian River County, FL",2016-2017,151382,154383,3001,1.982,-852,3853,12,61,H1
"Jackson County, FL",2000-2001,46701,46242,-459,-0.983,12,-471,12,63,H1
"Jackson County, FL",2001-2002,46242,46139,-103,-0.223,17,-120,12,63,H1
"Jackson County, FL",2002-2003,46139,46274,135,0.293,45,90,12,63,H1
"Jackson County, FL",2003-2004,46274,46946,672,1.452,33,639,12,63,H1
"Jackson County, FL",2004-2005,46946,47930,984,2.096,82,902,12,63,H1
"Jackson County, FL",2005-2006,47930,48265,335,0.699,18,317,12,63,H1
"Jackson County, FL",2006-2007,48265,48368,103,0.213,97,6,12,63,H1
"Jackson County, FL",2007-2008,48368,50272,1904,3.936,58,1846,12,63,H1
"Jackson County, FL",2008-2009,50272,50064,-208,-0.414,47,-255,12,63,H1
"Jackson County, FL",2009-2010,50064,49618,-446,-0.891,23,-469,12,63,H1
"Jackson County, FL",2010-2011,49618,49126,-492,-0.992,-77,-415,12,63,H1
"Jackson County, FL",2011-2012,49126,48980,-146,-0.297,-62,-84,12,63,H1
"Jackson County, FL",2012-2013,48980,4.90E+04,20,0.041,-67,87,12,63,H1
"Jackson County, FL",2013-2014,4.90E+04,48801,-199,-0.406,-84,-115,12,63,H1
"Jackson County, FL",2014-2015,48796,48599,-197,-0.404,-94,-103,12,63,H1
"Jackson County, FL",2015-2016,48599,48292,-307,-0.632,-163,-144,12,63,H1
"Jackson County, FL",2016-2017,48292,48330,38,0.079,-110,148,12,63,H1
"Jefferson County, FL",2000-2001,12891,12871,-20,-0.155,-36,16,12,65,H1
"Jefferson County, FL",2001-2002,12871,13316,445,3.457,19,426,12,65,H1
"Jefferson County, FL",2002-2003,13316,13602,286,2.148,-7,293,12,65,H1
"Jefferson County, FL",2003-2004,13602,14030,428,3.147,-5,433,12,65,H1
"Jefferson County, FL",2004-2005,14030,14210,180,1.283,34,146,12,65,H1
"Jefferson County, FL",2005-2006,14210,14461,251,1.766,10,241,12,65,H1
"Jefferson County, FL",2006-2007,14461,14383,-78,-0.539,19,-97,12,65,H1
"Jefferson County, FL",2007-2008,14383,14606,223,1.55,12,211,12,65,H1
"Jefferson County, FL",2008-2009,14606,14704,98,0.671,7,91,12,65,H1
"Jefferson County, FL",2009-2010,14704,14745,41,0.279,-13,54,12,65,H1
"Jefferson County, FL",2010-2011,14745,14496,-249,-1.689,-46,-203,12,65,H1
"Jefferson County, FL",2011-2012,14496,14193,-303,-2.09,-26,-277,12,65,H1
"Jefferson County, FL",2012-2013,14193,14192,-1,-0.007,13,-14,12,65,H1
"Jefferson County, FL",2013-2014,14192,14050,-142,-1.001,-7,-135,12,65,H1
"Jefferson County, FL",2014-2015,14035,14081,46,0.328,-19,65,12,65,H1
"Jefferson County, FL",2015-2016,14081,13933,-148,-1.051,-47,-101,12,65,H1
"Jefferson County, FL",2016-2017,13933,14144,211,1.514,-40,251,12,65,H1
"Lafayette County, FL",2000-2001,7011,7153,142,2.025,43,99,12,67,H1
"Lafayette County, FL",2001-2002,7153,7287,134,1.873,19,115,12,67,H1
"Lafayette County, FL",2002-2003,7287,7356,69,0.947,0,69,12,67,H1
"Lafayette County, FL",2003-2004,7356,7630,274,3.725,34,240,12,67,H1
"Lafayette County, FL",2004-2005,7630,8131,501,6.566,29,472,12,67,H1
"Lafayette County, FL",2005-2006,8131,8341,210,2.583,39,171,12,67,H1
"Lafayette County, FL",2006-2007,8341,8398,57,0.683,38,19,12,67,H1
"Lafayette County, FL",2007-2008,8398,8465,67,0.798,35,32,12,67,H1
"Lafayette County, FL",2008-2009,8465,8435,-30,-0.354,28,-58,12,67,H1
"Lafayette County, FL",2009-2010,8435,8812,377,4.469,23,354,12,67,H1
"Lafayette County, FL",2010-2011,8812,8808,-4,-0.045,-5,1,12,67,H1
"Lafayette County, FL",2011-2012,8808,8802,-6,-0.068,2,-8,12,67,H1
"Lafayette County, FL",2012-2013,8802,8846,44,0.5,30,14,12,67,H1
"Lafayette County, FL",2013-2014,8846,8835,-11,-0.124,2,-13,12,67,H1
"Lafayette County, FL",2014-2015,8859,8663,-196,-2.212,16,-212,12,67,H1
"Lafayette County, FL",2015-2016,8663,8654,-9,-0.104,7,-16,12,67,H1
"Lafayette County, FL",2016-2017,8654,8451,-203,-2.346,-8,-195,12,67,H1
"Lake County, FL",2000-2001,212347,222297,9950,4.686,-507,10457,12,69,H1
"Lake County, FL",2001-2002,222297,231519,9222,4.149,-504,9726,12,69,H1
"Lake County, FL",2002-2003,231519,241489,9970,4.306,-290,10260,12,69,H1
"Lake County, FL",2003-2004,241489,254625,13136,5.44,-77,13213,12,69,H1
"Lake County, FL",2004-2005,254625,267587,12962,5.091,-168,13130,12,69,H1
"Lake County, FL",2005-2006,267587,281329,13742,5.136,44,13698,12,69,H1
"Lake County, FL",2006-2007,281329,289909,8580,3.05,414,8166,12,69,H1
"Lake County, FL",2007-2008,289909,293654,3745,1.292,166,3579,12,69,H1
"Lake County, FL",2008-2009,293654,295511,1857,0.632,-512,2369,12,69,H1
"Lake County, FL",2009-2010,295511,297910,2399,0.812,-859,3258,12,69,H1
"Lake County, FL",2010-2011,297910,299886,1976,0.663,-379,2355,12,69,H1
"Lake County, FL",2011-2012,299886,303450,3564,1.188,-249,3813,12,69,H1
"Lake County, FL",2012-2013,303450,308115,4665,1.537,-564,5229,12,69,H1
"Lake County, FL",2013-2014,308115,315690,7575,2.458,-617,8192,12,69,H1
"Lake County, FL",2014-2015,315736,325875,10139,3.211,-604,10743,12,69,H1
"Lake County, FL",2015-2016,325875,335431,9556,2.932,-840,10396,12,69,H1
"Lake County, FL",2016-2017,335431,346017,10586,3.156,-890,11476,12,69,H1
"Lee County, FL",2000-2001,444311,461037,16726,3.764,10,16716,12,71,H1
"Lee County, FL",2001-2002,461037,478889,17852,3.872,-42,17894,12,71,H1
"Lee County, FL",2002-2003,478889,497662,18773,3.92,140,18633,12,71,H1
"Lee County, FL",2003-2004,497662,522431,24769,4.977,300,24469,12,71,H1
"Lee County, FL",2004-2005,522431,555029,32598,6.24,597,32001,12,71,H1
"Lee County, FL",2005-2006,555029,582678,27649,4.982,1147,26502,12,71,H1
"Lee County, FL",2006-2007,582678,604716,22038,3.782,1891,20147,12,71,H1
"Lee County, FL",2007-2008,604716,610984,6268,1.037,1478,4790,12,71,H1
"Lee County, FL",2008-2009,610984,612297,1313,0.215,1288,25,12,71,H1
"Lee County, FL",2009-2010,612297,620521,8224,1.343,1007,7217,12,71,H1
"Lee County, FL",2010-2011,620521,631412,10891,1.755,196,10695,12,71,H1
"Lee County, FL",2011-2012,631412,644988,13576,2.15,344,13232,12,71,H1
"Lee County, FL",2012-2013,644988,661336,16348,2.535,133,16215,12,71,H1
"Lee County, FL",2013-2014,661336,679513,18177,2.749,-52,18229,12,71,H1
"Lee County, FL",2014-2015,679233,701982,22749,3.349,-225,22974,12,71,H1
"Lee County, FL",2015-2016,701982,722506,20524,2.924,-430,20954,12,71,H1
"Lee County, FL",2016-2017,722506,739224,16718,2.314,-525,17243,12,71,H1
"Leon County, FL",2000-2001,240571,242583,2012,0.836,1506,506,12,73,H1
"Leon County, FL",2001-2002,242583,245404,2821,1.163,1282,1539,12,73,H1
"Leon County, FL",2002-2003,245404,250673,5269,2.147,1480,3789,12,73,H1
"Leon County, FL",2003-2004,250673,254188,3515,1.402,1669,1846,12,73,H1
"Leon County, FL",2004-2005,254188,258083,3895,1.532,1562,2333,12,73,H1
"Leon County, FL",2005-2006,258083,263076,4993,1.935,1657,3336,12,73,H1
"Leon County, FL",2006-2007,263076,268519,5443,2.069,1866,3577,12,73,H1
"Leon County, FL",2007-2008,268519,271130,2611,0.972,1739,872,12,73,H1
"Leon County, FL",2008-2009,271130,273263,2133,0.787,1732,401,12,73,H1
"Leon County, FL",2009-2010,273263,276063,2800,1.025,1908,892,12,73,H1
"Leon County, FL",2010-2011,276063,278320,2257,0.818,1398,859,12,73,H1
"Leon County, FL",2011-2012,278320,283854,5534,1.988,1322,4212,12,73,H1
"Leon County, FL",2012-2013,283854,282184,-1670,-0.588,1163,-2833,12,73,H1
"Leon County, FL",2013-2014,282184,283988,1804,0.639,1174,630,12,73,H1
"Leon County, FL",2014-2015,284064,286272,2208,0.777,1288,920,12,73,H1
"Leon County, FL",2015-2016,286272,287074,802,0.28,1197,-395,12,73,H1
"Leon County, FL",2016-2017,287074,290292,3218,1.121,1140,2078,12,73,H1
"Levy County, FL",2000-2001,34644,35118,474,1.368,-18,492,12,75,H1
"Levy County, FL",2001-2002,35118,35964,846,2.409,-77,923,12,75,H1
"Levy County, FL",2002-2003,35964,36530,566,1.574,-18,584,12,75,H1
"Levy County, FL",2003-2004,36530,37510,980,2.683,-41,1021,12,75,H1
"Levy County, FL",2004-2005,37510,38355,845,2.253,-28,873,12,75,H1
"Levy County, FL",2005-2006,38355,39447,1092,2.847,9,1083,12,75,H1
"Levy County, FL",2006-2007,39447,40204,757,1.919,47,710,12,75,H1
"Levy County, FL",2007-2008,40204,40809,605,1.505,1,604,12,75,H1
"Levy County, FL",2008-2009,40809,40880,71,0.174,18,53,12,75,H1
"Levy County, FL",2009-2010,40880,40716,-164,-0.401,-29,-135,12,75,H1
"Levy County, FL",2010-2011,40716,40267,-449,-1.103,-146,-303,12,75,H1
"Levy County, FL",2011-2012,40267,39997,-270,-0.671,-115,-155,12,75,H1
"Levy County, FL",2012-2013,39997,39694,-303,-0.758,-92,-211,12,75,H1
"Levy County, FL",2013-2014,39694,39613,-81,-0.204,-121,40,12,75,H1
"Levy County, FL",2014-2015,39508,39832,324,0.82,-121,445,12,75,H1
"Levy County, FL",2015-2016,39832,39851,19,0.048,-146,165,12,75,H1
"Levy County, FL",2016-2017,39851,40355,504,1.265,-149,653,12,75,H1
"Liberty County, FL",2000-2001,6989,7049,60,0.858,12,48,12,77,H1
"Liberty County, FL",2001-2002,7049,7231,182,2.582,31,151,12,77,H1
"Liberty County, FL",2002-2003,7231,7325,94,1.3,40,54,12,77,H1
"Liberty County, FL",2003-2004,7325,7449,124,1.693,31,93,12,77,H1
"Liberty County, FL",2004-2005,7449,7820,371,4.981,24,347,12,77,H1
"Liberty County, FL",2005-2006,7820,8011,191,2.442,53,138,12,77,H1
"Liberty County, FL",2006-2007,8011,8113,102,1.273,61,41,12,77,H1
"Liberty County, FL",2007-2008,8113,8323,210,2.588,68,142,12,77,H1
"Liberty County, FL",2008-2009,8323,8347,24,0.288,61,-37,12,77,H1
"Liberty County, FL",2009-2010,8347,8343,-4,-0.048,43,-47,12,77,H1
"Liberty County, FL",2010-2011,8343,8233,-110,-1.318,6,-116,12,77,H1
"Liberty County, FL",2011-2012,8233,8247,14,0.17,8,6,12,77,H1
"Liberty County, FL",2012-2013,8247,8328,81,0.982,34,47,12,77,H1
"Liberty County, FL",2013-2014,8328,8360,32,0.384,18,14,12,77,H1
"Liberty County, FL",2014-2015,8363,8331,-32,-0.383,20,-52,12,77,H1
"Liberty County, FL",2015-2016,8331,8319,-12,-0.144,34,-46,12,77,H1
"Liberty County, FL",2016-2017,8319,8242,-77,-0.926,15,-92,12,77,H1
"Madison County, FL",2000-2001,18734,18859,125,0.667,47,78,12,79,H1
"Madison County, FL",2001-2002,18859,18707,-152,-0.806,-9,-143,12,79,H1
"Madison County, FL",2002-2003,18707,18778,71,0.38,34,37,12,79,H1
"Madison County, FL",2003-2004,18778,19075,297,1.582,18,279,12,79,H1
"Madison County, FL",2004-2005,19075,19070,-5,-0.026,27,-32,12,79,H1
"Madison County, FL",2005-2006,19070,19299,229,1.201,25,204,12,79,H1
"Madison County, FL",2006-2007,19299,19322,23,0.119,51,-28,12,79,H1
"Madison County, FL",2007-2008,19322,19347,25,0.129,43,-18,12,79,H1
"Madison County, FL",2008-2009,19347,19329,-18,-0.093,5,-23,12,79,H1
"Madison County, FL",2009-2010,19329,19255,-74,-0.383,6,-80,12,79,H1
"Madison County, FL",2010-2011,19255,19105,-150,-0.779,5,-155,12,79,H1
"Madison County, FL",2011-2012,19105,18915,-190,-0.995,15,-205,12,79,H1
"Madison County, FL",2012-2013,18915,18713,-202,-1.068,-17,-185,12,79,H1
"Madison County, FL",2013-2014,18713,18518,-195,-1.042,-6,-189,12,79,H1
"Madison County, FL",2014-2015,18521,18408,-113,-0.61,-22,-91,12,79,H1
"Madison County, FL",2015-2016,18408,18306,-102,-0.554,-22,-80,12,79,H1
"Madison County, FL",2016-2017,18306,18449,143,0.781,-29,172,12,79,H1
"Manatee County, FL",2000-2001,265644,272281,6637,2.498,-143,6780,12,81,H1
"Manatee County, FL",2001-2002,272281,279950,7669,2.817,-49,7718,12,81,H1
"Manatee County, FL",2002-2003,279950,2.87E+05,7050,2.518,-26,7076,12,81,H1
"Manatee County, FL",2003-2004,2.87E+05,296183,9183,3.2,169,9014,12,81,H1
"Manatee County, FL",2004-2005,296183,306845,10662,3.6,222,10440,12,81,H1
"Manatee County, FL",2005-2006,306845,313771,6926,2.257,632,6294,12,81,H1
"Manatee County, FL",2006-2007,313771,316410,2639,0.841,841,1798,12,81,H1
"Manatee County, FL",2007-2008,316410,318766,2356,0.745,572,1784,12,81,H1
"Manatee County, FL",2008-2009,318766,320711,1945,0.61,385,1560,12,81,H1
"Manatee County, FL",2009-2010,320711,323510,2799,0.873,243,2556,12,81,H1
"Manatee County, FL",2010-2011,323510,327458,3948,1.22,-117,4065,12,81,H1
"Manatee County, FL",2011-2012,327458,334071,6613,2.019,-63,6676,12,81,H1
"Manatee County, FL",2012-2013,334071,342417,8346,2.498,-69,8415,12,81,H1
"Manatee County, FL",2013-2014,342417,351746,9329,2.724,-127,9456,12,81,H1
"Manatee County, FL",2014-2015,351771,363369,11598,3.297,-199,11797,12,81,H1
"Manatee County, FL",2015-2016,363369,375563,12194,3.356,-623,12817,12,81,H1
"Manatee County, FL",2016-2017,375563,385571,10008,2.665,-542,10550,12,81,H1
"Marion County, FL",2000-2001,260221,264553,4332,1.665,-613,4945,12,83,H1
"Marion County, FL",2001-2002,264553,271716,7163,2.708,-558,7721,12,83,H1
"Marion County, FL",2002-2003,271716,280091,8375,3.082,-885,9260,12,83,H1
"Marion County, FL",2003-2004,280091,291164,11073,3.953,-737,11810,12,83,H1
"Marion County, FL",2004-2005,291164,303558,12394,4.257,-475,12869,12,83,H1
"Marion County, FL",2005-2006,303558,316310,12752,4.201,-473,13225,12,83,H1
"Marion County, FL",2006-2007,316310,325634,9324,2.948,-294,9618,12,83,H1
"Marion County, FL",2007-2008,325634,330052,4418,1.357,-394,4812,12,83,H1
"Marion County, FL",2008-2009,330052,330880,828,0.251,-592,1420,12,83,H1
"Marion County, FL",2009-2010,330880,331527,647,0.196,-580,1227,12,83,H1
"Marion County, FL",2010-2011,331527,332507,980,0.296,-994,1974,12,83,H1
"Marion County, FL",2011-2012,332507,334495,1988,0.598,-1033,3021,12,83,H1
"Marion County, FL",2012-2013,334495,336159,1664,0.497,-1505,3169,12,83,H1
"Marion County, FL",2013-2014,336159,339167,3008,0.895,-1298,4306,12,83,H1
"Marion County, FL",2014-2015,338749,343254,4505,1.33,-1155,5660,12,83,H1
"Marion County, FL",2015-2016,343254,348139,4885,1.423,-1480,6365,12,83,H1
"Marion County, FL",2016-2017,348139,354353,6214,1.785,-1412,7626,12,83,H1
"Martin County, FL",2000-2001,127301,129856,2555,2.007,-283,2838,12,85,H1
"Martin County, FL",2001-2002,129856,132945,3089,2.379,-442,3531,12,85,H1
"Martin County, FL",2002-2003,132945,136598,3653,2.748,-453,4106,12,85,H1
"Martin County, FL",2003-2004,136598,139729,3131,2.292,-501,3632,12,85,H1
"Martin County, FL",2004-2005,139729,141912,2183,1.562,-434,2617,12,85,H1
"Martin County, FL",2005-2006,141912,141802,-110,-0.078,-291,181,12,85,H1
"Martin County, FL",2006-2007,141802,143542,1740,1.227,-307,2047,12,85,H1
"Martin County, FL",2007-2008,143542,144369,827,0.576,-358,1185,12,85,H1
"Martin County, FL",2008-2009,144369,145506,1137,0.788,-388,1525,12,85,H1
"Martin County, FL",2009-2010,145506,146978,1472,1.012,-367,1839,12,85,H1
"Martin County, FL",2010-2011,146978,147595,617,0.42,-472,1089,12,85,H1
"Martin County, FL",2011-2012,147595,148846,1251,0.848,-549,1800,12,85,H1
"Martin County, FL",2012-2013,148846,151478,2632,1.768,-670,3302,12,85,H1
"Martin County, FL",2013-2014,151478,153392,1914,1.264,-717,2631,12,85,H1
"Martin County, FL",2014-2015,153538,156283,2745,1.788,-656,3401,12,85,H1
"Martin County, FL",2015-2016,156283,158484,2201,1.408,-662,2863,12,85,H1
"Martin County, FL",2016-2017,158484,159923,1439,0.908,-727,2166,12,85,H1
"Miami-Dade County, FL",2000-2001,2259508,2287458,27950,1.237,13539,14411,12,86,H1
"Miami-Dade County, FL",2001-2002,2287458,2315747,28289,1.237,13736,14553,12,86,H1
"Miami-Dade County, FL",2002-2003,2315747,2336070,20323,0.878,14224,6099,12,86,H1
"Miami-Dade County, FL",2003-2004,2336070,2358684,22614,0.968,13622,8992,12,86,H1
"Miami-Dade County, FL",2004-2005,2358684,2385872,27188,1.153,13754,13434,12,86,H1
"Miami-Dade County, FL",2005-2006,2385872,2405911,20039,0.84,14736,5303,12,86,H1
"Miami-Dade County, FL",2006-2007,2405911,2415576,9665,0.402,16331,-6666,12,86,H1
"Miami-Dade County, FL",2007-2008,2415576,2436062,20486,0.848,15629,4857,12,86,H1
"Miami-Dade County, FL",2008-2009,2436062,2463943,27881,1.145,14470,13411,12,86,H1
"Miami-Dade County, FL",2009-2010,2463943,2508689,44746,1.816,14902,29844,12,86,H1
"Miami-Dade County, FL",2010-2011,2508689,2579916,71227,2.839,12921,58306,12,86,H1
"Miami-Dade County, FL",2011-2012,2579916,2610960,31044,1.203,12977,18067,12,86,H1
"Miami-Dade County, FL",2012-2013,2610960,2641866,30906,1.184,11421,19485,12,86,H1
"Miami-Dade County, FL",2013-2014,2641866,2662874,21008,0.795,10470,10538,12,86,H1
"Miami-Dade County, FL",2014-2015,2668903,2693117,24214,0.907,11221,12993,12,86,H1
"Miami-Dade County, FL",2015-2016,2693117,2736543,43426,1.612,11985,31441,12,86,H1
"Miami-Dade County, FL",2016-2017,2736543,2751796,15253,0.557,10439,4814,12,86,H1
"Monroe County, FL",2000-2001,79470,79038,-432,-0.544,68,-500,12,87,H1
"Monroe County, FL",2001-2002,79038,78755,-283,-0.358,-20,-263,12,87,H1
"Monroe County, FL",2002-2003,78755,78497,-258,-0.328,-23,-235,12,87,H1
"Monroe County, FL",2003-2004,78497,77616,-881,-1.122,34,-915,12,87,H1
"Monroe County, FL",2004-2005,77616,75819,-1797,-2.315,24,-1821,12,87,H1
"Monroe County, FL",2005-2006,75819,73793,-2026,-2.672,-13,-2013,12,87,H1
"Monroe County, FL",2006-2007,73793,72906,-887,-1.202,150,-1037,12,87,H1
"Monroe County, FL",2007-2008,72906,72730,-176,-0.241,109,-285,12,87,H1
"Monroe County, FL",2008-2009,72730,72627,-103,-0.142,38,-141,12,87,H1
"Monroe County, FL",2009-2010,72627,73226,599,0.825,139,460,12,87,H1
"Monroe County, FL",2010-2011,73226,74151,925,1.263,41,884,12,87,H1
"Monroe County, FL",2011-2012,74151,74991,840,1.133,79,761,12,87,H1
"Monroe County, FL",2012-2013,74991,76536,1545,2.06,82,1463,12,87,H1
"Monroe County, FL",2013-2014,76536,77136,600,0.784,55,545,12,87,H1
"Monroe County, FL",2014-2015,76858,77482,624,0.812,41,583,12,87,H1
"Monroe County, FL",2015-2016,77482,77304,-178,-0.23,-46,-132,12,87,H1
"Monroe County, FL",2016-2017,77304,77013,-291,-0.376,-24,-267,12,87,H1
"Nassau County, FL",2000-2001,57957,59300,1343,2.317,235,1108,12,89,H1
"Nassau County, FL",2001-2002,59300,60816,1516,2.556,167,1349,12,89,H1
"Nassau County, FL",2002-2003,60816,62069,1253,2.06,135,1118,12,89,H1
"Nassau County, FL",2003-2004,62069,63699,1630,2.626,116,1514,12,89,H1
"Nassau County, FL",2004-2005,63699,65568,1869,2.934,157,1712,12,89,H1
"Nassau County, FL",2005-2006,65568,67823,2255,3.439,163,2092,12,89,H1
"Nassau County, FL",2006-2007,67823,69969,2146,3.164,228,1918,12,89,H1
"Nassau County, FL",2007-2008,69969,71557,1588,2.27,239,1349,12,89,H1
"Nassau County, FL",2008-2009,71557,72671,1114,1.557,201,913,12,89,H1
"Nassau County, FL",2009-2010,72671,73543,872,1.2,105,767,12,89,H1
"Nassau County, FL",2010-2011,73543,74159,616,0.838,70,546,12,89,H1
"Nassau County, FL",2011-2012,74159,74640,481,0.649,73,408,12,89,H1
"Nassau County, FL",2012-2013,74640,75628,988,1.324,46,942,12,89,H1
"Nassau County, FL",2013-2014,75628,76619,991,1.31,-44,1035,12,89,H1
"Nassau County, FL",2014-2015,76597,78444,1847,2.411,-56,1903,12,89,H1
"Nassau County, FL",2015-2016,78444,79922,1478,1.884,19,1459,12,89,H1
"Nassau County, FL",2016-2017,79922,82721,2799,3.502,-78,2877,12,89,H1
"Okaloosa County, FL",2000-2001,171200,172564,1364,0.797,906,458,12,91,H1
"Okaloosa County, FL",2001-2002,172564,176257,3693,2.14,1039,2654,12,91,H1
"Okaloosa County, FL",2002-2003,176257,177649,1392,0.79,1150,242,12,91,H1
"Okaloosa County, FL",2003-2004,177649,182506,4857,2.734,1114,3743,12,91,H1
"Okaloosa County, FL",2004-2005,182506,184045,1539,0.843,1344,195,12,91,H1
"Okaloosa County, FL",2005-2006,184045,184071,26,0.014,1365,-1339,12,91,H1
"Okaloosa County, FL",2006-2007,184071,182677,-1394,-0.757,1389,-2783,12,91,H1
"Okaloosa County, FL",2007-2008,182677,181752,-925,-0.506,1216,-2141,12,91,H1
"Okaloosa County, FL",2008-2009,181752,181153,-599,-0.33,1179,-1778,12,91,H1
"Okaloosa County, FL",2009-2010,181153,180751,-402,-0.222,1342,-1744,12,91,H1
"Okaloosa County, FL",2010-2011,180751,183314,2563,1.418,1099,1464,12,91,H1
"Okaloosa County, FL",2011-2012,183314,190437,7123,3.886,1171,5952,12,91,H1
"Okaloosa County, FL",2012-2013,190437,193906,3469,1.822,1007,2462,12,91,H1
"Okaloosa County, FL",2013-2014,193906,196512,2606,1.344,1049,1557,12,91,H1
"Okaloosa County, FL",2014-2015,195650,198664,3014,1.541,1118,1896,12,91,H1
"Okaloosa County, FL",2015-2016,198664,199915,1251,0.63,975,276,12,91,H1
"Okaloosa County, FL",2016-2017,199915,202970,3055,1.528,943,2112,12,91,H1
"Okeechobee County, FL",2000-2001,35917,36298,381,1.061,201,180,12,93,H1
"Okeechobee County, FL",2001-2002,36298,36776,478,1.317,193,285,12,93,H1
"Okeechobee County, FL",2002-2003,36776,37224,448,1.218,124,324,12,93,H1
"Okeechobee County, FL",2003-2004,37224,38556,1332,3.578,201,1131,12,93,H1
"Okeechobee County, FL",2004-2005,38556,39247,691,1.792,140,551,12,93,H1
"Okeechobee County, FL",2005-2006,39247,39668,421,1.073,189,232,12,93,H1
"Okeechobee County, FL",2006-2007,39668,39840,172,0.434,152,20,12,93,H1
"Okeechobee County, FL",2007-2008,39840,39968,128,0.321,218,-90,12,93,H1
"Okeechobee County, FL",2008-2009,39968,39899,-69,-0.173,185,-254,12,93,H1
"Okeechobee County, FL",2009-2010,39899,40039,140,0.351,228,-88,12,93,H1
"Okeechobee County, FL",2010-2011,40039,39441,-598,-1.494,129,-727,12,93,H1
"Okeechobee County, FL",2011-2012,39441,39285,-156,-0.396,149,-305,12,93,H1
"Okeechobee County, FL",2012-2013,39285,39076,-209,-0.532,126,-335,12,93,H1
"Okeechobee County, FL",2013-2014,39076,39149,73,0.187,129,-56,12,93,H1
"Okeechobee County, FL",2014-2015,39114,39469,355,0.908,142,213,12,93,H1
"Okeechobee County, FL",2015-2016,39469,40697,1228,3.111,81,1147,12,93,H1
"Okeechobee County, FL",2016-2017,40697,41605,908,2.231,85,823,12,93,H1
"Orange County, FL",2000-2001,903019,931775,28756,3.184,7823,20933,12,95,H1
"Orange County, FL",2001-2002,931775,955136,23361,2.507,7892,15469,12,95,H1
"Orange County, FL",2002-2003,955136,979227,24091,2.522,7785,16306,12,95,H1
"Orange County, FL",2003-2004,979227,1011681,32454,3.314,8672,23782,12,95,H1
"Orange County, FL",2004-2005,1011681,1053341,41660,4.118,9373,32287,12,95,H1
"Orange County, FL",2005-2006,1053341,1083429,30088,2.856,10222,19866,12,95,H1
"Orange County, FL",2006-2007,1083429,1100663,17234,1.591,10609,6625,12,95,H1
"Orange County, FL",2007-2008,1100663,1115525,14862,1.35,9955,4907,12,95,H1
"Orange County, FL",2008-2009,1115525,1131351,15826,1.419,9823,6003,12,95,H1
"Orange County, FL",2009-2010,1131351,1148953,17602,1.556,10494,7108,12,95,H1
"Orange County, FL",2010-2011,1148953,1170411,21458,1.868,8231,13227,12,95,H1
"Orange County, FL",2011-2012,1170411,1202076,31665,2.705,8824,22841,12,95,H1
"Orange County, FL",2012-2013,1202076,1226764,24688,2.054,8353,16335,12,95,H1
"Orange County, FL",2013-2014,1226764,1253001,26237,2.139,8447,17790,12,95,H1
"Orange County, FL",2014-2015,1256495,1288126,31631,2.517,8736,22895,12,95,H1
"Orange County, FL",2015-2016,1288126,1323598,35472,2.754,8613,26859,12,95,H1
"Orange County, FL",2016-2017,1323598,1348975,25377,1.917,8564,16813,12,95,H1
"Osceola County, FL",2000-2001,174146,181694,7548,4.334,1442,6106,12,97,H1
"Osceola County, FL",2001-2002,181694,190844,9150,5.036,1364,7786,12,97,H1
"Osceola County, FL",2002-2003,190844,202687,11843,6.206,1534,10309,12,97,H1
"Osceola County, FL",2003-2004,202687,216541,13854,6.835,1794,12060,12,97,H1
"Osceola County, FL",2004-2005,216541,228026,11485,5.304,1954,9531,12,97,H1
"Osceola County, FL",2005-2006,228026,242081,14055,6.164,2158,11897,12,97,H1
"Osceola County, FL",2006-2007,242081,253722,11641,4.809,2588,9053,12,97,H1
"Osceola County, FL",2007-2008,253722,261746,8024,3.163,2565,5459,12,97,H1
"Osceola County, FL",2008-2009,261746,265267,3521,1.345,2415,1106,12,97,H1
"Osceola County, FL",2009-2010,265267,269811,4544,1.713,2165,2379,12,97,H1
"Osceola County, FL",2010-2011,269811,278755,8944,3.315,2060,6884,12,97,H1
"Osceola County, FL",2011-2012,278755,288970,10215,3.665,2052,8163,12,97,H1
"Osceola County, FL",2012-2013,288970,299498,10528,3.643,1954,8574,12,97,H1
"Osceola County, FL",2013-2014,299498,310211,10713,3.577,2065,8648,12,97,H1
"Osceola County, FL",2014-2015,311965,323993,12028,3.856,2147,9881,12,97,H1
"Osceola County, FL",2015-2016,323993,337990,13997,4.32,2097,11900,12,97,H1
"Osceola County, FL",2016-2017,337990,352180,14190,4.198,2129,12061,12,97,H1
"Palm Beach County, FL",2000-2001,1135787,1160474,24687,2.174,315,24372,12,99,H1
"Palm Beach County, FL",2001-2002,1160474,1191340,30866,2.66,468,30398,12,99,H1
"Palm Beach County, FL",2002-2003,1191340,1218100,26760,2.246,558,26202,12,99,H1
"Palm Beach County, FL",2003-2004,1218100,1252223,34123,2.801,1322,32801,12,99,H1
"Palm Beach County, FL",2004-2005,1252223,1278380,26157,2.089,1374,24783,12,99,H1
"Palm Beach County, FL",2005-2006,1278380,1284489,6109,0.478,2173,3936,12,99,H1
"Palm Beach County, FL",2006-2007,1284489,1286586,2097,0.163,2662,-565,12,99,H1
"Palm Beach County, FL",2007-2008,1286586,1294938,8352,0.649,1716,6636,12,99,H1
"Palm Beach County, FL",2008-2009,1294938,1307371,12433,0.96,1425,11008,12,99,H1
"Palm Beach County, FL",2009-2010,1307371,1324241,16870,1.29,1828,15042,12,99,H1
"Palm Beach County, FL",2010-2011,1324241,1338609,14368,1.085,611,13757,12,99,H1
"Palm Beach County, FL",2011-2012,1338609,1358613,20004,1.494,967,19037,12,99,H1
"Palm Beach County, FL",2012-2013,1358613,1376199,17586,1.294,114,17472,12,99,H1
"Palm Beach County, FL",2013-2014,1376199,1397710,21511,1.563,-36,21547,12,99,H1
"Palm Beach County, FL",2014-2015,1398518,1422789,24271,1.735,203,24068,12,99,H1
"Palm Beach County, FL",2015-2016,1422789,1453768,30979,2.177,-29,31008,12,99,H1
"Palm Beach County, FL",2016-2017,1453768,1471150,17382,1.196,-156,17538,12,99,H1
"Pasco County, FL",2000-2001,347038,357653,10615,3.059,-1440,12055,12,101,H1
"Pasco County, FL",2001-2002,357653,369665,12012,3.359,-1435,13447,12,101,H1
"Pasco County, FL",2002-2003,369665,383238,13573,3.672,-1419,14992,12,101,H1
"Pasco County, FL",2003-2004,383238,401648,18410,4.804,-1332,19742,12,101,H1
"Pasco County, FL",2004-2005,401648,421844,20196,5.028,-643,20839,12,101,H1
"Pasco County, FL",2005-2006,421844,439529,17685,4.192,-400,18085,12,101,H1
"Pasco County, FL",2006-2007,439529,453579,14050,3.197,-42,14092,12,101,H1
"Pasco County, FL",2007-2008,453579,461313,7734,1.705,-98,7832,12,101,H1
"Pasco County, FL",2008-2009,461313,462607,1294,0.281,-37,1331,12,101,H1
"Pasco County, FL",2009-2010,462607,465541,2934,0.634,-220,3154,12,101,H1
"Pasco County, FL",2010-2011,465541,466552,1011,0.217,-774,1785,12,101,H1
"Pasco County, FL",2011-2012,466552,470604,4052,0.868,-732,4784,12,101,H1
"Pasco County, FL",2012-2013,470604,475695,5091,1.082,-958,6049,12,101,H1
"Pasco County, FL",2013-2014,475695,485331,9636,2.026,-923,10559,12,101,H1
"Pasco County, FL",2014-2015,485640,497909,12269,2.526,-812,13081,12,101,H1
"Pasco County, FL",2015-2016,497909,510561,12652,2.541,-994,13646,12,101,H1
"Pasco County, FL",2016-2017,510561,525643,15082,2.954,-946,16028,12,101,H1
"Pinellas County, FL",2000-2001,922150,923850,1700,0.184,-3468,5168,12,103,H1
"Pinellas County, FL",2001-2002,923850,925102,1252,0.136,-3680,4932,12,103,H1
"Pinellas County, FL",2002-2003,925102,926266,1164,0.126,-2959,4123,12,103,H1
"Pinellas County, FL",2003-2004,926266,928305,2039,0.22,-3035,5074,12,103,H1
"Pinellas County, FL",2004-2005,928305,929426,1121,0.121,-2873,3994,12,103,H1
"Pinellas County, FL",2005-2006,929426,924182,-5244,-0.564,-2594,-2650,12,103,H1
"Pinellas County, FL",2006-2007,924182,918624,-5558,-0.601,-1805,-3753,12,103,H1
"Pinellas County, FL",2007-2008,918624,916458,-2166,-0.236,-1855,-311,12,103,H1
"Pinellas County, FL",2008-2009,916458,915330,-1128,-0.123,-2368,1240,12,103,H1
"Pinellas County, FL",2009-2010,915330,916701,1371,0.15,-1680,3051,12,103,H1
"Pinellas County, FL",2010-2011,916701,917979,1278,0.139,-2904,4182,12,103,H1
"Pinellas County, FL",2011-2012,917979,922265,4286,0.467,-2741,7027,12,103,H1
"Pinellas County, FL",2012-2013,922265,930109,7844,0.851,-3170,11014,12,103,H1
"Pinellas County, FL",2013-2014,930109,938098,7989,0.859,-3392,11381,12,103,H1
"Pinellas County, FL",2014-2015,938144,949827,11683,1.245,-3358,15041,12,103,H1
"Pinellas County, FL",2015-2016,949827,962106,12279,1.293,-3415,15694,12,103,H1
"Pinellas County, FL",2016-2017,962106,970637,8531,0.887,-3822,12353,12,103,H1
"Polk County, FL",2000-2001,485515,492917,7402,1.525,1696,5706,12,105,H1
"Polk County, FL",2001-2002,492917,501469,8552,1.735,1578,6974,12,105,H1
"Polk County, FL",2002-2003,501469,513058,11589,2.311,1640,9949,12,105,H1
"Polk County, FL",2003-2004,513058,527685,14627,2.851,1698,12929,12,105,H1
"Polk County, FL",2004-2005,527685,547373,19688,3.731,1769,17919,12,105,H1
"Polk County, FL",2005-2006,547373,568324,20951,3.828,2401,18550,12,105,H1
"Polk County, FL",2006-2007,568324,585982,17658,3.107,3104,14554,12,105,H1
"Polk County, FL",2007-2008,585982,594801,8819,1.505,2556,6263,12,105,H1
"Polk County, FL",2008-2009,594801,598683,3882,0.653,2552,1330,12,105,H1
"Polk County, FL",2009-2010,598683,603359,4676,0.781,2565,2111,12,105,H1
"Polk County, FL",2010-2011,603359,609696,6337,1.05,1210,5127,12,105,H1
"Polk County, FL",2011-2012,609696,615764,6068,0.995,1418,4650,12,105,H1
"Polk County, FL",2012-2013,615764,623159,7395,1.201,1094,6301,12,105,H1
"Polk County, FL",2013-2014,623159,634638,11479,1.842,1053,10426,12,105,H1
"Polk County, FL",2014-2015,635264,650092,14828,2.334,1187,13641,12,105,H1
"Polk County, FL",2015-2016,650092,667018,16926,2.604,758,16168,12,105,H1
"Polk County, FL",2016-2017,667018,686483,19465,2.918,1006,18459,12,105,H1
"Putnam County, FL",2000-2001,70433,70585,152,0.216,8,144,12,107,H1
"Putnam County, FL",2001-2002,70585,71386,801,1.135,21,780,12,107,H1
"Putnam County, FL",2002-2003,71386,71853,467,0.654,-9,476,12,107,H1
"Putnam County, FL",2003-2004,71853,72831,978,1.361,36,942,12,107,H1
"Putnam County, FL",2004-2005,72831,73792,961,1.319,62,899,12,107,H1
"Putnam County, FL",2005-2006,73792,74663,871,1.18,119,752,12,107,H1
"Putnam County, FL",2006-2007,74663,75107,444,0.595,174,270,12,107,H1
"Putnam County, FL",2007-2008,75107,74999,-108,-0.144,144,-252,12,107,H1
"Putnam County, FL",2008-2009,74999,74546,-453,-0.604,106,-559,12,107,H1
"Putnam County, FL",2009-2010,74546,74221,-325,-0.436,28,-353,12,107,H1
"Putnam County, FL",2010-2011,74221,73928,-293,-0.395,-65,-228,12,107,H1
"Putnam County, FL",2011-2012,73928,73119,-809,-1.094,-49,-760,12,107,H1
"Putnam County, FL",2012-2013,73119,72543,-576,-0.788,-137,-439,12,107,H1
"Putnam County, FL",2013-2014,72543,72143,-400,-0.551,-105,-295,12,107,H1
"Putnam County, FL",2014-2015,72040,72023,-17,-0.024,-107,90,12,107,H1
"Putnam County, FL",2015-2016,72023,72404,381,0.529,-135,516,12,107,H1
"Putnam County, FL",2016-2017,72404,73464,1060,1.464,-116,1176,12,107,H1
"St. Johns County, FL",2000-2001,124522,129805,5283,4.243,142,5141,12,109,H1
"St. Johns County, FL",2001-2002,129805,135770,5965,4.595,166,5799,12,109,H1
"St. Johns County, FL",2002-2003,135770,142165,6395,4.71,259,6136,12,109,H1
"St. Johns County, FL",2003-2004,142165,151717,9552,6.719,317,9235,12,109,H1
"St. Johns County, FL",2004-2005,151717,160266,8549,5.635,388,8161,12,109,H1
"St. Johns County, FL",2005-2006,160266,168480,8214,5.125,498,7716,12,109,H1
"St. Johns County, FL",2006-2007,168480,175318,6838,4.059,419,6419,12,109,H1
"St. Johns County, FL",2007-2008,175318,181720,6402,3.652,474,5928,12,109,H1
"St. Johns County, FL",2008-2009,181720,186281,4561,2.51,549,4012,12,109,H1
"St. Johns County, FL",2009-2010,186281,191257,4976,2.671,331,4645,12,109,H1
"St. Johns County, FL",2010-2011,191257,196025,4768,2.493,335,4433,12,109,H1
"St. Johns County, FL",2011-2012,196025,202264,6239,3.183,334,5905,12,109,H1
"St. Johns County, FL",2012-2013,202264,209544,7280,3.599,290,6990,12,109,H1
"St. Johns County, FL",2013-2014,209544,217919,8375,3.997,344,8031,12,109,H1
"St. Johns County, FL",2014-2015,218043,226640,8597,3.943,404,8193,12,109,H1
"St. Johns County, FL",2015-2016,226640,235046,8406,3.709,193,8213,12,109,H1
"St. Johns County, FL",2016-2017,235046,243812,8766,3.729,235,8531,12,109,H1
"St. Lucie County, FL",2000-2001,193518,198459,4941,2.553,-219,5160,12,111,H1
"St. Lucie County, FL",2001-2002,198459,205796,7337,3.697,-1,7338,12,111,H1
"St. Lucie County, FL",2002-2003,205796,214924,9128,4.435,-60,9188,12,111,H1
"St. Lucie County, FL",2003-2004,214924,228548,13624,6.339,241,13383,12,111,H1
"St. Lucie County, FL",2004-2005,228548,241965,13417,5.871,468,12949,12,111,H1
"St. Lucie County, FL",2005-2006,241965,255251,13286,5.491,770,12516,12,111,H1
"St. Lucie County, FL",2006-2007,255251,266860,11609,4.548,1185,10424,12,111,H1
"St. Lucie County, FL",2007-2008,266860,273151,6291,2.357,843,5448,12,111,H1
"St. Lucie County, FL",2008-2009,273151,274344,1193,0.437,834,359,12,111,H1
"St. Lucie County, FL",2009-2010,274344,278268,3924,1.43,518,3406,12,111,H1
"St. Lucie County, FL",2010-2011,278268,280779,2511,0.902,378,2133,12,111,H1
"St. Lucie County, FL",2011-2012,280779,283559,2780,0.99,232,2548,12,111,H1
"St. Lucie County, FL",2012-2013,283559,286307,2748,0.969,-1,2749,12,111,H1
"St. Lucie County, FL",2013-2014,286307,291028,4721,1.649,-72,4793,12,111,H1
"St. Lucie County, FL",2014-2015,290957,298563,7606,2.614,-75,7681,12,111,H1
"St. Lucie County, FL",2015-2016,298563,306079,7516,2.517,-136,7652,12,111,H1
"St. Lucie County, FL",2016-2017,306079,313506,7427,2.426,-252,7679,12,111,H1
"Santa Rosa County, FL",2000-2001,118360,121261,2901,2.451,588,2313,12,113,H1
"Santa Rosa County, FL",2001-2002,121261,127438,6177,5.094,635,5542,12,113,H1
"Santa Rosa County, FL",2002-2003,127438,131463,4025,3.158,650,3375,12,113,H1
"Santa Rosa County, FL",2003-2004,131463,137241,5778,4.395,587,5191,12,113,H1
"Santa Rosa County, FL",2004-2005,137241,141132,3891,2.835,631,3260,12,113,H1
"Santa Rosa County, FL",2005-2006,141132,142983,1851,1.312,786,1065,12,113,H1
"Santa Rosa County, FL",2006-2007,142983,146158,3175,2.221,840,2335,12,113,H1
"Santa Rosa County, FL",2007-2008,146158,148538,2380,1.628,796,1584,12,113,H1
"Santa Rosa County, FL",2008-2009,148538,149544,1006,0.677,840,166,12,113,H1
"Santa Rosa County, FL",2009-2010,149544,152870,3326,2.224,707,2619,12,113,H1
"Santa Rosa County, FL",2010-2011,152870,155697,2827,1.849,563,2264,12,113,H1
"Santa Rosa County, FL",2011-2012,155697,158398,2701,1.735,556,2145,12,113,H1
"Santa Rosa County, FL",2012-2013,158398,160811,2413,1.523,605,1808,12,113,H1
"Santa Rosa County, FL",2013-2014,160811,163422,2611,1.624,532,2079,12,113,H1
"Santa Rosa County, FL",2014-2015,163244,167040,3796,2.325,484,3312,12,113,H1
"Santa Rosa County, FL",2015-2016,167040,170063,3023,1.81,560,2463,12,113,H1
"Santa Rosa County, FL",2016-2017,170063,174272,4209,2.475,455,3754,12,113,H1
"Sarasota County, FL",2000-2001,327165,333707,6542,2,-2012,8554,12,115,H1
"Sarasota County, FL",2001-2002,333707,340590,6883,2.063,-2049,8932,12,115,H1
"Sarasota County, FL",2002-2003,340590,347862,7272,2.135,-1709,8981,12,115,H1
"Sarasota County, FL",2003-2004,347862,357751,9889,2.843,-1691,11580,12,115,H1
"Sarasota County, FL",2004-2005,357751,367912,10161,2.84,-1958,12119,12,115,H1
"Sarasota County, FL",2005-2006,367912,371361,3449,0.937,-1854,5303,12,115,H1
"Sarasota County, FL",2006-2007,371361,375325,3964,1.067,-1615,5579,12,115,H1
"Sarasota County, FL",2007-2008,375325,377178,1853,0.494,-1825,3678,12,115,H1
"Sarasota County, FL",2008-2009,377178,377262,84,0.022,-1975,2059,12,115,H1
"Sarasota County, FL",2009-2010,377262,379952,2690,0.713,-1783,4473,12,115,H1
"Sarasota County, FL",2010-2011,379952,381513,1561,0.411,-2121,3682,12,115,H1
"Sarasota County, FL",2011-2012,381513,386050,4537,1.189,-2041,6578,12,115,H1
"Sarasota County, FL",2012-2013,386050,390242,4192,1.086,-2316,6508,12,115,H1
"Sarasota County, FL",2013-2014,390242,396962,6720,1.722,-2437,9157,12,115,H1
"Sarasota County, FL",2014-2015,397024,405549,8525,2.147,-2505,11030,12,115,H1
"Sarasota County, FL",2015-2016,405549,412879,7330,1.807,-2816,10146,12,115,H1
"Sarasota County, FL",2016-2017,412879,419119,6240,1.511,-2959,9199,12,115,H1
"Seminole County, FL",2000-2001,367378,374593,7215,1.964,1935,5280,12,117,H1
"Seminole County, FL",2001-2002,374593,382846,8253,2.203,1764,6489,12,117,H1
"Seminole County, FL",2002-2003,382846,388141,5295,1.383,1960,3335,12,117,H1
"Seminole County, FL",2003-2004,388141,395230,7089,1.826,1926,5163,12,117,H1
"Seminole County, FL",2004-2005,395230,406840,11610,2.938,1960,9650,12,117,H1
"Seminole County, FL",2005-2006,406840,413218,6378,1.568,2239,4139,12,117,H1
"Seminole County, FL",2006-2007,413218,413571,353,0.085,2034,-1681,12,117,H1
"Seminole County, FL",2007-2008,413571,416564,2993,0.724,1931,1062,12,117,H1
"Seminole County, FL",2008-2009,416564,419788,3224,0.774,2031,1193,12,117,H1
"Seminole County, FL",2009-2010,419788,423012,3224,0.768,2176,1048,12,117,H1
"Seminole County, FL",2010-2011,423012,427036,4024,0.951,1621,2403,12,117,H1
"Seminole County, FL",2011-2012,427036,431405,4369,1.023,1505,2864,12,117,H1
"Seminole County, FL",2012-2013,431405,436706,5301,1.229,1249,4052,12,117,H1
"Seminole County, FL",2013-2014,436706,442516,5810,1.33,1240,4570,12,117,H1
"Seminole County, FL",2014-2015,442533,449144,6611,1.494,1196,5415,12,117,H1
"Seminole County, FL",2015-2016,449144,456314,7170,1.596,1116,6054,12,117,H1
"Seminole County, FL",2016-2017,456314,462659,6345,1.39,1102,5243,12,117,H1
"Sumter County, FL",2000-2001,53738,55793,2055,3.824,-136,2191,12,119,H1
"Sumter County, FL",2001-2002,55793,59539,3746,6.714,-322,4068,12,119,H1
"Sumter County, FL",2002-2003,59539,61934,2395,4.023,-272,2667,12,119,H1
"Sumter County, FL",2003-2004,61934,64456,2522,4.072,-256,2778,12,119,H1
"Sumter County, FL",2004-2005,64456,69261,4805,7.455,-288,5093,12,119,H1
"Sumter County, FL",2005-2006,69261,76202,6941,10.022,-379,7320,12,119,H1
"Sumter County, FL",2006-2007,76202,82101,5899,7.741,-312,6211,12,119,H1
"Sumter County, FL",2007-2008,82101,86433,4332,5.276,-467,4799,12,119,H1
"Sumter County, FL",2008-2009,86433,90643,4210,4.871,-284,4494,12,119,H1
"Sumter County, FL",2009-2010,90643,94287,3644,4.02,-270,3914,12,119,H1
"Sumter County, FL",2010-2011,94287,98598,4311,4.572,-768,5079,12,119,H1
"Sumter County, FL",2011-2012,98598,102823,4225,4.285,-864,5089,12,119,H1
"Sumter County, FL",2012-2013,102823,108483,5660,5.505,-872,6532,12,119,H1
"Sumter County, FL",2013-2014,108483,114350,5867,5.408,-960,6827,12,119,H1
"Sumter County, FL",2014-2015,1.14E+05,118891,4891,4.29,-1076,5967,12,119,H1
"Sumter County, FL",2015-2016,118891,122121,3230,2.717,-1366,4596,12,119,H1
"Sumter County, FL",2016-2017,122121,125165,3044,2.493,-1363,4407,12,119,H1
"Suwannee County, FL",2000-2001,35071,35679,608,1.734,55,553,12,121,H1
"Suwannee County, FL",2001-2002,35679,36186,507,1.421,-13,520,12,121,H1
"Suwannee County, FL",2002-2003,36186,36812,626,1.73,15,611,12,121,H1
"Suwannee County, FL",2003-2004,36812,37597,785,2.132,29,756,12,121,H1
"Suwannee County, FL",2004-2005,37597,38687,1090,2.899,12,1078,12,121,H1
"Suwannee County, FL",2005-2006,38687,39533,846,2.187,-38,884,12,121,H1
"Suwannee County, FL",2006-2007,39533,40309,776,1.963,70,706,12,121,H1
"Suwannee County, FL",2007-2008,40309,40774,465,1.154,68,397,12,121,H1
"Suwannee County, FL",2008-2009,40774,41263,489,1.199,54,435,12,121,H1
"Suwannee County, FL",2009-2010,41263,42320,1057,2.562,0,1057,12,121,H1
"Suwannee County, FL",2010-2011,42320,43385,1065,2.517,-43,1108,12,121,H1
"Suwannee County, FL",2011-2012,43385,43576,191,0.44,-54,245,12,121,H1
"Suwannee County, FL",2012-2013,43576,43718,142,0.326,-51,193,12,121,H1
"Suwannee County, FL",2013-2014,43718,44022,304,0.695,-49,353,12,121,H1
"Suwannee County, FL",2014-2015,43818,43760,-58,-0.132,-83,25,12,121,H1
"Suwannee County, FL",2015-2016,43760,43835,75,0.171,-101,176,12,121,H1
"Suwannee County, FL",2016-2017,43835,44190,355,0.81,-97,452,12,121,H1
"Taylor County, FL",2000-2001,19233,19379,146,0.759,26,120,12,123,H1
"Taylor County, FL",2001-2002,19379,19465,86,0.444,24,62,12,123,H1
"Taylor County, FL",2002-2003,19465,20011,546,2.805,-19,565,12,123,H1
"Taylor County, FL",2003-2004,20011,20093,82,0.41,26,56,12,123,H1
"Taylor County, FL",2004-2005,20093,20515,422,2.1,31,391,12,123,H1
"Taylor County, FL",2005-2006,20515,20793,278,1.355,66,212,12,123,H1
"Taylor County, FL",2006-2007,20793,21805,1012,4.867,67,945,12,123,H1
"Taylor County, FL",2007-2008,21805,22356,551,2.527,50,501,12,123,H1
"Taylor County, FL",2008-2009,22356,22482,126,0.564,64,62,12,123,H1
"Taylor County, FL",2009-2010,22482,22573,91,0.405,29,62,12,123,H1
"Taylor County, FL",2010-2011,22573,22678,105,0.465,36,69,12,123,H1
"Taylor County, FL",2011-2012,22678,22739,61,0.269,25,36,12,123,H1
"Taylor County, FL",2012-2013,22739,22879,140,0.616,-9,149,12,123,H1
"Taylor County, FL",2013-2014,22879,22582,-297,-1.298,6,-303,12,123,H1
"Taylor County, FL",2014-2015,22603,22493,-110,-0.487,-1,-109,12,123,H1
"Taylor County, FL",2015-2016,22493,22118,-375,-1.667,6,-381,12,123,H1
"Taylor County, FL",2016-2017,22118,21833,-285,-1.289,-8,-277,12,123,H1
"Union County, FL",2000-2001,13450,13598,148,1.1,-1,149,12,125,H1
"Union County, FL",2001-2002,13598,13662,64,0.471,-5,69,12,125,H1
"Union County, FL",2002-2003,13662,13787,125,0.915,3,122,12,125,H1
"Union County, FL",2003-2004,13787,14470,683,4.954,-50,733,12,125,H1
"Union County, FL",2004-2005,14470,14856,386,2.668,5,381,12,125,H1
"Union County, FL",2005-2006,14856,14873,17,0.114,-38,55,12,125,H1
"Union County, FL",2006-2007,14873,15419,546,3.671,7,539,12,125,H1
"Union County, FL",2007-2008,15419,15718,299,1.939,-36,335,12,125,H1
"Union County, FL",2008-2009,15718,15340,-378,-2.405,-38,-340,12,125,H1
"Union County, FL",2009-2010,15340,15537,197,1.284,-44,241,12,125,H1
"Union County, FL",2010-2011,15537,15239,-298,-1.918,-23,-275,12,125,H1
"Union County, FL",2011-2012,15239,15239,0,0,5,-5,12,125,H1
"Union County, FL",2012-2013,15239,15086,-153,-1.004,-25,-128,12,125,H1
"Union County, FL",2013-2014,15086,15190,104,0.689,-21,125,12,125,H1
"Union County, FL",2014-2015,15168,15234,66,0.435,-30,96,12,125,H1
"Union County, FL",2015-2016,15234,15267,33,0.217,-91,124,12,125,H1
"Union County, FL",2016-2017,15267,15517,250,1.638,-66,316,12,125,H1
"Volusia County, FL",2000-2001,444935,451103,6168,1.386,-1204,7372,12,127,H1
"Volusia County, FL",2001-2002,451103,458248,7145,1.584,-1356,8501,12,127,H1
"Volusia County, FL",2002-2003,458248,466074,7826,1.708,-1353,9179,12,127,H1
"Volusia County, FL",2003-2004,466074,476845,10771,2.311,-1151,11922,12,127,H1
"Volusia County, FL",2004-2005,476845,486297,9452,1.982,-1364,10816,12,127,H1
"Volusia County, FL",2005-2006,486297,494748,8451,1.738,-1005,9456,12,127,H1
"Volusia County, FL",2006-2007,494748,498935,4187,0.846,-576,4763,12,127,H1
"Volusia County, FL",2007-2008,498935,497366,-1569,-0.314,-641,-928,12,127,H1
"Volusia County, FL",2008-2009,497366,494688,-2678,-0.538,-830,-1848,12,127,H1
"Volusia County, FL",2009-2010,494688,494625,-63,-0.013,-1002,939,12,127,H1
"Volusia County, FL",2010-2011,494625,494458,-167,-0.034,-1553,1386,12,127,H1
"Volusia County, FL",2011-2012,494458,497092,2634,0.533,-1510,4144,12,127,H1
"Volusia County, FL",2012-2013,497092,501201,4109,0.827,-1742,5851,12,127,H1
"Volusia County, FL",2013-2014,501201,507531,6330,1.263,-1697,8027,12,127,H1
"Volusia County, FL",2014-2015,507729,517887,10158,2.001,-1794,11952,12,127,H1
"Volusia County, FL",2015-2016,517887,529038,11151,2.153,-2125,13276,12,127,H1
"Volusia County, FL",2016-2017,529038,538692,9654,1.825,-1883,11537,12,127,H1
"Wakulla County, FL",2000-2001,22924,23779,855,3.73,120,735,12,129,H1
"Wakulla County, FL",2001-2002,23779,24458,679,2.855,94,585,12,129,H1
"Wakulla County, FL",2002-2003,24458,25062,604,2.47,78,526,12,129,H1
"Wakulla County, FL",2003-2004,25062,25832,770,3.072,89,681,12,129,H1
"Wakulla County, FL",2004-2005,25832,26706,874,3.383,103,771,12,129,H1
"Wakulla County, FL",2005-2006,26706,27785,1079,4.04,49,1030,12,129,H1
"Wakulla County, FL",2006-2007,27785,28588,803,2.89,119,684,12,129,H1
"Wakulla County, FL",2007-2008,28588,29183,595,2.081,103,492,12,129,H1
"Wakulla County, FL",2008-2009,29183,30459,1276,4.372,87,1189,12,129,H1
"Wakulla County, FL",2009-2010,30459,30853,394,1.294,33,361,12,129,H1
"Wakulla County, FL",2010-2011,30853,30953,100,0.324,112,-12,12,129,H1
"Wakulla County, FL",2011-2012,30953,30823,-130,-0.42,56,-186,12,129,H1
"Wakulla County, FL",2012-2013,30823,31016,193,0.626,93,100,12,129,H1
"Wakulla County, FL",2013-2014,31016,31432,416,1.341,94,322,12,129,H1
"Wakulla County, FL",2014-2015,31399,31535,136,0.433,86,50,12,129,H1
"Wakulla County, FL",2015-2016,31535,31885,350,1.11,78,272,12,129,H1
"Wakulla County, FL",2016-2017,31885,32120,235,0.737,83,152,12,129,H1
"Walton County, FL",2000-2001,40755,42391,1636,4.014,43,1593,12,131,H1
"Walton County, FL",2001-2002,42391,43935,1544,3.642,64,1480,12,131,H1
"Walton County, FL",2002-2003,43935,45578,1643,3.74,46,1597,12,131,H1
"Walton County, FL",2003-2004,45578,47518,1940,4.256,72,1868,12,131,H1
"Walton County, FL",2004-2005,47518,49392,1874,3.944,66,1808,12,131,H1
"Walton County, FL",2005-2006,49392,51145,1753,3.549,169,1584,12,131,H1
"Walton County, FL",2006-2007,51145,52355,1210,2.366,196,1014,12,131,H1
"Walton County, FL",2007-2008,52355,53563,1208,2.307,221,987,12,131,H1
"Walton County, FL",2008-2009,53563,54534,971,1.813,201,770,12,131,H1
"Walton County, FL",2009-2010,54534,55255,721,1.322,104,617,12,131,H1
"Walton County, FL",2010-2011,55255,55640,385,0.697,59,326,12,131,H1
"Walton County, FL",2011-2012,55640,57275,1635,2.939,147,1488,12,131,H1
"Walton County, FL",2012-2013,57275,59403,2128,3.715,186,1942,12,131,H1
"Walton County, FL",2013-2014,59403,61530,2127,3.581,190,1937,12,131,H1
"Walton County, FL",2014-2015,61559,63508,1949,3.166,197,1752,12,131,H1
"Walton County, FL",2015-2016,63508,65440,1932,3.042,172,1760,12,131,H1
"Walton County, FL",2016-2017,65440,68376,2936,4.487,175,2761,12,131,H1
"Washington County, FL",2000-2001,21023,21316,293,1.394,-28,321,12,133,H1
"Washington County, FL",2001-2002,21316,21287,-29,-0.136,-32,3,12,133,H1
"Washington County, FL",2002-2003,21287,21537,250,1.174,-21,271,12,133,H1
"Washington County, FL",2003-2004,21537,21967,430,1.997,-15,445,12,133,H1
"Washington County, FL",2004-2005,21967,22216,249,1.134,-2,251,12,133,H1
"Washington County, FL",2005-2006,22216,22860,644,2.899,1,643,12,133,H1
"Washington County, FL",2006-2007,22860,23469,609,2.664,3,606,12,133,H1
"Washington County, FL",2007-2008,23469,24706,1237,5.271,29,1208,12,133,H1
"Washington County, FL",2008-2009,24706,24693,-13,-0.053,32,-45,12,133,H1
"Washington County, FL",2009-2010,24693,24760,67,0.271,7,60,12,133,H1
"Washington County, FL",2010-2011,24760,24596,-164,-0.662,-54,-110,12,133,H1
"Washington County, FL",2011-2012,24596,24857,261,1.061,-30,291,12,133,H1
"Washington County, FL",2012-2013,24857,24635,-222,-0.893,11,-233,12,133,H1
"Washington County, FL",2013-2014,24635,24451,-184,-0.747,-33,-151,12,133,H1
"Washington County, FL",2014-2015,24435,24687,252,1.031,-27,279,12,133,H1
"Washington County, FL",2015-2016,24687,24450,-237,-0.96,-82,-155,12,133,H1
"Washington County, FL",2016-2017,24450,24567,117,0.479,-69,186,12,133,H1
Georgia,2000-2001,8227303,8377038,149735,1.82,69221,80514,13,0,STATE
Georgia,2001-2002,8377038,8508256,131218,1.566,68511,62707,13,0,STATE
Georgia,2002-2003,8508256,8622793,114537,1.346,68549,45988,13,0,STATE
Georgia,2003-2004,8622793,8769252,146459,1.699,70559,75900,13,0,STATE
Georgia,2004-2005,8769252,8925922,156670,1.787,74397,82273,13,0,STATE
Georgia,2005-2006,8925922,9155813,229891,2.576,76861,153030,13,0,STATE
Georgia,2006-2007,9155813,9349988,194175,2.121,82148,112027,13,0,STATE
Georgia,2007-2008,9349988,9504843,154855,1.656,81153,73702,13,0,STATE
Georgia,2008-2009,9504843,9620846,116003,1.22,76618,39385,13,0,STATE
Georgia,2009-2010,9620846,9713454,92608,0.963,70398,22210,13,0,STATE
Georgia,2010-2011,9713454,9812280,98826,1.017,61538,37288,13,0,STATE
Georgia,2011-2012,9812280,9917639,105359,1.074,61492,43867,13,0,STATE
Georgia,2012-2013,9917639,9991562,73923,0.745,53881,20042,13,0,STATE
Georgia,2013-2014,9991562,10097132,105570,1.057,53602,51968,13,0,STATE
Georgia,2014-2015,10097132,10214860,117728,1.166,53540,64188,13,0,STATE
Georgia,2015-2016,10214860,10313620,98760,0.967,50311,48449,13,0,STATE
Georgia,2016-2017,10313620,10429379,115759,1.122,48785,66974,13,0,STATE
"Appling County, GA",2000-2001,17396,17455,59,0.339,95,-36,13,1,H1
"Appling County, GA",2001-2002,17455,17502,47,0.269,46,1,13,1,H1
"Appling County, GA",2002-2003,17502,17732,230,1.314,97,133,13,1,H1
"Appling County, GA",2003-2004,17732,17740,8,0.045,93,-85,13,1,H1
"Appling County, GA",2004-2005,17740,17769,29,0.163,131,-102,13,1,H1
"Appling County, GA",2005-2006,17769,17725,-44,-0.248,41,-85,13,1,H1
"Appling County, GA",2006-2007,17725,17985,260,1.467,82,178,13,1,H1
"Appling County, GA",2007-2008,17985,18133,148,0.823,93,55,13,1,H1
"Appling County, GA",2008-2009,18133,18144,11,0.061,65,-54,13,1,H1
"Appling County, GA",2009-2010,18144,18337,193,1.064,81,112,13,1,H1
"Appling County, GA",2010-2011,18337,18458,121,0.66,65,56,13,1,H1
"Appling County, GA",2011-2012,18458,18379,-79,-0.428,99,-178,13,1,H1
"Appling County, GA",2012-2013,18379,18391,12,0.065,95,-83,13,1,H1
"Appling County, GA",2013-2014,18391,18540,149,0.81,79,70,13,1,H1
"Appling County, GA",2014-2015,18477,18454,-23,-0.124,45,-68,13,1,H1
"Appling County, GA",2015-2016,18454,18485,31,0.168,59,-28,13,1,H1
"Appling County, GA",2016-2017,18485,18521,36,0.195,52,-16,13,1,H1
"Atkinson County, GA",2000-2001,7591,7641,50,0.659,87,-37,13,3,H1
"Atkinson County, GA",2001-2002,7641,7748,107,1.4,76,31,13,3,H1
"Atkinson County, GA",2002-2003,7748,7990,242,3.123,93,149,13,3,H1
"Atkinson County, GA",2003-2004,7990,7985,-5,-0.063,74,-79,13,3,H1
"Atkinson County, GA",2004-2005,7985,8096,111,1.39,75,36,13,3,H1
"Atkinson County, GA",2005-2006,8096,8197,101,1.248,81,20,13,3,H1
"Atkinson County, GA",2006-2007,8197,8346,149,1.818,78,71,13,3,H1
"Atkinson County, GA",2007-2008,8346,8366,20,0.24,102,-82,13,3,H1
"Atkinson County, GA",2008-2009,8366,8386,20,0.239,106,-86,13,3,H1
"Atkinson County, GA",2009-2010,8386,8365,-21,-0.25,81,-102,13,3,H1
"Atkinson County, GA",2010-2011,8365,8364,-1,-0.012,75,-76,13,3,H1
"Atkinson County, GA",2011-2012,8364,8247,-117,-1.399,42,-159,13,3,H1
"Atkinson County, GA",2012-2013,8247,8287,40,0.485,61,-21,13,3,H1
"Atkinson County, GA",2013-2014,8287,8223,-64,-0.772,84,-148,13,3,H1
"Atkinson County, GA",2014-2015,8203,8398,195,2.377,97,98,13,3,H1
"Atkinson County, GA",2015-2016,8398,8320,-78,-0.929,79,-157,13,3,H1
"Atkinson County, GA",2016-2017,8320,8342,22,0.264,76,-54,13,3,H1
"Bacon County, GA",2000-2001,10131,10133,2,0.02,30,-28,13,5,H1
"Bacon County, GA",2001-2002,10133,10101,-32,-0.316,25,-57,13,5,H1
"Bacon County, GA",2002-2003,10101,10253,152,1.505,38,114,13,5,H1
"Bacon County, GA",2003-2004,10253,10283,30,0.293,31,-1,13,5,H1
"Bacon County, GA",2004-2005,10283,10552,269,2.616,33,236,13,5,H1
"Bacon County, GA",2005-2006,10552,10682,130,1.232,48,82,13,5,H1
"Bacon County, GA",2006-2007,10682,10968,286,2.677,42,244,13,5,H1
"Bacon County, GA",2007-2008,10968,10987,19,0.173,41,-22,13,5,H1
"Bacon County, GA",2008-2009,10987,11134,147,1.338,26,121,13,5,H1
"Bacon County, GA",2009-2010,11134,11090,-44,-0.395,39,-83,13,5,H1
"Bacon County, GA",2010-2011,11090,11191,101,0.911,1,100,13,5,H1
"Bacon County, GA",2011-2012,11191,11186,-5,-0.045,56,-61,13,5,H1
"Bacon County, GA",2012-2013,11186,11230,44,0.393,41,3,13,5,H1
"Bacon County, GA",2013-2014,11230,11281,51,0.454,43,8,13,5,H1
"Bacon County, GA",2014-2015,11248,11299,51,0.453,36,15,13,5,H1
"Bacon County, GA",2015-2016,11299,11365,66,0.584,33,33,13,5,H1
"Bacon County, GA",2016-2017,11365,11319,-46,-0.405,39,-85,13,5,H1
"Baker County, GA",2000-2001,4025,4005,-20,-0.497,2,-22,13,7,H1
"Baker County, GA",2001-2002,4005,3923,-82,-2.047,-2,-80,13,7,H1
"Baker County, GA",2002-2003,3923,4124,201,5.124,-3,204,13,7,H1
"Baker County, GA",2003-2004,4124,4024,-100,-2.425,-10,-90,13,7,H1
"Baker County, GA",2004-2005,4024,3967,-57,-1.417,-1,-56,13,7,H1
"Baker County, GA",2005-2006,3967,3877,-90,-2.269,2,-92,13,7,H1
"Baker County, GA",2006-2007,3877,3706,-171,-4.411,11,-182,13,7,H1
"Baker County, GA",2007-2008,3706,3728,22,0.594,15,7,13,7,H1
"Baker County, GA",2008-2009,3728,3560,-168,-4.506,17,-185,13,7,H1
"Baker County, GA",2009-2010,3560,3443,-117,-3.287,16,-133,13,7,H1
"Baker County, GA",2010-2011,3443,3323,-120,-3.485,8,-128,13,7,H1
"Baker County, GA",2011-2012,3323,3369,46,1.384,21,25,13,7,H1
"Baker County, GA",2012-2013,3369,3321,-48,-1.425,14,-62,13,7,H1
"Baker County, GA",2013-2014,3321,3255,-66,-1.987,3,-69,13,7,H1
"Baker County, GA",2014-2015,3274,3180,-94,-2.871,14,-108,13,7,H1
"Baker County, GA",2015-2016,3180,3208,28,0.881,9,19,13,7,H1
"Baker County, GA",2016-2017,3208,3200,-8,-0.249,0,-8,13,7,H1
"Baldwin County, GA",2000-2001,44684,44764,80,0.179,111,-31,13,9,H1
"Baldwin County, GA",2001-2002,44764,45203,439,0.981,155,284,13,9,H1
"Baldwin County, GA",2002-2003,45203,45433,230,0.509,122,108,13,9,H1
"Baldwin County, GA",2003-2004,45433,45967,534,1.175,183,351,13,9,H1
"Baldwin County, GA",2004-2005,45967,46304,337,0.733,187,150,13,9,H1
"Baldwin County, GA",2005-2006,46304,46513,209,0.451,135,74,13,9,H1
"Baldwin County, GA",2006-2007,46513,47336,823,1.769,169,654,13,9,H1
"Baldwin County, GA",2007-2008,47336,47855,519,1.096,160,359,13,9,H1
"Baldwin County, GA",2008-2009,47855,47087,-768,-1.605,170,-938,13,9,H1
"Baldwin County, GA",2009-2010,47087,45685,-1402,-2.977,171,-1573,13,9,H1
"Baldwin County, GA",2010-2011,45685,45081,-604,-1.322,129,-733,13,9,H1
"Baldwin County, GA",2011-2012,45081,46455,1374,3.048,67,1307,13,9,H1
"Baldwin County, GA",2012-2013,46455,46139,-316,-0.68,98,-414,13,9,H1
"Baldwin County, GA",2013-2014,46139,45909,-230,-0.498,51,-281,13,9,H1
"Baldwin County, GA",2014-2015,45822,45459,-363,-0.792,12,-375,13,9,H1
"Baldwin County, GA",2015-2016,45459,45190,-269,-0.592,-52,-217,13,9,H1
"Baldwin County, GA",2016-2017,45190,44906,-284,-0.628,-58,-226,13,9,H1
"Banks County, GA",2000-2001,14544,15025,481,3.307,76,405,13,11,H1
"Banks County, GA",2001-2002,15025,15485,460,3.062,93,367,13,11,H1
"Banks County, GA",2002-2003,15485,15836,351,2.267,66,285,13,11,H1
"Banks County, GA",2003-2004,15836,16250,414,2.614,117,297,13,11,H1
"Banks County, GA",2004-2005,16250,16683,433,2.665,103,330,13,11,H1
"Banks County, GA",2005-2006,16683,17076,393,2.356,74,319,13,11,H1
"Banks County, GA",2006-2007,17076,17550,474,2.776,87,387,13,11,H1
"Banks County, GA",2007-2008,17550,17953,403,2.296,73,330,13,11,H1
"Banks County, GA",2008-2009,17953,18208,255,1.42,76,179,13,11,H1
"Banks County, GA",2009-2010,18208,18403,195,1.071,66,129,13,11,H1
"Banks County, GA",2010-2011,18403,18330,-73,-0.397,46,-119,13,11,H1
"Banks County, GA",2011-2012,18330,18232,-98,-0.535,14,-112,13,11,H1
"Banks County, GA",2012-2013,18232,18325,93,0.51,47,46,13,11,H1
"Banks County, GA",2013-2014,18325,18295,-30,-0.164,56,-86,13,11,H1
"Banks County, GA",2014-2015,18313,18495,182,0.994,71,111,13,11,H1
"Banks County, GA",2015-2016,18495,18309,-186,-1.006,25,-211,13,11,H1
"Banks County, GA",2016-2017,18309,18634,325,1.775,62,263,13,11,H1
"Barrow County, GA",2000-2001,46520,48171,1651,3.549,430,1221,13,13,H1
"Barrow County, GA",2001-2002,48171,50409,2238,4.646,472,1766,13,13,H1
"Barrow County, GA",2002-2003,50409,52253,1844,3.658,470,1374,13,13,H1
"Barrow County, GA",2003-2004,52253,55032,2779,5.318,590,2189,13,13,H1
"Barrow County, GA",2004-2005,55032,57889,2857,5.192,671,2186,13,13,H1
"Barrow County, GA",2005-2006,57889,61395,3506,6.056,707,2799,13,13,H1
"Barrow County, GA",2006-2007,61395,64760,3365,5.481,749,2616,13,13,H1
"Barrow County, GA",2007-2008,64760,67362,2602,4.018,828,1774,13,13,H1
"Barrow County, GA",2008-2009,67362,68548,1186,1.761,796,390,13,13,H1
"Barrow County, GA",2009-2010,68548,69681,1133,1.653,607,526,13,13,H1
"Barrow County, GA",2010-2011,69681,69846,165,0.237,559,-394,13,13,H1
"Barrow County, GA",2011-2012,69846,70171,325,0.465,589,-264,13,13,H1
"Barrow County, GA",2012-2013,70171,71425,1254,1.787,557,697,13,13,H1
"Barrow County, GA",2013-2014,71425,73240,1815,2.541,535,1280,13,13,H1
"Barrow County, GA",2014-2015,73190,75370,2180,2.979,487,1693,13,13,H1
"Barrow County, GA",2015-2016,75370,77091,1721,2.283,495,1226,13,13,H1
"Barrow County, GA",2016-2017,77091,79061,1970,2.555,524,1446,13,13,H1
"Bartow County, GA",2000-2001,76806,79984,3178,4.138,781,2397,13,15,H1
"Bartow County, GA",2001-2002,79984,83106,3122,3.903,782,2340,13,15,H1
"Bartow County, GA",2002-2003,83106,85731,2625,3.159,784,1841,13,15,H1
"Bartow County, GA",2003-2004,85731,87834,2103,2.453,826,1277,13,15,H1
"Bartow County, GA",2004-2005,87834,90334,2500,2.846,757,1743,13,15,H1
"Bartow County, GA",2005-2006,90334,92983,2649,2.932,823,1826,13,15,H1
"Bartow County, GA",2006-2007,92983,95714,2731,2.937,805,1926,13,15,H1
"Bartow County, GA",2007-2008,95714,98415,2701,2.822,811,1890,13,15,H1
"Bartow County, GA",2008-2009,98415,99807,1392,1.414,785,607,13,15,H1
"Bartow County, GA",2009-2010,99807,100113,306,0.307,644,-338,13,15,H1
"Bartow County, GA",2010-2011,100113,100242,129,0.129,446,-317,13,15,H1
"Bartow County, GA",2011-2012,100242,100477,235,0.234,480,-245,13,15,H1
"Bartow County, GA",2012-2013,100477,101289,812,0.808,428,384,13,15,H1
"Bartow County, GA",2013-2014,101289,101736,447,0.441,431,16,13,15,H1
"Bartow County, GA",2014-2015,101795,102747,952,0.935,464,488,13,15,H1
"Bartow County, GA",2015-2016,102747,103431,684,0.666,416,268,13,15,H1
"Bartow County, GA",2016-2017,103431,105054,1623,1.569,431,1192,13,15,H1
"Ben Hill County, GA",2000-2001,17483,17315,-168,-0.961,87,-255,13,17,H1
"Ben Hill County, GA",2001-2002,17315,17178,-137,-0.791,71,-208,13,17,H1
"Ben Hill County, GA",2002-2003,17178,17095,-83,-0.483,62,-145,13,17,H1
"Ben Hill County, GA",2003-2004,17095,17106,11,0.064,49,-38,13,17,H1
"Ben Hill County, GA",2004-2005,17106,17243,137,0.801,98,39,13,17,H1
"Ben Hill County, GA",2005-2006,17243,17525,282,1.635,141,141,13,17,H1
"Ben Hill County, GA",2006-2007,17525,17719,194,1.107,151,43,13,17,H1
"Ben Hill County, GA",2007-2008,17719,17675,-44,-0.248,136,-180,13,17,H1
"Ben Hill County, GA",2008-2009,17675,17581,-94,-0.532,89,-183,13,17,H1
"Ben Hill County, GA",2009-2010,17581,17639,58,0.33,87,-29,13,17,H1
"Ben Hill County, GA",2010-2011,17639,17599,-40,-0.227,54,-94,13,17,H1
"Ben Hill County, GA",2011-2012,17599,17545,-54,-0.307,59,-113,13,17,H1
"Ben Hill County, GA",2012-2013,17545,17490,-55,-0.313,6,-61,13,17,H1
"Ben Hill County, GA",2013-2014,17490,17464,-26,-0.149,22,-48,13,17,H1
"Ben Hill County, GA",2014-2015,17417,17403,-14,-0.08,21,-35,13,17,H1
"Ben Hill County, GA",2015-2016,17403,17190,-213,-1.224,-19,-194,13,17,H1
"Ben Hill County, GA",2016-2017,17190,16996,-194,-1.129,21,-215,13,17,H1
"Berrien County, GA",2000-2001,16268,16392,124,0.762,82,42,13,19,H1
"Berrien County, GA",2001-2002,16392,16671,279,1.702,70,209,13,19,H1
"Berrien County, GA",2002-2003,16671,17017,346,2.075,66,280,13,19,H1
"Berrien County, GA",2003-2004,17017,17399,382,2.245,69,313,13,19,H1
"Berrien County, GA",2004-2005,17399,17735,336,1.931,80,256,13,19,H1
"Berrien County, GA",2005-2006,17735,18051,316,1.782,87,229,13,19,H1
"Berrien County, GA",2006-2007,18051,18255,204,1.13,106,98,13,19,H1
"Berrien County, GA",2007-2008,18255,18863,608,3.331,102,506,13,19,H1
"Berrien County, GA",2008-2009,18863,19067,204,1.081,109,95,13,19,H1
"Berrien County, GA",2009-2010,19067,19345,278,1.458,68,210,13,19,H1
"Berrien County, GA",2010-2011,19345,19342,-3,-0.016,21,-24,13,19,H1
"Berrien County, GA",2011-2012,19342,19063,-279,-1.442,38,-317,13,19,H1
"Berrien County, GA",2012-2013,19063,19005,-58,-0.304,35,-93,13,19,H1
"Berrien County, GA",2013-2014,19005,18700,-305,-1.605,34,-339,13,19,H1
"Berrien County, GA",2014-2015,18717,18963,246,1.314,42,204,13,19,H1
"Berrien County, GA",2015-2016,18963,19014,51,0.269,52,-1,13,19,H1
"Berrien County, GA",2016-2017,19014,19186,172,0.905,41,131,13,19,H1
"Bibb County, GA",2000-2001,153857,153548,-309,-0.201,850,-1159,13,21,H1
"Bibb County, GA",2001-2002,153548,153929,381,0.248,777,-396,13,21,H1
"Bibb County, GA",2002-2003,153929,153697,-232,-0.151,743,-975,13,21,H1
"Bibb County, GA",2003-2004,153697,154159,462,0.301,833,-371,13,21,H1
"Bibb County, GA",2004-2005,154159,154003,-156,-0.101,783,-939,13,21,H1
"Bibb County, GA",2005-2006,154003,154510,507,0.329,787,-280,13,21,H1
"Bibb County, GA",2006-2007,154510,154286,-224,-0.145,879,-1103,13,21,H1
"Bibb County, GA",2007-2008,154286,154384,98,0.064,883,-785,13,21,H1
"Bibb County, GA",2008-2009,154384,155154,770,0.499,875,-105,13,21,H1
"Bibb County, GA",2009-2010,155154,155630,476,0.307,890,-414,13,21,H1
"Bibb County, GA",2010-2011,155630,155850,220,0.141,682,-462,13,21,H1
"Bibb County, GA",2011-2012,155850,156184,334,0.214,781,-447,13,21,H1
"Bibb County, GA",2012-2013,156184,154615,-1569,-1.005,504,-2073,13,21,H1
"Bibb County, GA",2013-2014,154615,153905,-710,-0.459,592,-1302,13,21,H1
"Bibb County, GA",2014-2015,153918,153721,-197,-0.128,610,-807,13,21,H1
"Bibb County, GA",2015-2016,153721,153205,-516,-0.336,408,-924,13,21,H1
"Bibb County, GA",2016-2017,153205,152862,-343,-0.224,445,-788,13,21,H1
"Bleckley County, GA",2000-2001,11654,11781,127,1.09,34,93,13,23,H1
"Bleckley County, GA",2001-2002,11781,11757,-24,-0.204,41,-65,13,23,H1
"Bleckley County, GA",2002-2003,11757,11807,50,0.425,12,38,13,23,H1
"Bleckley County, GA",2003-2004,11807,12018,211,1.787,12,199,13,23,H1
"Bleckley County, GA",2004-2005,12018,12127,109,0.907,-5,114,13,23,H1
"Bleckley County, GA",2005-2006,12127,12553,426,3.513,29,397,13,23,H1
"Bleckley County, GA",2006-2007,12553,13016,463,3.688,33,430,13,23,H1
"Bleckley County, GA",2007-2008,13016,12985,-31,-0.238,38,-69,13,23,H1
"Bleckley County, GA",2008-2009,12985,13034,49,0.377,59,-10,13,23,H1
"Bleckley County, GA",2009-2010,13034,13054,20,0.153,11,9,13,23,H1
"Bleckley County, GA",2010-2011,13054,13059,5,0.038,-10,15,13,23,H1
"Bleckley County, GA",2011-2012,13059,12897,-162,-1.241,0,-162,13,23,H1
"Bleckley County, GA",2012-2013,12897,12755,-142,-1.101,18,-160,13,23,H1
"Bleckley County, GA",2013-2014,12755,12795,40,0.314,23,17,13,23,H1
"Bleckley County, GA",2014-2015,12794,12243,-551,-4.307,30,-581,13,23,H1
"Bleckley County, GA",2015-2016,12243,12898,655,5.35,7,648,13,23,H1
"Bleckley County, GA",2016-2017,12898,12830,-68,-0.527,11,-79,13,23,H1
"Brantley County, GA",2000-2001,14700,15093,393,2.673,17,376,13,25,H1
"Brantley County, GA",2001-2002,15093,15556,463,3.068,40,423,13,25,H1
"Brantley County, GA",2002-2003,15556,15911,355,2.282,18,337,13,25,H1
"Brantley County, GA",2003-2004,15911,16222,311,1.955,26,285,13,25,H1
"Brantley County, GA",2004-2005,16222,16535,313,1.929,56,257,13,25,H1
"Brantley County, GA",2005-2006,16535,16895,360,2.177,-15,375,13,25,H1
"Brantley County, GA",2006-2007,16895,17198,303,1.793,9,294,13,25,H1
"Brantley County, GA",2007-2008,17198,17593,395,2.297,-22,417,13,25,H1
"Brantley County, GA",2008-2009,17593,18129,536,3.047,-17,553,13,25,H1
"Brantley County, GA",2009-2010,18129,18465,336,1.853,33,303,13,25,H1
"Brantley County, GA",2010-2011,18465,18581,116,0.628,7,109,13,25,H1
"Brantley County, GA",2011-2012,18581,18555,-26,-0.14,5,-31,13,25,H1
"Brantley County, GA",2012-2013,18555,18299,-256,-1.38,44,-300,13,25,H1
"Brantley County, GA",2013-2014,18299,18417,118,0.645,14,104,13,25,H1
"Brantley County, GA",2014-2015,18408,18455,47,0.255,30,17,13,25,H1
"Brantley County, GA",2015-2016,18455,18355,-100,-0.542,45,-145,13,25,H1
"Brantley County, GA",2016-2017,18355,18731,376,2.048,27,349,13,25,H1
"Brooks County, GA",2000-2001,16458,16307,-151,-0.917,18,-169,13,27,H1
"Brooks County, GA",2001-2002,16307,16229,-78,-0.478,18,-96,13,27,H1
"Brooks County, GA",2002-2003,16229,16051,-178,-1.097,-19,-159,13,27,H1
"Brooks County, GA",2003-2004,16051,16127,76,0.473,19,57,13,27,H1
"Brooks County, GA",2004-2005,16127,16124,-3,-0.019,-5,2,13,27,H1
"Brooks County, GA",2005-2006,16124,16309,185,1.147,63,122,13,27,H1
"Brooks County, GA",2006-2007,16309,16333,24,0.147,61,-37,13,27,H1
"Brooks County, GA",2007-2008,16333,16475,142,0.869,48,94,13,27,H1
"Brooks County, GA",2008-2009,16475,16375,-100,-0.607,-9,-91,13,27,H1
"Brooks County, GA",2009-2010,16375,16278,-97,-0.592,7,-104,13,27,H1
"Brooks County, GA",2010-2011,16278,15968,-310,-1.904,20,-330,13,27,H1
"Brooks County, GA",2011-2012,15968,15537,-431,-2.699,66,-497,13,27,H1
"Brooks County, GA",2012-2013,15537,15631,94,0.605,18,76,13,27,H1
"Brooks County, GA",2013-2014,15631,15418,-213,-1.363,7,-220,13,27,H1
"Brooks County, GA",2014-2015,15421,15658,237,1.537,-20,257,13,27,H1
"Brooks County, GA",2015-2016,15658,15693,35,0.224,-24,59,13,27,H1
"Brooks County, GA",2016-2017,15693,15587,-106,-0.675,-36,-70,13,27,H1
"Bryan County, GA",2000-2001,23474,23867,393,1.674,213,180,13,29,H1
"Bryan County, GA",2001-2002,23867,24377,510,2.137,174,336,13,29,H1
"Bryan County, GA",2002-2003,24377,25069,692,2.839,208,484,13,29,H1
"Bryan County, GA",2003-2004,25069,26061,992,3.957,226,766,13,29,H1
"Bryan County, GA",2004-2005,26061,26557,496,1.903,234,262,13,29,H1
"Bryan County, GA",2005-2006,26557,27346,789,2.971,196,593,13,29,H1
"Bryan County, GA",2006-2007,27346,28302,956,3.496,237,719,13,29,H1
"Bryan County, GA",2007-2008,28302,29178,876,3.095,305,571,13,29,H1
"Bryan County, GA",2008-2009,29178,29987,809,2.773,322,487,13,29,H1
"Bryan County, GA",2009-2010,29987,30401,414,1.381,267,147,13,29,H1
"Bryan County, GA",2010-2011,30401,31238,837,2.753,191,646,13,29,H1
"Bryan County, GA",2011-2012,31238,32246,1008,3.227,298,710,13,29,H1
"Bryan County, GA",2012-2013,32246,33133,887,2.751,291,596,13,29,H1
"Bryan County, GA",2013-2014,33133,33906,773,2.333,333,440,13,29,H1
"Bryan County, GA",2014-2015,33921,35137,1216,3.585,323,893,13,29,H1
"Bryan County, GA",2015-2016,35137,35842,705,2.006,270,435,13,29,H1
"Bryan County, GA",2016-2017,35842,37060,1218,3.398,289,929,13,29,H1
"Bulloch County, GA",2000-2001,56146,56808,662,1.179,266,396,13,31,H1
"Bulloch County, GA",2001-2002,56808,57361,553,0.973,350,203,13,31,H1
"Bulloch County, GA",2002-2003,57361,59314,1953,3.405,341,1612,13,31,H1
"Bulloch County, GA",2003-2004,59314,60832,1518,2.559,372,1146,13,31,H1
"Bulloch County, GA",2004-2005,60832,63048,2216,3.643,365,1851,13,31,H1
"Bulloch County, GA",2005-2006,63048,64304,1256,1.992,367,889,13,31,H1
"Bulloch County, GA",2006-2007,64304,65768,1464,2.277,443,1021,13,31,H1
"Bulloch County, GA",2007-2008,65768,67092,1324,2.013,423,901,13,31,H1
"Bulloch County, GA",2008-2009,67092,68598,1506,2.245,404,1102,13,31,H1
"Bulloch County, GA",2009-2010,68598,70638,2040,2.974,410,1630,13,31,H1
"Bulloch County, GA",2010-2011,70638,72842,2204,3.12,352,1852,13,31,H1
"Bulloch County, GA",2011-2012,72842,72824,-18,-0.025,346,-364,13,31,H1
"Bulloch County, GA",2012-2013,72824,71308,-1516,-2.082,368,-1884,13,31,H1
"Bulloch County, GA",2013-2014,71308,72087,779,1.092,287,492,13,31,H1
"Bulloch County, GA",2014-2015,72217,72651,434,0.601,363,71,13,31,H1
"Bulloch County, GA",2015-2016,72651,74721,2070,2.849,330,1740,13,31,H1
"Bulloch County, GA",2016-2017,74721,76149,1428,1.911,348,1080,13,31,H1
"Burke County, GA",2000-2001,22279,22582,303,1.36,264,39,13,33,H1
"Burke County, GA",2001-2002,22582,22626,44,0.195,152,-108,13,33,H1
"Burke County, GA",2002-2003,22626,22692,66,0.292,156,-90,13,33,H1
"Burke County, GA",2003-2004,22692,22867,175,0.771,160,15,13,33,H1
"Burke County, GA",2004-2005,22867,22939,72,0.315,127,-55,13,33,H1
"Burke County, GA",2005-2006,22939,22875,-64,-0.279,153,-217,13,33,H1
"Burke County, GA",2006-2007,22875,22972,97,0.424,95,2,13,33,H1
"Burke County, GA",2007-2008,22972,23084,112,0.488,79,33,13,33,H1
"Burke County, GA",2008-2009,23084,23117,33,0.143,98,-65,13,33,H1
"Burke County, GA",2009-2010,23117,23360,243,1.051,83,160,13,33,H1
"Burke County, GA",2010-2011,23360,23559,199,0.852,86,113,13,33,H1
"Burke County, GA",2011-2012,23559,23128,-431,-1.829,91,-522,13,33,H1
"Burke County, GA",2012-2013,23128,22925,-203,-0.878,67,-270,13,33,H1
"Burke County, GA",2013-2014,22925,22709,-216,-0.942,75,-291,13,33,H1
"Burke County, GA",2014-2015,22714,22745,31,0.136,68,-37,13,33,H1
"Burke County, GA",2015-2016,22745,22608,-137,-0.602,55,-192,13,33,H1
"Burke County, GA",2016-2017,22608,22522,-86,-0.38,53,-139,13,33,H1
"Butts County, GA",2000-2001,19621,20186,565,2.88,78,487,13,35,H1
"Butts County, GA",2001-2002,20186,20993,807,3.998,118,689,13,35,H1
"Butts County, GA",2002-2003,20993,21540,547,2.606,122,425,13,35,H1
"Butts County, GA",2003-2004,21540,21706,166,0.771,96,70,13,35,H1
"Butts County, GA",2004-2005,21706,22055,349,1.608,106,243,13,35,H1
"Butts County, GA",2005-2006,22055,22669,614,2.784,97,517,13,35,H1
"Butts County, GA",2006-2007,22669,23184,515,2.272,122,393,13,35,H1
"Butts County, GA",2007-2008,23184,23794,610,2.631,82,528,13,35,H1
"Butts County, GA",2008-2009,23794,23682,-112,-0.471,94,-206,13,35,H1
"Butts County, GA",2009-2010,23682,23739,57,0.241,68,-11,13,35,H1
"Butts County, GA",2010-2011,23739,23562,-177,-0.746,33,-210,13,35,H1
"Butts County, GA",2011-2012,23562,23454,-108,-0.458,66,-174,13,35,H1
"Butts County, GA",2012-2013,23454,23222,-232,-0.989,17,-249,13,35,H1
"Butts County, GA",2013-2014,23222,23368,146,0.629,36,110,13,35,H1
"Butts County, GA",2014-2015,23394,23593,199,0.851,43,156,13,35,H1
"Butts County, GA",2015-2016,23593,23710,117,0.496,0,117,13,35,H1
"Butts County, GA",2016-2017,23710,24059,349,1.472,9,340,13,35,H1
"Calhoun County, GA",2000-2001,6325,6271,-54,-0.854,36,-90,13,37,H1
"Calhoun County, GA",2001-2002,6271,6359,88,1.403,22,66,13,37,H1
"Calhoun County, GA",2002-2003,6359,6286,-73,-1.148,29,-102,13,37,H1
"Calhoun County, GA",2003-2004,6286,6306,20,0.318,20,0,13,37,H1
"Calhoun County, GA",2004-2005,6306,6256,-50,-0.793,4,-54,13,37,H1
"Calhoun County, GA",2005-2006,6256,6350,94,1.503,16,78,13,37,H1
"Calhoun County, GA",2006-2007,6350,6269,-81,-1.276,-8,-73,13,37,H1
"Calhoun County, GA",2007-2008,6269,6456,187,2.983,19,168,13,37,H1
"Calhoun County, GA",2008-2009,6456,6670,214,3.315,40,174,13,37,H1
"Calhoun County, GA",2009-2010,6670,6712,42,0.63,30,12,13,37,H1
"Calhoun County, GA",2010-2011,6712,6549,-163,-2.428,14,-177,13,37,H1
"Calhoun County, GA",2011-2012,6549,6502,-47,-0.718,-11,-36,13,37,H1
"Calhoun County, GA",2012-2013,6502,6517,15,0.231,2,13,13,37,H1
"Calhoun County, GA",2013-2014,6517,6463,-54,-0.829,21,-75,13,37,H1
"Calhoun County, GA",2014-2015,6431,6479,48,0.746,5,43,13,37,H1
"Calhoun County, GA",2015-2016,6479,6393,-86,-1.327,-4,-82,13,37,H1
"Calhoun County, GA",2016-2017,6393,6455,62,0.97,4,58,13,37,H1
"Camden County, GA",2000-2001,43824,44469,645,1.472,530,115,13,39,H1
"Camden County, GA",2001-2002,44469,45299,830,1.866,605,225,13,39,H1
"Camden County, GA",2002-2003,45299,44568,-731,-1.614,547,-1278,13,39,H1
"Camden County, GA",2003-2004,44568,46096,1528,3.428,504,1024,13,39,H1
"Camden County, GA",2004-2005,46096,46673,577,1.252,445,132,13,39,H1
"Camden County, GA",2005-2006,46673,47086,413,0.885,521,-108,13,39,H1
"Camden County, GA",2006-2007,47086,48947,1861,3.952,619,1242,13,39,H1
"Camden County, GA",2007-2008,48947,49713,766,1.565,635,131,13,39,H1
"Camden County, GA",2008-2009,49713,50024,311,0.626,581,-270,13,39,H1
"Camden County, GA",2009-2010,50024,50689,665,1.329,562,103,13,39,H1
"Camden County, GA",2010-2011,50689,50332,-357,-0.704,514,-871,13,39,H1
"Camden County, GA",2011-2012,50332,51402,1070,2.126,480,590,13,39,H1
"Camden County, GA",2012-2013,51402,51517,115,0.224,554,-439,13,39,H1
"Camden County, GA",2013-2014,51517,52027,510,0.99,533,-23,13,39,H1
"Camden County, GA",2014-2015,51973,52102,129,0.248,508,-379,13,39,H1
"Camden County, GA",2015-2016,52102,52416,314,0.603,441,-127,13,39,H1
"Camden County, GA",2016-2017,52416,53044,628,1.198,435,193,13,39,H1
"Candler County, GA",2000-2001,9585,9442,-143,-1.492,37,-180,13,43,H1
"Candler County, GA",2001-2002,9442,9772,330,3.495,39,291,13,43,H1
"Candler County, GA",2002-2003,9772,9937,165,1.688,52,113,13,43,H1
"Candler County, GA",2003-2004,9937,10039,102,1.026,45,57,13,43,H1
"Candler County, GA",2004-2005,10039,10158,119,1.185,69,50,13,43,H1
"Candler County, GA",2005-2006,10158,10388,230,2.264,55,175,13,43,H1
"Candler County, GA",2006-2007,10388,10586,198,1.906,93,105,13,43,H1
"Candler County, GA",2007-2008,10586,10691,105,0.992,83,22,13,43,H1
"Candler County, GA",2008-2009,10691,10880,189,1.768,60,129,13,43,H1
"Candler County, GA",2009-2010,10880,11017,137,1.259,50,87,13,43,H1
"Candler County, GA",2010-2011,11017,11304,287,2.605,22,265,13,43,H1
"Candler County, GA",2011-2012,11304,11125,-179,-1.584,26,-205,13,43,H1
"Candler County, GA",2012-2013,11125,10944,-181,-1.627,51,-232,13,43,H1
"Candler County, GA",2013-2014,10944,10888,-56,-0.512,32,-88,13,43,H1
"Candler County, GA",2014-2015,10879,10886,7,0.064,17,-10,13,43,H1
"Candler County, GA",2015-2016,10886,10915,29,0.266,-2,31,13,43,H1
"Candler County, GA",2016-2017,10915,10797,-118,-1.081,8,-126,13,43,H1
"Carroll County, GA",2000-2001,87932,91132,3200,3.639,711,2489,13,45,H1
"Carroll County, GA",2001-2002,91132,94087,2955,3.243,640,2315,13,45,H1
"Carroll County, GA",2002-2003,94087,97396,3309,3.517,704,2605,13,45,H1
"Carroll County, GA",2003-2004,97396,99774,2378,2.442,730,1648,13,45,H1
"Carroll County, GA",2004-2005,99774,102526,2752,2.758,704,2048,13,45,H1
"Carroll County, GA",2005-2006,102526,105853,3327,3.245,773,2554,13,45,H1
"Carroll County, GA",2006-2007,105853,108947,3094,2.923,926,2168,13,45,H1
"Carroll County, GA",2007-2008,108947,110242,1295,1.189,941,354,13,45,H1
"Carroll County, GA",2008-2009,110242,110433,191,0.173,878,-687,13,45,H1
"Carroll County, GA",2009-2010,110433,110704,271,0.245,651,-380,13,45,H1
"Carroll County, GA",2010-2011,110704,110722,18,0.016,508,-490,13,45,H1
"Carroll County, GA",2011-2012,110722,111453,731,0.66,651,80,13,45,H1
"Carroll County, GA",2012-2013,111453,112388,935,0.839,401,534,13,45,H1
"Carroll County, GA",2013-2014,112388,114093,1705,1.517,491,1214,13,45,H1
"Carroll County, GA",2014-2015,113999,114545,546,0.479,495,51,13,45,H1
"Carroll County, GA",2015-2016,114545,116291,1746,1.524,464,1282,13,45,H1
"Carroll County, GA",2016-2017,116291,117812,1521,1.308,502,1019,13,45,H1
"Catoosa County, GA",2000-2001,53549,54638,1089,2.034,268,821,13,47,H1
"Catoosa County, GA",2001-2002,54638,56024,1386,2.537,244,1142,13,47,H1
"Catoosa County, GA",2002-2003,56024,57614,1590,2.838,267,1323,13,47,H1
"Catoosa County, GA",2003-2004,57614,58866,1252,2.173,243,1009,13,47,H1
"Catoosa County, GA",2004-2005,58866,59745,879,1.493,235,644,13,47,H1
"Catoosa County, GA",2005-2006,59745,61095,1350,2.26,177,1173,13,47,H1
"Catoosa County, GA",2006-2007,61095,62539,1444,2.364,320,1124,13,47,H1
"Catoosa County, GA",2007-2008,62539,63271,732,1.17,396,336,13,47,H1
"Catoosa County, GA",2008-2009,63271,63874,603,0.953,314,289,13,47,H1
"Catoosa County, GA",2009-2010,63874,64020,146,0.229,211,-65,13,47,H1
"Catoosa County, GA",2010-2011,64020,64839,819,1.279,210,609,13,47,H1
"Catoosa County, GA",2011-2012,64839,64961,122,0.188,219,-97,13,47,H1
"Catoosa County, GA",2012-2013,64961,65335,374,0.576,238,136,13,47,H1
"Catoosa County, GA",2013-2014,65335,65621,286,0.438,189,97,13,47,H1
"Catoosa County, GA",2014-2015,65598,66050,452,0.689,151,301,13,47,H1
"Catoosa County, GA",2015-2016,66050,66267,217,0.329,3,214,13,47,H1
"Catoosa County, GA",2016-2017,66267,66550,283,0.427,37,246,13,47,H1
"Charlton County, GA",2000-2001,10312,10675,363,3.52,35,328,13,49,H1
"Charlton County, GA",2001-2002,10675,10910,235,2.201,28,207,13,49,H1
"Charlton County, GA",2002-2003,10910,11282,372,3.41,28,344,13,49,H1
"Charlton County, GA",2003-2004,11282,11378,96,0.851,29,67,13,49,H1
"Charlton County, GA",2004-2005,11378,11635,257,2.259,15,242,13,49,H1
"Charlton County, GA",2005-2006,11635,12089,454,3.902,60,394,13,49,H1
"Charlton County, GA",2006-2007,12089,12056,-33,-0.273,56,-89,13,49,H1
"Charlton County, GA",2007-2008,12056,12604,548,4.545,78,470,13,49,H1
"Charlton County, GA",2008-2009,12604,12665,61,0.484,55,6,13,49,H1
"Charlton County, GA",2009-2010,12665,12831,166,1.311,49,117,13,49,H1
"Charlton County, GA",2010-2011,12831,13410,579,4.513,37,542,13,49,H1
"Charlton County, GA",2011-2012,13410,13308,-102,-0.761,26,-128,13,49,H1
"Charlton County, GA",2012-2013,13308,13044,-264,-1.984,38,-302,13,49,H1
"Charlton County, GA",2013-2014,13044,12897,-147,-1.127,49,-196,13,49,H1
"Charlton County, GA",2014-2015,12886,12965,79,0.613,37,42,13,49,H1
"Charlton County, GA",2015-2016,12965,12751,-214,-1.651,36,-250,13,49,H1
"Charlton County, GA",2016-2017,12751,12715,-36,-0.282,45,-81,13,49,H1
"Chatham County, GA",2000-2001,232492,234150,1658,0.713,1223,435,13,51,H1
"Chatham County, GA",2001-2002,234150,236510,2360,1.008,1310,1050,13,51,H1
"Chatham County, GA",2002-2003,236510,237348,838,0.354,1394,-556,13,51,H1
"Chatham County, GA",2003-2004,237348,240818,3470,1.462,1355,2115,13,51,H1
"Chatham County, GA",2004-2005,240818,242242,1424,0.591,1550,-126,13,51,H1
"Chatham County, GA",2005-2006,242242,246896,4654,1.921,1521,3133,13,51,H1
"Chatham County, GA",2006-2007,246896,251981,5085,2.06,1734,3351,13,51,H1
"Chatham County, GA",2007-2008,251981,255269,3288,1.305,1727,1561,13,51,H1
"Chatham County, GA",2008-2009,255269,262122,6853,2.685,1667,5186,13,51,H1
"Chatham County, GA",2009-2010,262122,265996,3874,1.478,2021,1853,13,51,H1
"Chatham County, GA",2010-2011,265996,272002,6006,2.258,1562,4444,13,51,H1
"Chatham County, GA",2011-2012,272002,276710,4708,1.731,1867,2841,13,51,H1
"Chatham County, GA",2012-2013,276710,278428,1718,0.621,1693,25,13,51,H1
"Chatham County, GA",2013-2014,278428,283379,4951,1.778,1629,3322,13,51,H1
"Chatham County, GA",2014-2015,282989,286956,3967,1.402,1609,2358,13,51,H1
"Chatham County, GA",2015-2016,286956,289390,2434,0.848,1556,878,13,51,H1
"Chatham County, GA",2016-2017,289390,290501,1111,0.384,1489,-378,13,51,H1
"Chattahoochee County, GA",2000-2001,15047,15780,733,4.871,210,523,13,53,H1
"Chattahoochee County, GA",2001-2002,15780,18043,2263,14.341,213,2050,13,53,H1
"Chattahoochee County, GA",2002-2003,18043,15289,-2754,-15.264,198,-2952,13,53,H1
"Chattahoochee County, GA",2003-2004,15289,15515,226,1.478,178,48,13,53,H1
"Chattahoochee County, GA",2004-2005,15515,14096,-1419,-9.146,213,-1632,13,53,H1
"Chattahoochee County, GA",2005-2006,14096,11828,-2268,-16.09,158,-2426,13,53,H1
"Chattahoochee County, GA",2006-2007,11828,11965,137,1.158,199,-62,13,53,H1
"Chattahoochee County, GA",2007-2008,11965,11624,-341,-2.85,222,-563,13,53,H1
"Chattahoochee County, GA",2008-2009,11624,11955,331,2.848,231,100,13,53,H1
"Chattahoochee County, GA",2009-2010,11955,11179,-776,-6.491,245,-1021,13,53,H1
"Chattahoochee County, GA",2010-2011,11179,11293,114,1.02,187,-73,13,53,H1
"Chattahoochee County, GA",2011-2012,11293,12570,1277,11.308,275,1002,13,53,H1
"Chattahoochee County, GA",2012-2013,12570,12350,-220,-1.75,222,-442,13,53,H1
"Chattahoochee County, GA",2013-2014,12350,11837,-513,-4.154,202,-715,13,53,H1
"Chattahoochee County, GA",2014-2015,11898,11368,-530,-4.455,193,-723,13,53,H1
"Chattahoochee County, GA",2015-2016,11368,10100,-1268,-11.154,177,-1445,13,53,H1
"Chattahoochee County, GA",2016-2017,10100,10343,243,2.406,166,77,13,53,H1
"Chattooga County, GA",2000-2001,25419,25675,256,1.007,82,174,13,55,H1
"Chattooga County, GA",2001-2002,25675,25688,13,0.051,33,-20,13,55,H1
"Chattooga County, GA",2002-2003,25688,25981,293,1.141,61,232,13,55,H1
"Chattooga County, GA",2003-2004,25981,25537,-444,-1.709,19,-463,13,55,H1
"Chattooga County, GA",2004-2005,25537,25506,-31,-0.121,12,-43,13,55,H1
"Chattooga County, GA",2005-2006,25506,25640,134,0.525,41,93,13,55,H1
"Chattooga County, GA",2006-2007,25640,26230,590,2.301,59,531,13,55,H1
"Chattooga County, GA",2007-2008,26230,26146,-84,-0.32,30,-114,13,55,H1
"Chattooga County, GA",2008-2009,26146,25894,-252,-0.964,2,-254,13,55,H1
"Chattooga County, GA",2009-2010,25894,25980,86,0.332,35,51,13,55,H1
"Chattooga County, GA",2010-2011,25980,25705,-275,-1.059,37,-312,13,55,H1
"Chattooga County, GA",2011-2012,25705,25676,-29,-0.113,-24,-5,13,55,H1
"Chattooga County, GA",2012-2013,25676,25120,-556,-2.165,-59,-497,13,55,H1
"Chattooga County, GA",2013-2014,25120,24939,-181,-0.721,-9,-172,13,55,H1
"Chattooga County, GA",2014-2015,24892,24922,30,0.121,-20,50,13,55,H1
"Chattooga County, GA",2015-2016,24922,24833,-89,-0.357,2,-91,13,55,H1
"Chattooga County, GA",2016-2017,24833,24770,-63,-0.254,9,-72,13,55,H1
"Cherokee County, GA",2000-2001,143777,151189,7412,5.155,1717,5695,13,57,H1
"Cherokee County, GA",2001-2002,151189,158682,7493,4.956,1898,5595,13,57,H1
"Cherokee County, GA",2002-2003,158682,165585,6903,4.35,1973,4930,13,57,H1
"Cherokee County, GA",2003-2004,165585,173105,7520,4.541,2032,5488,13,57,H1
"Cherokee County, GA",2004-2005,173105,182128,9023,5.212,2170,6853,13,57,H1
"Cherokee County, GA",2005-2006,182128,193241,11113,6.102,2425,8688,13,57,H1
"Cherokee County, GA",2006-2007,193241,202544,9303,4.814,2371,6932,13,57,H1
"Cherokee County, GA",2007-2008,202544,208271,5727,2.828,2367,3360,13,57,H1
"Cherokee County, GA",2008-2009,208271,212232,3961,1.902,2464,1497,13,57,H1
"Cherokee County, GA",2009-2010,212232,215216,2984,1.406,2016,968,13,57,H1
"Cherokee County, GA",2010-2011,215216,217770,2554,1.187,1643,911,13,57,H1
"Cherokee County, GA",2011-2012,217770,220914,3144,1.444,1563,1581,13,57,H1
"Cherokee County, GA",2012-2013,220914,224869,3955,1.79,1474,2481,13,57,H1
"Cherokee County, GA",2013-2014,224869,230985,6116,2.72,1475,4641,13,57,H1
"Cherokee County, GA",2014-2015,230720,235900,5180,2.245,1539,3641,13,57,H1
"Cherokee County, GA",2015-2016,235900,241600,5700,2.416,1350,4350,13,57,H1
"Cherokee County, GA",2016-2017,241600,247573,5973,2.472,1302,4671,13,57,H1
"Clarke County, GA",2000-2001,102401,103890,1489,1.454,607,882,13,59,H6
"Clarke County, GA",2001-2002,103890,104673,783,0.754,744,39,13,59,H6
"Clarke County, GA",2002-2003,104673,106287,1614,1.542,762,852,13,59,H6
"Clarke County, GA",2003-2004,106287,109752,3465,3.26,719,2746,13,59,H6
"Clarke County, GA",2004-2005,109752,109536,-216,-0.197,874,-1090,13,59,H6
"Clarke County, GA",2005-2006,109536,112074,2538,2.317,946,1592,13,59,H6
"Clarke County, GA",2006-2007,112074,113995,1921,1.714,1015,906,13,59,H6
"Clarke County, GA",2007-2008,113995,115768,1773,1.555,963,810,13,59,H6
"Clarke County, GA",2008-2009,115768,116843,1075,0.929,954,121,13,59,H6
"Clarke County, GA",2009-2010,116843,117484,641,0.549,847,-206,13,59,H6
"Clarke County, GA",2010-2011,117484,118509,1025,0.872,819,206,13,59,H6
"Clarke County, GA",2011-2012,118509,120270,1761,1.486,811,950,13,59,H6
"Clarke County, GA",2012-2013,120270,121206,936,0.778,696,240,13,59,H6
"Clarke County, GA",2013-2014,121206,120938,-268,-0.221,744,-1012,13,59,H6
"Clarke County, GA",2014-2015,120814,123912,3098,2.564,630,2468,13,59,H6
"Clarke County, GA",2015-2016,123912,125018,1106,0.893,617,489,13,59,H6
"Clarke County, GA",2016-2017,125018,127064,2046,1.637,602,1444,13,59,H6
"Clay County, GA",2000-2001,3353,3360,7,0.209,6,1,13,61,H1
"Clay County, GA",2001-2002,3360,3314,-46,-1.369,-10,-36,13,61,H1
"Clay County, GA",2002-2003,3314,3303,-11,-0.332,-4,-7,13,61,H1
"Clay County, GA",2003-2004,3303,3233,-70,-2.119,-5,-65,13,61,H1
"Clay County, GA",2004-2005,3233,3216,-17,-0.526,-12,-5,13,61,H1
"Clay County, GA",2005-2006,3216,3232,16,0.498,19,-3,13,61,H1
"Clay County, GA",2006-2007,3232,3262,30,0.928,17,13,13,61,H1
"Clay County, GA",2007-2008,3262,3233,-29,-0.889,26,-55,13,61,H1
"Clay County, GA",2008-2009,3233,3201,-32,-0.99,38,-70,13,61,H1
"Clay County, GA",2009-2010,3201,3160,-41,-1.281,24,-65,13,61,H1
"Clay County, GA",2010-2011,3160,3150,-10,-0.316,-9,-1,13,61,H1
"Clay County, GA",2011-2012,3150,3102,-48,-1.524,5,-53,13,61,H1
"Clay County, GA",2012-2013,3102,3037,-65,-2.095,-1,-64,13,61,H1
"Clay County, GA",2013-2014,3037,3102,65,2.14,1,64,13,61,H1
"Clay County, GA",2014-2015,3097,3141,44,1.421,2,42,13,61,H1
"Clay County, GA",2015-2016,3141,3006,-135,-4.298,3,-138,13,61,H1
"Clay County, GA",2016-2017,3006,2962,-44,-1.464,-9,-35,13,61,H1
"Clayton County, GA",2000-2001,238079,245327,7248,3.044,3150,4098,13,63,H1
"Clayton County, GA",2001-2002,245327,248954,3627,1.478,3102,525,13,63,H1
"Clayton County, GA",2002-2003,248954,252631,3677,1.477,3139,538,13,63,H1
"Clayton County, GA",2003-2004,252631,255322,2691,1.065,3359,-668,13,63,H1
"Clayton County, GA",2004-2005,255322,256292,970,0.38,3247,-2277,13,63,H1
"Clayton County, GA",2005-2006,256292,258552,2260,0.882,3660,-1400,13,63,H1
"Clayton County, GA",2006-2007,258552,260441,1889,0.731,3779,-1890,13,63,H1
"Clayton County, GA",2007-2008,260441,262099,1658,0.637,3478,-1820,13,63,H1
"Clayton County, GA",2008-2009,262099,260067,-2032,-0.775,3103,-5135,13,63,H1
"Clayton County, GA",2009-2010,260067,259824,-243,-0.093,2971,-3214,13,63,H1
"Clayton County, GA",2010-2011,259824,262643,2819,1.085,2944,-125,13,63,H1
"Clayton County, GA",2011-2012,262643,266253,3610,1.374,2778,832,13,63,H1
"Clayton County, GA",2012-2013,266253,264843,-1410,-0.53,2550,-3960,13,63,H1
"Clayton County, GA",2013-2014,264843,267542,2699,1.019,2245,454,13,63,H1
"Clayton County, GA",2014-2015,268172,273955,5783,2.156,2293,3490,13,63,H1
"Clayton County, GA",2015-2016,273955,280006,6051,2.209,2557,3494,13,63,H1
"Clayton County, GA",2016-2017,280006,285153,5147,1.838,2394,2753,13,63,H1
"Clinch County, GA",2000-2001,6831,6901,70,1.025,65,5,13,65,H1
"Clinch County, GA",2001-2002,6901,6870,-31,-0.449,25,-56,13,65,H1
"Clinch County, GA",2002-2003,6870,6933,63,0.917,27,36,13,65,H1
"Clinch County, GA",2003-2004,6933,6893,-40,-0.577,22,-62,13,65,H1
"Clinch County, GA",2004-2005,6893,6948,55,0.798,36,19,13,65,H1
"Clinch County, GA",2005-2006,6948,6828,-120,-1.727,31,-151,13,65,H1
"Clinch County, GA",2006-2007,6828,6838,10,0.146,41,-31,13,65,H1
"Clinch County, GA",2007-2008,6838,6941,103,1.506,67,36,13,65,H1
"Clinch County, GA",2008-2009,6941,6799,-142,-2.046,34,-176,13,65,H1
"Clinch County, GA",2009-2010,6799,6788,-11,-0.162,34,-45,13,65,H1
"Clinch County, GA",2010-2011,6788,6750,-38,-0.56,26,-64,13,65,H1
"Clinch County, GA",2011-2012,6750,6715,-35,-0.519,34,-69,13,65,H1
"Clinch County, GA",2012-2013,6715,6802,87,1.296,51,36,13,65,H1
"Clinch County, GA",2013-2014,6802,6831,29,0.426,49,-20,13,65,H1
"Clinch County, GA",2014-2015,6816,6893,77,1.13,46,31,13,65,H1
"Clinch County, GA",2015-2016,6893,6789,-104,-1.509,28,-132,13,65,H1
"Clinch County, GA",2016-2017,6789,6727,-62,-0.913,28,-90,13,65,H1
"Cobb County, GA",2000-2001,611505,623006,11501,1.881,7194,4307,13,67,H1
"Cobb County, GA",2001-2002,623006,631018,8012,1.286,7250,762,13,67,H1
"Cobb County, GA",2002-2003,631018,634638,3620,0.574,7132,-3512,13,67,H1
"Cobb County, GA",2003-2004,634638,640346,5708,0.899,7221,-1513,13,67,H1
"Cobb County, GA",2004-2005,640346,646754,6408,1.001,7340,-932,13,67,H1
"Cobb County, GA",2005-2006,646754,661913,15159,2.344,7852,7307,13,67,H1
"Cobb County, GA",2006-2007,661913,670438,8525,1.288,8045,480,13,67,H1
"Cobb County, GA",2007-2008,670438,679822,9384,1.4,7419,1965,13,67,H1
"Cobb County, GA",2008-2009,679822,684776,4954,0.729,6836,-1882,13,67,H1
"Cobb County, GA",2009-2010,684776,689692,4916,0.718,6529,-1613,13,67,H1
"Cobb County, GA",2010-2011,689692,697682,7990,1.158,5737,2253,13,67,H1
"Cobb County, GA",2011-2012,697682,708036,10354,1.484,5838,4516,13,67,H1
"Cobb County, GA",2012-2013,708036,718208,10172,1.437,5343,4829,13,67,H1
"Cobb County, GA",2013-2014,718208,730981,12773,1.778,5385,7388,13,67,H1
"Cobb County, GA",2014-2015,731018,741334,10316,1.411,5441,4875,13,67,H1
"Cobb County, GA",2015-2016,741334,750477,9143,1.233,5104,4039,13,67,H1
"Cobb County, GA",2016-2017,750477,755754,5277,0.703,5016,261,13,67,H1
"Coffee County, GA",2000-2001,37592,38350,758,2.016,309,449,13,69,H1
"Coffee County, GA",2001-2002,38350,38791,441,1.15,334,107,13,69,H1
"Coffee County, GA",2002-2003,38791,39183,392,1.011,252,140,13,69,H1
"Coffee County, GA",2003-2004,39183,39383,200,0.51,287,-87,13,69,H1
"Coffee County, GA",2004-2005,39383,39829,446,1.132,275,171,13,69,H1
"Coffee County, GA",2005-2006,39829,40702,873,2.192,362,511,13,69,H1
"Coffee County, GA",2006-2007,40702,41299,597,1.467,394,203,13,69,H1
"Coffee County, GA",2007-2008,41299,41813,514,1.245,306,208,13,69,H1
"Coffee County, GA",2008-2009,41813,42089,276,0.66,229,47,13,69,H1
"Coffee County, GA",2009-2010,42089,42738,649,1.542,235,414,13,69,H1
"Coffee County, GA",2010-2011,42738,42964,226,0.529,201,25,13,69,H1
"Coffee County, GA",2011-2012,42964,43093,129,0.3,226,-97,13,69,H1
"Coffee County, GA",2012-2013,43093,43129,36,0.084,229,-193,13,69,H1
"Coffee County, GA",2013-2014,43129,42811,-318,-0.737,219,-537,13,69,H1
"Coffee County, GA",2014-2015,42793,43108,315,0.736,237,78,13,69,H1
"Coffee County, GA",2015-2016,43108,43015,-93,-0.216,121,-214,13,69,H1
"Coffee County, GA",2016-2017,43015,43014,-1,-0.002,152,-153,13,69,H1
"Colquitt County, GA",2000-2001,42140,42223,83,0.197,241,-158,13,71,H1
"Colquitt County, GA",2001-2002,42223,42570,347,0.822,301,46,13,71,H1
"Colquitt County, GA",2002-2003,42570,42554,-16,-0.038,215,-231,13,71,H1
"Colquitt County, GA",2003-2004,42554,42987,433,1.018,256,177,13,71,H1
"Colquitt County, GA",2004-2005,42987,42993,6,0.014,311,-305,13,71,H1
"Colquitt County, GA",2005-2006,42993,43700,707,1.644,263,444,13,71,H1
"Colquitt County, GA",2006-2007,43700,44209,509,1.165,340,169,13,71,H1
"Colquitt County, GA",2007-2008,44209,44872,663,1.5,350,313,13,71,H1
"Colquitt County, GA",2008-2009,44872,45152,280,0.624,294,-14,13,71,H1
"Colquitt County, GA",2009-2010,45152,45648,496,1.099,286,210,13,71,H1
"Colquitt County, GA",2010-2011,45648,45804,156,0.342,317,-161,13,71,H1
"Colquitt County, GA",2011-2012,45804,46095,291,0.635,268,23,13,71,H1
"Colquitt County, GA",2012-2013,46095,46288,193,0.419,171,22,13,71,H1
"Colquitt County, GA",2013-2014,46288,46102,-186,-0.402,231,-417,13,71,H1
"Colquitt County, GA",2014-2015,46051,45844,-207,-0.45,213,-420,13,71,H1
"Colquitt County, GA",2015-2016,45844,45671,-173,-0.377,150,-323,13,71,H1
"Colquitt County, GA",2016-2017,45671,45835,164,0.359,178,-14,13,71,H1
"Columbia County, GA",2000-2001,90138,92537,2399,2.661,745,1654,13,73,H1
"Columbia County, GA",2001-2002,92537,95818,3281,3.546,709,2572,13,73,H1
"Columbia County, GA",2002-2003,95818,98761,2943,3.071,760,2183,13,73,H1
"Columbia County, GA",2003-2004,98761,102934,4173,4.225,734,3439,13,73,H1
"Columbia County, GA",2004-2005,102934,106477,3543,3.442,767,2776,13,73,H1
"Columbia County, GA",2005-2006,106477,110845,4368,4.102,777,3591,13,73,H1
"Columbia County, GA",2006-2007,110845,115074,4229,3.815,859,3370,13,73,H1
"Columbia County, GA",2007-2008,115074,117504,2430,2.112,885,1545,13,73,H1
"Columbia County, GA",2008-2009,117504,121050,3546,3.018,911,2635,13,73,H1
"Columbia County, GA",2009-2010,121050,124955,3905,3.226,822,3083,13,73,H1
"Columbia County, GA",2010-2011,124955,128753,3798,3.039,842,2956,13,73,H1
"Columbia County, GA",2011-2012,128753,132556,3803,2.954,943,2860,13,73,H1
"Columbia County, GA",2012-2013,132556,136287,3731,2.815,690,3041,13,73,H1
"Columbia County, GA",2013-2014,136287,139257,2970,2.179,787,2183,13,73,H1
"Columbia County, GA",2014-2015,139343,144052,4709,3.379,702,4007,13,73,H1
"Columbia County, GA",2015-2016,144052,147451,3399,2.36,985,2414,13,73,H1
"Columbia County, GA",2016-2017,147451,151579,4128,2.8,872,3256,13,73,H1
"Cook County, GA",2000-2001,15855,15885,30,0.189,48,-18,13,75,H1
"Cook County, GA",2001-2002,15885,15985,100,0.63,52,48,13,75,H1
"Cook County, GA",2002-2003,15985,16060,75,0.469,84,-9,13,75,H1
"Cook County, GA",2003-2004,16060,16268,208,1.295,65,143,13,75,H1
"Cook County, GA",2004-2005,16268,16567,299,1.838,56,243,13,75,H1
"Cook County, GA",2005-2006,16567,16622,55,0.332,110,-55,13,75,H1
"Cook County, GA",2006-2007,16622,16848,226,1.36,111,115,13,75,H1
"Cook County, GA",2007-2008,16848,17067,219,1.3,107,112,13,75,H1
"Cook County, GA",2008-2009,17067,17114,47,0.275,75,-28,13,75,H1
"Cook County, GA",2009-2010,17114,17226,112,0.654,62,50,13,75,H1
"Cook County, GA",2010-2011,17226,16979,-247,-1.434,60,-307,13,75,H1
"Cook County, GA",2011-2012,16979,16859,-120,-0.707,49,-169,13,75,H1
"Cook County, GA",2012-2013,16859,17025,166,0.985,42,124,13,75,H1
"Cook County, GA",2013-2014,17025,17214,189,1.11,31,158,13,75,H1
"Cook County, GA",2014-2015,17204,17124,-80,-0.465,51,-131,13,75,H1
"Cook County, GA",2015-2016,17124,17187,63,0.368,16,47,13,75,H1
"Cook County, GA",2016-2017,17187,17277,90,0.524,33,57,13,75,H1
"Coweta County, GA",2000-2001,90117,93627,3510,3.895,885,2625,13,77,H1
"Coweta County, GA",2001-2002,93627,97191,3564,3.807,930,2634,13,77,H1
"Coweta County, GA",2002-2003,97191,100382,3191,3.283,852,2339,13,77,H1
"Coweta County, GA",2003-2004,100382,104089,3707,3.693,899,2808,13,77,H1
"Coweta County, GA",2004-2005,104089,108371,4282,4.114,957,3325,13,77,H1
"Coweta County, GA",2005-2006,108371,113749,5378,4.963,908,4470,13,77,H1
"Coweta County, GA",2006-2007,113749,118156,4407,3.874,936,3471,13,77,H1
"Coweta County, GA",2007-2008,118156,122281,4125,3.491,1130,2995,13,77,H1
"Coweta County, GA",2008-2009,122281,125501,3220,2.633,1159,2061,13,77,H1
"Coweta County, GA",2009-2010,125501,127946,2445,1.948,871,1574,13,77,H1
"Coweta County, GA",2010-2011,127946,129480,1534,1.199,759,775,13,77,H1
"Coweta County, GA",2011-2012,129480,130878,1398,1.08,775,623,13,77,H1
"Coweta County, GA",2012-2013,130878,133222,2344,1.791,730,1614,13,77,H1
"Coweta County, GA",2013-2014,133222,135571,2349,1.763,709,1640,13,77,H1
"Coweta County, GA",2014-2015,135410,138427,3017,2.228,764,2253,13,77,H1
"Coweta County, GA",2015-2016,138427,140472,2045,1.477,590,1455,13,77,H1
"Coweta County, GA",2016-2017,140472,143114,2642,1.881,578,2064,13,77,H1
"Crawford County, GA",2000-2001,12408,12496,88,0.709,19,69,13,79,H1
"Crawford County, GA",2001-2002,12496,12553,57,0.456,11,46,13,79,H1
"Crawford County, GA",2002-2003,12553,12592,39,0.311,77,-38,13,79,H1
"Crawford County, GA",2003-2004,12592,12784,192,1.525,15,177,13,79,H1
"Crawford County, GA",2004-2005,12784,12875,91,0.712,56,35,13,79,H1
"Crawford County, GA",2005-2006,12875,12943,68,0.528,68,0,13,79,H1
"Crawford County, GA",2006-2007,12943,12895,-48,-0.371,65,-113,13,79,H1
"Crawford County, GA",2007-2008,12895,12967,72,0.558,54,18,13,79,H1
"Crawford County, GA",2008-2009,12967,12711,-256,-1.974,19,-275,13,79,H1
"Crawford County, GA",2009-2010,12711,12587,-124,-0.976,9,-133,13,79,H1
"Crawford County, GA",2010-2011,12587,12605,18,0.143,39,-21,13,79,H1
"Crawford County, GA",2011-2012,12605,12619,14,0.111,30,-16,13,79,H1
"Crawford County, GA",2012-2013,12619,12481,-138,-1.094,0,-138,13,79,H1
"Crawford County, GA",2013-2014,12481,12387,-94,-0.753,-20,-74,13,79,H1
"Crawford County, GA",2014-2015,12472,12388,-84,-0.674,-23,-61,13,79,H1
"Crawford County, GA",2015-2016,12388,12291,-97,-0.783,-17,-80,13,79,H1
"Crawford County, GA",2016-2017,12291,12295,4,0.033,-52,56,13,79,H1
"Crisp County, GA",2000-2001,22018,22184,166,0.754,118,48,13,81,H1
"Crisp County, GA",2001-2002,22184,22284,100,0.451,93,7,13,81,H1
"Crisp County, GA",2002-2003,22284,22194,-90,-0.404,72,-162,13,81,H1
"Crisp County, GA",2003-2004,22194,22320,126,0.568,81,45,13,81,H1
"Crisp County, GA",2004-2005,22320,22456,136,0.609,110,26,13,81,H1
"Crisp County, GA",2005-2006,22456,22718,262,1.167,66,196,13,81,H1
"Crisp County, GA",2006-2007,22718,23146,428,1.884,127,301,13,81,H1
"Crisp County, GA",2007-2008,23146,23243,97,0.419,133,-36,13,81,H1
"Crisp County, GA",2008-2009,23243,23378,135,0.581,74,61,13,81,H1
"Crisp County, GA",2009-2010,23378,23407,29,0.124,69,-40,13,81,H1
"Crisp County, GA",2010-2011,23407,23785,378,1.615,84,294,13,81,H1
"Crisp County, GA",2011-2012,23785,23657,-128,-0.538,65,-193,13,81,H1
"Crisp County, GA",2012-2013,23657,23232,-425,-1.797,31,-456,13,81,H1
"Crisp County, GA",2013-2014,23232,22934,-298,-1.283,18,-316,13,81,H1
"Crisp County, GA",2014-2015,22988,22881,-107,-0.465,13,-120,13,81,H1
"Crisp County, GA",2015-2016,22881,22935,54,0.236,96,-42,13,81,H1
"Crisp County, GA",2016-2017,22935,22736,-199,-0.868,33,-232,13,81,H1
"Dade County, GA",2000-2001,15199,15520,321,2.112,51,270,13,83,H1
"Dade County, GA",2001-2002,15520,15658,138,0.889,50,88,13,83,H1
"Dade County, GA",2002-2003,15658,15901,243,1.552,25,218,13,83,H1
"Dade County, GA",2003-2004,15901,16028,127,0.799,35,92,13,83,H1
"Dade County, GA",2004-2005,16028,16188,160,0.998,-7,167,13,83,H1
"Dade County, GA",2005-2006,16188,16411,223,1.378,-14,237,13,83,H1
"Dade County, GA",2006-2007,16411,16648,237,1.444,24,213,13,83,H1
"Dade County, GA",2007-2008,16648,16651,3,0.018,41,-38,13,83,H1
"Dade County, GA",2008-2009,16651,16657,6,0.036,15,-9,13,83,H1
"Dade County, GA",2009-2010,16657,16630,-27,-0.162,2,-29,13,83,H1
"Dade County, GA",2010-2011,16630,16591,-39,-0.235,6,-45,13,83,H1
"Dade County, GA",2011-2012,16591,16551,-40,-0.241,50,-90,13,83,H1
"Dade County, GA",2012-2013,16551,16502,-49,-0.296,-13,-36,13,83,H1
"Dade County, GA",2013-2014,16502,16389,-113,-0.685,6,-119,13,83,H1
"Dade County, GA",2014-2015,16364,16264,-100,-0.611,3,-103,13,83,H1
"Dade County, GA",2015-2016,16264,16242,-22,-0.135,-3,-19,13,83,H1
"Dade County, GA",2016-2017,16242,16285,43,0.265,-8,51,13,83,H1
"Dawson County, GA",2000-2001,16238,16875,637,3.923,128,509,13,85,H1
"Dawson County, GA",2001-2002,16875,17521,646,3.828,136,510,13,85,H1
"Dawson County, GA",2002-2003,17521,18406,885,5.051,106,779,13,85,H1
"Dawson County, GA",2003-2004,18406,18831,425,2.309,145,280,13,85,H1
"Dawson County, GA",2004-2005,18831,19611,780,4.142,90,690,13,85,H1
"Dawson County, GA",2005-2006,19611,20660,1049,5.349,152,897,13,85,H1
"Dawson County, GA",2006-2007,20660,21509,849,4.109,102,747,13,85,H1
"Dawson County, GA",2007-2008,21509,21951,442,2.055,99,343,13,85,H1
"Dawson County, GA",2008-2009,21951,22325,374,1.704,143,231,13,85,H1
"Dawson County, GA",2009-2010,22325,22300,-25,-0.112,93,-118,13,85,H1
"Dawson County, GA",2010-2011,22300,22214,-86,-0.386,78,-164,13,85,H1
"Dawson County, GA",2011-2012,22214,22376,162,0.729,47,115,13,85,H1
"Dawson County, GA",2012-2013,22376,22651,275,1.229,89,186,13,85,H1
"Dawson County, GA",2013-2014,22651,22957,306,1.351,88,218,13,85,H1
"Dawson County, GA",2014-2015,22896,23312,416,1.817,76,340,13,85,H1
"Dawson County, GA",2015-2016,23312,23613,301,1.291,50,251,13,85,H1
"Dawson County, GA",2016-2017,23613,24379,766,3.244,69,697,13,85,H1
"Decatur County, GA",2000-2001,28223,27870,-353,-1.251,131,-484,13,87,H1
"Decatur County, GA",2001-2002,27870,27892,22,0.079,119,-97,13,87,H1
"Decatur County, GA",2002-2003,27892,27795,-97,-0.348,107,-204,13,87,H1
"Decatur County, GA",2003-2004,27795,27763,-32,-0.115,89,-121,13,87,H1
"Decatur County, GA",2004-2005,27763,27511,-252,-0.908,99,-351,13,87,H1
"Decatur County, GA",2005-2006,27511,27835,324,1.178,115,209,13,87,H1
"Decatur County, GA",2006-2007,27835,27883,48,0.172,162,-114,13,87,H1
"Decatur County, GA",2007-2008,27883,28010,127,0.455,107,20,13,87,H1
"Decatur County, GA",2008-2009,28010,28058,48,0.171,74,-26,13,87,H1
"Decatur County, GA",2009-2010,28058,27821,-237,-0.845,105,-342,13,87,H1
"Decatur County, GA",2010-2011,27821,27663,-158,-0.568,59,-217,13,87,H1
"Decatur County, GA",2011-2012,27663,27463,-200,-0.723,53,-253,13,87,H1
"Decatur County, GA",2012-2013,27463,27372,-91,-0.331,64,-155,13,87,H1
"Decatur County, GA",2013-2014,27372,27220,-152,-0.555,59,-211,13,87,H1
"Decatur County, GA",2014-2015,27239,27174,-65,-0.239,9,-74,13,87,H1
"Decatur County, GA",2015-2016,27174,26715,-459,-1.689,63,-522,13,87,H1
"Decatur County, GA",2016-2017,26715,26716,1,0.004,42,-41,13,87,H1
"DeKalb County, GA",2000-2001,668271,670900,2629,0.393,7065,-4436,13,89,H1
"DeKalb County, GA",2001-2002,670900,669789,-1111,-0.166,6822,-7933,13,89,H1
"DeKalb County, GA",2002-2003,669789,668148,-1641,-0.245,6907,-8548,13,89,H1
"DeKalb County, GA",2003-2004,668148,666204,-1944,-0.291,6929,-8873,13,89,H1
"DeKalb County, GA",2004-2005,666204,668998,2794,0.419,6949,-4155,13,89,H1
"DeKalb County, GA",2005-2006,668998,676687,7689,1.149,7481,208,13,89,H1
"DeKalb County, GA",2006-2007,676687,680962,4275,0.632,7744,-3469,13,89,H1
"DeKalb County, GA",2007-2008,680962,685646,4684,0.688,7214,-2530,13,89,H1
"DeKalb County, GA",2008-2009,685646,690658,5012,0.731,6541,-1529,13,89,H1
"DeKalb County, GA",2009-2010,690658,692574,1916,0.277,7092,-5176,13,89,H1
"DeKalb County, GA",2010-2011,692574,697953,5379,0.777,6832,-1453,13,89,H1
"DeKalb County, GA",2011-2012,697953,708304,10351,1.483,6856,3495,13,89,H1
"DeKalb County, GA",2012-2013,708304,714935,6631,0.936,6568,63,13,89,H1
"DeKalb County, GA",2013-2014,714935,722161,7226,1.011,6433,793,13,89,H1
"DeKalb County, GA",2014-2015,724222,734871,10649,1.47,6407,4242,13,89,H1
"DeKalb County, GA",2015-2016,734871,746690,11819,1.608,6427,5392,13,89,H1
"DeKalb County, GA",2016-2017,746690,753253,6563,0.879,6384,179,13,89,H1
"Dodge County, GA",2000-2001,19168,19513,345,1.8,35,310,13,91,H1
"Dodge County, GA",2001-2002,19513,19771,258,1.322,-7,265,13,91,H1
"Dodge County, GA",2002-2003,19771,20180,409,2.069,60,349,13,91,H1
"Dodge County, GA",2003-2004,20180,20319,139,0.689,34,105,13,91,H1
"Dodge County, GA",2004-2005,20319,20550,231,1.137,47,184,13,91,H1
"Dodge County, GA",2005-2006,20550,20954,404,1.966,55,349,13,91,H1
"Dodge County, GA",2006-2007,20954,21225,271,1.293,74,197,13,91,H1
"Dodge County, GA",2007-2008,21225,21399,174,0.82,71,103,13,91,H1
"Dodge County, GA",2008-2009,21399,21659,260,1.215,12,248,13,91,H1
"Dodge County, GA",2009-2010,21659,21789,130,0.6,55,75,13,91,H1
"Dodge County, GA",2010-2011,21789,21462,-327,-1.501,6,-333,13,91,H1
"Dodge County, GA",2011-2012,21462,21353,-109,-0.508,1,-110,13,91,H1
"Dodge County, GA",2012-2013,21353,21243,-110,-0.515,55,-165,13,91,H1
"Dodge County, GA",2013-2014,21243,20976,-267,-1.257,0,-267,13,91,H1
"Dodge County, GA",2014-2015,20992,20882,-110,-0.524,-8,-102,13,91,H1
"Dodge County, GA",2015-2016,20882,20837,-45,-0.215,-25,-20,13,91,H1
"Dodge County, GA",2016-2017,20837,20730,-107,-0.514,-40,-67,13,91,H1
"Dooly County, GA",2000-2001,11519,12040,521,4.523,77,444,13,93,H1
"Dooly County, GA",2001-2002,12040,12207,167,1.387,54,113,13,93,H1
"Dooly County, GA",2002-2003,12207,12508,301,2.466,75,226,13,93,H1
"Dooly County, GA",2003-2004,12508,12848,340,2.718,53,287,13,93,H1
"Dooly County, GA",2004-2005,12848,13292,444,3.456,46,398,13,93,H1
"Dooly County, GA",2005-2006,13292,13719,427,3.212,59,368,13,93,H1
"Dooly County, GA",2006-2007,13719,13867,148,1.079,48,100,13,93,H1
"Dooly County, GA",2007-2008,13867,14191,324,2.336,56,268,13,93,H1
"Dooly County, GA",2008-2009,14191,14769,578,4.073,47,531,13,93,H1
"Dooly County, GA",2009-2010,14769,14838,69,0.467,26,43,13,93,H1
"Dooly County, GA",2010-2011,14838,14548,-290,-1.954,17,-307,13,93,H1
"Dooly County, GA",2011-2012,14548,14326,-222,-1.526,-8,-214,13,93,H1
"Dooly County, GA",2012-2013,14326,14313,-13,-0.091,-5,-8,13,93,H1
"Dooly County, GA",2013-2014,14313,14188,-125,-0.873,4,-129,13,93,H1
"Dooly County, GA",2014-2015,14203,14035,-168,-1.183,2,-170,13,93,H1
"Dooly County, GA",2015-2016,14035,13885,-150,-1.069,-4,-146,13,93,H1
"Dooly County, GA",2016-2017,13885,13737,-148,-1.066,-3,-145,13,93,H1
"Dougherty County, GA",2000-2001,95859,95944,85,0.089,789,-704,13,95,H1
"Dougherty County, GA",2001-2002,95944,95429,-515,-0.537,620,-1135,13,95,H1
"Dougherty County, GA",2002-2003,95429,95015,-414,-0.434,593,-1007,13,95,H1
"Dougherty County, GA",2003-2004,95015,94596,-419,-0.441,508,-927,13,95,H1
"Dougherty County, GA",2004-2005,94596,94610,14,0.015,682,-668,13,95,H1
"Dougherty County, GA",2005-2006,94610,94418,-192,-0.203,782,-974,13,95,H1
"Dougherty County, GA",2006-2007,94418,94522,104,0.11,735,-631,13,95,H1
"Dougherty County, GA",2007-2008,94522,94363,-159,-0.168,725,-884,13,95,H1
"Dougherty County, GA",2008-2009,94363,94688,325,0.344,708,-383,13,95,H1
"Dougherty County, GA",2009-2010,94688,94530,-158,-0.167,725,-883,13,95,H1
"Dougherty County, GA",2010-2011,94530,94839,309,0.327,810,-501,13,95,H1
"Dougherty County, GA",2011-2012,94839,94542,-297,-0.313,492,-789,13,95,H1
"Dougherty County, GA",2012-2013,94542,93130,-1412,-1.494,420,-1832,13,95,H1
"Dougherty County, GA",2013-2014,93130,92407,-723,-0.776,440,-1163,13,95,H1
"Dougherty County, GA",2014-2015,92515,91332,-1183,-1.279,456,-1639,13,95,H1
"Dougherty County, GA",2015-2016,91332,90395,-937,-1.026,202,-1139,13,95,H1
"Dougherty County, GA",2016-2017,90395,89502,-893,-0.988,288,-1181,13,95,H1
"Douglas County, GA",2000-2001,92774,95720,2946,3.175,813,2133,13,97,H1
"Douglas County, GA",2001-2002,95720,98582,2862,2.99,799,2063,13,97,H1
"Douglas County, GA",2002-2003,98582,102034,3452,3.502,803,2649,13,97,H1
"Douglas County, GA",2003-2004,102034,107377,5343,5.236,880,4463,13,97,H1
"Douglas County, GA",2004-2005,107377,113354,5977,5.566,1048,4929,13,97,H1
"Douglas County, GA",2005-2006,113354,119918,6564,5.791,1118,5446,13,97,H1
"Douglas County, GA",2006-2007,119918,125560,5642,4.705,1197,4445,13,97,H1
"Douglas County, GA",2007-2008,125560,129508,3948,3.144,1283,2665,13,97,H1
"Douglas County, GA",2008-2009,129508,131292,1784,1.378,1252,532,13,97,H1
"Douglas County, GA",2009-2010,131292,132644,1352,1.03,1050,302,13,97,H1
"Douglas County, GA",2010-2011,132644,133280,636,0.479,922,-286,13,97,H1
"Douglas County, GA",2011-2012,133280,133926,646,0.485,920,-274,13,97,H1
"Douglas County, GA",2012-2013,133926,136560,2634,1.967,886,1748,13,97,H1
"Douglas County, GA",2013-2014,136560,138776,2216,1.623,800,1416,13,97,H1
"Douglas County, GA",2014-2015,138466,140733,2267,1.637,796,1471,13,97,H1
"Douglas County, GA",2015-2016,140733,142021,1288,0.915,799,489,13,97,H1
"Douglas County, GA",2016-2017,142021,143882,1861,1.31,747,1114,13,97,H1
"Early County, GA",2000-2001,12303,12207,-96,-0.78,51,-147,13,99,H1
"Early County, GA",2001-2002,12207,12047,-160,-1.311,56,-216,13,99,H1
"Early County, GA",2002-2003,12047,11978,-69,-0.573,24,-93,13,99,H1
"Early County, GA",2003-2004,11978,11800,-178,-1.486,48,-226,13,99,H1
"Early County, GA",2004-2005,11800,11749,-51,-0.432,33,-84,13,99,H1
"Early County, GA",2005-2006,11749,11648,-101,-0.86,19,-120,13,99,H1
"Early County, GA",2006-2007,11648,11429,-219,-1.88,35,-254,13,99,H1
"Early County, GA",2007-2008,11429,11262,-167,-1.461,54,-221,13,99,H1
"Early County, GA",2008-2009,11262,11101,-161,-1.43,40,-201,13,99,H1
"Early County, GA",2009-2010,11101,10963,-138,-1.243,25,-163,13,99,H1
"Early County, GA",2010-2011,10963,10742,-221,-2.016,36,-257,13,99,H1
"Early County, GA",2011-2012,10742,10605,-137,-1.275,32,-169,13,99,H1
"Early County, GA",2012-2013,10605,10511,-94,-0.886,-38,-56,13,99,H1
"Early County, GA",2013-2014,10511,10491,-20,-0.19,14,-34,13,99,H1
"Early County, GA",2014-2015,10458,10575,117,1.119,-19,136,13,99,H1
"Early County, GA",2015-2016,10575,10298,-277,-2.619,11,-288,13,99,H1
"Early County, GA",2016-2017,10298,10296,-2,-0.019,-15,13,13,99,H1
"Echols County, GA",2000-2001,3782,3774,-8,-0.212,11,-19,13,101,H1
"Echols County, GA",2001-2002,3774,3751,-23,-0.609,38,-61,13,101,H1
"Echols County, GA",2002-2003,3751,3844,93,2.479,47,46,13,101,H1
"Echols County, GA",2003-2004,3844,3926,82,2.133,63,19,13,101,H1
"Echols County, GA",2004-2005,3926,3946,20,0.509,69,-49,13,101,H1
"Echols County, GA",2005-2006,3946,3913,-33,-0.836,41,-74,13,101,H1
"Echols County, GA",2006-2007,3913,3938,25,0.639,34,-9,13,101,H1
"Echols County, GA",2007-2008,3938,3954,16,0.406,42,-26,13,101,H1
"Echols County, GA",2008-2009,3954,4012,58,1.467,16,42,13,101,H1
"Echols County, GA",2009-2010,4012,4027,15,0.374,51,-36,13,101,H1
"Echols County, GA",2010-2011,4027,4096,69,1.713,32,37,13,101,H1
"Echols County, GA",2011-2012,4096,3965,-131,-3.198,55,-186,13,101,H1
"Echols County, GA",2012-2013,3965,3997,32,0.807,45,-13,13,101,H1
"Echols County, GA",2013-2014,3997,4003,6,0.15,34,-28,13,101,H1
"Echols County, GA",2014-2015,4054,4040,-14,-0.345,22,-36,13,101,H1
"Echols County, GA",2015-2016,4040,3981,-59,-1.46,20,-79,13,101,H1
"Echols County, GA",2016-2017,3981,3936,-45,-1.13,10,-55,13,101,H1
"Effingham County, GA",2000-2001,37755,39116,1361,3.605,329,1032,13,103,H1
"Effingham County, GA",2001-2002,39116,40757,1641,4.195,326,1315,13,103,H1
"Effingham County, GA",2002-2003,40757,42168,1411,3.462,326,1085,13,103,H1
"Effingham County, GA",2003-2004,42168,43674,1506,3.571,338,1168,13,103,H1
"Effingham County, GA",2004-2005,43674,45729,2055,4.705,390,1665,13,103,H1
"Effingham County, GA",2005-2006,45729,47823,2094,4.579,440,1654,13,103,H1
"Effingham County, GA",2006-2007,47823,49660,1837,3.841,424,1413,13,103,H1
"Effingham County, GA",2007-2008,49660,50738,1078,2.171,408,670,13,103,H1
"Effingham County, GA",2008-2009,50738,51908,1170,2.306,385,785,13,103,H1
"Effingham County, GA",2009-2010,51908,52446,538,1.036,330,208,13,103,H1
"Effingham County, GA",2010-2011,52446,52673,227,0.433,334,-107,13,103,H1
"Effingham County, GA",2011-2012,52673,53337,664,1.261,374,290,13,103,H1
"Effingham County, GA",2012-2013,53337,54488,1151,2.158,376,775,13,103,H1
"Effingham County, GA",2013-2014,54488,55423,935,1.716,360,575,13,103,H1
"Effingham County, GA",2014-2015,55447,57106,1659,2.992,297,1362,13,103,H1
"Effingham County, GA",2015-2016,57106,58553,1447,2.534,316,1131,13,103,H1
"Effingham County, GA",2016-2017,58553,59982,1429,2.441,346,1083,13,103,H1
"Elbert County, GA",2000-2001,20464,20544,80,0.391,29,51,13,105,H1
"Elbert County, GA",2001-2002,20544,20610,66,0.321,15,51,13,105,H1
"Elbert County, GA",2002-2003,20610,20572,-38,-0.184,6,-44,13,105,H1
"Elbert County, GA",2003-2004,20572,20693,121,0.588,36,85,13,105,H1
"Elbert County, GA",2004-2005,20693,20593,-100,-0.483,28,-128,13,105,H1
"Elbert County, GA",2005-2006,20593,20631,38,0.185,-5,43,13,105,H1
"Elbert County, GA",2006-2007,20631,20551,-80,-0.388,41,-121,13,105,H1
"Elbert County, GA",2007-2008,20551,20477,-74,-0.36,13,-87,13,105,H1
"Elbert County, GA",2008-2009,20477,20335,-142,-0.693,-17,-125,13,105,H1
"Elbert County, GA",2009-2010,20335,20101,-234,-1.151,8,-242,13,105,H1
"Elbert County, GA",2010-2011,20101,19823,-278,-1.383,-11,-267,13,105,H1
"Elbert County, GA",2011-2012,19823,19593,-230,-1.16,5,-235,13,105,H1
"Elbert County, GA",2012-2013,19593,19514,-79,-0.403,-21,-58,13,105,H1
"Elbert County, GA",2013-2014,19514,19438,-76,-0.389,-37,-39,13,105,H1
"Elbert County, GA",2014-2015,19413,19364,-49,-0.252,-26,-23,13,105,H1
"Elbert County, GA",2015-2016,19364,19143,-221,-1.141,-44,-177,13,105,H1
"Elbert County, GA",2016-2017,19143,19109,-34,-0.178,-44,10,13,105,H1
"Emanuel County, GA",2000-2001,21851,21683,-168,-0.769,62,-230,13,107,H1
"Emanuel County, GA",2001-2002,21683,21511,-172,-0.793,65,-237,13,107,H1
"Emanuel County, GA",2002-2003,21511,21616,105,0.488,130,-25,13,107,H1
"Emanuel County, GA",2003-2004,21616,21579,-37,-0.171,75,-112,13,107,H1
"Emanuel County, GA",2004-2005,21579,21777,198,0.918,134,64,13,107,H1
"Emanuel County, GA",2005-2006,21777,22091,314,1.442,115,199,13,107,H1
"Emanuel County, GA",2006-2007,22091,22109,18,0.081,119,-101,13,107,H1
"Emanuel County, GA",2007-2008,22109,22421,312,1.411,137,175,13,107,H1
"Emanuel County, GA",2008-2009,22421,22456,35,0.156,103,-68,13,107,H1
"Emanuel County, GA",2009-2010,22456,22609,153,0.681,86,67,13,107,H1
"Emanuel County, GA",2010-2011,22609,22581,-28,-0.124,56,-84,13,107,H1
"Emanuel County, GA",2011-2012,22581,22849,268,1.187,66,202,13,107,H1
"Emanuel County, GA",2012-2013,22849,22861,12,0.053,46,-34,13,107,H1
"Emanuel County, GA",2013-2014,22861,22755,-106,-0.464,63,-169,13,107,H1
"Emanuel County, GA",2014-2015,22710,22708,-2,-0.009,58,-60,13,107,H1
"Emanuel County, GA",2015-2016,22708,22404,-304,-1.339,28,-332,13,107,H1
"Emanuel County, GA",2016-2017,22404,22530,126,0.562,11,115,13,107,H1
"Evans County, GA",2000-2001,10531,10691,160,1.519,84,76,13,109,H1
"Evans County, GA",2001-2002,10691,10885,194,1.815,68,126,13,109,H1
"Evans County, GA",2002-2003,10885,11020,135,1.24,74,61,13,109,H1
"Evans County, GA",2003-2004,11020,10889,-131,-1.189,70,-201,13,109,H1
"Evans County, GA",2004-2005,10889,10895,6,0.055,124,-118,13,109,H1
"Evans County, GA",2005-2006,10895,10889,-6,-0.055,84,-90,13,109,H1
"Evans County, GA",2006-2007,10889,10899,10,0.092,89,-79,13,109,H1
"Evans County, GA",2007-2008,10899,11020,121,1.11,90,31,13,109,H1
"Evans County, GA",2008-2009,11020,11016,-4,-0.036,90,-94,13,109,H1
"Evans County, GA",2009-2010,11016,11006,-10,-0.091,72,-82,13,109,H1
"Evans County, GA",2010-2011,11006,10965,-41,-0.373,44,-85,13,109,H1
"Evans County, GA",2011-2012,10965,10660,-305,-2.782,69,-374,13,109,H1
"Evans County, GA",2012-2013,10660,10813,153,1.435,83,70,13,109,H1
"Evans County, GA",2013-2014,10813,10898,85,0.786,70,15,13,109,H1
"Evans County, GA",2014-2015,10864,10787,-77,-0.709,45,-122,13,109,H1
"Evans County, GA",2015-2016,10787,10668,-119,-1.103,35,-154,13,109,H1
"Evans County, GA",2016-2017,10668,10775,107,1.003,34,73,13,109,H1
"Fannin County, GA",2000-2001,19954,20412,458,2.295,-3,461,13,111,H1
"Fannin County, GA",2001-2002,20412,21041,629,3.082,-16,645,13,111,H1
"Fannin County, GA",2002-2003,21041,21424,383,1.82,-29,412,13,111,H1
"Fannin County, GA",2003-2004,21424,21873,449,2.096,-23,472,13,111,H1
"Fannin County, GA",2004-2005,21873,22174,301,1.376,-36,337,13,111,H1
"Fannin County, GA",2005-2006,22174,22758,584,2.634,-47,631,13,111,H1
"Fannin County, GA",2006-2007,22758,23185,427,1.876,-62,489,13,111,H1
"Fannin County, GA",2007-2008,23185,23416,231,0.996,-16,247,13,111,H1
"Fannin County, GA",2008-2009,23416,23661,245,1.046,-15,260,13,111,H1
"Fannin County, GA",2009-2010,23661,23688,27,0.114,-71,98,13,111,H1
"Fannin County, GA",2010-2011,23688,23505,-183,-0.773,-69,-114,13,111,H1
"Fannin County, GA",2011-2012,23505,23467,-38,-0.162,-113,75,13,111,H1
"Fannin County, GA",2012-2013,23467,23746,279,1.189,-130,409,13,111,H1
"Fannin County, GA",2013-2014,23746,23753,7,0.029,-86,93,13,111,H1
"Fannin County, GA",2014-2015,23713,24303,590,2.488,-83,673,13,111,H1
"Fannin County, GA",2015-2016,24303,24991,688,2.831,-141,829,13,111,H1
"Fannin County, GA",2016-2017,24991,25322,331,1.324,-118,449,13,111,H1
"Fayette County, GA",2000-2001,92073,94086,2013,2.186,371,1642,13,113,H1
"Fayette County, GA",2001-2002,94086,95707,1621,1.723,335,1286,13,113,H1
"Fayette County, GA",2002-2003,95707,97634,1927,2.013,318,1609,13,113,H1
"Fayette County, GA",2003-2004,97634,99443,1809,1.853,287,1522,13,113,H1
"Fayette County, GA",2004-2005,99443,101961,2518,2.532,384,2134,13,113,H1
"Fayette County, GA",2005-2006,101961,104099,2138,2.097,261,1877,13,113,H1
"Fayette County, GA",2006-2007,104099,104989,890,0.855,343,547,13,113,H1
"Fayette County, GA",2007-2008,104989,105192,203,0.193,403,-200,13,113,H1
"Fayette County, GA",2008-2009,105192,105493,301,0.286,349,-48,13,113,H1
"Fayette County, GA",2009-2010,105493,106990,1497,1.419,95,1402,13,113,H1
"Fayette County, GA",2010-2011,106990,107211,221,0.207,14,207,13,113,H1
"Fayette County, GA",2011-2012,107211,107432,221,0.206,139,82,13,113,H1
"Fayette County, GA",2012-2013,107432,108355,923,0.859,22,901,13,113,H1
"Fayette County, GA",2013-2014,108355,109664,1309,1.208,52,1257,13,113,H1
"Fayette County, GA",2014-2015,109648,110714,1066,0.972,99,967,13,113,H1
"Fayette County, GA",2015-2016,110714,111248,534,0.482,-41,575,13,113,H1
"Fayette County, GA",2016-2017,111248,112549,1301,1.169,31,1270,13,113,H1
"Floyd County, GA",2000-2001,90837,91181,344,0.379,411,-67,13,115,H1
"Floyd County, GA",2001-2002,91181,92597,1416,1.553,353,1063,13,115,H1
"Floyd County, GA",2002-2003,92597,93539,942,1.017,418,524,13,115,H1
"Floyd County, GA",2003-2004,93539,94014,475,0.508,405,70,13,115,H1
"Floyd County, GA",2004-2005,94014,94332,318,0.338,366,-48,13,115,H1
"Floyd County, GA",2005-2006,94332,95165,833,0.883,473,360,13,115,H1
"Floyd County, GA",2006-2007,95165,95308,143,0.15,492,-349,13,115,H1
"Floyd County, GA",2007-2008,95308,95922,614,0.644,458,156,13,115,H1
"Floyd County, GA",2008-2009,95922,96383,461,0.481,415,46,13,115,H1
"Floyd County, GA",2009-2010,96383,96393,10,0.01,337,-327,13,115,H1
"Floyd County, GA",2010-2011,96393,96182,-211,-0.219,324,-535,13,115,H1
"Floyd County, GA",2011-2012,96182,96066,-116,-0.121,121,-237,13,115,H1
"Floyd County, GA",2012-2013,96066,96025,-41,-0.043,107,-148,13,115,H1
"Floyd County, GA",2013-2014,96025,96063,38,0.04,93,-55,13,115,H1
"Floyd County, GA",2014-2015,96061,96504,443,0.461,126,317,13,115,H1
"Floyd County, GA",2015-2016,96504,96620,116,0.12,132,-16,13,115,H1
"Floyd County, GA",2016-2017,96620,97613,993,1.028,138,855,13,115,H1
"Forsyth County, GA",2000-2001,100400,108491,8091,8.059,1501,6590,13,117,H1
"Forsyth County, GA",2001-2002,108491,115797,7306,6.734,1509,5797,13,117,H1
"Forsyth County, GA",2002-2003,115797,122698,6901,5.96,1569,5332,13,117,H1
"Forsyth County, GA",2003-2004,122698,129639,6941,5.657,1620,5321,13,117,H1
"Forsyth County, GA",2004-2005,129639,137643,8004,6.174,1772,6232,13,117,H1
"Forsyth County, GA",2005-2006,137643,147228,9585,6.964,1701,7884,13,117,H1
"Forsyth County, GA",2006-2007,147228,157129,9901,6.725,1765,8136,13,117,H1
"Forsyth County, GA",2007-2008,157129,166338,9209,5.861,1835,7374,13,117,H1
"Forsyth County, GA",2008-2009,166338,171993,5655,3.4,1923,3732,13,117,H1
"Forsyth County, GA",2009-2010,171993,176737,4744,2.758,1480,3264,13,117,H1
"Forsyth County, GA",2010-2011,176737,182392,5655,3.2,1402,4253,13,117,H1
"Forsyth County, GA",2011-2012,182392,187826,5434,2.979,1278,4156,13,117,H1
"Forsyth County, GA",2012-2013,187826,195312,7486,3.986,1207,6279,13,117,H1
"Forsyth County, GA",2013-2014,195312,204302,8990,4.603,1157,7833,13,117,H1
"Forsyth County, GA",2014-2015,203882,212438,8556,4.197,1163,7393,13,117,H1
"Forsyth County, GA",2015-2016,212438,220067,7629,3.591,1221,6408,13,117,H1
"Forsyth County, GA",2016-2017,220067,227967,7900,3.59,1139,6761,13,117,H1
"Franklin County, GA",2000-2001,20314,20703,389,1.915,13,376,13,119,H1
"Franklin County, GA",2001-2002,20703,20942,239,1.154,40,199,13,119,H1
"Franklin County, GA",2002-2003,20942,21193,251,1.199,17,234,13,119,H1
"Franklin County, GA",2003-2004,21193,21430,237,1.118,29,208,13,119,H1
"Franklin County, GA",2004-2005,21430,21725,295,1.377,54,241,13,119,H1
"Franklin County, GA",2005-2006,21725,21956,231,1.063,79,152,13,119,H1
"Franklin County, GA",2006-2007,21956,22195,239,1.089,70,169,13,119,H1
"Franklin County, GA",2007-2008,22195,22254,59,0.266,48,11,13,119,H1
"Franklin County, GA",2008-2009,22254,22152,-102,-0.458,55,-157,13,119,H1
"Franklin County, GA",2009-2010,22152,22066,-86,-0.388,50,-136,13,119,H1
"Franklin County, GA",2010-2011,22066,21957,-109,-0.494,19,-128,13,119,H1
"Franklin County, GA",2011-2012,21957,21923,-34,-0.155,18,-52,13,119,H1
"Franklin County, GA",2012-2013,21923,22044,121,0.552,-18,139,13,119,H1
"Franklin County, GA",2013-2014,22044,22264,220,0.998,8,212,13,119,H1
"Franklin County, GA",2014-2015,22250,22311,61,0.274,-12,73,13,119,H1
"Franklin County, GA",2015-2016,22311,22306,-5,-0.022,-8,3,13,119,H1
"Franklin County, GA",2016-2017,22306,22820,514,2.304,-7,521,13,119,H1
"Fulton County, GA",2000-2001,816190,820213,4023,0.493,7420,-3397,13,121,H1
"Fulton County, GA",2001-2002,820213,815224,-4989,-0.608,7020,-12009,13,121,H1
"Fulton County, GA",2002-2003,815224,812568,-2656,-0.326,7114,-9770,13,121,H1
"Fulton County, GA",2003-2004,812568,809481,-3087,-0.38,6995,-10082,13,121,H1
"Fulton County, GA",2004-2005,809481,818737,9256,1.143,7293,1963,13,121,H1
"Fulton County, GA",2005-2006,818737,845181,26444,3.23,7433,19011,13,121,H1
"Fulton County, GA",2006-2007,845181,869329,24148,2.857,8063,16085,13,121,H1
"Fulton County, GA",2007-2008,869329,888694,19365,2.228,8272,11093,13,121,H1
"Fulton County, GA",2008-2009,888694,905511,16817,1.892,8590,8227,13,121,H1
"Fulton County, GA",2009-2010,905511,926149,20638,2.279,7773,12865,13,121,H1
"Fulton County, GA",2010-2011,926149,950359,24210,2.614,7428,16782,13,121,H1
"Fulton County, GA",2011-2012,950359,977950,27591,2.903,7217,20374,13,121,H1
"Fulton County, GA",2012-2013,977950,984721,6771,0.692,6465,306,13,121,H1
"Fulton County, GA",2013-2014,984721,996319,11598,1.178,6078,5520,13,121,H1
"Fulton County, GA",2014-2015,996463,1010562,14099,1.415,6219,7880,13,121,H1
"Fulton County, GA",2015-2016,1010562,1024248,13686,1.354,5988,7698,13,121,H1
"Fulton County, GA",2016-2017,1024248,1041423,17175,1.677,5926,11249,13,121,H1
"Gilmer County, GA",2000-2001,23634,24229,595,2.518,165,430,13,123,H1
"Gilmer County, GA",2001-2002,24229,24920,691,2.852,122,569,13,123,H1
"Gilmer County, GA",2002-2003,24920,25575,655,2.628,104,551,13,123,H1
"Gilmer County, GA",2003-2004,25575,26175,600,2.346,197,403,13,123,H1
"Gilmer County, GA",2004-2005,26175,26808,633,2.418,149,484,13,123,H1
"Gilmer County, GA",2005-2006,26808,27665,857,3.197,147,710,13,123,H1
"Gilmer County, GA",2006-2007,27665,27996,331,1.196,178,153,13,123,H1
"Gilmer County, GA",2007-2008,27996,28211,215,0.768,177,38,13,123,H1
"Gilmer County, GA",2008-2009,28211,28174,-37,-0.131,131,-168,13,123,H1
"Gilmer County, GA",2009-2010,28174,28306,132,0.469,74,58,13,123,H1
"Gilmer County, GA",2010-2011,28306,28280,-26,-0.092,131,-157,13,123,H1
"Gilmer County, GA",2011-2012,28280,28205,-75,-0.265,82,-157,13,123,H1
"Gilmer County, GA",2012-2013,28205,28587,382,1.354,13,369,13,123,H1
"Gilmer County, GA",2013-2014,28587,28829,242,0.847,1,241,13,123,H1
"Gilmer County, GA",2014-2015,28866,29400,534,1.85,5,529,13,123,H1
"Gilmer County, GA",2015-2016,29400,30033,633,2.153,-17,650,13,123,H1
"Gilmer County, GA",2016-2017,30033,30674,641,2.134,0,641,13,123,H1
"Glascock County, GA",2000-2001,2574,2586,12,0.466,-5,17,13,125,H1
"Glascock County, GA",2001-2002,2586,2618,32,1.237,-7,39,13,125,H1
"Glascock County, GA",2002-2003,2618,2644,26,0.993,-10,36,13,125,H1
"Glascock County, GA",2003-2004,2644,2720,76,2.874,-2,78,13,125,H1
"Glascock County, GA",2004-2005,2720,2763,43,1.581,-25,68,13,125,H1
"Glascock County, GA",2005-2006,2763,2893,130,4.705,12,118,13,125,H1
"Glascock County, GA",2006-2007,2893,2988,95,3.284,7,88,13,125,H1
"Glascock County, GA",2007-2008,2988,3010,22,0.736,7,15,13,125,H1
"Glascock County, GA",2008-2009,3010,3066,56,1.86,2,54,13,125,H1
"Glascock County, GA",2009-2010,3066,3064,-2,-0.065,0,-2,13,125,H1
"Glascock County, GA",2010-2011,3064,3108,44,1.436,-2,46,13,125,H1
"Glascock County, GA",2011-2012,3108,3120,12,0.386,-24,36,13,125,H1
"Glascock County, GA",2012-2013,3120,3083,-37,-1.186,0,-37,13,125,H1
"Glascock County, GA",2013-2014,3083,3053,-30,-0.973,0,-30,13,125,H1
"Glascock County, GA",2014-2015,3046,3065,19,0.624,-7,26,13,125,H1
"Glascock County, GA",2015-2016,3065,2992,-73,-2.382,0,-73,13,125,H1
"Glascock County, GA",2016-2017,2992,3062,70,2.34,-6,76,13,125,H1
"Glynn County, GA",2000-2001,67696,68558,862,1.273,280,582,13,127,H1
"Glynn County, GA",2001-2002,68558,69408,850,1.24,246,604,13,127,H1
"Glynn County, GA",2002-2003,69408,70391,983,1.416,281,702,13,127,H1
"Glynn County, GA",2003-2004,70391,71475,1084,1.54,227,857,13,127,H1
"Glynn County, GA",2004-2005,71475,72589,1114,1.559,292,822,13,127,H1
"Glynn County, GA",2005-2006,72589,74870,2281,3.142,305,1976,13,127,H1
"Glynn County, GA",2006-2007,74870,76513,1643,2.194,391,1252,13,127,H1
"Glynn County, GA",2007-2008,76513,78013,1500,1.96,367,1133,13,127,H1
"Glynn County, GA",2008-2009,78013,78946,933,1.196,366,567,13,127,H1
"Glynn County, GA",2009-2010,78946,79802,856,1.084,304,552,13,127,H1
"Glynn County, GA",2010-2011,79802,80216,414,0.519,249,165,13,127,H1
"Glynn County, GA",2011-2012,80216,80960,744,0.927,242,502,13,127,H1
"Glynn County, GA",2012-2013,80960,81533,573,0.708,147,426,13,127,H1
"Glynn County, GA",2013-2014,81533,82175,642,0.787,178,464,13,127,H1
"Glynn County, GA",2014-2015,82343,83579,1236,1.501,161,1075,13,127,H1
"Glynn County, GA",2015-2016,83579,84528,949,1.135,119,830,13,127,H1
"Glynn County, GA",2016-2017,84528,85282,754,0.892,60,694,13,127,H1
"Gordon County, GA",2000-2001,44401,45757,1356,3.054,445,911,13,129,H1
"Gordon County, GA",2001-2002,45757,46939,1182,2.583,389,793,13,129,H1
"Gordon County, GA",2002-2003,46939,48145,1206,2.569,395,811,13,129,H1
"Gordon County, GA",2003-2004,48145,49426,1281,2.661,441,840,13,129,H1
"Gordon County, GA",2004-2005,49426,50602,1176,2.379,396,780,13,129,H1
"Gordon County, GA",2005-2006,50602,52161,1559,3.081,481,1078,13,129,H1
"Gordon County, GA",2006-2007,52161,53409,1248,2.393,459,789,13,129,H1
"Gordon County, GA",2007-2008,53409,54567,1158,2.168,436,722,13,129,H1
"Gordon County, GA",2008-2009,54567,54945,378,0.693,445,-67,13,129,H1
"Gordon County, GA",2009-2010,54945,55204,259,0.471,386,-127,13,129,H1
"Gordon County, GA",2010-2011,55204,55508,304,0.551,228,76,13,129,H1
"Gordon County, GA",2011-2012,55508,55740,232,0.418,247,-15,13,129,H1
"Gordon County, GA",2012-2013,55740,55830,90,0.161,241,-151,13,129,H1
"Gordon County, GA",2013-2014,55830,56047,217,0.389,226,-9,13,129,H1
"Gordon County, GA",2014-2015,55917,56574,657,1.175,178,479,13,129,H1
"Gordon County, GA",2015-2016,56574,56987,413,0.73,216,197,13,129,H1
"Gordon County, GA",2016-2017,56987,57089,102,0.179,197,-95,13,129,H1
"Grady County, GA",2000-2001,23624,23635,11,0.047,163,-152,13,131,H1
"Grady County, GA",2001-2002,23635,23635,0,0,124,-124,13,131,H1
"Grady County, GA",2002-2003,23635,23716,81,0.343,119,-38,13,131,H1
"Grady County, GA",2003-2004,23716,23840,124,0.523,153,-29,13,131,H1
"Grady County, GA",2004-2005,23840,24031,191,0.801,136,55,13,131,H1
"Grady County, GA",2005-2006,24031,24384,353,1.469,146,207,13,131,H1
"Grady County, GA",2006-2007,24384,24624,240,0.984,175,65,13,131,H1
"Grady County, GA",2007-2008,24624,24728,104,0.422,181,-77,13,131,H1
"Grady County, GA",2008-2009,24728,24893,165,0.667,166,-1,13,131,H1
"Grady County, GA",2009-2010,24893,25047,154,0.619,135,19,13,131,H1
"Grady County, GA",2010-2011,25047,25165,118,0.471,194,-76,13,131,H1
"Grady County, GA",2011-2012,25165,25366,201,0.799,125,76,13,131,H1
"Grady County, GA",2012-2013,25366,25258,-108,-0.426,85,-193,13,131,H1
"Grady County, GA",2013-2014,25258,25359,101,0.4,85,16,13,131,H1
"Grady County, GA",2014-2015,25308,25205,-103,-0.407,86,-189,13,131,H1
"Grady County, GA",2015-2016,25205,24893,-312,-1.238,103,-415,13,131,H1
"Grady County, GA",2016-2017,24893,24819,-74,-0.297,72,-146,13,131,H1
"Greene County, GA",2000-2001,14389,14703,314,2.182,32,282,13,133,H1
"Greene County, GA",2001-2002,14703,14984,281,1.911,57,224,13,133,H1
"Greene County, GA",2002-2003,14984,15110,126,0.841,31,95,13,133,H1
"Greene County, GA",2003-2004,15110,15330,220,1.456,7,213,13,133,H1
"Greene County, GA",2004-2005,15330,15499,169,1.102,25,144,13,133,H1
"Greene County, GA",2005-2006,15499,15587,88,0.568,29,59,13,133,H1
"Greene County, GA",2006-2007,15587,15823,236,1.514,43,193,13,133,H1
"Greene County, GA",2007-2008,15823,15869,46,0.291,26,20,13,133,H1
"Greene County, GA",2008-2009,15869,15934,65,0.41,3,62,13,133,H1
"Greene County, GA",2009-2010,15934,15992,58,0.364,-18,76,13,133,H1
"Greene County, GA",2010-2011,15992,16051,59,0.369,-1,60,13,133,H1
"Greene County, GA",2011-2012,16051,16132,81,0.505,-2,83,13,133,H1
"Greene County, GA",2012-2013,16132,16283,151,0.936,-17,168,13,133,H1
"Greene County, GA",2013-2014,16283,16490,207,1.271,-33,240,13,133,H1
"Greene County, GA",2014-2015,16474,16710,236,1.433,-37,273,13,133,H1
"Greene County, GA",2015-2016,16710,16939,229,1.37,-4,233,13,133,H1
"Greene County, GA",2016-2017,16939,17281,342,2.019,-49,391,13,133,H1
"Gwinnett County, GA",2000-2001,595584,620025,24441,4.104,8519,15922,13,135,H1
"Gwinnett County, GA",2001-2002,620025,641986,21961,3.542,8868,13093,13,135,H1
"Gwinnett County, GA",2002-2003,641986,663391,21405,3.334,9336,12069,13,135,H1
"Gwinnett County, GA",2003-2004,663391,687468,24077,3.629,10009,14068,13,135,H1
"Gwinnett County, GA",2004-2005,687468,710978,23510,3.42,10544,12966,13,135,H1
"Gwinnett County, GA",2005-2006,710978,740267,29289,4.12,10731,18558,13,135,H1
"Gwinnett County, GA",2006-2007,740267,764129,23862,3.223,10976,12886,13,135,H1
"Gwinnett County, GA",2007-2008,764129,780721,16592,2.171,10473,6119,13,135,H1
"Gwinnett County, GA",2008-2009,780721,796276,15555,1.992,9966,5589,13,135,H1
"Gwinnett County, GA",2009-2010,796276,808374,12098,1.519,9430,2668,13,135,H1
"Gwinnett County, GA",2010-2011,808374,824981,16607,2.054,8247,8360,13,135,H1
"Gwinnett County, GA",2011-2012,824981,840221,15240,1.847,8029,7211,13,135,H1
"Gwinnett County, GA",2012-2013,840221,858956,18735,2.23,7483,11252,13,135,H1
"Gwinnett County, GA",2013-2014,858956,877922,18966,2.208,7256,11710,13,135,H1
"Gwinnett County, GA",2014-2015,877726,895823,18097,2.062,7506,10591,13,135,H1
"Gwinnett County, GA",2015-2016,895823,907101,11278,1.259,7578,3700,13,135,H1
"Gwinnett County, GA",2016-2017,907101,920260,13159,1.451,7225,5934,13,135,H1
"Habersham County, GA",2000-2001,36095,36914,819,2.269,198,621,13,137,H1
"Habersham County, GA",2001-2002,36914,37421,507,1.373,186,321,13,137,H1
"Habersham County, GA",2002-2003,37421,38051,630,1.684,144,486,13,137,H1
"Habersham County, GA",2003-2004,38051,38491,440,1.156,282,158,13,137,H1
"Habersham County, GA",2004-2005,38491,39155,664,1.725,287,377,13,137,H1
"Habersham County, GA",2005-2006,39155,40616,1461,3.731,292,1169,13,137,H1
"Habersham County, GA",2006-2007,40616,41865,1249,3.075,312,937,13,137,H1
"Habersham County, GA",2007-2008,41865,42550,685,1.636,331,354,13,137,H1
"Habersham County, GA",2008-2009,42550,42947,397,0.933,330,67,13,137,H1
"Habersham County, GA",2009-2010,42947,43095,148,0.345,220,-72,13,137,H1
"Habersham County, GA",2010-2011,43095,43106,11,0.026,117,-106,13,137,H1
"Habersham County, GA",2011-2012,43106,43463,357,0.828,100,257,13,137,H1
"Habersham County, GA",2012-2013,43463,43294,-169,-0.389,82,-251,13,137,H1
"Habersham County, GA",2013-2014,43294,43752,458,1.058,93,365,13,137,H1
"Habersham County, GA",2014-2015,43753,43996,243,0.555,92,151,13,137,H1
"Habersham County, GA",2015-2016,43996,44177,181,0.411,62,119,13,137,H1
"Habersham County, GA",2016-2017,44177,44567,390,0.883,53,337,13,137,H1
"Hall County, GA",2000-2001,140993,146148,5155,3.656,1836,3319,13,139,H1
"Hall County, GA",2001-2002,146148,150229,4081,2.792,1883,2198,13,139,H1
"Hall County, GA",2002-2003,150229,153561,3332,2.218,1865,1467,13,139,H1
"Hall County, GA",2003-2004,153561,156385,2824,1.839,1795,1029,13,139,H1
"Hall County, GA",2004-2005,156385,160979,4594,2.938,2079,2515,13,139,H1
"Hall County, GA",2005-2006,160979,166524,5545,3.445,1892,3653,13,139,H1
"Hall County, GA",2006-2007,166524,172446,5922,3.556,1975,3947,13,139,H1
"Hall County, GA",2007-2008,172446,177277,4831,2.801,2112,2719,13,139,H1
"Hall County, GA",2008-2009,177277,178503,1226,0.692,2142,-916,13,139,H1
"Hall County, GA",2009-2010,178503,180034,1531,0.858,1712,-181,13,139,H1
"Hall County, GA",2010-2011,180034,182954,2920,1.622,1421,1499,13,139,H1
"Hall County, GA",2011-2012,182954,185084,2130,1.164,1297,833,13,139,H1
"Hall County, GA",2012-2013,185084,187759,2675,1.445,1155,1520,13,139,H1
"Hall County, GA",2013-2014,187759,190761,3002,1.599,1127,1875,13,139,H1
"Hall County, GA",2014-2015,190525,193535,3010,1.58,1055,1955,13,139,H1
"Hall County, GA",2015-2016,193535,196237,2702,1.396,1177,1525,13,139,H1
"Hall County, GA",2016-2017,196237,199335,3098,1.579,1161,1937,13,139,H1
"Hancock County, GA",2000-2001,10066,10022,-44,-0.437,45,-89,13,141,H1
"Hancock County, GA",2001-2002,10022,9829,-193,-1.926,-21,-172,13,141,H1
"Hancock County, GA",2002-2003,9829,9764,-65,-0.661,-7,-58,13,141,H1
"Hancock County, GA",2003-2004,9764,9673,-91,-0.932,8,-99,13,141,H1
"Hancock County, GA",2004-2005,9673,9634,-39,-0.403,3,-42,13,141,H1
"Hancock County, GA",2005-2006,9634,9650,16,0.166,13,3,13,141,H1
"Hancock County, GA",2006-2007,9650,9889,239,2.477,13,226,13,141,H1
"Hancock County, GA",2007-2008,9889,9808,-81,-0.819,16,-97,13,141,H1
"Hancock County, GA",2008-2009,9808,9508,-300,-3.059,-4,-296,13,141,H1
"Hancock County, GA",2009-2010,9508,9410,-98,-1.031,-26,-72,13,141,H1
"Hancock County, GA",2010-2011,9410,9368,-42,-0.446,8,-50,13,141,H1
"Hancock County, GA",2011-2012,9368,9030,-338,-3.608,-2,-336,13,141,H1
"Hancock County, GA",2012-2013,9030,8898,-132,-1.462,2,-134,13,141,H1
"Hancock County, GA",2013-2014,8898,8509,-389,-4.372,-22,-367,13,141,H1
"Hancock County, GA",2014-2015,8519,8551,32,0.376,-39,71,13,141,H1
"Hancock County, GA",2015-2016,8551,8657,106,1.24,-30,136,13,141,H1
"Hancock County, GA",2016-2017,8657,8561,-96,-1.109,-49,-47,13,141,H1
"Haralson County, GA",2000-2001,25788,26232,444,1.722,133,311,13,143,H1
"Haralson County, GA",2001-2002,26232,26676,444,1.693,99,345,13,143,H1
"Haralson County, GA",2002-2003,26676,27227,551,2.066,91,460,13,143,H1
"Haralson County, GA",2003-2004,27227,27621,394,1.447,85,309,13,143,H1
"Haralson County, GA",2004-2005,27621,27987,366,1.325,67,299,13,143,H1
"Haralson County, GA",2005-2006,27987,28121,134,0.479,96,38,13,143,H1
"Haralson County, GA",2006-2007,28121,28558,437,1.554,134,303,13,143,H1
"Haralson County, GA",2007-2008,28558,28645,87,0.305,83,4,13,143,H1
"Haralson County, GA",2008-2009,28645,28774,129,0.45,44,85,13,143,H1
"Haralson County, GA",2009-2010,28774,28788,14,0.049,45,-31,13,143,H1
"Haralson County, GA",2010-2011,28788,28515,-273,-0.948,-8,-265,13,143,H1
"Haralson County, GA",2011-2012,28515,28388,-127,-0.445,11,-138,13,143,H1
"Haralson County, GA",2012-2013,28388,28482,94,0.331,44,50,13,143,H1
"Haralson County, GA",2013-2014,28482,28641,159,0.558,21,138,13,143,H1
"Haralson County, GA",2014-2015,28615,28854,239,0.835,3,236,13,143,H1
"Haralson County, GA",2015-2016,28854,28833,-21,-0.073,-36,15,13,143,H1
"Haralson County, GA",2016-2017,28833,29256,423,1.467,-13,436,13,143,H1
"Harris County, GA",2000-2001,23912,24547,635,2.656,89,546,13,145,H1
"Harris County, GA",2001-2002,24547,25327,780,3.178,78,702,13,145,H1
"Harris County, GA",2002-2003,25327,26256,929,3.668,92,837,13,145,H1
"Harris County, GA",2003-2004,26256,27180,924,3.519,116,808,13,145,H1
"Harris County, GA",2004-2005,27180,28170,990,3.642,74,916,13,145,H1
"Harris County, GA",2005-2006,28170,29289,1119,3.972,108,1011,13,145,H1
"Harris County, GA",2006-2007,29289,30276,987,3.37,120,867,13,145,H1
"Harris County, GA",2007-2008,30276,30807,531,1.754,103,428,13,145,H1
"Harris County, GA",2008-2009,30807,31494,687,2.23,107,580,13,145,H1
"Harris County, GA",2009-2010,31494,32167,673,2.137,77,596,13,145,H1
"Harris County, GA",2010-2011,32167,32366,199,0.619,82,117,13,145,H1
"Harris County, GA",2011-2012,32366,32613,247,0.763,95,152,13,145,H1
"Harris County, GA",2012-2013,32613,32673,60,0.184,38,22,13,145,H1
"Harris County, GA",2013-2014,32673,32876,203,0.621,5,198,13,145,H1
"Harris County, GA",2014-2015,32873,33381,508,1.545,-11,519,13,145,H1
"Harris County, GA",2015-2016,33381,33617,236,0.707,4,232,13,145,H1
"Harris County, GA",2016-2017,33617,33915,298,0.886,-12,310,13,145,H1
"Hart County, GA",2000-2001,23046,23049,3,0.013,1,2,13,147,H1
"Hart County, GA",2001-2002,23049,23286,237,1.028,4,233,13,147,H1
"Hart County, GA",2002-2003,23286,23402,116,0.498,15,101,13,147,H1
"Hart County, GA",2003-2004,23402,23966,564,2.41,-24,588,13,147,H1
"Hart County, GA",2004-2005,23966,24376,410,1.711,47,363,13,147,H1
"Hart County, GA",2005-2006,24376,24764,388,1.592,-25,413,13,147,H1
"Hart County, GA",2006-2007,24764,24894,130,0.525,-2,132,13,147,H1
"Hart County, GA",2007-2008,24894,25138,244,0.98,28,216,13,147,H1
"Hart County, GA",2008-2009,25138,25108,-30,-0.119,16,-46,13,147,H1
"Hart County, GA",2009-2010,25108,25189,81,0.323,19,62,13,147,H1
"Hart County, GA",2010-2011,25189,25435,246,0.977,-3,249,13,147,H1
"Hart County, GA",2011-2012,25435,25549,114,0.448,-42,156,13,147,H1
"Hart County, GA",2012-2013,25549,25480,-69,-0.27,13,-82,13,147,H1
"Hart County, GA",2013-2014,25480,25377,-103,-0.404,-24,-79,13,147,H1
"Hart County, GA",2014-2015,25412,25534,122,0.48,-7,129,13,147,H1
"Hart County, GA",2015-2016,25534,25548,14,0.055,-31,45,13,147,H1
"Hart County, GA",2016-2017,25548,25794,246,0.963,-33,279,13,147,H1
"Heard County, GA",2000-2001,11038,11173,135,1.223,72,63,13,149,H1
"Heard County, GA",2001-2002,11173,11207,34,0.304,38,-4,13,149,H1
"Heard County, GA",2002-2003,11207,11169,-38,-0.339,40,-78,13,149,H1
"Heard County, GA",2003-2004,11169,11273,104,0.931,25,79,13,149,H1
"Heard County, GA",2004-2005,11273,11350,77,0.683,30,47,13,149,H1
"Heard County, GA",2005-2006,11350,11553,203,1.789,42,161,13,149,H1
"Heard County, GA",2006-2007,11553,11618,65,0.563,27,38,13,149,H1
"Heard County, GA",2007-2008,11618,11809,191,1.644,9,182,13,149,H1
"Heard County, GA",2008-2009,11809,11765,-44,-0.373,24,-68,13,149,H1
"Heard County, GA",2009-2010,11765,11851,86,0.731,12,74,13,149,H1
"Heard County, GA",2010-2011,11851,11711,-140,-1.181,3,-143,13,149,H1
"Heard County, GA",2011-2012,11711,11644,-67,-0.572,13,-80,13,149,H1
"Heard County, GA",2012-2013,11644,11561,-83,-0.713,37,-120,13,149,H1
"Heard County, GA",2013-2014,11561,11603,42,0.363,17,25,13,149,H1
"Heard County, GA",2014-2015,11606,11539,-67,-0.577,-1,-66,13,149,H1
"Heard County, GA",2015-2016,11539,11574,35,0.303,-21,56,13,149,H1
"Heard County, GA",2016-2017,11574,11730,156,1.348,-15,171,13,149,H1
"Henry County, GA",2000-2001,121774,1.31E+05,9226,7.576,1269,7957,13,151,H1
"Henry County, GA",2001-2002,1.31E+05,140747,9747,7.44,1432,8315,13,151,H1
"Henry County, GA",2002-2003,140747,150928,10181,7.234,1490,8691,13,151,H1
"Henry County, GA",2003-2004,150928,159971,9043,5.992,1712,7331,13,151,H1
"Henry County, GA",2004-2005,159971,169607,9636,6.024,1727,7909,13,151,H1
"Henry County, GA",2005-2006,169607,180304,10697,6.307,1842,8855,13,151,H1
"Henry County, GA",2006-2007,180304,188736,8432,4.677,1851,6581,13,151,H1
"Henry County, GA",2007-2008,188736,194658,5922,3.138,1909,4013,13,151,H1
"Henry County, GA",2008-2009,194658,199622,4964,2.55,2164,2800,13,151,H1
"Henry County, GA",2009-2010,199622,205206,5584,2.797,1660,3924,13,151,H1
"Henry County, GA",2010-2011,205206,207071,1865,0.909,1285,580,13,151,H1
"Henry County, GA",2011-2012,207071,208443,1372,0.663,1116,256,13,151,H1
"Henry County, GA",2012-2013,208443,210755,2312,1.109,1050,1262,13,151,H1
"Henry County, GA",2013-2014,210755,213869,3114,1.478,1193,1921,13,151,H1
"Henry County, GA",2014-2015,213738,217739,4001,1.872,1153,2848,13,151,H1
"Henry County, GA",2015-2016,217739,221355,3616,1.661,939,2677,13,151,H1
"Henry County, GA",2016-2017,221355,225813,4458,2.014,986,3472,13,151,H1
"Houston County, GA",2000-2001,111294,113432,2138,1.921,894,1244,13,153,H1
"Houston County, GA",2001-2002,113432,116411,2979,2.626,795,2184,13,153,H1
"Houston County, GA",2002-2003,116411,119396,2985,2.564,925,2060,13,153,H1
"Houston County, GA",2003-2004,119396,123723,4327,3.624,1037,3290,13,153,H1
"Houston County, GA",2004-2005,123723,126201,2478,2.003,1055,1423,13,153,H1
"Houston County, GA",2005-2006,126201,128978,2777,2.2,1110,1667,13,153,H1
"Houston County, GA",2006-2007,128978,132373,3395,2.632,1221,2174,13,153,H1
"Houston County, GA",2007-2008,132373,134922,2549,1.926,1176,1373,13,153,H1
"Houston County, GA",2008-2009,134922,137416,2494,1.848,1047,1447,13,153,H1
"Houston County, GA",2009-2010,137416,140721,3305,2.405,1026,2279,13,153,H1
"Houston County, GA",2010-2011,140721,144161,3440,2.445,1073,2367,13,153,H1
"Houston County, GA",2011-2012,144161,146200,2039,1.414,1113,926,13,153,H1
"Houston County, GA",2012-2013,146200,147919,1719,1.176,1007,712,13,153,H1
"Houston County, GA",2013-2014,147919,149111,1192,0.806,903,289,13,153,H1
"Houston County, GA",2014-2015,149228,150033,805,0.539,831,-26,13,153,H1
"Houston County, GA",2015-2016,150033,151862,1829,1.219,799,1030,13,153,H1
"Houston County, GA",2016-2017,151862,153479,1617,1.065,784,833,13,153,H1
"Irwin County, GA",2000-2001,9905,9953,48,0.485,15,33,13,155,H1
"Irwin County, GA",2001-2002,9953,9775,-178,-1.788,22,-200,13,155,H1
"Irwin County, GA",2002-2003,9775,9777,2,0.02,1,1,13,155,H1
"Irwin County, GA",2003-2004,9777,9402,-375,-3.836,17,-392,13,155,H1
"Irwin County, GA",2004-2005,9402,9779,377,4.01,9,368,13,155,H1
"Irwin County, GA",2005-2006,9779,9852,73,0.746,18,55,13,155,H1
"Irwin County, GA",2006-2007,9852,9493,-359,-3.644,38,-397,13,155,H1
"Irwin County, GA",2007-2008,9493,9803,310,3.266,49,261,13,155,H1
"Irwin County, GA",2008-2009,9803,9536,-267,-2.724,15,-282,13,155,H1
"Irwin County, GA",2009-2010,9536,9601,65,0.682,23,42,13,155,H1
"Irwin County, GA",2010-2011,9601,9692,91,0.948,11,80,13,155,H1
"Irwin County, GA",2011-2012,9692,9600,-92,-0.949,14,-106,13,155,H1
"Irwin County, GA",2012-2013,9600,9412,-188,-1.958,14,-202,13,155,H1
"Irwin County, GA",2013-2014,9412,9104,-308,-3.272,4,-312,13,155,H1
"Irwin County, GA",2014-2015,9091,9245,154,1.694,1,153,13,155,H1
"Irwin County, GA",2015-2016,9245,9359,114,1.233,16,98,13,155,H1
"Irwin County, GA",2016-2017,9359,9410,51,0.545,-15,66,13,155,H1
"Jackson County, GA",2000-2001,41845,43367,1522,3.637,258,1264,13,157,H1
"Jackson County, GA",2001-2002,43367,44940,1573,3.627,314,1259,13,157,H1
"Jackson County, GA",2002-2003,44940,46230,1290,2.87,338,952,13,157,H1
"Jackson County, GA",2003-2004,46230,48288,2058,4.452,326,1732,13,157,H1
"Jackson County, GA",2004-2005,48288,50607,2319,4.802,336,1983,13,157,H1
"Jackson County, GA",2005-2006,50607,54037,3430,6.778,458,2972,13,157,H1
"Jackson County, GA",2006-2007,54037,57521,3484,6.447,515,2969,13,157,H1
"Jackson County, GA",2007-2008,57521,59420,1899,3.301,527,1372,13,157,H1
"Jackson County, GA",2008-2009,59420,60052,632,1.064,532,100,13,157,H1
"Jackson County, GA",2009-2010,60052,60777,725,1.207,306,419,13,157,H1
"Jackson County, GA",2010-2011,60777,60551,-226,-0.372,311,-537,13,157,H1
"Jackson County, GA",2011-2012,60551,60472,-79,-0.13,245,-324,13,157,H1
"Jackson County, GA",2012-2013,60472,60971,499,0.825,188,311,13,157,H1
"Jackson County, GA",2013-2014,60971,61870,899,1.474,266,633,13,157,H1
"Jackson County, GA",2014-2015,61848,63360,1512,2.445,257,1255,13,157,H1
"Jackson County, GA",2015-2016,63360,64978,1618,2.554,247,1371,13,157,H1
"Jackson County, GA",2016-2017,64978,67519,2541,3.911,271,2270,13,157,H1
"Jasper County, GA",2000-2001,11496,11629,133,1.157,44,89,13,159,H1
"Jasper County, GA",2001-2002,11629,12027,398,3.422,68,330,13,159,H1
"Jasper County, GA",2002-2003,12027,12417,390,3.243,82,308,13,159,H1
"Jasper County, GA",2003-2004,12417,12588,171,1.377,44,127,13,159,H1
"Jasper County, GA",2004-2005,12588,12985,397,3.154,107,290,13,159,H1
"Jasper County, GA",2005-2006,12985,13370,385,2.965,64,321,13,159,H1
"Jasper County, GA",2006-2007,13370,13569,199,1.488,77,122,13,159,H1
"Jasper County, GA",2007-2008,13569,13769,200,1.474,82,118,13,159,H1
"Jasper County, GA",2008-2009,13769,13842,73,0.53,65,8,13,159,H1
"Jasper County, GA",2009-2010,13842,13885,43,0.311,67,-24,13,159,H1
"Jasper County, GA",2010-2011,13885,13778,-107,-0.771,75,-182,13,159,H1
"Jasper County, GA",2011-2012,13778,13596,-182,-1.321,47,-229,13,159,H1
"Jasper County, GA",2012-2013,13596,13543,-53,-0.39,58,-111,13,159,H1
"Jasper County, GA",2013-2014,13543,13432,-111,-0.82,32,-143,13,159,H1
"Jasper County, GA",2014-2015,13440,13635,195,1.451,20,175,13,159,H1
"Jasper County, GA",2015-2016,13635,13821,186,1.364,38,148,13,159,H1
"Jasper County, GA",2016-2017,13821,13964,143,1.035,32,111,13,159,H1
"Jeff Davis County, GA",2000-2001,12734,12877,143,1.123,62,81,13,161,H1
"Jeff Davis County, GA",2001-2002,12877,13088,211,1.639,74,137,13,161,H1
"Jeff Davis County, GA",2002-2003,13088,13234,146,1.116,40,106,13,161,H1
"Jeff Davis County, GA",2003-2004,13234,13433,199,1.504,73,126,13,161,H1
"Jeff Davis County, GA",2004-2005,13433,13729,296,2.204,72,224,13,161,H1
"Jeff Davis County, GA",2005-2006,13729,14028,299,2.178,97,202,13,161,H1
"Jeff Davis County, GA",2006-2007,14028,14204,176,1.255,104,72,13,161,H1
"Jeff Davis County, GA",2007-2008,14204,14577,373,2.626,102,271,13,161,H1
"Jeff Davis County, GA",2008-2009,14577,14892,315,2.161,98,217,13,161,H1
"Jeff Davis County, GA",2009-2010,14892,15091,199,1.336,99,100,13,161,H1
"Jeff Davis County, GA",2010-2011,15091,15088,-3,-0.02,41,-44,13,161,H1
"Jeff Davis County, GA",2011-2012,15088,15114,26,0.172,84,-58,13,161,H1
"Jeff Davis County, GA",2012-2013,15114,14986,-128,-0.847,57,-185,13,161,H1
"Jeff Davis County, GA",2013-2014,14986,14859,-127,-0.847,47,-174,13,161,H1
"Jeff Davis County, GA",2014-2015,14862,14920,58,0.39,57,1,13,161,H1
"Jeff Davis County, GA",2015-2016,14920,14970,50,0.335,45,5,13,161,H1
"Jeff Davis County, GA",2016-2017,14970,15025,55,0.367,48,7,13,161,H1
"Jefferson County, GA",2000-2001,17229,17121,-108,-0.627,67,-175,13,163,H1
"Jefferson County, GA",2001-2002,17121,17091,-30,-0.175,64,-94,13,163,H1
"Jefferson County, GA",2002-2003,17091,17019,-72,-0.421,56,-128,13,163,H1
"Jefferson County, GA",2003-2004,17019,16988,-31,-0.182,95,-126,13,163,H1
"Jefferson County, GA",2004-2005,16988,16924,-64,-0.377,50,-114,13,163,H1
"Jefferson County, GA",2005-2006,16924,16889,-35,-0.207,42,-77,13,163,H1
"Jefferson County, GA",2006-2007,16889,16830,-59,-0.349,39,-98,13,163,H1
"Jefferson County, GA",2007-2008,16830,16925,95,0.564,28,67,13,163,H1
"Jefferson County, GA",2008-2009,16925,17067,142,0.839,38,104,13,163,H1
"Jefferson County, GA",2009-2010,17067,16919,-148,-0.867,48,-196,13,163,H1
"Jefferson County, GA",2010-2011,16919,16816,-103,-0.609,37,-140,13,163,H1
"Jefferson County, GA",2011-2012,16816,16422,-394,-2.343,5,-399,13,163,H1
"Jefferson County, GA",2012-2013,16422,16342,-80,-0.487,-27,-53,13,163,H1
"Jefferson County, GA",2013-2014,16342,16272,-70,-0.428,-14,-56,13,163,H1
"Jefferson County, GA",2014-2015,16237,16106,-131,-0.807,-12,-119,13,163,H1
"Jefferson County, GA",2015-2016,16106,15788,-318,-1.974,10,-328,13,163,H1
"Jefferson County, GA",2016-2017,15788,15648,-140,-0.887,-12,-128,13,163,H1
"Jenkins County, GA",2000-2001,8584,8577,-7,-0.082,68,-75,13,165,H1
"Jenkins County, GA",2001-2002,8577,8543,-34,-0.396,17,-51,13,165,H1
"Jenkins County, GA",2002-2003,8543,8518,-25,-0.293,23,-48,13,165,H1
"Jenkins County, GA",2003-2004,8518,8490,-28,-0.329,21,-49,13,165,H1
"Jenkins County, GA",2004-2005,8490,8510,20,0.236,30,-10,13,165,H1
"Jenkins County, GA",2005-2006,8510,8533,23,0.27,48,-25,13,165,H1
"Jenkins County, GA",2006-2007,8533,8442,-91,-1.066,39,-130,13,165,H1
"Jenkins County, GA",2007-2008,8442,8340,-102,-1.208,45,-147,13,165,H1
"Jenkins County, GA",2008-2009,8340,8339,-1,-0.012,37,-38,13,165,H1
"Jenkins County, GA",2009-2010,8339,8321,-18,-0.216,32,-50,13,165,H1
"Jenkins County, GA",2010-2011,8321,8122,-199,-2.392,14,-213,13,165,H1
"Jenkins County, GA",2011-2012,8122,9133,1011,12.448,-30,1041,13,165,H1
"Jenkins County, GA",2012-2013,9133,9268,135,1.478,26,109,13,165,H1
"Jenkins County, GA",2013-2014,9268,9125,-143,-1.543,-3,-140,13,165,H1
"Jenkins County, GA",2014-2015,9129,8957,-172,-1.884,11,-183,13,165,H1
"Jenkins County, GA",2015-2016,8957,8770,-187,-2.088,7,-194,13,165,H1
"Jenkins County, GA",2016-2017,8770,8767,-3,-0.034,-7,4,13,165,H1
"Johnson County, GA",2000-2001,8567,8768,201,2.346,-3,204,13,167,H1
"Johnson County, GA",2001-2002,8768,9436,668,7.619,23,645,13,167,H1
"Johnson County, GA",2002-2003,9436,9456,20,0.212,7,13,13,167,H1
"Johnson County, GA",2003-2004,9456,9613,157,1.66,14,143,13,167,H1
"Johnson County, GA",2004-2005,9613,9516,-97,-1.009,-8,-89,13,167,H1
"Johnson County, GA",2005-2006,9516,9638,122,1.282,24,98,13,167,H1
"Johnson County, GA",2006-2007,9638,10107,469,4.866,11,458,13,167,H1
"Johnson County, GA",2007-2008,10107,10127,20,0.198,8,12,13,167,H1
"Johnson County, GA",2008-2009,10127,9990,-137,-1.353,24,-161,13,167,H1
"Johnson County, GA",2009-2010,9990,9973,-17,-0.17,20,-37,13,167,H1
"Johnson County, GA",2010-2011,9973,9918,-55,-0.551,-1,-54,13,167,H1
"Johnson County, GA",2011-2012,9918,9882,-36,-0.363,-10,-26,13,167,H1
"Johnson County, GA",2012-2013,9882,9776,-106,-1.073,-9,-97,13,167,H1
"Johnson County, GA",2013-2014,9776,9701,-75,-0.767,-10,-65,13,167,H1
"Johnson County, GA",2014-2015,9707,9656,-51,-0.525,-15,-36,13,167,H1
"Johnson County, GA",2015-2016,9656,9730,74,0.766,30,44,13,167,H1
"Johnson County, GA",2016-2017,9730,9788,58,0.596,-3,61,13,167,H1
"Jones County, GA",2000-2001,23762,24315,553,2.327,141,412,13,169,H1
"Jones County, GA",2001-2002,24315,24909,594,2.443,152,442,13,169,H1
"Jones County, GA",2002-2003,24909,25738,829,3.328,125,704,13,169,H1
"Jones County, GA",2003-2004,25738,26537,799,3.104,131,668,13,169,H1
"Jones County, GA",2004-2005,26537,27189,652,2.457,135,517,13,169,H1
"Jones County, GA",2005-2006,27189,27563,374,1.376,161,213,13,169,H1
"Jones County, GA",2006-2007,27563,2.80E+04,437,1.585,132,305,13,169,H1
"Jones County, GA",2007-2008,2.80E+04,28552,552,1.971,100,452,13,169,H1
"Jones County, GA",2008-2009,28552,28710,158,0.553,41,117,13,169,H1
"Jones County, GA",2009-2010,28710,28656,-54,-0.188,61,-115,13,169,H1
"Jones County, GA",2010-2011,28656,28910,254,0.886,88,166,13,169,H1
"Jones County, GA",2011-2012,28910,28795,-115,-0.398,55,-170,13,169,H1
"Jones County, GA",2012-2013,28795,28769,-26,-0.09,42,-68,13,169,H1
"Jones County, GA",2013-2014,28769,28787,18,0.063,4,14,13,169,H1
"Jones County, GA",2014-2015,28791,28494,-297,-1.032,-42,-255,13,169,H1
"Jones County, GA",2015-2016,28494,28553,59,0.207,24,35,13,169,H1
"Jones County, GA",2016-2017,28553,28470,-83,-0.291,-37,-46,13,169,H1
"Lamar County, GA",2000-2001,16024,16464,440,2.746,65,375,13,171,H1
"Lamar County, GA",2001-2002,16464,16289,-175,-1.063,18,-193,13,171,H1
"Lamar County, GA",2002-2003,16289,16470,181,1.111,33,148,13,171,H1
"Lamar County, GA",2003-2004,16470,16567,97,0.589,20,77,13,171,H1
"Lamar County, GA",2004-2005,16567,16961,394,2.378,49,345,13,171,H1
"Lamar County, GA",2005-2006,16961,17115,154,0.908,4,150,13,171,H1
"Lamar County, GA",2006-2007,17115,17476,361,2.109,19,342,13,171,H1
"Lamar County, GA",2007-2008,17476,18025,549,3.141,46,503,13,171,H1
"Lamar County, GA",2008-2009,18025,18233,208,1.154,42,166,13,171,H1
"Lamar County, GA",2009-2010,18233,18268,35,0.192,49,-14,13,171,H1
"Lamar County, GA",2010-2011,18268,18178,-90,-0.493,10,-100,13,171,H1
"Lamar County, GA",2011-2012,18178,18039,-139,-0.765,3,-142,13,171,H1
"Lamar County, GA",2012-2013,18039,17946,-93,-0.516,0,-93,13,171,H1
"Lamar County, GA",2013-2014,17946,18207,261,1.454,-19,280,13,171,H1
"Lamar County, GA",2014-2015,18212,18201,-11,-0.06,-32,21,13,171,H1
"Lamar County, GA",2015-2016,18201,18470,269,1.478,-1,270,13,171,H1
"Lamar County, GA",2016-2017,18470,18599,129,0.698,-8,137,13,171,H1
"Lanier County, GA",2000-2001,7283,7253,-30,-0.412,2,-32,13,173,H1
"Lanier County, GA",2001-2002,7253,7422,169,2.33,28,141,13,173,H1
"Lanier County, GA",2002-2003,7422,7748,326,4.392,53,273,13,173,H1
"Lanier County, GA",2003-2004,7748,7824,76,0.981,42,34,13,173,H1
"Lanier County, GA",2004-2005,7824,8068,244,3.119,45,199,13,173,H1
"Lanier County, GA",2005-2006,8068,8509,441,5.466,47,394,13,173,H1
"Lanier County, GA",2006-2007,8509,9013,504,5.923,72,432,13,173,H1
"Lanier County, GA",2007-2008,9013,9560,547,6.069,60,487,13,173,H1
"Lanier County, GA",2008-2009,9560,9810,250,2.615,38,212,13,173,H1
"Lanier County, GA",2009-2010,9810,10099,289,2.946,57,232,13,173,H1
"Lanier County, GA",2010-2011,10099,10468,369,3.654,58,311,13,173,H1
"Lanier County, GA",2011-2012,10468,10444,-24,-0.229,50,-74,13,173,H1
"Lanier County, GA",2012-2013,10444,10398,-46,-0.44,61,-107,13,173,H1
"Lanier County, GA",2013-2014,10398,10373,-25,-0.24,35,-60,13,173,H1
"Lanier County, GA",2014-2015,10390,10312,-78,-0.751,44,-122,13,173,H1
"Lanier County, GA",2015-2016,10312,10454,142,1.377,84,58,13,173,H1
"Lanier County, GA",2016-2017,10454,10425,-29,-0.277,27,-56,13,173,H1
"Laurens County, GA",2000-2001,44931,45123,192,0.427,222,-30,13,175,H1
"Laurens County, GA",2001-2002,45123,45634,511,1.132,216,295,13,175,H1
"Laurens County, GA",2002-2003,45634,46277,643,1.409,170,473,13,175,H1
"Laurens County, GA",2003-2004,46277,46329,52,0.112,155,-103,13,175,H1
"Laurens County, GA",2004-2005,46329,46751,422,0.911,215,207,13,175,H1
"Laurens County, GA",2005-2006,46751,47287,536,1.146,241,295,13,175,H1
"Laurens County, GA",2006-2007,47287,47649,362,0.766,289,73,13,175,H1
"Laurens County, GA",2007-2008,47649,48192,543,1.14,213,330,13,175,H1
"Laurens County, GA",2008-2009,48192,48601,409,0.849,179,230,13,175,H1
"Laurens County, GA",2009-2010,48601,48389,-212,-0.436,189,-401,13,175,H1
"Laurens County, GA",2010-2011,48389,48003,-386,-0.798,119,-505,13,175,H1
"Laurens County, GA",2011-2012,48003,47970,-33,-0.069,148,-181,13,175,H1
"Laurens County, GA",2012-2013,47970,47927,-43,-0.09,113,-156,13,175,H1
"Laurens County, GA",2013-2014,47927,47851,-76,-0.159,119,-195,13,175,H1
"Laurens County, GA",2014-2015,47777,47731,-46,-0.096,94,-140,13,175,H1
"Laurens County, GA",2015-2016,47731,47192,-539,-1.129,65,-604,13,175,H1
"Laurens County, GA",2016-2017,47192,47330,138,0.292,74,64,13,175,H1
"Lee County, GA",2000-2001,24808,24945,137,0.552,190,-53,13,177,H1
"Lee County, GA",2001-2002,24945,25115,170,0.681,212,-42,13,177,H1
"Lee County, GA",2002-2003,25115,25260,145,0.577,158,-13,13,177,H1
"Lee County, GA",2003-2004,25260,25965,705,2.791,193,512,13,177,H1
"Lee County, GA",2004-2005,25965,26505,540,2.08,196,344,13,177,H1
"Lee County, GA",2005-2006,26505,27365,860,3.245,174,686,13,177,H1
"Lee County, GA",2006-2007,27365,27792,427,1.56,191,236,13,177,H1
"Lee County, GA",2007-2008,27792,28111,319,1.148,219,100,13,177,H1
"Lee County, GA",2008-2009,28111,28326,215,0.765,214,1,13,177,H1
"Lee County, GA",2009-2010,28326,28431,105,0.371,187,-82,13,177,H1
"Lee County, GA",2010-2011,28431,28614,183,0.644,214,-31,13,177,H1
"Lee County, GA",2011-2012,28614,28727,113,0.395,206,-93,13,177,H1
"Lee County, GA",2012-2013,28727,29061,334,1.163,157,177,13,177,H1
"Lee County, GA",2013-2014,29061,29191,130,0.447,168,-38,13,177,H1
"Lee County, GA",2014-2015,29159,29202,43,0.147,140,-97,13,177,H1
"Lee County, GA",2015-2016,29202,29230,28,0.096,142,-114,13,177,H1
"Lee County, GA",2016-2017,29230,29470,240,0.821,102,138,13,177,H1
"Liberty County, GA",2000-2001,61811,61388,-423,-0.684,1150,-1573,13,179,H1
"Liberty County, GA",2001-2002,61388,62505,1117,1.82,1155,-38,13,179,H1
"Liberty County, GA",2002-2003,62505,60403,-2102,-3.363,1119,-3221,13,179,H1
"Liberty County, GA",2003-2004,60403,63254,2851,4.72,987,1864,13,179,H1
"Liberty County, GA",2004-2005,63254,64718,1464,2.314,1242,222,13,179,H1
"Liberty County, GA",2005-2006,64718,63047,-1671,-2.582,775,-2446,13,179,H1
"Liberty County, GA",2006-2007,63047,63708,661,1.048,1123,-462,13,179,H1
"Liberty County, GA",2007-2008,63708,62635,-1073,-1.684,1273,-2346,13,179,H1
"Liberty County, GA",2008-2009,62635,67061,4426,7.066,862,3564,13,179,H1
"Liberty County, GA",2009-2010,67061,62686,-4375,-6.524,1418,-5793,13,179,H1
"Liberty County, GA",2010-2011,62686,65115,2429,3.875,918,1511,13,179,H1
"Liberty County, GA",2011-2012,65115,65391,276,0.424,1386,-1110,13,179,H1
"Liberty County, GA",2012-2013,65391,64057,-1334,-2.04,1133,-2467,13,179,H1
"Liberty County, GA",2013-2014,64057,65198,1141,1.781,1154,-13,13,179,H1
"Liberty County, GA",2014-2015,65141,62467,-2674,-4.105,1145,-3819,13,179,H1
"Liberty County, GA",2015-2016,62467,61390,-1077,-1.724,1061,-2138,13,179,H1
"Liberty County, GA",2016-2017,61390,61386,-4,-0.007,1084,-1088,13,179,H1
"Lincoln County, GA",2000-2001,8335,8375,40,0.48,-11,51,13,181,H1
"Lincoln County, GA",2001-2002,8375,8375,0,0,-6,6,13,181,H1
"Lincoln County, GA",2002-2003,8375,8357,-18,-0.215,-25,7,13,181,H1
"Lincoln County, GA",2003-2004,8357,8284,-73,-0.874,-21,-52,13,181,H1
"Lincoln County, GA",2004-2005,8284,8274,-10,-0.121,18,-28,13,181,H1
"Lincoln County, GA",2005-2006,8274,8198,-76,-0.919,-26,-50,13,181,H1
"Lincoln County, GA",2006-2007,8198,8161,-37,-0.451,-8,-29,13,181,H1
"Lincoln County, GA",2007-2008,8161,8156,-5,-0.061,16,-21,13,181,H1
"Lincoln County, GA",2008-2009,8156,8073,-83,-1.018,-7,-76,13,181,H1
"Lincoln County, GA",2009-2010,8073,7991,-82,-1.016,-12,-70,13,181,H1
"Lincoln County, GA",2010-2011,7991,7898,-93,-1.164,-21,-72,13,181,H1
"Lincoln County, GA",2011-2012,7898,7770,-128,-1.621,-9,-119,13,181,H1
"Lincoln County, GA",2012-2013,7770,7719,-51,-0.656,-25,-26,13,181,H1
"Lincoln County, GA",2013-2014,7719,7622,-97,-1.257,-14,-83,13,181,H1
"Lincoln County, GA",2014-2015,7603,7673,70,0.921,-11,81,13,181,H1
"Lincoln County, GA",2015-2016,7673,7864,191,2.489,10,181,13,181,H1
"Lincoln County, GA",2016-2017,7864,7880,16,0.203,-7,23,13,181,H1
"Long County, GA",2000-2001,10370,10551,181,1.745,103,78,13,183,H1
"Long County, GA",2001-2002,10551,10894,343,3.251,101,242,13,183,H1
"Long County, GA",2002-2003,10894,10849,-45,-0.413,96,-141,13,183,H1
"Long County, GA",2003-2004,10849,11355,506,4.664,81,425,13,183,H1
"Long County, GA",2004-2005,11355,11677,322,2.836,123,199,13,183,H1
"Long County, GA",2005-2006,11677,12152,475,4.068,71,404,13,183,H1
"Long County, GA",2006-2007,12152,12381,229,1.884,100,129,13,183,H1
"Long County, GA",2007-2008,12381,12744,363,2.932,98,265,13,183,H1
"Long County, GA",2008-2009,12744,13787,1043,8.184,87,956,13,183,H1
"Long County, GA",2009-2010,13787,14679,892,6.47,94,798,13,183,H1
"Long County, GA",2010-2011,14679,15243,564,3.842,76,488,13,183,H1
"Long County, GA",2011-2012,15243,16161,918,6.022,158,760,13,183,H1
"Long County, GA",2012-2013,16161,16641,480,2.97,166,314,13,183,H1
"Long County, GA",2013-2014,16641,17113,472,2.836,127,345,13,183,H1
"Long County, GA",2014-2015,17176,17731,555,3.231,145,410,13,183,H1
"Long County, GA",2015-2016,17731,18594,863,4.867,190,673,13,183,H1
"Long County, GA",2016-2017,18594,19014,420,2.259,160,260,13,183,H1
"Lowndes County, GA",2000-2001,92206,92402,196,0.213,733,-537,13,185,H1
"Lowndes County, GA",2001-2002,92402,93903,1501,1.624,702,799,13,185,H1
"Lowndes County, GA",2002-2003,93903,94207,304,0.324,711,-407,13,185,H1
"Lowndes County, GA",2003-2004,94207,96510,2303,2.445,880,1423,13,185,H1
"Lowndes County, GA",2004-2005,96510,98273,1763,1.827,832,931,13,185,H1
"Lowndes County, GA",2005-2006,98273,100592,2319,2.36,991,1328,13,185,H1
"Lowndes County, GA",2006-2007,100592,101752,1160,1.153,1034,126,13,185,H1
"Lowndes County, GA",2007-2008,101752,104918,3166,3.111,1009,2157,13,185,H1
"Lowndes County, GA",2008-2009,104918,107583,2665,2.54,1037,1628,13,185,H1
"Lowndes County, GA",2009-2010,107583,109700,2117,1.968,1101,1016,13,185,H1
"Lowndes County, GA",2010-2011,109700,111882,2182,1.989,934,1248,13,185,H1
"Lowndes County, GA",2011-2012,111882,114668,2786,2.49,916,1870,13,185,H1
"Lowndes County, GA",2012-2013,114668,112802,-1866,-1.627,804,-2670,13,185,H1
"Lowndes County, GA",2013-2014,112802,113523,721,0.639,741,-20,13,185,H1
"Lowndes County, GA",2014-2015,113563,112865,-698,-0.615,794,-1492,13,185,H1
"Lowndes County, GA",2015-2016,112865,114306,1441,1.277,696,745,13,185,H1
"Lowndes County, GA",2016-2017,114306,115489,1183,1.035,713,470,13,185,H1
"Lumpkin County, GA",2000-2001,21251,22152,901,4.24,133,768,13,187,H1
"Lumpkin County, GA",2001-2002,22152,23048,896,4.045,159,737,13,187,H1
"Lumpkin County, GA",2002-2003,23048,24162,1114,4.833,153,961,13,187,H1
"Lumpkin County, GA",2003-2004,24162,24916,754,3.121,92,662,13,187,H1
"Lumpkin County, GA",2004-2005,24916,25884,968,3.885,164,804,13,187,H1
"Lumpkin County, GA",2005-2006,25884,27300,1416,5.471,87,1329,13,187,H1
"Lumpkin County, GA",2006-2007,27300,28228,928,3.399,130,798,13,187,H1
"Lumpkin County, GA",2007-2008,28228,29128,900,3.188,140,760,13,187,H1
"Lumpkin County, GA",2008-2009,29128,29723,595,2.043,103,492,13,187,H1
"Lumpkin County, GA",2009-2010,29723,30309,586,1.972,83,503,13,187,H1
"Lumpkin County, GA",2010-2011,30309,30482,173,0.571,84,89,13,187,H1
"Lumpkin County, GA",2011-2012,30482,30721,239,0.784,135,104,13,187,H1
"Lumpkin County, GA",2012-2013,30721,30908,187,0.609,67,120,13,187,H1
"Lumpkin County, GA",2013-2014,30908,31176,268,0.867,55,213,13,187,H1
"Lumpkin County, GA",2014-2015,31141,31408,267,0.857,15,252,13,187,H1
"Lumpkin County, GA",2015-2016,31408,31528,120,0.382,5,115,13,187,H1
"Lumpkin County, GA",2016-2017,31528,32873,1345,4.266,11,1334,13,187,H1
"McDuffie County, GA",2000-2001,21269,21323,54,0.254,105,-51,13,189,H1
"McDuffie County, GA",2001-2002,21323,21141,-182,-0.854,67,-249,13,189,H1
"McDuffie County, GA",2002-2003,21141,21155,14,0.066,10,4,13,189,H1
"McDuffie County, GA",2003-2004,21155,21256,101,0.477,101,0,13,189,H1
"McDuffie County, GA",2004-2005,21256,21419,163,0.767,97,66,13,189,H1
"McDuffie County, GA",2005-2006,21419,21564,145,0.677,112,33,13,189,H1
"McDuffie County, GA",2006-2007,21564,21527,-37,-0.172,94,-131,13,189,H1
"McDuffie County, GA",2007-2008,21527,21790,263,1.222,72,191,13,189,H1
"McDuffie County, GA",2008-2009,21790,21836,46,0.211,75,-29,13,189,H1
"McDuffie County, GA",2009-2010,21836,21822,-14,-0.064,72,-86,13,189,H1
"McDuffie County, GA",2010-2011,21822,21621,-201,-0.921,64,-265,13,189,H1
"McDuffie County, GA",2011-2012,21621,21581,-40,-0.185,50,-90,13,189,H1
"McDuffie County, GA",2012-2013,21581,21421,-160,-0.741,4,-164,13,189,H1
"McDuffie County, GA",2013-2014,21421,21370,-51,-0.238,37,-88,13,189,H1
"McDuffie County, GA",2014-2015,21535,21540,5,0.023,55,-50,13,189,H1
"McDuffie County, GA",2015-2016,21540,21456,-84,-0.39,75,-159,13,189,H1
"McDuffie County, GA",2016-2017,21456,21498,42,0.196,35,7,13,189,H1
"McIntosh County, GA",2000-2001,10948,11401,453,4.138,58,395,13,191,H1
"McIntosh County, GA",2001-2002,11401,11648,247,2.166,23,224,13,191,H1
"McIntosh County, GA",2002-2003,11648,11878,230,1.975,42,188,13,191,H1
"McIntosh County, GA",2003-2004,11878,12182,304,2.559,21,283,13,191,H1
"McIntosh County, GA",2004-2005,12182,12408,226,1.855,24,202,13,191,H1
"McIntosh County, GA",2005-2006,12408,12950,542,4.368,31,511,13,191,H1
"McIntosh County, GA",2006-2007,12950,13623,673,5.197,52,621,13,191,H1
"McIntosh County, GA",2007-2008,13623,13973,350,2.569,36,314,13,191,H1
"McIntosh County, GA",2008-2009,13973,14268,295,2.111,13,282,13,191,H1
"McIntosh County, GA",2009-2010,14268,14307,39,0.273,-3,42,13,191,H1
"McIntosh County, GA",2010-2011,14307,14237,-70,-0.489,10,-80,13,191,H1
"McIntosh County, GA",2011-2012,14237,13922,-315,-2.213,79,-394,13,191,H1
"McIntosh County, GA",2012-2013,13922,14180,258,1.853,121,137,13,191,H1
"McIntosh County, GA",2013-2014,14180,14214,34,0.24,27,7,13,191,H1
"McIntosh County, GA",2014-2015,14007,13969,-38,-0.271,8,-46,13,191,H1
"McIntosh County, GA",2015-2016,13969,14072,103,0.737,-10,113,13,191,H1
"McIntosh County, GA",2016-2017,14072,14106,34,0.242,-12,46,13,191,H1
"Macon County, GA",2000-2001,14025,14186,161,1.148,89,72,13,193,H1
"Macon County, GA",2001-2002,14186,14245,59,0.416,42,17,13,193,H1
"Macon County, GA",2002-2003,14245,14294,49,0.344,52,-3,13,193,H1
"Macon County, GA",2003-2004,14294,14304,10,0.07,39,-29,13,193,H1
"Macon County, GA",2004-2005,14304,14241,-63,-0.44,10,-73,13,193,H1
"Macon County, GA",2005-2006,14241,14364,123,0.864,7,116,13,193,H1
"Macon County, GA",2006-2007,14364,14402,38,0.265,-10,48,13,193,H1
"Macon County, GA",2007-2008,14402,14496,94,0.653,7,87,13,193,H1
"Macon County, GA",2008-2009,14496,14842,346,2.387,27,319,13,193,H1
"Macon County, GA",2009-2010,14842,14655,-187,-1.26,-13,-174,13,193,H1
"Macon County, GA",2010-2011,14655,14479,-176,-1.201,6,-182,13,193,H1
"Macon County, GA",2011-2012,14479,14274,-205,-1.416,-11,-194,13,193,H1
"Macon County, GA",2012-2013,14274,13961,-313,-2.193,-33,-280,13,193,H1
"Macon County, GA",2013-2014,13961,13792,-169,-1.211,-22,-147,13,193,H1
"Macon County, GA",2014-2015,13818,13632,-186,-1.346,-23,-163,13,193,H1
"Macon County, GA",2015-2016,13632,13520,-112,-0.822,-3,-109,13,193,H1
"Macon County, GA",2016-2017,13520,13314,-206,-1.524,-19,-187,13,193,H1
"Madison County, GA",2000-2001,25800,26046,246,0.953,120,126,13,195,H1
"Madison County, GA",2001-2002,26046,26512,466,1.789,119,347,13,195,H1
"Madison County, GA",2002-2003,26512,26857,345,1.301,140,205,13,195,H1
"Madison County, GA",2003-2004,26857,26859,2,0.007,64,-62,13,195,H1
"Madison County, GA",2004-2005,26859,27123,264,0.983,98,166,13,195,H1
"Madison County, GA",2005-2006,27123,27347,224,0.826,72,152,13,195,H1
"Madison County, GA",2006-2007,27347,27649,302,1.104,106,196,13,195,H1
"Madison County, GA",2007-2008,27649,27820,171,0.618,116,55,13,195,H1
"Madison County, GA",2008-2009,27820,28008,188,0.676,83,105,13,195,H1
"Madison County, GA",2009-2010,28008,28155,147,0.525,69,78,13,195,H1
"Madison County, GA",2010-2011,28155,28110,-45,-0.16,38,-83,13,195,H1
"Madison County, GA",2011-2012,28110,28018,-92,-0.327,16,-108,13,195,H1
"Madison County, GA",2012-2013,28018,28116,98,0.35,36,62,13,195,H1
"Madison County, GA",2013-2014,28116,28312,196,0.697,64,132,13,195,H1
"Madison County, GA",2014-2015,28388,28441,53,0.187,96,-43,13,195,H1
"Madison County, GA",2015-2016,28441,28827,386,1.357,88,298,13,195,H1
"Madison County, GA",2016-2017,28827,29302,475,1.648,79,396,13,195,H1
"Marion County, GA",2000-2001,7189,7322,133,1.85,22,111,13,197,H1
"Marion County, GA",2001-2002,7322,7400,78,1.065,27,51,13,197,H1
"Marion County, GA",2002-2003,7400,7521,121,1.635,-11,132,13,197,H1
"Marion County, GA",2003-2004,7521,7637,116,1.542,33,83,13,197,H1
"Marion County, GA",2004-2005,7637,7818,181,2.37,42,139,13,197,H1
"Marion County, GA",2005-2006,7818,8089,271,3.466,8,263,13,197,H1
"Marion County, GA",2006-2007,8089,8255,166,2.052,27,139,13,197,H1
"Marion County, GA",2007-2008,8255,8357,102,1.236,50,52,13,197,H1
"Marion County, GA",2008-2009,8357,8561,204,2.441,23,181,13,197,H1
"Marion County, GA",2009-2010,8561,8747,186,2.173,25,161,13,197,H1
"Marion County, GA",2010-2011,8747,8737,-10,-0.114,27,-37,13,197,H1
"Marion County, GA",2011-2012,8737,8751,14,0.16,34,-20,13,197,H1
"Marion County, GA",2012-2013,8751,8721,-30,-0.343,52,-82,13,197,H1
"Marion County, GA",2013-2014,8721,8797,76,0.871,10,66,13,197,H1
"Marion County, GA",2014-2015,8772,8761,-11,-0.125,3,-14,13,197,H1
"Marion County, GA",2015-2016,8761,8511,-250,-2.854,32,-282,13,197,H1
"Marion County, GA",2016-2017,8511,8450,-61,-0.717,4,-65,13,197,H1
"Meriwether County, GA",2000-2001,22526,22524,-2,-0.009,74,-76,13,199,H1
"Meriwether County, GA",2001-2002,22524,22726,202,0.897,88,114,13,199,H1
"Meriwether County, GA",2002-2003,22726,22615,-111,-0.488,52,-163,13,199,H1
"Meriwether County, GA",2003-2004,22615,22563,-52,-0.23,26,-78,13,199,H1
"Meriwether County, GA",2004-2005,22563,22587,24,0.106,46,-22,13,199,H1
"Meriwether County, GA",2005-2006,22587,22694,107,0.474,51,56,13,199,H1
"Meriwether County, GA",2006-2007,22694,22506,-188,-0.828,86,-274,13,199,H1
"Meriwether County, GA",2007-2008,22506,22632,126,0.56,83,43,13,199,H1
"Meriwether County, GA",2008-2009,22632,22446,-186,-0.822,23,-209,13,199,H1
"Meriwether County, GA",2009-2010,22446,21843,-603,-2.686,15,-618,13,199,H1
"Meriwether County, GA",2010-2011,21843,21606,-237,-1.085,-7,-230,13,199,H1
"Meriwether County, GA",2011-2012,21606,21316,-290,-1.342,55,-345,13,199,H1
"Meriwether County, GA",2012-2013,21316,21207,-109,-0.511,-31,-78,13,199,H1
"Meriwether County, GA",2013-2014,21207,21198,-9,-0.042,-21,12,13,199,H1
"Meriwether County, GA",2014-2015,21203,21190,-13,-0.061,3,-16,13,199,H1
"Meriwether County, GA",2015-2016,21190,21072,-118,-0.557,-46,-72,13,199,H1
"Meriwether County, GA",2016-2017,21072,21049,-23,-0.109,-23,0,13,199,H1
"Miller County, GA",2000-2001,6351,6372,21,0.331,27,-6,13,201,H1
"Miller County, GA",2001-2002,6372,6336,-36,-0.565,4,-40,13,201,H1
"Miller County, GA",2002-2003,6336,6206,-130,-2.052,-14,-116,13,201,H1
"Miller County, GA",2003-2004,6206,6135,-71,-1.144,-4,-67,13,201,H1
"Miller County, GA",2004-2005,6135,6096,-39,-0.636,8,-47,13,201,H1
"Miller County, GA",2005-2006,6096,6104,8,0.131,-5,13,13,201,H1
"Miller County, GA",2006-2007,6104,6124,20,0.328,20,0,13,201,H1
"Miller County, GA",2007-2008,6124,6158,34,0.555,18,16,13,201,H1
"Miller County, GA",2008-2009,6158,6131,-27,-0.438,12,-39,13,201,H1
"Miller County, GA",2009-2010,6131,6155,24,0.391,10,14,13,201,H1
"Miller County, GA",2010-2011,6155,6074,-81,-1.316,2,-83,13,201,H1
"Miller County, GA",2011-2012,6074,5982,-92,-1.515,2,-94,13,201,H1
"Miller County, GA",2012-2013,5982,5917,-65,-1.087,-17,-48,13,201,H1
"Miller County, GA",2013-2014,5917,5958,41,0.693,-12,53,13,201,H1
"Miller County, GA",2014-2015,5923,5854,-69,-1.165,-3,-66,13,201,H1
"Miller County, GA",2015-2016,5854,5881,27,0.461,-25,52,13,201,H1
"Miller County, GA",2016-2017,5881,5838,-43,-0.731,-16,-27,13,201,H1
"Mitchell County, GA",2000-2001,23965,23872,-93,-0.388,116,-209,13,205,H1
"Mitchell County, GA",2001-2002,23872,23698,-174,-0.729,64,-238,13,205,H1
"Mitchell County, GA",2002-2003,23698,23594,-104,-0.439,97,-201,13,205,H1
"Mitchell County, GA",2003-2004,23594,23520,-74,-0.314,87,-161,13,205,H1
"Mitchell County, GA",2004-2005,23520,23363,-157,-0.668,110,-267,13,205,H1
"Mitchell County, GA",2005-2006,23363,23579,216,0.925,165,51,13,205,H1
"Mitchell County, GA",2006-2007,23579,23974,395,1.675,145,250,13,205,H1
"Mitchell County, GA",2007-2008,23974,23840,-134,-0.559,106,-240,13,205,H1
"Mitchell County, GA",2008-2009,23840,23592,-248,-1.04,72,-320,13,205,H1
"Mitchell County, GA",2009-2010,23592,23509,-83,-0.352,56,-139,13,205,H1
"Mitchell County, GA",2010-2011,23509,23445,-64,-0.272,68,-132,13,205,H1
"Mitchell County, GA",2011-2012,23445,23121,-324,-1.382,73,-397,13,205,H1
"Mitchell County, GA",2012-2013,23121,23027,-94,-0.407,40,-134,13,205,H1
"Mitchell County, GA",2013-2014,23027,22771,-256,-1.112,33,-289,13,205,H1
"Mitchell County, GA",2014-2015,22778,22574,-204,-0.896,37,-241,13,205,H1
"Mitchell County, GA",2015-2016,22574,22411,-163,-0.722,16,-179,13,205,H1
"Mitchell County, GA",2016-2017,22411,22292,-119,-0.531,25,-144,13,205,H1
"Monroe County, GA",2000-2001,21824,22092,268,1.228,86,182,13,207,H1
"Monroe County, GA",2001-2002,22092,22767,675,3.055,64,611,13,207,H1
"Monroe County, GA",2002-2003,22767,23499,732,3.215,108,624,13,207,H1
"Monroe County, GA",2003-2004,23499,23648,149,0.634,50,99,13,207,H1
"Monroe County, GA",2004-2005,23648,24080,432,1.827,68,364,13,207,H1
"Monroe County, GA",2005-2006,24080,24924,844,3.505,61,783,13,207,H1
"Monroe County, GA",2006-2007,24924,25726,802,3.218,50,752,13,207,H1
"Monroe County, GA",2007-2008,25726,25969,243,0.945,46,197,13,207,H1
"Monroe County, GA",2008-2009,25969,26233,264,1.017,55,209,13,207,H1
"Monroe County, GA",2009-2010,26233,26469,236,0.9,25,211,13,207,H1
"Monroe County, GA",2010-2011,26469,26673,204,0.771,36,168,13,207,H1
"Monroe County, GA",2011-2012,26673,26741,68,0.255,70,-2,13,207,H1
"Monroe County, GA",2012-2013,26741,27005,264,0.987,-1,265,13,207,H1
"Monroe County, GA",2013-2014,27005,27051,46,0.17,-34,80,13,207,H1
"Monroe County, GA",2014-2015,27056,27103,47,0.174,-46,93,13,207,H1
"Monroe County, GA",2015-2016,27103,26879,-224,-0.826,-23,-201,13,207,H1
"Monroe County, GA",2016-2017,26879,27113,234,0.871,-51,285,13,207,H1
"Montgomery County, GA",2000-2001,8234,8505,271,3.291,38,233,13,209,H1
"Montgomery County, GA",2001-2002,8505,8532,27,0.317,37,-10,13,209,H1
"Montgomery County, GA",2002-2003,8532,8805,273,3.2,44,229,13,209,H1
"Montgomery County, GA",2003-2004,8805,9040,235,2.669,35,200,13,209,H1
"Montgomery County, GA",2004-2005,9040,8997,-43,-0.476,33,-76,13,209,H1
"Montgomery County, GA",2005-2006,8997,9165,168,1.867,15,153,13,209,H1
"Montgomery County, GA",2006-2007,9165,9175,10,0.109,40,-30,13,209,H1
"Montgomery County, GA",2007-2008,9175,9100,-75,-0.817,59,-134,13,209,H1
"Montgomery County, GA",2008-2009,9100,9136,36,0.396,41,-5,13,209,H1
"Montgomery County, GA",2009-2010,9136,9088,-48,-0.525,42,-90,13,209,H1
"Montgomery County, GA",2010-2011,9088,9039,-49,-0.539,26,-75,13,209,H1
"Montgomery County, GA",2011-2012,9039,8909,-130,-1.438,28,-158,13,209,H1
"Montgomery County, GA",2012-2013,8909,8973,64,0.718,40,24,13,209,H1
"Montgomery County, GA",2013-2014,8973,8991,18,0.201,30,-12,13,209,H1
"Montgomery County, GA",2014-2015,8975,8951,-24,-0.267,16,-40,13,209,H1
"Montgomery County, GA",2015-2016,8951,8983,32,0.358,43,-11,13,209,H1
"Montgomery County, GA",2016-2017,8983,9031,48,0.534,10,38,13,209,H1
"Morgan County, GA",2000-2001,15531,15951,420,2.704,97,323,13,211,H1
"Morgan County, GA",2001-2002,15951,16244,293,1.837,71,222,13,211,H1
"Morgan County, GA",2002-2003,16244,16397,153,0.942,70,83,13,211,H1
"Morgan County, GA",2003-2004,16397,16604,207,1.262,85,122,13,211,H1
"Morgan County, GA",2004-2005,16604,16925,321,1.933,76,245,13,211,H1
"Morgan County, GA",2005-2006,16925,17316,391,2.31,52,339,13,211,H1
"Morgan County, GA",2006-2007,17316,17648,332,1.917,48,284,13,211,H1
"Morgan County, GA",2007-2008,17648,17958,310,1.757,71,239,13,211,H1
"Morgan County, GA",2008-2009,17958,17921,-37,-0.206,87,-124,13,211,H1
"Morgan County, GA",2009-2010,17921,17895,-26,-0.145,57,-83,13,211,H1
"Morgan County, GA",2010-2011,17895,17906,11,0.061,3,8,13,211,H1
"Morgan County, GA",2011-2012,17906,17823,-83,-0.464,14,-97,13,211,H1
"Morgan County, GA",2012-2013,17823,17752,-71,-0.398,6,-77,13,211,H1
"Morgan County, GA",2013-2014,17752,17956,204,1.149,13,191,13,211,H1
"Morgan County, GA",2014-2015,17981,18046,65,0.361,38,27,13,211,H1
"Morgan County, GA",2015-2016,18046,18121,75,0.416,21,54,13,211,H1
"Morgan County, GA",2016-2017,18121,18412,291,1.606,47,244,13,211,H1
"Murray County, GA",2000-2001,36737,37683,946,2.575,305,641,13,213,H1
"Murray County, GA",2001-2002,37683,38167,484,1.284,362,122,13,213,H1
"Murray County, GA",2002-2003,38167,38998,831,2.177,400,431,13,213,H1
"Murray County, GA",2003-2004,38998,39465,467,1.197,292,175,13,213,H1
"Murray County, GA",2004-2005,39465,39723,258,0.654,394,-136,13,213,H1
"Murray County, GA",2005-2006,39723,40173,450,1.133,378,72,13,213,H1
"Murray County, GA",2006-2007,40173,40138,-35,-0.087,373,-408,13,213,H1
"Murray County, GA",2007-2008,40138,39869,-269,-0.67,332,-601,13,213,H1
"Murray County, GA",2008-2009,39869,39888,19,0.048,277,-258,13,213,H1
"Murray County, GA",2009-2010,39888,39548,-340,-0.852,261,-601,13,213,H1
"Murray County, GA",2010-2011,39548,39428,-120,-0.303,152,-272,13,213,H1
"Murray County, GA",2011-2012,39428,39394,-34,-0.086,160,-194,13,213,H1
"Murray County, GA",2012-2013,39394,39298,-96,-0.244,132,-228,13,213,H1
"Murray County, GA",2013-2014,39298,39410,112,0.285,98,14,13,213,H1
"Murray County, GA",2014-2015,39375,39565,190,0.483,126,64,13,213,H1
"Murray County, GA",2015-2016,39565,39376,-189,-0.478,97,-286,13,213,H1
"Murray County, GA",2016-2017,39376,39782,406,1.031,53,353,13,213,H1
"Muscogee County, GA",2000-2001,186478,186375,-103,-0.055,1276,-1379,13,215,H6
"Muscogee County, GA",2001-2002,186375,185139,-1236,-0.663,1066,-2302,13,215,H6
"Muscogee County, GA",2002-2003,185139,180838,-4301,-2.323,1124,-5425,13,215,H6
"Muscogee County, GA",2003-2004,180838,185057,4219,2.333,1259,2960,13,215,H6
"Muscogee County, GA",2004-2005,185057,186543,1486,0.803,1259,227,13,215,H6
"Muscogee County, GA",2005-2006,186543,189464,2921,1.566,1136,1785,13,215,H6
"Muscogee County, GA",2006-2007,189464,184704,-4760,-2.512,1397,-6157,13,215,H6
"Muscogee County, GA",2007-2008,184704,184763,59,0.032,1414,-1355,13,215,H6
"Muscogee County, GA",2008-2009,184763,188796,4033,2.183,1209,2824,13,215,H6
"Muscogee County, GA",2009-2010,188796,191082,2286,1.211,1611,675,13,215,H6
"Muscogee County, GA",2010-2011,191082,195272,4190,2.193,1258,2932,13,215,H6
"Muscogee County, GA",2011-2012,195272,200041,4769,2.442,1579,3190,13,215,H6
"Muscogee County, GA",2012-2013,200041,203952,3911,1.955,1364,2547,13,215,H6
"Muscogee County, GA",2013-2014,203952,200887,-3065,-1.503,1448,-4513,13,215,H6
"Muscogee County, GA",2014-2015,201087,200579,-508,-0.253,1280,-1788,13,215,H6
"Muscogee County, GA",2015-2016,200579,196307,-4272,-2.13,999,-5271,13,215,H6
"Muscogee County, GA",2016-2017,196307,194058,-2249,-1.146,899,-3148,13,215,H6
"Newton County, GA",2000-2001,62768,66823,4055,6.46,658,3397,13,217,H1
"Newton County, GA",2001-2002,66823,71102,4279,6.403,664,3615,13,217,H1
"Newton County, GA",2002-2003,71102,75610,4508,6.34,782,3726,13,217,H1
"Newton County, GA",2003-2004,75610,80603,4993,6.604,881,4112,13,217,H1
"Newton County, GA",2004-2005,80603,85647,5044,6.258,822,4222,13,217,H1
"Newton County, GA",2005-2006,85647,90647,5.00E+03,5.838,930,4070,13,217,H1
"Newton County, GA",2006-2007,90647,95699,5052,5.573,936,4116,13,217,H1
"Newton County, GA",2007-2008,95699,98240,2541,2.655,940,1601,13,217,H1
"Newton County, GA",2008-2009,98240,99494,1254,1.276,962,292,13,217,H1
"Newton County, GA",2009-2010,99494,100160,666,0.669,701,-35,13,217,H1
"Newton County, GA",2010-2011,100160,100464,304,0.304,646,-342,13,217,H1
"Newton County, GA",2011-2012,100464,101016,552,0.549,583,-31,13,217,H1
"Newton County, GA",2012-2013,101016,102201,1185,1.173,473,712,13,217,H1
"Newton County, GA",2013-2014,102201,103675,1474,1.442,511,963,13,217,H1
"Newton County, GA",2014-2015,103839,105473,1634,1.574,552,1082,13,217,H1
"Newton County, GA",2015-2016,105473,106580,1107,1.05,555,552,13,217,H1
"Newton County, GA",2016-2017,106580,108078,1498,1.406,557,941,13,217,H1
"Oconee County, GA",2000-2001,25874,26135,261,1.009,163,98,13,219,H1
"Oconee County, GA",2001-2002,26135,26501,366,1.4,168,198,13,219,H1
"Oconee County, GA",2002-2003,26501,27334,833,3.143,183,650,13,219,H1
"Oconee County, GA",2003-2004,27334,27904,570,2.085,161,409,13,219,H1
"Oconee County, GA",2004-2005,27904,28616,712,2.552,211,501,13,219,H1
"Oconee County, GA",2005-2006,28616,29720,1104,3.858,139,965,13,219,H1
"Oconee County, GA",2006-2007,29720,30755,1035,3.483,187,848,13,219,H1
"Oconee County, GA",2007-2008,30755,31697,942,3.063,224,718,13,219,H1
"Oconee County, GA",2008-2009,31697,32386,689,2.174,210,479,13,219,H1
"Oconee County, GA",2009-2010,32386,32927,541,1.67,118,423,13,219,H1
"Oconee County, GA",2010-2011,32927,33255,328,0.996,98,230,13,219,H1
"Oconee County, GA",2011-2012,33255,33520,265,0.797,118,147,13,219,H1
"Oconee County, GA",2012-2013,33520,34050,530,1.581,108,422,13,219,H1
"Oconee County, GA",2013-2014,34050,35093,1043,3.063,125,918,13,219,H1
"Oconee County, GA",2014-2015,35147,35965,818,2.327,113,705,13,219,H1
"Oconee County, GA",2015-2016,35965,36866,901,2.505,115,786,13,219,H1
"Oconee County, GA",2016-2017,36866,38028,1162,3.152,131,1031,13,219,H1
"Oglethorpe County, GA",2000-2001,12688,12902,214,1.687,43,171,13,221,H1
"Oglethorpe County, GA",2001-2002,12902,13152,250,1.938,53,197,13,221,H1
"Oglethorpe County, GA",2002-2003,13152,13369,217,1.65,60,157,13,221,H1
"Oglethorpe County, GA",2003-2004,13369,13591,222,1.661,46,176,13,221,H1
"Oglethorpe County, GA",2004-2005,13591,13699,108,0.795,68,40,13,221,H1
"Oglethorpe County, GA",2005-2006,13699,14030,331,2.416,20,311,13,221,H1
"Oglethorpe County, GA",2006-2007,14030,14382,352,2.509,26,326,13,221,H1
"Oglethorpe County, GA",2007-2008,14382,14663,281,1.954,44,237,13,221,H1
"Oglethorpe County, GA",2008-2009,14663,14784,121,0.825,43,78,13,221,H1
"Oglethorpe County, GA",2009-2010,14784,14910,126,0.852,35,91,13,221,H1
"Oglethorpe County, GA",2010-2011,14910,14784,-126,-0.845,31,-157,13,221,H1
"Oglethorpe County, GA",2011-2012,14784,14597,-187,-1.265,27,-214,13,221,H1
"Oglethorpe County, GA",2012-2013,14597,14512,-85,-0.582,19,-104,13,221,H1
"Oglethorpe County, GA",2013-2014,14512,14673,161,1.109,18,143,13,221,H1
"Oglethorpe County, GA",2014-2015,14680,14871,191,1.301,23,168,13,221,H1
"Oglethorpe County, GA",2015-2016,14871,14710,-161,-1.083,17,-178,13,221,H1
"Oglethorpe County, GA",2016-2017,14710,14877,167,1.135,4,163,13,221,H1
"Paulding County, GA",2000-2001,83026,88910,5884,7.087,1149,4735,13,223,H1
"Paulding County, GA",2001-2002,88910,94561,5651,6.356,1227,4424,13,223,H1
"Paulding County, GA",2002-2003,94561,100340,5779,6.111,1333,4446,13,223,H1
"Paulding County, GA",2003-2004,100340,106350,6010,5.99,1238,4772,13,223,H1
"Paulding County, GA",2004-2005,106350,113132,6782,6.377,1357,5425,13,223,H1
"Paulding County, GA",2005-2006,113132,122635,9503,8.4,1354,8149,13,223,H1
"Paulding County, GA",2006-2007,122635,131172,8537,6.961,1469,7068,13,223,H1
"Paulding County, GA",2007-2008,131172,137066,5894,4.493,1538,4356,13,223,H1
"Paulding County, GA",2008-2009,137066,140761,3695,2.696,1432,2263,13,223,H1
"Paulding County, GA",2009-2010,140761,142763,2002,1.422,1186,816,13,223,H1
"Paulding County, GA",2010-2011,142763,143829,1066,0.747,1167,-101,13,223,H1
"Paulding County, GA",2011-2012,143829,145066,1237,0.86,1178,59,13,223,H1
"Paulding County, GA",2012-2013,145066,147181,2115,1.458,1008,1107,13,223,H1
"Paulding County, GA",2013-2014,147181,148987,1806,1.227,941,865,13,223,H1
"Paulding County, GA",2014-2015,148921,152238,3317,2.227,922,2395,13,223,H1
"Paulding County, GA",2015-2016,152238,155374,3136,2.06,973,2163,13,223,H1
"Paulding County, GA",2016-2017,155374,159445,4071,2.62,802,3269,13,223,H1
"Peach County, GA",2000-2001,23871,24063,192,0.804,138,54,13,225,H1
"Peach County, GA",2001-2002,24063,24348,285,1.184,172,113,13,225,H1
"Peach County, GA",2002-2003,24348,24595,247,1.014,92,155,13,225,H1
"Peach County, GA",2003-2004,24595,24818,223,0.907,108,115,13,225,H1
"Peach County, GA",2004-2005,24818,24756,-62,-0.25,88,-150,13,225,H1
"Peach County, GA",2005-2006,24756,25510,754,3.046,147,607,13,225,H1
"Peach County, GA",2006-2007,25510,26467,957,3.751,143,814,13,225,H1
"Peach County, GA",2007-2008,26467,27222,755,2.853,181,574,13,225,H1
"Peach County, GA",2008-2009,27222,27474,252,0.926,229,23,13,225,H1
"Peach County, GA",2009-2010,27474,27772,298,1.085,139,159,13,225,H1
"Peach County, GA",2010-2011,27772,27577,-195,-0.702,83,-278,13,225,H1
"Peach County, GA",2011-2012,27577,27510,-67,-0.243,92,-159,13,225,H1
"Peach County, GA",2012-2013,27510,26905,-605,-2.199,64,-669,13,225,H1
"Peach County, GA",2013-2014,26905,26922,17,0.063,120,-103,13,225,H1
"Peach County, GA",2014-2015,26828,26720,-108,-0.403,108,-216,13,225,H1
"Peach County, GA",2015-2016,26720,26899,179,0.67,2,177,13,225,H1
"Peach County, GA",2016-2017,26899,27099,200,0.744,56,144,13,225,H1
"Pickens County, GA",2000-2001,23412,24334,922,3.938,124,798,13,227,H1
"Pickens County, GA",2001-2002,24334,25258,924,3.797,126,798,13,227,H1
"Pickens County, GA",2002-2003,25258,26209,951,3.765,119,832,13,227,H1
"Pickens County, GA",2003-2004,26209,26810,601,2.293,111,490,13,227,H1
"Pickens County, GA",2004-2005,26810,27277,467,1.742,87,380,13,227,H1
"Pickens County, GA",2005-2006,27277,28169,892,3.27,93,799,13,227,H1
"Pickens County, GA",2006-2007,28169,29095,926,3.287,84,842,13,227,H1
"Pickens County, GA",2007-2008,29095,29531,436,1.499,81,355,13,227,H1
"Pickens County, GA",2008-2009,29531,29542,11,0.037,65,-54,13,227,H1
"Pickens County, GA",2009-2010,29542,29458,-84,-0.284,1,-85,13,227,H1
"Pickens County, GA",2010-2011,29458,29468,10,0.034,18,-8,13,227,H1
"Pickens County, GA",2011-2012,29468,29316,-152,-0.516,-3,-149,13,227,H1
"Pickens County, GA",2012-2013,29316,29509,193,0.658,-15,208,13,227,H1
"Pickens County, GA",2013-2014,29509,29997,488,1.654,-23,511,13,227,H1
"Pickens County, GA",2014-2015,30046,30309,263,0.875,-25,288,13,227,H1
"Pickens County, GA",2015-2016,30309,30695,386,1.274,-40,426,13,227,H1
"Pickens County, GA",2016-2017,30695,31588,893,2.909,-56,949,13,227,H1
"Pierce County, GA",2000-2001,15702,15811,109,0.694,78,31,13,229,H1
"Pierce County, GA",2001-2002,15811,15995,184,1.164,39,145,13,229,H1
"Pierce County, GA",2002-2003,15995,16278,283,1.769,71,212,13,229,H1
"Pierce County, GA",2003-2004,16278,16755,477,2.93,47,430,13,229,H1
"Pierce County, GA",2004-2005,16755,17179,424,2.531,104,320,13,229,H1
"Pierce County, GA",2005-2006,17179,17502,323,1.88,101,222,13,229,H1
"Pierce County, GA",2006-2007,17502,17933,431,2.463,81,350,13,229,H1
"Pierce County, GA",2007-2008,17933,18210,277,1.545,109,168,13,229,H1
"Pierce County, GA",2008-2009,18210,18564,354,1.944,112,242,13,229,H1
"Pierce County, GA",2009-2010,18564,18802,238,1.282,75,163,13,229,H1
"Pierce County, GA",2010-2011,18802,18723,-79,-0.42,47,-126,13,229,H1
"Pierce County, GA",2011-2012,18723,18835,112,0.598,45,67,13,229,H1
"Pierce County, GA",2012-2013,18835,18948,113,0.6,59,54,13,229,H1
"Pierce County, GA",2013-2014,18948,18991,43,0.227,50,-7,13,229,H1
"Pierce County, GA",2014-2015,19001,19103,102,0.537,52,50,13,229,H1
"Pierce County, GA",2015-2016,19103,19218,115,0.602,73,42,13,229,H1
"Pierce County, GA",2016-2017,19218,19307,89,0.463,45,44,13,229,H1
"Pike County, GA",2000-2001,13571,13834,263,1.938,46,217,13,231,H1
"Pike County, GA",2001-2002,13834,14445,611,4.417,80,531,13,231,H1
"Pike County, GA",2002-2003,14445,14881,436,3.018,61,375,13,231,H1
"Pike County, GA",2003-2004,14881,15474,593,3.985,53,540,13,231,H1
"Pike County, GA",2004-2005,15474,15908,434,2.805,38,396,13,231,H1
"Pike County, GA",2005-2006,15908,16590,682,4.287,57,625,13,231,H1
"Pike County, GA",2006-2007,16590,17220,630,3.797,62,568,13,231,H1
"Pike County, GA",2007-2008,17220,17619,399,2.317,67,332,13,231,H1
"Pike County, GA",2008-2009,17619,17721,102,0.579,96,6,13,231,H1
"Pike County, GA",2009-2010,17721,17918,197,1.112,45,152,13,231,H1
"Pike County, GA",2010-2011,17918,17802,-116,-0.647,19,-135,13,231,H1
"Pike County, GA",2011-2012,17802,17804,2,0.011,-15,17,13,231,H1
"Pike County, GA",2012-2013,17804,17796,-8,-0.045,16,-24,13,231,H1
"Pike County, GA",2013-2014,17796,17784,-12,-0.067,12,-24,13,231,H1
"Pike County, GA",2014-2015,17760,17941,181,1.019,13,168,13,231,H1
"Pike County, GA",2015-2016,17941,17923,-18,-0.1,17,-35,13,231,H1
"Pike County, GA",2016-2017,17923,18217,294,1.64,-17,311,13,231,H1
"Polk County, GA",2000-2001,38178,38612,434,1.137,220,214,13,233,H1
"Polk County, GA",2001-2002,38612,39109,497,1.287,311,186,13,233,H1
"Polk County, GA",2002-2003,39109,39246,137,0.35,197,-60,13,233,H1
"Polk County, GA",2003-2004,39246,39564,318,0.81,186,132,13,233,H1
"Polk County, GA",2004-2005,39564,39860,296,0.748,230,66,13,233,H1
"Polk County, GA",2005-2006,39860,40372,512,1.284,269,243,13,233,H1
"Polk County, GA",2006-2007,40372,40789,417,1.033,268,149,13,233,H1
"Polk County, GA",2007-2008,40789,41407,618,1.515,294,324,13,233,H1
"Polk County, GA",2008-2009,41407,41386,-21,-0.051,258,-279,13,233,H1
"Polk County, GA",2009-2010,41386,41532,146,0.353,233,-87,13,233,H1
"Polk County, GA",2010-2011,41532,41283,-249,-0.6,139,-388,13,233,H1
"Polk County, GA",2011-2012,41283,41127,-156,-0.378,111,-267,13,233,H1
"Polk County, GA",2012-2013,41127,41177,50,0.122,114,-64,13,233,H1
"Polk County, GA",2013-2014,41177,41133,-44,-0.107,114,-158,13,233,H1
"Polk County, GA",2014-2015,41042,41524,482,1.174,94,388,13,233,H1
"Polk County, GA",2015-2016,41524,41730,206,0.496,61,145,13,233,H1
"Polk County, GA",2016-2017,41730,42085,355,0.851,76,279,13,233,H1
"Pulaski County, GA",2000-2001,9655,9882,227,2.351,32,195,13,235,H1
"Pulaski County, GA",2001-2002,9882,10168,286,2.894,26,260,13,235,H1
"Pulaski County, GA",2002-2003,10168,10351,183,1.8,-3,186,13,235,H1
"Pulaski County, GA",2003-2004,10351,10646,295,2.85,-18,313,13,235,H1
"Pulaski County, GA",2004-2005,10646,10890,244,2.292,4,240,13,235,H1
"Pulaski County, GA",2005-2006,10890,11183,293,2.691,-5,298,13,235,H1
"Pulaski County, GA",2006-2007,11183,11445,262,2.343,-3,265,13,235,H1
"Pulaski County, GA",2007-2008,11445,11638,193,1.686,12,181,13,235,H1
"Pulaski County, GA",2008-2009,11638,11903,265,2.277,22,243,13,235,H1
"Pulaski County, GA",2009-2010,11903,11919,16,0.134,17,-1,13,235,H1
"Pulaski County, GA",2010-2011,11919,11851,-68,-0.571,-30,-38,13,235,H1
"Pulaski County, GA",2011-2012,11851,11680,-171,-1.443,0,-171,13,235,H1
"Pulaski County, GA",2012-2013,11680,11531,-149,-1.276,1,-150,13,235,H1
"Pulaski County, GA",2013-2014,11531,11483,-48,-0.416,-31,-17,13,235,H1
"Pulaski County, GA",2014-2015,11478,11396,-82,-0.714,-10,-72,13,235,H1
"Pulaski County, GA",2015-2016,11396,11307,-89,-0.781,-20,-69,13,235,H1
"Pulaski County, GA",2016-2017,11307,11201,-106,-0.937,-42,-64,13,235,H1
"Putnam County, GA",2000-2001,18834,19152,318,1.688,104,214,13,237,H1
"Putnam County, GA",2001-2002,19152,19366,214,1.117,52,162,13,237,H1
"Putnam County, GA",2002-2003,19366,19494,128,0.661,60,68,13,237,H1
"Putnam County, GA",2003-2004,19494,19810,316,1.621,56,260,13,237,H1
"Putnam County, GA",2004-2005,19810,20012,202,1.02,87,115,13,237,H1
"Putnam County, GA",2005-2006,20012,20368,356,1.779,84,272,13,237,H1
"Putnam County, GA",2006-2007,20368,20800,432,2.121,82,350,13,237,H1
"Putnam County, GA",2007-2008,20800,21075,275,1.322,74,201,13,237,H1
"Putnam County, GA",2008-2009,21075,21179,104,0.493,65,39,13,237,H1
"Putnam County, GA",2009-2010,21179,21208,29,0.137,76,-47,13,237,H1
"Putnam County, GA",2010-2011,21208,21261,53,0.25,50,3,13,237,H1
"Putnam County, GA",2011-2012,21261,21161,-100,-0.47,49,-149,13,237,H1
"Putnam County, GA",2012-2013,21161,21310,149,0.704,10,139,13,237,H1
"Putnam County, GA",2013-2014,21310,21192,-118,-0.554,-5,-113,13,237,H1
"Putnam County, GA",2014-2015,21173,21353,180,0.85,-22,202,13,237,H1
"Putnam County, GA",2015-2016,21353,21548,195,0.913,-34,229,13,237,H1
"Putnam County, GA",2016-2017,21548,21730,182,0.845,-25,207,13,237,H1
"Quitman County, GA",2000-2001,2596,2607,11,0.424,6,5,13,239,H1
"Quitman County, GA",2001-2002,2607,2547,-60,-2.301,3,-63,13,239,H1
"Quitman County, GA",2002-2003,2547,2478,-69,-2.709,11,-80,13,239,H1
"Quitman County, GA",2003-2004,2478,2457,-21,-0.847,-15,-6,13,239,H1
"Quitman County, GA",2004-2005,2457,2519,62,2.523,-11,73,13,239,H1
"Quitman County, GA",2005-2006,2519,2545,26,1.032,1,25,13,239,H1
"Quitman County, GA",2006-2007,2545,2529,-16,-0.629,6,-22,13,239,H1
"Quitman County, GA",2007-2008,2529,2547,18,0.712,19,-1,13,239,H1
"Quitman County, GA",2008-2009,2547,2497,-50,-1.963,26,-76,13,239,H1
"Quitman County, GA",2009-2010,2497,2505,8,0.32,12,-4,13,239,H1
"Quitman County, GA",2010-2011,2505,2459,-46,-1.836,7,-53,13,239,H1
"Quitman County, GA",2011-2012,2459,2398,-61,-2.481,-18,-43,13,239,H1
"Quitman County, GA",2012-2013,2398,2366,-32,-1.334,-4,-28,13,239,H1
"Quitman County, GA",2013-2014,2366,2315,-51,-2.156,13,-64,13,239,H1
"Quitman County, GA",2014-2015,2303,2302,-1,-0.043,-12,11,13,239,H1
"Quitman County, GA",2015-2016,2302,2333,31,1.347,10,21,13,239,H1
"Quitman County, GA",2016-2017,2333,2358,25,1.072,12,13,13,239,H1
"Rabun County, GA",2000-2001,15070,15310,240,1.593,16,224,13,241,H1
"Rabun County, GA",2001-2002,15310,15458,148,0.967,0,148,13,241,H1
"Rabun County, GA",2002-2003,15458,15691,233,1.507,25,208,13,241,H1
"Rabun County, GA",2003-2004,15691,15757,66,0.421,13,53,13,241,H1
"Rabun County, GA",2004-2005,15757,15934,177,1.123,33,144,13,241,H1
"Rabun County, GA",2005-2006,15934,16090,156,0.979,-13,169,13,241,H1
"Rabun County, GA",2006-2007,16090,16306,216,1.342,0,216,13,241,H1
"Rabun County, GA",2007-2008,16306,16359,53,0.325,27,26,13,241,H1
"Rabun County, GA",2008-2009,16359,16295,-64,-0.391,15,-79,13,241,H1
"Rabun County, GA",2009-2010,16295,16258,-37,-0.227,0,-37,13,241,H1
"Rabun County, GA",2010-2011,16258,16279,21,0.129,-33,54,13,241,H1
"Rabun County, GA",2011-2012,16279,16307,28,0.172,-20,48,13,241,H1
"Rabun County, GA",2012-2013,16307,16247,-60,-0.368,-68,8,13,241,H1
"Rabun County, GA",2013-2014,16247,16243,-4,-0.025,-62,58,13,241,H1
"Rabun County, GA",2014-2015,16230,16281,51,0.314,-45,96,13,241,H1
"Rabun County, GA",2015-2016,16281,16528,247,1.517,-52,299,13,241,H1
"Rabun County, GA",2016-2017,16528,16602,74,0.448,-60,134,13,241,H1
"Randolph County, GA",2000-2001,7773,7786,13,0.167,-24,37,13,243,H1
"Randolph County, GA",2001-2002,7786,7747,-39,-0.501,-23,-16,13,243,H1
"Randolph County, GA",2002-2003,7747,7699,-48,-0.62,-14,-34,13,243,H1
"Randolph County, GA",2003-2004,7699,7726,27,0.351,4,23,13,243,H1
"Randolph County, GA",2004-2005,7726,7707,-19,-0.246,1,-20,13,243,H1
"Randolph County, GA",2005-2006,7707,7786,79,1.025,27,52,13,243,H1
"Randolph County, GA",2006-2007,7786,7758,-28,-0.36,11,-39,13,243,H1
"Randolph County, GA",2007-2008,7758,7645,-113,-1.457,26,-139,13,243,H1
"Randolph County, GA",2008-2009,7645,7736,91,1.19,10,81,13,243,H1
"Randolph County, GA",2009-2010,7736,7672,-64,-0.827,2,-66,13,243,H1
"Randolph County, GA",2010-2011,7672,7579,-93,-1.212,18,-111,13,243,H1
"Randolph County, GA",2011-2012,7579,7308,-271,-3.576,-15,-256,13,243,H1
"Randolph County, GA",2012-2013,7308,7185,-123,-1.683,11,-134,13,243,H1
"Randolph County, GA",2013-2014,7185,7313,128,1.781,17,111,13,243,H1
"Randolph County, GA",2014-2015,7300,7193,-107,-1.466,13,-120,13,243,H1
"Randolph County, GA",2015-2016,7193,7225,32,0.445,-8,40,13,243,H1
"Randolph County, GA",2016-2017,7225,7075,-150,-2.076,2,-152,13,243,H1
"Richmond County, GA",2000-2001,199547,199443,-104,-0.052,1369,-1473,13,245,H6
"Richmond County, GA",2001-2002,199443,198670,-773,-0.388,1332,-2105,13,245,H6
"Richmond County, GA",2002-2003,198670,196958,-1712,-0.862,1132,-2844,13,245,H6
"Richmond County, GA",2003-2004,196958,196883,-75,-0.038,1173,-1248,13,245,H6
"Richmond County, GA",2004-2005,196883,195837,-1046,-0.531,1296,-2342,13,245,H6
"Richmond County, GA",2005-2006,195837,196449,612,0.313,1337,-725,13,245,H6
"Richmond County, GA",2006-2007,196449,196483,34,0.017,1509,-1475,13,245,H6
"Richmond County, GA",2007-2008,196483,198423,1940,0.987,1475,465,13,245,H6
"Richmond County, GA",2008-2009,198423,198489,66,0.033,1293,-1227,13,245,H6
"Richmond County, GA",2009-2010,198489,201015,2526,1.273,1350,1176,13,245,H6
"Richmond County, GA",2010-2011,201015,200595,-420,-0.209,1115,-1535,13,245,H6
"Richmond County, GA",2011-2012,200595,201966,1371,0.683,1170,201,13,245,H6
"Richmond County, GA",2012-2013,201966,201276,-690,-0.342,1100,-1790,13,245,H6
"Richmond County, GA",2013-2014,201276,201368,92,0.046,1130,-1038,13,245,H6
"Richmond County, GA",2014-2015,201149,201793,644,0.32,1220,-576,13,245,H6
"Richmond County, GA",2015-2016,201793,202008,215,0.107,806,-591,13,245,H6
"Richmond County, GA",2016-2017,202008,201800,-208,-0.103,934,-1142,13,245,H6
"Rockdale County, GA",2000-2001,70724,71875,1151,1.627,506,645,13,247,H1
"Rockdale County, GA",2001-2002,71875,73158,1283,1.785,487,796,13,247,H1
"Rockdale County, GA",2002-2003,73158,74860,1702,2.326,502,1200,13,247,H1
"Rockdale County, GA",2003-2004,74860,76577,1717,2.294,574,1143,13,247,H1
"Rockdale County, GA",2004-2005,76577,78086,1509,1.971,623,886,13,247,H1
"Rockdale County, GA",2005-2006,78086,79911,1825,2.337,553,1272,13,247,H1
"Rockdale County, GA",2006-2007,79911,82146,2235,2.797,633,1602,13,247,H1
"Rockdale County, GA",2007-2008,82146,83558,1412,1.719,691,721,13,247,H1
"Rockdale County, GA",2008-2009,83558,84625,1067,1.277,697,370,13,247,H1
"Rockdale County, GA",2009-2010,84625,85425,800,0.945,552,248,13,247,H1
"Rockdale County, GA",2010-2011,85425,85601,176,0.206,483,-307,13,247,H1
"Rockdale County, GA",2011-2012,85601,85684,83,0.097,426,-343,13,247,H1
"Rockdale County, GA",2012-2013,85684,86815,1131,1.32,268,863,13,247,H1
"Rockdale County, GA",2013-2014,86815,87754,939,1.082,381,558,13,247,H1
"Rockdale County, GA",2014-2015,87681,88856,1175,1.34,357,818,13,247,H1
"Rockdale County, GA",2015-2016,88856,89375,519,0.584,311,208,13,247,H1
"Rockdale County, GA",2016-2017,89375,90312,937,1.048,328,609,13,247,H1
"Schley County, GA",2000-2001,3791,3860,69,1.82,2,67,13,249,H1
"Schley County, GA",2001-2002,3860,3920,60,1.554,-2,62,13,249,H1
"Schley County, GA",2002-2003,3920,3976,56,1.429,28,28,13,249,H1
"Schley County, GA",2003-2004,3976,4070,94,2.364,16,78,13,249,H1
"Schley County, GA",2004-2005,4070,4270,200,4.914,6,194,13,249,H1
"Schley County, GA",2005-2006,4270,4374,104,2.436,17,87,13,249,H1
"Schley County, GA",2006-2007,4374,4601,227,5.19,29,198,13,249,H1
"Schley County, GA",2007-2008,4601,4835,234,5.086,40,194,13,249,H1
"Schley County, GA",2008-2009,4835,4954,119,2.461,29,90,13,249,H1
"Schley County, GA",2009-2010,4954,5021,67,1.352,24,43,13,249,H1
"Schley County, GA",2010-2011,5021,5025,4,0.08,32,-28,13,249,H1
"Schley County, GA",2011-2012,5025,4989,-36,-0.716,8,-44,13,249,H1
"Schley County, GA",2012-2013,4989,5072,83,1.664,23,60,13,249,H1
"Schley County, GA",2013-2014,5072,5163,91,1.794,21,70,13,249,H1
"Schley County, GA",2014-2015,5143,5168,25,0.486,19,6,13,249,H1
"Schley County, GA",2015-2016,5168,5158,-10,-0.193,37,-47,13,249,H1
"Schley County, GA",2016-2017,5158,5213,55,1.066,21,34,13,249,H1
"Screven County, GA",2000-2001,15341,15057,-284,-1.851,31,-315,13,251,H1
"Screven County, GA",2001-2002,15057,15226,169,1.122,28,141,13,251,H1
"Screven County, GA",2002-2003,15226,15040,-186,-1.222,10,-196,13,251,H1
"Screven County, GA",2003-2004,15040,15047,7,0.047,20,-13,13,251,H1
"Screven County, GA",2004-2005,15047,15065,18,0.12,32,-14,13,251,H1
"Screven County, GA",2005-2006,15065,14884,-181,-1.201,30,-211,13,251,H1
"Screven County, GA",2006-2007,14884,14865,-19,-0.128,21,-40,13,251,H1
"Screven County, GA",2007-2008,14865,14843,-22,-0.148,13,-35,13,251,H1
"Screven County, GA",2008-2009,14843,14905,62,0.418,10,52,13,251,H1
"Screven County, GA",2009-2010,14905,14511,-394,-2.643,40,-434,13,251,H1
"Screven County, GA",2010-2011,14511,14393,-118,-0.813,35,-153,13,251,H1
"Screven County, GA",2011-2012,14393,14200,-193,-1.341,21,-214,13,251,H1
"Screven County, GA",2012-2013,14200,14216,16,0.113,45,-29,13,251,H1
"Screven County, GA",2013-2014,14216,14085,-131,-0.921,15,-146,13,251,H1
"Screven County, GA",2014-2015,14074,14162,88,0.625,0,88,13,251,H1
"Screven County, GA",2015-2016,14162,14032,-130,-0.918,32,-162,13,251,H1
"Screven County, GA",2016-2017,14032,13953,-79,-0.563,-1,-78,13,251,H1
"Seminole County, GA",2000-2001,9329,9251,-78,-0.836,3,-81,13,253,H1
"Seminole County, GA",2001-2002,9251,9210,-41,-0.443,18,-59,13,253,H1
"Seminole County, GA",2002-2003,9210,9033,-177,-1.922,-13,-164,13,253,H1
"Seminole County, GA",2003-2004,9033,9065,32,0.354,20,12,13,253,H1
"Seminole County, GA",2004-2005,9065,8905,-160,-1.765,-2,-158,13,253,H1
"Seminole County, GA",2005-2006,8905,8869,-36,-0.404,6,-42,13,253,H1
"Seminole County, GA",2006-2007,8869,8800,-69,-0.778,9,-78,13,253,H1
"Seminole County, GA",2007-2008,8800,8827,27,0.307,37,-10,13,253,H1
"Seminole County, GA",2008-2009,8827,8760,-67,-0.759,30,-97,13,253,H1
"Seminole County, GA",2009-2010,8760,8733,-27,-0.308,-1,-26,13,253,H1
"Seminole County, GA",2010-2011,8733,8782,49,0.561,3,46,13,253,H1
"Seminole County, GA",2011-2012,8782,8915,133,1.514,-3,136,13,253,H1
"Seminole County, GA",2012-2013,8915,8903,-12,-0.135,-9,-3,13,253,H1
"Seminole County, GA",2013-2014,8903,8686,-217,-2.437,8,-225,13,253,H1
"Seminole County, GA",2014-2015,8651,8647,-4,-0.046,-2,-2,13,253,H1
"Seminole County, GA",2015-2016,8647,8445,-202,-2.336,-26,-176,13,253,H1
"Seminole County, GA",2016-2017,8445,8292,-153,-1.812,-28,-125,13,253,H1
"Spalding County, GA",2000-2001,58497,58927,430,0.735,343,87,13,255,H1
"Spalding County, GA",2001-2002,58927,59699,772,1.31,333,439,13,255,H1
"Spalding County, GA",2002-2003,59699,60222,523,0.876,291,232,13,255,H1
"Spalding County, GA",2003-2004,60222,60588,366,0.608,337,29,13,255,H1
"Spalding County, GA",2004-2005,60588,61091,503,0.83,414,89,13,255,H1
"Spalding County, GA",2005-2006,61091,61971,880,1.44,392,488,13,255,H1
"Spalding County, GA",2006-2007,61971,62682,711,1.147,390,321,13,255,H1
"Spalding County, GA",2007-2008,62682,63651,969,1.546,308,661,13,255,H1
"Spalding County, GA",2008-2009,63651,64135,484,0.76,329,155,13,255,H1
"Spalding County, GA",2009-2010,64135,64085,-50,-0.078,293,-343,13,255,H1
"Spalding County, GA",2010-2011,64085,64118,33,0.051,234,-201,13,255,H1
"Spalding County, GA",2011-2012,64118,63799,-319,-0.498,154,-473,13,255,H1
"Spalding County, GA",2012-2013,63799,63741,-58,-0.091,129,-187,13,255,H1
"Spalding County, GA",2013-2014,63741,63988,247,0.388,77,170,13,255,H1
"Spalding County, GA",2014-2015,63872,64051,179,0.28,62,117,13,255,H1
"Spalding County, GA",2015-2016,64051,64553,502,0.784,49,453,13,255,H1
"Spalding County, GA",2016-2017,64553,65380,827,1.281,35,792,13,255,H1
"Stephens County, GA",2000-2001,25482,25594,112,0.44,39,73,13,257,H1
"Stephens County, GA",2001-2002,25594,25625,31,0.121,-37,68,13,257,H1
"Stephens County, GA",2002-2003,25625,25432,-193,-0.753,39,-232,13,257,H1
"Stephens County, GA",2003-2004,25432,25314,-118,-0.464,-9,-109,13,257,H1
"Stephens County, GA",2004-2005,25314,25332,18,0.071,14,4,13,257,H1
"Stephens County, GA",2005-2006,25332,25488,156,0.616,11,145,13,257,H1
"Stephens County, GA",2006-2007,25488,25620,132,0.518,61,71,13,257,H1
"Stephens County, GA",2007-2008,25620,26004,384,1.499,68,316,13,257,H1
"Stephens County, GA",2008-2009,26004,26069,65,0.25,42,23,13,257,H1
"Stephens County, GA",2009-2010,26069,26155,86,0.33,12,74,13,257,H1
"Stephens County, GA",2010-2011,26155,25751,-404,-1.545,-18,-386,13,257,H1
"Stephens County, GA",2011-2012,25751,25725,-26,-0.101,-36,10,13,257,H1
"Stephens County, GA",2012-2013,25725,25595,-130,-0.505,-49,-81,13,257,H1
"Stephens County, GA",2013-2014,25595,25480,-115,-0.449,23,-138,13,257,H1
"Stephens County, GA",2014-2015,25455,25586,131,0.515,24,107,13,257,H1
"Stephens County, GA",2015-2016,25586,25724,138,0.539,7,131,13,257,H1
"Stephens County, GA",2016-2017,25724,25890,166,0.645,4,162,13,257,H1
"Stewart County, GA",2000-2001,5284,5358,74,1.4,6,68,13,259,H1
"Stewart County, GA",2001-2002,5358,5424,66,1.232,-30,96,13,259,H1
"Stewart County, GA",2002-2003,5424,5472,48,0.885,-13,61,13,259,H1
"Stewart County, GA",2003-2004,5472,5534,62,1.133,-8,70,13,259,H1
"Stewart County, GA",2004-2005,5534,5595,61,1.102,-12,73,13,259,H1
"Stewart County, GA",2005-2006,5595,5627,32,0.572,-17,49,13,259,H1
"Stewart County, GA",2006-2007,5627,5691,64,1.137,-13,77,13,259,H1
"Stewart County, GA",2007-2008,5691,5814,123,2.161,6,117,13,259,H1
"Stewart County, GA",2008-2009,5814,5968,154,2.649,7,147,13,259,H1
"Stewart County, GA",2009-2010,5968,6110,142,2.379,15,127,13,259,H1
"Stewart County, GA",2010-2011,6110,6070,-40,-0.655,-3,-37,13,259,H1
"Stewart County, GA",2011-2012,6070,6090,20,0.329,-23,43,13,259,H1
"Stewart County, GA",2012-2013,6090,5484,-606,-9.951,-9,-597,13,259,H1
"Stewart County, GA",2013-2014,5484,5744,260,4.741,-27,287,13,259,H1
"Stewart County, GA",2014-2015,5803,5851,48,0.827,-24,72,13,259,H1
"Stewart County, GA",2015-2016,5851,5875,24,0.41,-5,29,13,259,H1
"Stewart County, GA",2016-2017,5875,5985,110,1.872,-18,128,13,259,H1
"Sumter County, GA",2000-2001,33448,33447,-1,-0.003,168,-169,13,261,H1
"Sumter County, GA",2001-2002,33447,33362,-85,-0.254,209,-294,13,261,H1
"Sumter County, GA",2002-2003,33362,33178,-184,-0.552,69,-253,13,261,H1
"Sumter County, GA",2003-2004,33178,32902,-276,-0.832,118,-394,13,261,H1
"Sumter County, GA",2004-2005,32902,32622,-280,-0.851,186,-466,13,261,H1
"Sumter County, GA",2005-2006,32622,32785,163,0.5,206,-43,13,261,H1
"Sumter County, GA",2006-2007,32785,32987,202,0.616,202,0,13,261,H1
"Sumter County, GA",2007-2008,32987,33012,25,0.076,165,-140,13,261,H1
"Sumter County, GA",2008-2009,33012,32724,-288,-0.872,142,-430,13,261,H1
"Sumter County, GA",2009-2010,32724,32707,-17,-0.052,105,-122,13,261,H1
"Sumter County, GA",2010-2011,32707,32095,-612,-1.871,85,-697,13,261,H1
"Sumter County, GA",2011-2012,32095,31631,-464,-1.446,108,-572,13,261,H1
"Sumter County, GA",2012-2013,31631,31357,-274,-0.866,70,-344,13,261,H1
"Sumter County, GA",2013-2014,31357,31232,-125,-0.399,106,-231,13,261,H1
"Sumter County, GA",2014-2015,31233,30779,-454,-1.454,52,-506,13,261,H1
"Sumter County, GA",2015-2016,30779,30355,-424,-1.378,-1,-423,13,261,H1
"Sumter County, GA",2016-2017,30355,29847,-508,-1.674,31,-539,13,261,H1
"Talbot County, GA",2000-2001,6563,6675,112,1.707,-9,121,13,263,H1
"Talbot County, GA",2001-2002,6675,6749,74,1.109,9,65,13,263,H1
"Talbot County, GA",2002-2003,6749,6696,-53,-0.785,-8,-45,13,263,H1
"Talbot County, GA",2003-2004,6696,6775,79,1.18,-13,92,13,263,H1
"Talbot County, GA",2004-2005,6775,6906,131,1.934,-3,134,13,263,H1
"Talbot County, GA",2005-2006,6906,6959,53,0.767,-22,75,13,263,H1
"Talbot County, GA",2006-2007,6959,7026,67,0.963,-7,74,13,263,H1
"Talbot County, GA",2007-2008,7026,6899,-127,-1.808,16,-143,13,263,H1
"Talbot County, GA",2008-2009,6899,6873,-26,-0.377,-8,-18,13,263,H1
"Talbot County, GA",2009-2010,6873,6834,-39,-0.567,-18,-21,13,263,H1
"Talbot County, GA",2010-2011,6834,6760,-74,-1.083,-1,-73,13,263,H1
"Talbot County, GA",2011-2012,6760,6538,-222,-3.284,-9,-213,13,263,H1
"Talbot County, GA",2012-2013,6538,6449,-89,-1.361,-18,-71,13,263,H1
"Talbot County, GA",2013-2014,6449,6390,-59,-0.915,-10,-49,13,263,H1
"Talbot County, GA",2014-2015,6377,6337,-40,-0.627,-15,-25,13,263,H1
"Talbot County, GA",2015-2016,6337,6353,16,0.252,-23,39,13,263,H1
"Talbot County, GA",2016-2017,6353,6249,-104,-1.637,-24,-80,13,263,H1
"Taliaferro County, GA",2000-2001,2076,2031,-45,-2.168,-6,-39,13,265,H1
"Taliaferro County, GA",2001-2002,2031,2040,9,0.443,3,6,13,265,H1
"Taliaferro County, GA",2002-2003,2040,1923,-117,-5.735,1,-118,13,265,H1
"Taliaferro County, GA",2003-2004,1923,1903,-20,-1.04,-17,-3,13,265,H1
"Taliaferro County, GA",2004-2005,1903,1858,-45,-2.365,-3,-42,13,265,H1
"Taliaferro County, GA",2005-2006,1858,1863,5,0.269,-15,20,13,265,H1
"Taliaferro County, GA",2006-2007,1863,1851,-12,-0.644,0,-12,13,265,H1
"Taliaferro County, GA",2007-2008,1851,1820,-31,-1.675,11,-42,13,265,H1
"Taliaferro County, GA",2008-2009,1820,1774,-46,-2.527,16,-62,13,265,H1
"Taliaferro County, GA",2009-2010,1774,1708,-66,-3.72,12,-78,13,265,H1
"Taliaferro County, GA",2010-2011,1708,1715,7,0.41,-12,19,13,265,H1
"Taliaferro County, GA",2011-2012,1715,1681,-34,-1.983,-12,-22,13,265,H1
"Taliaferro County, GA",2012-2013,1681,1693,12,0.714,9,3,13,265,H1
"Taliaferro County, GA",2013-2014,1693,1693,0,0,-8,8,13,265,H1
"Taliaferro County, GA",2014-2015,1693,1639,-54,-3.19,-10,-44,13,265,H1
"Taliaferro County, GA",2015-2016,1639,1626,-13,-0.793,-4,-9,13,265,H1
"Taliaferro County, GA",2016-2017,1626,1628,2,0.123,-6,8,13,265,H1
"Tattnall County, GA",2000-2001,22322,22242,-80,-0.358,90,-170,13,267,H1
"Tattnall County, GA",2001-2002,22242,22276,34,0.153,114,-80,13,267,H1
"Tattnall County, GA",2002-2003,22276,22485,209,0.938,114,95,13,267,H1
"Tattnall County, GA",2003-2004,22485,23034,549,2.442,103,446,13,267,H1
"Tattnall County, GA",2004-2005,23034,23165,131,0.569,115,16,13,267,H1
"Tattnall County, GA",2005-2006,23165,23417,252,1.088,89,163,13,267,H1
"Tattnall County, GA",2006-2007,23417,23444,27,0.115,125,-98,13,267,H1
"Tattnall County, GA",2007-2008,23444,23801,357,1.523,122,235,13,267,H1
"Tattnall County, GA",2008-2009,23801,25068,1267,5.323,109,1158,13,267,H1
"Tattnall County, GA",2009-2010,25068,25491,423,1.687,132,291,13,267,H1
"Tattnall County, GA",2010-2011,25491,25281,-210,-0.824,109,-319,13,267,H1
"Tattnall County, GA",2011-2012,25281,25305,24,0.095,120,-96,13,267,H1
"Tattnall County, GA",2012-2013,25305,25477,172,0.68,103,69,13,267,H1
"Tattnall County, GA",2013-2014,25477,25224,-253,-0.993,85,-338,13,267,H1
"Tattnall County, GA",2014-2015,25195,25229,34,0.135,53,-19,13,267,H1
"Tattnall County, GA",2015-2016,25229,25281,52,0.206,38,14,13,267,H1
"Tattnall County, GA",2016-2017,25281,25334,53,0.21,41,12,13,267,H1
"Taylor County, GA",2000-2001,8821,8756,-65,-0.737,-10,-55,13,269,H1
"Taylor County, GA",2001-2002,8756,8837,81,0.925,12,69,13,269,H1
"Taylor County, GA",2002-2003,8837,8879,42,0.475,6,36,13,269,H1
"Taylor County, GA",2003-2004,8879,8918,39,0.439,17,22,13,269,H1
"Taylor County, GA",2004-2005,8918,8860,-58,-0.65,-9,-49,13,269,H1
"Taylor County, GA",2005-2006,8860,8798,-62,-0.7,0,-62,13,269,H1
"Taylor County, GA",2006-2007,8798,8868,70,0.796,11,59,13,269,H1
"Taylor County, GA",2007-2008,8868,8945,77,0.868,42,35,13,269,H1
"Taylor County, GA",2008-2009,8945,8854,-91,-1.017,32,-123,13,269,H1
"Taylor County, GA",2009-2010,8854,8781,-73,-0.824,11,-84,13,269,H1
"Taylor County, GA",2010-2011,8781,8478,-303,-3.451,-19,-284,13,269,H1
"Taylor County, GA",2011-2012,8478,8381,-97,-1.144,11,-108,13,269,H1
"Taylor County, GA",2012-2013,8381,8441,60,0.716,7,53,13,269,H1
"Taylor County, GA",2013-2014,8441,8442,1,0.012,8,-7,13,269,H1
"Taylor County, GA",2014-2015,8421,8330,-91,-1.081,9,-100,13,269,H1
"Taylor County, GA",2015-2016,8330,8199,-131,-1.573,-9,-122,13,269,H1
"Taylor County, GA",2016-2017,8199,8142,-57,-0.695,-3,-54,13,269,H1
"Telfair County, GA",2000-2001,11893,12155,262,2.203,28,234,13,271,H1
"Telfair County, GA",2001-2002,12155,12347,192,1.58,-9,201,13,271,H1
"Telfair County, GA",2002-2003,12347,13887,1540,12.473,-13,1553,13,271,H1
"Telfair County, GA",2003-2004,13887,14685,798,5.746,28,770,13,271,H1
"Telfair County, GA",2004-2005,14685,15070,385,2.622,37,348,13,271,H1
"Telfair County, GA",2005-2006,15070,15401,331,2.196,-35,366,13,271,H1
"Telfair County, GA",2006-2007,15401,15932,531,3.448,22,509,13,271,H1
"Telfair County, GA",2007-2008,15932,16230,298,1.87,19,279,13,271,H1
"Telfair County, GA",2008-2009,16230,16200,-30,-0.185,-8,-22,13,271,H1
"Telfair County, GA",2009-2010,16200,16494,294,1.815,18,276,13,271,H1
"Telfair County, GA",2010-2011,16494,16317,-177,-1.073,13,-190,13,271,H1
"Telfair County, GA",2011-2012,16317,16429,112,0.686,-36,148,13,271,H1
"Telfair County, GA",2012-2013,16429,16705,276,1.68,17,259,13,271,H1
"Telfair County, GA",2013-2014,16705,16518,-187,-1.119,-27,-160,13,271,H1
"Telfair County, GA",2014-2015,16470,16400,-70,-0.425,-24,-46,13,271,H1
"Telfair County, GA",2015-2016,16400,16034,-366,-2.232,3,-369,13,271,H1
"Telfair County, GA",2016-2017,16034,15989,-45,-0.281,-37,-8,13,271,H1
"Terrell County, GA",2000-2001,10935,10822,-113,-1.033,73,-186,13,273,H1
"Terrell County, GA",2001-2002,10822,10607,-215,-1.987,24,-239,13,273,H1
"Terrell County, GA",2002-2003,10607,10641,34,0.321,10,24,13,273,H1
"Terrell County, GA",2003-2004,10641,10453,-188,-1.767,21,-209,13,273,H1
"Terrell County, GA",2004-2005,10453,10134,-319,-3.052,33,-352,13,273,H1
"Terrell County, GA",2005-2006,10134,9969,-165,-1.628,45,-210,13,273,H1
"Terrell County, GA",2006-2007,9969,9701,-268,-2.688,44,-312,13,273,H1
"Terrell County, GA",2007-2008,9701,9648,-53,-0.546,32,-85,13,273,H1
"Terrell County, GA",2008-2009,9648,9596,-52,-0.539,-1,-51,13,273,H1
"Terrell County, GA",2009-2010,9596,9525,-71,-0.74,1,-72,13,273,H1
"Terrell County, GA",2010-2011,9525,9398,-127,-1.333,26,-153,13,273,H1
"Terrell County, GA",2011-2012,9398,9247,-151,-1.607,39,-190,13,273,H1
"Terrell County, GA",2012-2013,9247,9214,-33,-0.357,31,-64,13,273,H1
"Terrell County, GA",2013-2014,9214,9132,-82,-0.89,36,-118,13,273,H1
"Terrell County, GA",2014-2015,9120,9113,-7,-0.077,30,-37,13,273,H1
"Terrell County, GA",2015-2016,9113,8888,-225,-2.469,16,-241,13,273,H1
"Terrell County, GA",2016-2017,8888,8729,-159,-1.789,5,-164,13,273,H1
"Thomas County, GA",2000-2001,42829,42674,-155,-0.362,140,-295,13,275,H1
"Thomas County, GA",2001-2002,42674,42555,-119,-0.279,111,-230,13,275,H1
"Thomas County, GA",2002-2003,42555,42956,401,0.942,126,275,13,275,H1
"Thomas County, GA",2003-2004,42956,42762,-194,-0.452,115,-309,13,275,H1
"Thomas County, GA",2004-2005,42762,43556,794,1.857,184,610,13,275,H1
"Thomas County, GA",2005-2006,43556,43901,345,0.792,240,105,13,275,H1
"Thomas County, GA",2006-2007,43901,44269,368,0.838,217,151,13,275,H1
"Thomas County, GA",2007-2008,44269,44627,358,0.809,207,151,13,275,H1
"Thomas County, GA",2008-2009,44627,44689,62,0.139,226,-164,13,275,H1
"Thomas County, GA",2009-2010,44689,44742,53,0.119,144,-91,13,275,H1
"Thomas County, GA",2010-2011,44742,44588,-154,-0.344,52,-206,13,275,H1
"Thomas County, GA",2011-2012,44588,44530,-58,-0.13,99,-157,13,275,H1
"Thomas County, GA",2012-2013,44530,44848,318,0.714,123,195,13,275,H1
"Thomas County, GA",2013-2014,44848,44959,111,0.248,146,-35,13,275,H1
"Thomas County, GA",2014-2015,44990,45063,73,0.162,117,-44,13,275,H1
"Thomas County, GA",2015-2016,45063,45090,27,0.06,54,-27,13,275,H1
"Thomas County, GA",2016-2017,45090,44779,-311,-0.69,55,-366,13,275,H1
"Tift County, GA",2000-2001,38348,38133,-215,-0.561,227,-442,13,277,H1
"Tift County, GA",2001-2002,38133,38217,84,0.22,280,-196,13,277,H1
"Tift County, GA",2002-2003,38217,38215,-2,-0.005,220,-222,13,277,H1
"Tift County, GA",2003-2004,38215,38622,407,1.065,328,79,13,277,H1
"Tift County, GA",2004-2005,38622,38789,167,0.432,290,-123,13,277,H1
"Tift County, GA",2005-2006,38789,39503,714,1.841,369,345,13,277,H1
"Tift County, GA",2006-2007,39503,39720,217,0.549,376,-159,13,277,H1
"Tift County, GA",2007-2008,39720,39806,86,0.217,320,-234,13,277,H1
"Tift County, GA",2008-2009,39806,39748,-58,-0.146,324,-382,13,277,H1
"Tift County, GA",2009-2010,39748,40246,498,1.253,304,194,13,277,H1
"Tift County, GA",2010-2011,40246,41380,1134,2.818,171,963,13,277,H1
"Tift County, GA",2011-2012,41380,40994,-386,-0.933,188,-574,13,277,H1
"Tift County, GA",2012-2013,40994,40280,-714,-1.742,183,-897,13,277,H1
"Tift County, GA",2013-2014,40280,40704,424,1.053,167,257,13,277,H1
"Tift County, GA",2014-2015,40619,40764,145,0.357,193,-48,13,277,H1
"Tift County, GA",2015-2016,40764,40650,-114,-0.28,165,-279,13,277,H1
"Tift County, GA",2016-2017,40650,40598,-52,-0.128,170,-222,13,277,H1
"Toombs County, GA",2000-2001,26137,26040,-97,-0.371,155,-252,13,279,H1
"Toombs County, GA",2001-2002,26040,26031,-9,-0.035,124,-133,13,279,H1
"Toombs County, GA",2002-2003,26031,26009,-22,-0.085,126,-148,13,279,H1
"Toombs County, GA",2003-2004,26009,26166,157,0.604,148,9,13,279,H1
"Toombs County, GA",2004-2005,26166,26539,373,1.426,162,211,13,279,H1
"Toombs County, GA",2005-2006,26539,26851,312,1.176,201,111,13,279,H1
"Toombs County, GA",2006-2007,26851,27185,334,1.244,204,130,13,279,H1
"Toombs County, GA",2007-2008,27185,27345,160,0.589,202,-42,13,279,H1
"Toombs County, GA",2008-2009,27345,27079,-266,-0.973,178,-444,13,279,H1
"Toombs County, GA",2009-2010,27079,27317,238,0.879,156,82,13,279,H1
"Toombs County, GA",2010-2011,27317,27240,-77,-0.282,133,-210,13,279,H1
"Toombs County, GA",2011-2012,27240,27217,-23,-0.084,81,-104,13,279,H1
"Toombs County, GA",2012-2013,27217,27302,85,0.312,109,-24,13,279,H1
"Toombs County, GA",2013-2014,27302,27282,-20,-0.073,95,-115,13,279,H1
"Toombs County, GA",2014-2015,27193,27241,48,0.177,106,-58,13,279,H1
"Toombs County, GA",2015-2016,27241,27195,-46,-0.169,75,-121,13,279,H1
"Toombs County, GA",2016-2017,27195,26999,-196,-0.721,71,-267,13,279,H1
"Towns County, GA",2000-2001,9348,9499,151,1.615,-39,190,13,281,H1
"Towns County, GA",2001-2002,9499,9532,33,0.347,-31,64,13,281,H1
"Towns County, GA",2002-2003,9532,9745,213,2.235,-73,286,13,281,H1
"Towns County, GA",2003-2004,9745,9872,127,1.303,-57,184,13,281,H1
"Towns County, GA",2004-2005,9872,9940,68,0.689,-61,129,13,281,H1
"Towns County, GA",2005-2006,9940,10281,341,3.431,-38,379,13,281,H1
"Towns County, GA",2006-2007,10281,10452,171,1.663,-42,213,13,281,H1
"Towns County, GA",2007-2008,10452,10485,33,0.316,-41,74,13,281,H1
"Towns County, GA",2008-2009,10485,10444,-41,-0.391,-41,0,13,281,H1
"Towns County, GA",2009-2010,10444,10534,90,0.862,-86,176,13,281,H1
"Towns County, GA",2010-2011,10534,10477,-57,-0.541,-95,38,13,281,H1
"Towns County, GA",2011-2012,10477,10487,10,0.095,-88,98,13,281,H1
"Towns County, GA",2012-2013,10487,10752,265,2.527,-61,326,13,281,H1
"Towns County, GA",2013-2014,10752,11098,346,3.218,-63,409,13,281,H1
"Towns County, GA",2014-2015,11087,11182,95,0.857,-70,165,13,281,H1
"Towns County, GA",2015-2016,11182,11349,167,1.493,-79,246,13,281,H1
"Towns County, GA",2016-2017,11349,11506,157,1.383,-87,244,13,281,H1
"Treutlen County, GA",2000-2001,6862,6895,33,0.481,6,27,13,283,H1
"Treutlen County, GA",2001-2002,6895,6881,-14,-0.203,2,-16,13,283,H1
"Treutlen County, GA",2002-2003,6881,6924,43,0.625,32,11,13,283,H1
"Treutlen County, GA",2003-2004,6924,6949,25,0.361,12,13,13,283,H1
"Treutlen County, GA",2004-2005,6949,6679,-270,-3.885,-2,-268,13,283,H1
"Treutlen County, GA",2005-2006,6679,6771,92,1.377,18,74,13,283,H1
"Treutlen County, GA",2006-2007,6771,6773,2,0.03,34,-32,13,283,H1
"Treutlen County, GA",2007-2008,6773,6847,74,1.093,34,40,13,283,H1
"Treutlen County, GA",2008-2009,6847,6906,59,0.862,12,47,13,283,H1
"Treutlen County, GA",2009-2010,6906,6889,-17,-0.246,13,-30,13,283,H1
"Treutlen County, GA",2010-2011,6889,6821,-68,-0.987,-20,-48,13,283,H1
"Treutlen County, GA",2011-2012,6821,6751,-70,-1.026,23,-93,13,283,H1
"Treutlen County, GA",2012-2013,6751,6665,-86,-1.274,29,-115,13,283,H1
"Treutlen County, GA",2013-2014,6665,6778,113,1.695,21,92,13,283,H1
"Treutlen County, GA",2014-2015,6808,6785,-23,-0.338,28,-51,13,283,H1
"Treutlen County, GA",2015-2016,6785,6727,-58,-0.855,35,-93,13,283,H1
"Treutlen County, GA",2016-2017,6727,6740,13,0.193,6,7,13,283,H1
"Troup County, GA",2000-2001,58923,59844,921,1.563,245,676,13,285,H1
"Troup County, GA",2001-2002,59844,60224,380,0.635,280,100,13,285,H1
"Troup County, GA",2002-2003,60224,60791,567,0.941,253,314,13,285,H1
"Troup County, GA",2003-2004,60791,62001,1210,1.99,297,913,13,285,H1
"Troup County, GA",2004-2005,62001,63233,1232,1.987,326,906,13,285,H1
"Troup County, GA",2005-2006,63233,63897,664,1.05,340,324,13,285,H1
"Troup County, GA",2006-2007,63897,64894,997,1.56,391,606,13,285,H1
"Troup County, GA",2007-2008,64894,65860,966,1.489,385,581,13,285,H1
"Troup County, GA",2008-2009,65860,66422,562,0.853,363,199,13,285,H1
"Troup County, GA",2009-2010,66422,67154,732,1.102,293,439,13,285,H1
"Troup County, GA",2010-2011,67154,67773,619,0.922,312,307,13,285,H1
"Troup County, GA",2011-2012,67773,68472,699,1.031,274,425,13,285,H1
"Troup County, GA",2012-2013,68472,69007,535,0.781,191,344,13,285,H1
"Troup County, GA",2013-2014,69007,69469,462,0.669,201,261,13,285,H1
"Troup County, GA",2014-2015,69489,69763,274,0.394,251,23,13,285,H1
"Troup County, GA",2015-2016,69763,69776,13,0.019,200,-187,13,285,H1
"Troup County, GA",2016-2017,69776,69786,10,0.014,175,-165,13,285,H1
"Turner County, GA",2000-2001,9475,9512,37,0.391,53,-16,13,287,H1
"Turner County, GA",2001-2002,9512,9514,2,0.021,45,-43,13,287,H1
"Turner County, GA",2002-2003,9514,9407,-107,-1.125,15,-122,13,287,H1
"Turner County, GA",2003-2004,9407,9310,-97,-1.031,46,-143,13,287,H1
"Turner County, GA",2004-2005,9310,9245,-65,-0.698,36,-101,13,287,H1
"Turner County, GA",2005-2006,9245,9133,-112,-1.211,53,-165,13,287,H1
"Turner County, GA",2006-2007,9133,9111,-22,-0.241,70,-92,13,287,H1
"Turner County, GA",2007-2008,9111,9029,-82,-0.9,67,-149,13,287,H1
"Turner County, GA",2008-2009,9029,8900,-129,-1.429,37,-166,13,287,H1
"Turner County, GA",2009-2010,8900,8944,44,0.494,24,20,13,287,H1
"Turner County, GA",2010-2011,8944,8847,-97,-1.085,1,-98,13,287,H1
"Turner County, GA",2011-2012,8847,8369,-478,-5.403,16,-494,13,287,H1
"Turner County, GA",2012-2013,8369,8143,-226,-2.7,39,-265,13,287,H1
"Turner County, GA",2013-2014,8143,8153,10,0.123,15,-5,13,287,H1
"Turner County, GA",2014-2015,8128,8214,86,1.058,16,70,13,287,H1
"Turner County, GA",2015-2016,8214,7972,-242,-2.946,36,-278,13,287,H1
"Turner County, GA",2016-2017,7972,7961,-11,-0.138,26,-37,13,287,H1
"Twiggs County, GA",2000-2001,10556,10418,-138,-1.307,7,-145,13,289,H1
"Twiggs County, GA",2001-2002,10418,10503,85,0.816,15,70,13,289,H1
"Twiggs County, GA",2002-2003,10503,10461,-42,-0.4,26,-68,13,289,H1
"Twiggs County, GA",2003-2004,10461,10266,-195,-1.864,26,-221,13,289,H1
"Twiggs County, GA",2004-2005,10266,9978,-288,-2.805,28,-316,13,289,H1
"Twiggs County, GA",2005-2006,9978,9715,-263,-2.636,26,-289,13,289,H1
"Twiggs County, GA",2006-2007,9715,9545,-170,-1.75,9,-179,13,289,H1
"Twiggs County, GA",2007-2008,9545,9442,-103,-1.079,27,-130,13,289,H1
"Twiggs County, GA",2008-2009,9442,9257,-185,-1.959,5,-190,13,289,H1
"Twiggs County, GA",2009-2010,9257,8965,-292,-3.154,-12,-280,13,289,H1
"Twiggs County, GA",2010-2011,8965,8813,-152,-1.695,-11,-141,13,289,H1
"Twiggs County, GA",2011-2012,8813,8501,-312,-3.54,26,-338,13,289,H1
"Twiggs County, GA",2012-2013,8501,8462,-39,-0.459,-37,-2,13,289,H1
"Twiggs County, GA",2013-2014,8462,8320,-142,-1.678,-61,-81,13,289,H1
"Twiggs County, GA",2014-2015,8354,8390,36,0.431,-40,76,13,289,H1
"Twiggs County, GA",2015-2016,8390,8235,-155,-1.847,2,-157,13,289,H1
"Twiggs County, GA",2016-2017,8235,8174,-61,-0.741,-45,-16,13,289,H1
"Union County, GA",2000-2001,17398,17822,424,2.437,-2,426,13,291,H1
"Union County, GA",2001-2002,17822,18349,527,2.957,-34,561,13,291,H1
"Union County, GA",2002-2003,18349,19018,669,3.646,-73,742,13,291,H1
"Union County, GA",2003-2004,19018,19378,360,1.893,-90,450,13,291,H1
"Union County, GA",2004-2005,19378,19856,478,2.467,-23,501,13,291,H1
"Union County, GA",2005-2006,19856,20460,604,3.042,-128,732,13,291,H1
"Union County, GA",2006-2007,20460,20988,528,2.581,-68,596,13,291,H1
"Union County, GA",2007-2008,20988,21285,297,1.415,-63,360,13,291,H1
"Union County, GA",2008-2009,21285,21338,53,0.249,-99,152,13,291,H1
"Union County, GA",2009-2010,21338,21324,-14,-0.066,-119,105,13,291,H1
"Union County, GA",2010-2011,21324,21369,45,0.211,-137,182,13,291,H1
"Union County, GA",2011-2012,21369,21481,112,0.524,-113,225,13,291,H1
"Union County, GA",2012-2013,21481,21607,126,0.587,-161,287,13,291,H1
"Union County, GA",2013-2014,21607,21984,377,1.745,-114,491,13,291,H1
"Union County, GA",2014-2015,21952,22267,315,1.435,-105,420,13,291,H1
"Union County, GA",2015-2016,22267,22660,393,1.765,-122,515,13,291,H1
"Union County, GA",2016-2017,22660,23459,799,3.526,-100,899,13,291,H1
"Upson County, GA",2000-2001,27746,27788,42,0.151,7,35,13,293,H1
"Upson County, GA",2001-2002,27788,27624,-164,-0.59,14,-178,13,293,H1
"Upson County, GA",2002-2003,27624,27648,24,0.087,-39,63,13,293,H1
"Upson County, GA",2003-2004,27648,27514,-134,-0.485,-92,-42,13,293,H1
"Upson County, GA",2004-2005,27514,27440,-74,-0.269,-62,-12,13,293,H1
"Upson County, GA",2005-2006,27440,27349,-91,-0.332,30,-121,13,293,H1
"Upson County, GA",2006-2007,27349,27423,74,0.271,51,23,13,293,H1
"Upson County, GA",2007-2008,27423,27321,-102,-0.372,11,-113,13,293,H1
"Upson County, GA",2008-2009,27321,27360,39,0.143,-35,74,13,293,H1
"Upson County, GA",2009-2010,27360,27067,-293,-1.071,-20,-273,13,293,H1
"Upson County, GA",2010-2011,27067,26943,-124,-0.458,-7,-117,13,293,H1
"Upson County, GA",2011-2012,26943,26615,-328,-1.217,-8,-320,13,293,H1
"Upson County, GA",2012-2013,26615,26522,-93,-0.349,-58,-35,13,293,H1
"Upson County, GA",2013-2014,26522,26256,-266,-1.003,-65,-201,13,293,H1
"Upson County, GA",2014-2015,26240,26368,128,0.488,-58,186,13,293,H1
"Upson County, GA",2015-2016,26368,26213,-155,-0.588,-64,-91,13,293,H1
"Upson County, GA",2016-2017,26213,26135,-78,-0.298,-60,-18,13,293,H1
"Walker County, GA",2000-2001,61268,62109,841,1.373,77,764,13,295,H1
"Walker County, GA",2001-2002,62109,62841,732,1.179,112,620,13,295,H1
"Walker County, GA",2002-2003,62841,63478,637,1.014,67,570,13,295,H1
"Walker County, GA",2003-2004,63478,64228,750,1.182,98,652,13,295,H1
"Walker County, GA",2004-2005,64228,65160,932,1.451,5,927,13,295,H1
"Walker County, GA",2005-2006,65160,66343,1183,1.816,109,1074,13,295,H1
"Walker County, GA",2006-2007,66343,67405,1062,1.601,135,927,13,295,H1
"Walker County, GA",2007-2008,67405,68103,698,1.036,209,489,13,295,H1
"Walker County, GA",2008-2009,68103,68612,509,0.747,139,370,13,295,H1
"Walker County, GA",2009-2010,68612,68889,277,0.404,-5,282,13,295,H1
"Walker County, GA",2010-2011,68889,68618,-271,-0.393,101,-372,13,295,H1
"Walker County, GA",2011-2012,68618,68184,-434,-0.632,36,-470,13,295,H1
"Walker County, GA",2012-2013,68184,68317,133,0.195,-25,158,13,295,H1
"Walker County, GA",2013-2014,68317,68218,-99,-0.145,5,-104,13,295,H1
"Walker County, GA",2014-2015,68261,68066,-195,-0.286,20,-215,13,295,H1
"Walker County, GA",2015-2016,68066,68326,260,0.382,-87,347,13,295,H1
"Walker County, GA",2016-2017,68326,68939,613,0.897,-43,656,13,295,H1
"Walton County, GA",2000-2001,61413,63847,2434,3.963,527,1907,13,297,H1
"Walton County, GA",2001-2002,63847,66103,2256,3.533,518,1738,13,297,H1
"Walton County, GA",2002-2003,66103,68161,2058,3.113,530,1528,13,297,H1
"Walton County, GA",2003-2004,68161,70334,2173,3.188,518,1655,13,297,H1
"Walton County, GA",2004-2005,70334,73696,3362,4.78,505,2857,13,297,H1
"Walton County, GA",2005-2006,73696,77057,3361,4.561,598,2763,13,297,H1
"Walton County, GA",2006-2007,77057,80440,3383,4.39,619,2764,13,297,H1
"Walton County, GA",2007-2008,80440,82602,2162,2.688,590,1572,13,297,H1
"Walton County, GA",2008-2009,82602,83353,751,0.909,590,161,13,297,H1
"Walton County, GA",2009-2010,83353,83979,626,0.751,367,259,13,297,H1
"Walton County, GA",2010-2011,83979,84441,462,0.55,317,145,13,297,H1
"Walton County, GA",2011-2012,84441,84867,426,0.504,399,27,13,297,H1
"Walton County, GA",2012-2013,84867,85987,1120,1.32,286,834,13,297,H1
"Walton County, GA",2013-2014,85987,87615,1628,1.893,375,1253,13,297,H1
"Walton County, GA",2014-2015,87449,88399,950,1.086,380,570,13,297,H1
"Walton County, GA",2015-2016,88399,89911,1512,1.71,239,1273,13,297,H1
"Walton County, GA",2016-2017,89911,91600,1689,1.879,338,1351,13,297,H1
"Ware County, GA",2000-2001,35421,35426,5,0.014,43,-38,13,299,H1
"Ware County, GA",2001-2002,35426,35203,-223,-0.629,75,-298,13,299,H1
"Ware County, GA",2002-2003,35203,35222,19,0.054,27,-8,13,299,H1
"Ware County, GA",2003-2004,35222,34991,-231,-0.656,84,-315,13,299,H1
"Ware County, GA",2004-2005,34991,35011,20,0.057,97,-77,13,299,H1
"Ware County, GA",2005-2006,35011,35624,613,1.751,109,504,13,299,H1
"Ware County, GA",2006-2007,35624,36016,392,1.1,107,285,13,299,H1
"Ware County, GA",2007-2008,36016,36065,49,0.136,80,-31,13,299,H1
"Ware County, GA",2008-2009,36065,35985,-80,-0.222,56,-136,13,299,H1
"Ware County, GA",2009-2010,35985,36366,381,1.059,47,334,13,299,H1
"Ware County, GA",2010-2011,36366,36177,-189,-0.52,78,-267,13,299,H1
"Ware County, GA",2011-2012,36177,35814,-363,-1.003,69,-432,13,299,H1
"Ware County, GA",2012-2013,35814,35704,-110,-0.307,33,-143,13,299,H1
"Ware County, GA",2013-2014,35704,35515,-189,-0.529,74,-263,13,299,H1
"Ware County, GA",2014-2015,35515,35370,-145,-0.408,66,-211,13,299,H1
"Ware County, GA",2015-2016,35370,35776,406,1.148,33,373,13,299,H1
"Ware County, GA",2016-2017,35776,35871,95,0.266,78,17,13,299,H1
"Warren County, GA",2000-2001,6275,6356,81,1.291,9,72,13,301,H1
"Warren County, GA",2001-2002,6356,6270,-86,-1.353,9,-95,13,301,H1
"Warren County, GA",2002-2003,6270,6229,-41,-0.654,9,-50,13,301,H1
"Warren County, GA",2003-2004,6229,6195,-34,-0.546,-9,-25,13,301,H1
"Warren County, GA",2004-2005,6195,6153,-42,-0.678,13,-55,13,301,H1
"Warren County, GA",2005-2006,6153,6038,-115,-1.869,-6,-109,13,301,H1
"Warren County, GA",2006-2007,6038,5981,-57,-0.944,18,-75,13,301,H1
"Warren County, GA",2007-2008,5981,5942,-39,-0.652,25,-64,13,301,H1
"Warren County, GA",2008-2009,5942,5914,-28,-0.471,6,-34,13,301,H1
"Warren County, GA",2009-2010,5914,5792,-122,-2.063,0,-122,13,301,H1
"Warren County, GA",2010-2011,5792,5701,-91,-1.571,-10,-81,13,301,H1
"Warren County, GA",2011-2012,5701,5563,-138,-2.421,9,-147,13,301,H1
"Warren County, GA",2012-2013,5563,5554,-9,-0.162,0,-9,13,301,H1
"Warren County, GA",2013-2014,5554,5520,-34,-0.612,-10,-24,13,301,H1
"Warren County, GA",2014-2015,5515,5460,-55,-0.997,-13,-42,13,301,H1
"Warren County, GA",2015-2016,5460,5382,-78,-1.429,-10,-68,13,301,H1
"Warren County, GA",2016-2017,5382,5303,-79,-1.468,-13,-66,13,301,H1
"Washington County, GA",2000-2001,21188,21170,-18,-0.085,65,-83,13,303,H1
"Washington County, GA",2001-2002,21170,2.10E+04,-170,-0.803,-8,-162,13,303,H1
"Washington County, GA",2002-2003,2.10E+04,21110,110,0.524,39,71,13,303,H1
"Washington County, GA",2003-2004,21110,21088,-22,-0.104,22,-44,13,303,H1
"Washington County, GA",2004-2005,21088,20155,-933,-4.424,50,-983,13,303,H1
"Washington County, GA",2005-2006,20155,20805,650,3.225,45,605,13,303,H1
"Washington County, GA",2006-2007,20805,21155,350,1.682,48,302,13,303,H1
"Washington County, GA",2007-2008,21155,21202,47,0.222,18,29,13,303,H1
"Washington County, GA",2008-2009,21202,21240,38,0.179,29,9,13,303,H1
"Washington County, GA",2009-2010,21240,21121,-119,-0.56,54,-173,13,303,H1
"Washington County, GA",2010-2011,21121,21015,-106,-0.502,26,-132,13,303,H1
"Washington County, GA",2011-2012,21015,20857,-158,-0.752,63,-221,13,303,H1
"Washington County, GA",2012-2013,20857,20679,-178,-0.853,35,-213,13,303,H1
"Washington County, GA",2013-2014,20679,20635,-44,-0.213,14,-58,13,303,H1
"Washington County, GA",2014-2015,20608,20816,208,1.009,28,180,13,303,H1
"Washington County, GA",2015-2016,20816,20343,-473,-2.272,-21,-452,13,303,H1
"Washington County, GA",2016-2017,20343,20313,-30,-0.147,-21,-9,13,303,H1
"Wayne County, GA",2000-2001,26596,26888,292,1.098,120,172,13,305,H1
"Wayne County, GA",2001-2002,26888,27308,420,1.562,137,283,13,305,H1
"Wayne County, GA",2002-2003,27308,27860,552,2.021,175,377,13,305,H1
"Wayne County, GA",2003-2004,27860,28227,367,1.317,90,277,13,305,H1
"Wayne County, GA",2004-2005,28227,28522,295,1.045,136,159,13,305,H1
"Wayne County, GA",2005-2006,28522,28929,407,1.427,176,231,13,305,H1
"Wayne County, GA",2006-2007,28929,29421,492,1.701,188,304,13,305,H1
"Wayne County, GA",2007-2008,29421,30042,621,2.111,213,408,13,305,H1
"Wayne County, GA",2008-2009,30042,30016,-26,-0.087,132,-158,13,305,H1
"Wayne County, GA",2009-2010,30016,30116,100,0.333,119,-19,13,305,H1
"Wayne County, GA",2010-2011,30116,30355,239,0.794,149,90,13,305,H1
"Wayne County, GA",2011-2012,30355,30371,16,0.053,108,-92,13,305,H1
"Wayne County, GA",2012-2013,30371,30058,-313,-1.031,79,-392,13,305,H1
"Wayne County, GA",2013-2014,30058,29949,-109,-0.363,58,-167,13,305,H1
"Wayne County, GA",2014-2015,29950,29534,-416,-1.389,64,-480,13,305,H1
"Wayne County, GA",2015-2016,29534,29985,451,1.527,57,394,13,305,H1
"Wayne County, GA",2016-2017,29985,29817,-168,-0.56,41,-209,13,305,H1
"Webster County, GA",2000-2001,2398,2369,-29,-1.209,12,-41,13,307,H1
"Webster County, GA",2001-2002,2369,2389,20,0.844,-9,29,13,307,H1
"Webster County, GA",2002-2003,2389,2488,99,4.144,0,99,13,307,H1
"Webster County, GA",2003-2004,2488,2549,61,2.452,-2,63,13,307,H1
"Webster County, GA",2004-2005,2549,2576,27,1.059,1,26,13,307,H1
"Webster County, GA",2005-2006,2576,2630,54,2.096,1,53,13,307,H1
"Webster County, GA",2006-2007,2630,2735,105,3.992,-2,107,13,307,H1
"Webster County, GA",2007-2008,2735,2710,-25,-0.914,8,-33,13,307,H1
"Webster County, GA",2008-2009,2710,2772,62,2.288,15,47,13,307,H1
"Webster County, GA",2009-2010,2772,2775,3,0.108,11,-8,13,307,H1
"Webster County, GA",2010-2011,2775,2797,22,0.793,-4,26,13,307,H1
"Webster County, GA",2011-2012,2797,2792,-5,-0.179,9,-14,13,307,H1
"Webster County, GA",2012-2013,2792,2707,-85,-3.044,6,-91,13,307,H1
"Webster County, GA",2013-2014,2707,2649,-58,-2.143,7,-65,13,307,H1
"Webster County, GA",2014-2015,2650,2648,-2,-0.075,8,-10,13,307,H1
"Webster County, GA",2015-2016,2648,2612,-36,-1.36,5,-41,13,307,H1
"Webster County, GA",2016-2017,2612,2605,-7,-0.268,7,-14,13,307,H1
"Wheeler County, GA",2000-2001,6174,6697,523,8.471,1,522,13,309,H1
"Wheeler County, GA",2001-2002,6697,6584,-113,-1.687,-1,-112,13,309,H1
"Wheeler County, GA",2002-2003,6584,6576,-8,-0.122,18,-26,13,309,H1
"Wheeler County, GA",2003-2004,6576,6500,-76,-1.156,30,-106,13,309,H1
"Wheeler County, GA",2004-2005,6500,6701,201,3.092,20,181,13,309,H1
"Wheeler County, GA",2005-2006,6701,6954,253,3.776,20,233,13,309,H1
"Wheeler County, GA",2006-2007,6954,6918,-36,-0.518,32,-68,13,309,H1
"Wheeler County, GA",2007-2008,6918,7018,100,1.446,42,58,13,309,H1
"Wheeler County, GA",2008-2009,7018,7150,132,1.881,38,94,13,309,H1
"Wheeler County, GA",2009-2010,7150,7761,611,8.545,41,570,13,309,H1
"Wheeler County, GA",2010-2011,7761,8059,298,3.84,13,285,13,309,H1
"Wheeler County, GA",2011-2012,8059,7908,-151,-1.874,-17,-134,13,309,H1
"Wheeler County, GA",2012-2013,7908,7939,31,0.392,12,19,13,309,H1
"Wheeler County, GA",2013-2014,7939,7995,56,0.705,2,54,13,309,H1
"Wheeler County, GA",2014-2015,7984,7903,-81,-1.015,0,-81,13,309,H1
"Wheeler County, GA",2015-2016,7903,8017,114,1.442,18,96,13,309,H1
"Wheeler County, GA",2016-2017,8017,7952,-65,-0.811,-1,-64,13,309,H1
"White County, GA",2000-2001,20186,21124,938,4.647,87,851,13,311,H1
"White County, GA",2001-2002,21124,22281,1157,5.477,73,1084,13,311,H1
"White County, GA",2002-2003,22281,23178,897,4.026,90,807,13,311,H1
"White County, GA",2003-2004,23178,24015,837,3.611,59,778,13,311,H1
"White County, GA",2004-2005,24015,24690,675,2.811,62,613,13,311,H1
"White County, GA",2005-2006,24690,25575,885,3.584,74,811,13,311,H1
"White County, GA",2006-2007,25575,26173,598,2.338,64,534,13,311,H1
"White County, GA",2007-2008,26173,26626,453,1.731,52,401,13,311,H1
"White County, GA",2008-2009,26626,26949,323,1.213,54,269,13,311,H1
"White County, GA",2009-2010,26949,27237,288,1.069,19,269,13,311,H1
"White County, GA",2010-2011,27237,27403,166,0.609,20,146,13,311,H1
"White County, GA",2011-2012,27403,27577,174,0.635,-25,199,13,311,H1
"White County, GA",2012-2013,27577,27781,204,0.74,30,174,13,311,H1
"White County, GA",2013-2014,27781,27970,189,0.68,14,175,13,311,H1
"White County, GA",2014-2015,27942,28319,377,1.349,3,374,13,311,H1
"White County, GA",2015-2016,28319,28825,506,1.787,-11,517,13,311,H1
"White County, GA",2016-2017,28825,29453,628,2.179,-8,636,13,311,H1
"Whitfield County, GA",2000-2001,84222,86332,2110,2.505,1043,1067,13,313,H1
"Whitfield County, GA",2001-2002,86332,88041,1709,1.98,1162,547,13,313,H1
"Whitfield County, GA",2002-2003,88041,89478,1437,1.632,935,502,13,313,H1
"Whitfield County, GA",2003-2004,89478,91842,2364,2.642,1131,1233,13,313,H1
"Whitfield County, GA",2004-2005,91842,94162,2320,2.526,1115,1205,13,313,H1
"Whitfield County, GA",2005-2006,94162,96408,2246,2.385,1144,1102,13,313,H1
"Whitfield County, GA",2006-2007,96408,98654,2246,2.33,1180,1066,13,313,H1
"Whitfield County, GA",2007-2008,98654,100546,1892,1.918,1134,758,13,313,H1
"Whitfield County, GA",2008-2009,100546,101009,463,0.46,1109,-646,13,313,H1
"Whitfield County, GA",2009-2010,101009,102769,1760,1.742,1003,757,13,313,H1
"Whitfield County, GA",2010-2011,102769,103076,307,0.299,744,-437,13,313,H1
"Whitfield County, GA",2011-2012,103076,103187,111,0.108,630,-519,13,313,H1
"Whitfield County, GA",2012-2013,103187,103087,-100,-0.097,578,-678,13,313,H1
"Whitfield County, GA",2013-2014,103087,103542,455,0.441,616,-161,13,313,H1
"Whitfield County, GA",2014-2015,103596,104216,620,0.598,616,4,13,313,H1
"Whitfield County, GA",2015-2016,104216,104698,482,0.463,585,-103,13,313,H1
"Whitfield County, GA",2016-2017,104698,104658,-40,-0.038,611,-651,13,313,H1
"Wilcox County, GA",2000-2001,8632,8868,236,2.734,6,230,13,315,H1
"Wilcox County, GA",2001-2002,8868,8766,-102,-1.15,17,-119,13,315,H1
"Wilcox County, GA",2002-2003,8766,8837,71,0.81,-5,76,13,315,H1
"Wilcox County, GA",2003-2004,8837,8882,45,0.509,1,44,13,315,H1
"Wilcox County, GA",2004-2005,8882,8789,-93,-1.047,3,-96,13,315,H1
"Wilcox County, GA",2005-2006,8789,8868,79,0.899,0,79,13,315,H1
"Wilcox County, GA",2006-2007,8868,8889,21,0.237,16,5,13,315,H1
"Wilcox County, GA",2007-2008,8889,9023,134,1.507,-4,138,13,315,H1
"Wilcox County, GA",2008-2009,9023,9156,133,1.474,-4,137,13,315,H1
"Wilcox County, GA",2009-2010,9156,9271,115,1.256,7,108,13,315,H1
"Wilcox County, GA",2010-2011,9271,9165,-106,-1.143,-3,-103,13,315,H1
"Wilcox County, GA",2011-2012,9165,9027,-138,-1.506,-14,-124,13,315,H1
"Wilcox County, GA",2012-2013,9027,8996,-31,-0.343,17,-48,13,315,H1
"Wilcox County, GA",2013-2014,8996,8847,-149,-1.656,-7,-142,13,315,H1
"Wilcox County, GA",2014-2015,8838,8857,19,0.215,-11,30,13,315,H1
"Wilcox County, GA",2015-2016,8857,8867,10,0.113,3,7,13,315,H1
"Wilcox County, GA",2016-2017,8867,8800,-67,-0.756,-8,-59,13,315,H1
"Wilkes County, GA",2000-2001,10694,10658,-36,-0.337,-10,-26,13,317,H1
"Wilkes County, GA",2001-2002,10658,10695,37,0.347,-17,54,13,317,H1
"Wilkes County, GA",2002-2003,10695,10736,41,0.383,-13,54,13,317,H1
"Wilkes County, GA",2003-2004,10736,10613,-123,-1.146,-21,-102,13,317,H1
"Wilkes County, GA",2004-2005,10613,10553,-60,-0.565,-8,-52,13,317,H1
"Wilkes County, GA",2005-2006,10553,10586,33,0.313,-8,41,13,317,H1
"Wilkes County, GA",2006-2007,10586,10524,-62,-0.586,7,-69,13,317,H1
"Wilkes County, GA",2007-2008,10524,10630,106,1.007,9,97,13,317,H1
"Wilkes County, GA",2008-2009,10630,10571,-59,-0.555,-9,-50,13,317,H1
"Wilkes County, GA",2009-2010,10571,10491,-80,-0.757,-16,-64,13,317,H1
"Wilkes County, GA",2010-2011,10491,10194,-297,-2.831,-20,-277,13,317,H1
"Wilkes County, GA",2011-2012,10194,10046,-148,-1.452,-18,-130,13,317,H1
"Wilkes County, GA",2012-2013,10046,9944,-102,-1.015,-30,-72,13,317,H1
"Wilkes County, GA",2013-2014,9944,9940,-4,-0.04,-28,24,13,317,H1
"Wilkes County, GA",2014-2015,9923,9867,-56,-0.564,-31,-25,13,317,H1
"Wilkes County, GA",2015-2016,9867,9822,-45,-0.456,-20,-25,13,317,H1
"Wilkes County, GA",2016-2017,9822,9892,70,0.713,-40,110,13,317,H1
"Wilkinson County, GA",2000-2001,10193,10227,34,0.334,39,-5,13,319,H1
"Wilkinson County, GA",2001-2002,10227,10126,-101,-0.988,52,-153,13,319,H1
"Wilkinson County, GA",2002-2003,10126,10040,-86,-0.849,16,-102,13,319,H1
"Wilkinson County, GA",2003-2004,10040,9968,-72,-0.717,40,-112,13,319,H1
"Wilkinson County, GA",2004-2005,9968,9881,-87,-0.873,44,-131,13,319,H1
"Wilkinson County, GA",2005-2006,9881,9793,-88,-0.891,88,-176,13,319,H1
"Wilkinson County, GA",2006-2007,9793,9750,-43,-0.439,79,-122,13,319,H1
"Wilkinson County, GA",2007-2008,9750,9691,-59,-0.605,77,-136,13,319,H1
"Wilkinson County, GA",2008-2009,9691,9652,-39,-0.402,51,-90,13,319,H1
"Wilkinson County, GA",2009-2010,9652,9516,-136,-1.409,41,-177,13,319,H1
"Wilkinson County, GA",2010-2011,9516,9457,-59,-0.62,23,-82,13,319,H1
"Wilkinson County, GA",2011-2012,9457,9542,85,0.899,-2,87,13,319,H1
"Wilkinson County, GA",2012-2013,9542,9436,-106,-1.111,16,-122,13,319,H1
"Wilkinson County, GA",2013-2014,9436,9326,-110,-1.166,-14,-96,13,319,H1
"Wilkinson County, GA",2014-2015,9344,9155,-189,-2.023,-11,-178,13,319,H1
"Wilkinson County, GA",2015-2016,9155,9048,-107,-1.169,-4,-103,13,319,H1
"Wilkinson County, GA",2016-2017,9048,8959,-89,-0.984,-39,-50,13,319,H1
"Worth County, GA",2000-2001,21983,22019,36,0.164,104,-68,13,321,H1
"Worth County, GA",2001-2002,22019,21873,-146,-0.663,117,-263,13,321,H1
"Worth County, GA",2002-2003,21873,21874,1,0.005,64,-63,13,321,H1
"Worth County, GA",2003-2004,21874,21873,-1,-0.005,38,-39,13,321,H1
"Worth County, GA",2004-2005,21873,21670,-203,-0.928,70,-273,13,321,H1
"Worth County, GA",2005-2006,21670,21783,113,0.521,52,61,13,321,H1
"Worth County, GA",2006-2007,21783,21646,-137,-0.629,58,-195,13,321,H1
"Worth County, GA",2007-2008,21646,21701,55,0.254,58,-3,13,321,H1
"Worth County, GA",2008-2009,21701,21799,98,0.452,18,80,13,321,H1
"Worth County, GA",2009-2010,21799,21734,-65,-0.298,80,-145,13,321,H1
"Worth County, GA",2010-2011,21734,21617,-117,-0.538,37,-154,13,321,H1
"Worth County, GA",2011-2012,21617,21470,-147,-0.68,29,-176,13,321,H1
"Worth County, GA",2012-2013,21470,21064,-406,-1.891,60,-466,13,321,H1
"Worth County, GA",2013-2014,21064,20940,-124,-0.589,25,-149,13,321,H1
"Worth County, GA",2014-2015,20952,20699,-253,-1.208,18,-271,13,321,H1
"Worth County, GA",2015-2016,20699,20719,20,0.097,44,-24,13,321,H1
"Worth County, GA",2016-2017,20719,20533,-186,-0.898,-6,-180,13,321,H1
Hawaii,2000-2001,1213519,1225948,12429,1.024,8811,3618,15,0,STATE
Hawaii,2001-2002,1225948,1239613,13665,1.115,8481,5184,15,0,STATE
Hawaii,2002-2003,1239613,1251154,11541,0.931,9355,2186,15,0,STATE
Hawaii,2003-2004,1251154,1273569,22415,1.792,9499,12916,15,0,STATE
Hawaii,2004-2005,1273569,1292729,19160,1.504,9171,9989,15,0,STATE
Hawaii,2005-2006,1292729,1309731,17002,1.315,9257,7745,15,0,STATE
Hawaii,2006-2007,1309731,1315675,5944,0.454,9788,-3844,15,0,STATE
Hawaii,2007-2008,1315675,1332213,16538,1.257,9657,6881,15,0,STATE
Hawaii,2008-2009,1332213,1346717,14504,1.089,9301,5203,15,0,STATE
Hawaii,2009-2010,1346717,1363980,17263,1.282,8655,8608,15,0,STATE
Hawaii,2010-2011,1363980,1378227,14247,1.045,9069,5178,15,0,STATE
Hawaii,2011-2012,1378227,1392641,14414,1.046,8644,5770,15,0,STATE
Hawaii,2012-2013,1392641,1408765,16124,1.158,8699,7425,15,0,STATE
Hawaii,2013-2014,1408765,1420257,11492,0.816,7420,4072,15,0,STATE
Hawaii,2014-2015,1420257,1431603,11346,0.799,7614,3732,15,0,STATE
Hawaii,2015-2016,1431603,1428683,-2920,-0.204,6266,-9186,15,0,STATE
Hawaii,2016-2017,1428683,1427538,-1145,-0.08,5716,-6861,15,0,STATE
"Hawaii County, HI",2000-2001,149244,151690,2446,1.639,775,1671,15,1,H1
"Hawaii County, HI",2001-2002,151690,154576,2886,1.903,653,2233,15,1,H1
"Hawaii County, HI",2002-2003,154576,158442,3866,2.501,836,3030,15,1,H1
"Hawaii County, HI",2003-2004,158442,162852,4410,2.783,999,3411,15,1,H1
"Hawaii County, HI",2004-2005,162852,168237,5385,3.307,1095,4290,15,1,H1
"Hawaii County, HI",2005-2006,168237,173536,5299,3.15,995,4304,15,1,H1
"Hawaii County, HI",2006-2007,173536,177733,4197,2.419,1163,3034,15,1,H1
"Hawaii County, HI",2007-2008,177733,181506,3773,2.123,1143,2630,15,1,H1
"Hawaii County, HI",2008-2009,181506,183629,2123,1.17,1248,875,15,1,H1
"Hawaii County, HI",2009-2010,183629,185325,1696,0.924,1002,694,15,1,H1
"Hawaii County, HI",2010-2011,185325,187039,1714,0.925,1064,650,15,1,H1
"Hawaii County, HI",2011-2012,187039,188946,1907,1.02,940,967,15,1,H1
"Hawaii County, HI",2012-2013,188946,191409,2463,1.304,764,1699,15,1,H1
"Hawaii County, HI",2013-2014,191409,194190,2781,1.453,726,2055,15,1,H1
"Hawaii County, HI",2014-2015,194016,196428,2412,1.243,726,1686,15,1,H1
"Hawaii County, HI",2015-2016,196428,198681,2253,1.147,405,1848,15,1,H1
"Hawaii County, HI",2016-2017,198681,200381,1700,0.856,417,1283,15,1,H1
"Honolulu County, HI",2000-2001,876629,882755,6126,0.699,6821,-695,15,3,H1
"Honolulu County, HI",2001-2002,882755,890473,7718,0.874,6573,1145,15,3,H1
"Honolulu County, HI",2002-2003,890473,894311,3838,0.431,7052,-3214,15,3,H1
"Honolulu County, HI",2003-2004,894311,907997,13686,1.53,7108,6578,15,3,H1
"Honolulu County, HI",2004-2005,907997,918181,10184,1.122,6713,3471,15,3,H1
"Honolulu County, HI",2005-2006,918181,926954,8773,0.955,6852,1921,15,3,H1
"Honolulu County, HI",2006-2007,926954,925335,-1619,-0.175,7092,-8711,15,3,H1
"Honolulu County, HI",2007-2008,925335,933680,8345,0.902,6931,1414,15,3,H1
"Honolulu County, HI",2008-2009,933680,943177,9497,1.017,6483,3014,15,3,H1
"Honolulu County, HI",2009-2010,943177,956336,13159,1.395,6172,6987,15,3,H1
"Honolulu County, HI",2010-2011,956336,966559,10223,1.069,6724,3499,15,3,H1
"Honolulu County, HI",2011-2012,966559,976746,10187,1.054,6386,3801,15,3,H1
"Honolulu County, HI",2012-2013,976746,987019,10273,1.052,5949,4324,15,3,H1
"Honolulu County, HI",2013-2014,987019,991788,4769,0.483,5874,-1105,15,3,H1
"Honolulu County, HI",2014-2015,992082,998714,6632,0.668,5779,853,15,3,H1
"Honolulu County, HI",2015-2016,998714,992761,-5953,-0.596,5030,-10983,15,3,H1
"Honolulu County, HI",2016-2017,992761,988650,-4111,-0.414,4526,-8637,15,3,H1
"Kalawao County, HI",2000-2001,145,138,-7,-4.828,-3,-4,15,5,H4
"Kalawao County, HI",2001-2002,138,133,-5,-3.623,0,-5,15,5,H4
"Kalawao County, HI",2002-2003,133,127,-6,-4.511,-3,-3,15,5,H4
"Kalawao County, HI",2003-2004,127,117,-10,-7.874,-6,-4,15,5,H4
"Kalawao County, HI",2004-2005,117,114,-3,-2.564,0,-3,15,5,H4
"Kalawao County, HI",2005-2006,114,109,-5,-4.386,-1,-4,15,5,H4
"Kalawao County, HI",2006-2007,109,105,-4,-3.67,-1,-3,15,5,H4
"Kalawao County, HI",2007-2008,105,99,-6,-5.714,-4,-2,15,5,H4
"Kalawao County, HI",2008-2009,99,93,-6,-6.061,-2,-4,15,5,H4
"Kalawao County, HI",2009-2010,93,90,-3,-3.226,0,-3,15,5,H4
"Kalawao County, HI",2010-2011,90,90,0,0,0,0,15,5,H4
"Kalawao County, HI",2011-2012,90,89,-1,-1.111,-1,0,15,5,H4
"Kalawao County, HI",2012-2013,89,89,0,0,0,0,15,5,H4
"Kalawao County, HI",2013-2014,89,89,0,0,0,0,15,5,H4
"Kalawao County, HI",2014-2015,89,89,0,0,0,0,15,5,H4
"Kalawao County, HI",2015-2016,89,88,-1,-1.124,0,-1,15,5,H4
"Kalawao County, HI",2016-2017,88,88,0,0,0,0,15,5,H4
"Kauai County, HI",2000-2001,58568,59075,507,0.866,315,192,15,7,H1
"Kauai County, HI",2001-2002,59075,59981,906,1.534,328,578,15,7,H1
"Kauai County, HI",2002-2003,59981,60805,824,1.374,368,456,15,7,H1
"Kauai County, HI",2003-2004,60805,62095,1290,2.122,383,907,15,7,H1
"Kauai County, HI",2004-2005,62095,62863,768,1.237,333,435,15,7,H1
"Kauai County, HI",2005-2006,62863,63465,602,0.958,341,261,15,7,H1
"Kauai County, HI",2006-2007,63465,64490,1025,1.615,366,659,15,7,H1
"Kauai County, HI",2007-2008,64490,65603,1113,1.726,417,696,15,7,H1
"Kauai County, HI",2008-2009,65603,66518,915,1.395,445,470,15,7,H1
"Kauai County, HI",2009-2010,66518,67217,699,1.051,401,298,15,7,H1
"Kauai County, HI",2010-2011,67217,67799,582,0.866,320,262,15,7,H1
"Kauai County, HI",2011-2012,67799,68553,754,1.112,391,363,15,7,H1
"Kauai County, HI",2012-2013,68553,69679,1126,1.643,274,852,15,7,H1
"Kauai County, HI",2013-2014,69679,70475,796,1.142,250,546,15,7,H1
"Kauai County, HI",2014-2015,70672,71735,1063,1.504,288,775,15,7,H1
"Kauai County, HI",2015-2016,71735,71769,34,0.047,217,-183,15,7,H1
"Kauai County, HI",2016-2017,71769,72159,390,0.543,205,185,15,7,H1
"Maui County, HI",2000-2001,128933,132290,3357,2.604,903,2454,15,9,H1
"Maui County, HI",2001-2002,132290,134450,2160,1.633,927,1233,15,9,H1
"Maui County, HI",2002-2003,134450,137469,3019,2.245,1102,1917,15,9,H1
"Maui County, HI",2003-2004,137469,140508,3039,2.211,1015,2024,15,9,H1
"Maui County, HI",2004-2005,140508,143334,2826,2.011,1030,1796,15,9,H1
"Maui County, HI",2005-2006,143334,145667,2333,1.628,1070,1263,15,9,H1
"Maui County, HI",2006-2007,145667,148012,2345,1.61,1168,1177,15,9,H1
"Maui County, HI",2007-2008,148012,151325,3313,2.238,1170,2143,15,9,H1
"Maui County, HI",2008-2009,151325,153300,1975,1.305,1127,848,15,9,H1
"Maui County, HI",2009-2010,153300,154982,1682,1.097,1080,602,15,9,H1
"Maui County, HI",2010-2011,154982,156764,1782,1.15,998,784,15,9,H1
"Maui County, HI",2011-2012,156764,158432,1668,1.064,947,721,15,9,H1
"Maui County, HI",2012-2013,158432,160791,2359,1.489,854,1505,15,9,H1
"Maui County, HI",2013-2014,160791,163019,2228,1.386,793,1435,15,9,H1
"Maui County, HI",2014-2015,163398,164637,1239,0.758,821,418,15,9,H1
"Maui County, HI",2015-2016,164637,165384,747,0.454,614,133,15,9,H1
"Maui County, HI",2016-2017,165384,166260,876,0.53,568,308,15,9,H1
Idaho,2000-2001,1299430,1319962,20532,1.58,10946,9586,16,0,STATE
Idaho,2001-2002,1319962,1340372,20410,1.546,10895,9515,16,0,STATE
Idaho,2002-2003,1340372,1363380,23008,1.717,11336,11672,16,0,STATE
Idaho,2003-2004,1363380,1391802,28422,2.085,11916,16506,16,0,STATE
Idaho,2004-2005,1391802,1428241,36439,2.618,12418,24021,16,0,STATE
Idaho,2005-2006,1428241,1468669,40428,2.831,13137,27291,16,0,STATE
Idaho,2006-2007,1468669,1505105,36436,2.481,14146,22290,16,0,STATE
Idaho,2007-2008,1505105,1534320,29215,1.941,14346,14869,16,0,STATE
Idaho,2008-2009,1534320,1554439,20119,1.311,14256,5863,16,0,STATE
Idaho,2009-2010,1554439,1570986,16547,1.064,13512,3035,16,0,STATE
Idaho,2010-2011,1570986,1584134,13148,0.837,11071,2077,16,0,STATE
Idaho,2011-2012,1584134,1596097,11963,0.755,10469,1494,16,0,STATE
Idaho,2012-2013,1596097,1612785,16688,1.046,10406,6282,16,0,STATE
Idaho,2013-2014,1612785,1634806,22021,1.365,10442,11579,16,0,STATE
Idaho,2014-2015,1634806,1654930,20124,1.231,10925,9199,16,0,STATE
Idaho,2015-2016,1654930,1680026,25096,1.516,10142,14954,16,0,STATE
Idaho,2016-2017,1680026,1716943,36917,2.197,10328,26589,16,0,STATE
"Ada County, ID",2000-2001,303328,313896,10568,3.484,3047,7521,16,1,H1
"Ada County, ID",2001-2002,313896,321616,7720,2.459,2959,4761,16,1,H1
"Ada County, ID",2002-2003,321616,327393,5777,1.796,3166,2611,16,1,H1
"Ada County, ID",2003-2004,327393,334926,7533,2.301,3131,4402,16,1,H1
"Ada County, ID",2004-2005,334926,348755,13829,4.129,3210,10619,16,1,H1
"Ada County, ID",2005-2006,348755,363498,14743,4.227,3414,11329,16,1,H1
"Ada County, ID",2006-2007,363498,375368,11870,3.265,3592,8278,16,1,H1
"Ada County, ID",2007-2008,375368,382618,7250,1.931,3478,3772,16,1,H1
"Ada County, ID",2008-2009,382618,388577,5959,1.557,3561,2398,16,1,H1
"Ada County, ID",2009-2010,388577,393412,4835,1.244,3186,1649,16,1,H1
"Ada County, ID",2010-2011,393412,401100,7688,1.954,2646,5042,16,1,H1
"Ada County, ID",2011-2012,401100,408891,7791,1.942,2479,5312,16,1,H1
"Ada County, ID",2012-2013,408891,416556,7665,1.875,2643,5022,16,1,H1
"Ada County, ID",2013-2014,416556,426236,9680,2.324,2561,7119,16,1,H1
"Ada County, ID",2014-2015,426847,434211,7364,1.725,2492,4872,16,1,H1
"Ada County, ID",2015-2016,434211,444269,10058,2.316,2222,7836,16,1,H1
"Ada County, ID",2016-2017,444269,456849,12580,2.832,2271,10309,16,1,H1
"Adams County, ID",2000-2001,3477,3495,18,0.518,-14,32,16,3,H1
"Adams County, ID",2001-2002,3495,3559,64,1.831,-2,66,16,3,H1
"Adams County, ID",2002-2003,3559,3624,65,1.826,-2,67,16,3,H1
"Adams County, ID",2003-2004,3624,3693,69,1.904,-8,77,16,3,H1
"Adams County, ID",2004-2005,3693,3817,124,3.358,0,124,16,3,H1
"Adams County, ID",2005-2006,3817,3788,-29,-0.76,-9,-20,16,3,H1
"Adams County, ID",2006-2007,3788,3949,161,4.25,29,132,16,3,H1
"Adams County, ID",2007-2008,3949,4021,72,1.823,7,65,16,3,H1
"Adams County, ID",2008-2009,4021,4.00E+03,-21,-0.522,13,-34,16,3,H1
"Adams County, ID",2009-2010,4.00E+03,3956,-44,-1.1,15,-59,16,3,H1
"Adams County, ID",2010-2011,3956,3982,26,0.657,-20,46,16,3,H1
"Adams County, ID",2011-2012,3982,3908,-74,-1.858,5,-79,16,3,H1
"Adams County, ID",2012-2013,3908,3831,-77,-1.97,6,-83,16,3,H1
"Adams County, ID",2013-2014,3831,3861,30,0.783,9,21,16,3,H1
"Adams County, ID",2014-2015,3848,3843,-5,-0.13,11,-16,16,3,H1
"Adams County, ID",2015-2016,3843,3949,106,2.758,4,102,16,3,H1
"Adams County, ID",2016-2017,3949,4147,198,5.014,6,192,16,3,H1
"Bannock County, ID",2000-2001,75728,76296,568,0.75,848,-280,16,5,H1
"Bannock County, ID",2001-2002,76296,76487,191,0.25,796,-605,16,5,H1
"Bannock County, ID",2002-2003,76487,76312,-175,-0.229,793,-968,16,5,H1
"Bannock County, ID",2003-2004,76312,76834,522,0.684,894,-372,16,5,H1
"Bannock County, ID",2004-2005,76834,77419,585,0.761,977,-392,16,5,H1
"Bannock County, ID",2005-2006,77419,78491,1072,1.385,813,259,16,5,H1
"Bannock County, ID",2006-2007,78491,79338,847,1.079,900,-53,16,5,H1
"Bannock County, ID",2007-2008,79338,80609,1271,1.602,910,361,16,5,H1
"Bannock County, ID",2008-2009,80609,81994,1385,1.718,938,447,16,5,H1
"Bannock County, ID",2009-2010,81994,8.30E+04,1006,1.227,1006,0,16,5,H1
"Bannock County, ID",2010-2011,8.30E+04,83562,562,0.677,765,-203,16,5,H1
"Bannock County, ID",2011-2012,83562,83741,179,0.214,630,-451,16,5,H1
"Bannock County, ID",2012-2013,83741,83322,-419,-0.5,644,-1063,16,5,H1
"Bannock County, ID",2013-2014,83322,83347,25,0.03,632,-607,16,5,H1
"Bannock County, ID",2014-2015,83471,83744,273,0.327,628,-355,16,5,H1
"Bannock County, ID",2015-2016,83744,84379,635,0.758,549,86,16,5,H1
"Bannock County, ID",2016-2017,84379,85269,890,1.055,548,342,16,5,H1
"Bear Lake County, ID",2000-2001,6424,6394,-30,-0.467,26,-56,16,7,H1
"Bear Lake County, ID",2001-2002,6394,6219,-175,-2.737,24,-199,16,7,H1
"Bear Lake County, ID",2002-2003,6219,6219,0,0,21,-21,16,7,H1
"Bear Lake County, ID",2003-2004,6219,6170,-49,-0.788,13,-62,16,7,H1
"Bear Lake County, ID",2004-2005,6170,6077,-93,-1.507,11,-104,16,7,H1
"Bear Lake County, ID",2005-2006,6077,6071,-6,-0.099,18,-24,16,7,H1
"Bear Lake County, ID",2006-2007,6071,6049,-22,-0.362,9,-31,16,7,H1
"Bear Lake County, ID",2007-2008,6049,6027,-22,-0.364,20,-42,16,7,H1
"Bear Lake County, ID",2008-2009,6027,6014,-13,-0.216,16,-29,16,7,H1
"Bear Lake County, ID",2009-2010,6014,5968,-46,-0.765,28,-74,16,7,H1
"Bear Lake County, ID",2010-2011,5968,5952,-16,-0.268,3,-19,16,7,H1
"Bear Lake County, ID",2011-2012,5952,5889,-63,-1.058,9,-72,16,7,H1
"Bear Lake County, ID",2012-2013,5889,5937,48,0.815,39,9,16,7,H1
"Bear Lake County, ID",2013-2014,5937,5957,20,0.337,33,-13,16,7,H1
"Bear Lake County, ID",2014-2015,5955,5922,-33,-0.554,26,-59,16,7,H1
"Bear Lake County, ID",2015-2016,5922,5942,20,0.338,45,-25,16,7,H1
"Bear Lake County, ID",2016-2017,5942,6028,86,1.447,21,65,16,7,H1
"Benewah County, ID",2000-2001,9186,8968,-218,-2.373,34,-252,16,9,H1
"Benewah County, ID",2001-2002,8968,8917,-51,-0.569,21,-72,16,9,H1
"Benewah County, ID",2002-2003,8917,8901,-16,-0.179,-11,-5,16,9,H1
"Benewah County, ID",2003-2004,8901,8907,6,0.067,41,-35,16,9,H1
"Benewah County, ID",2004-2005,8907,9053,146,1.639,7,139,16,9,H1
"Benewah County, ID",2005-2006,9053,9260,207,2.287,40,167,16,9,H1
"Benewah County, ID",2006-2007,9260,9296,36,0.389,31,5,16,9,H1
"Benewah County, ID",2007-2008,9296,9385,89,0.957,11,78,16,9,H1
"Benewah County, ID",2008-2009,9385,9286,-99,-1.055,16,-115,16,9,H1
"Benewah County, ID",2009-2010,9286,9287,1,0.011,12,-11,16,9,H1
"Benewah County, ID",2010-2011,9287,9168,-119,-1.281,-15,-104,16,9,H1
"Benewah County, ID",2011-2012,9168,9125,-43,-0.469,0,-43,16,9,H1
"Benewah County, ID",2012-2013,9125,9049,-76,-0.833,26,-102,16,9,H1
"Benewah County, ID",2013-2014,9049,9118,69,0.763,13,56,16,9,H1
"Benewah County, ID",2014-2015,9080,9052,-28,-0.308,-5,-23,16,9,H1
"Benewah County, ID",2015-2016,9052,9022,-30,-0.331,-18,-12,16,9,H1
"Benewah County, ID",2016-2017,9022,9184,162,1.796,-7,169,16,9,H1
"Bingham County, ID",2000-2001,41753,42073,320,0.766,479,-159,16,11,H1
"Bingham County, ID",2001-2002,42073,42101,28,0.067,448,-420,16,11,H1
"Bingham County, ID",2002-2003,42101,42555,454,1.078,514,-60,16,11,H1
"Bingham County, ID",2003-2004,42555,42702,147,0.345,459,-312,16,11,H1
"Bingham County, ID",2004-2005,42702,43173,471,1.103,541,-70,16,11,H1
"Bingham County, ID",2005-2006,43173,43396,223,0.517,528,-305,16,11,H1
"Bingham County, ID",2006-2007,43396,43816,420,0.968,503,-83,16,11,H1
"Bingham County, ID",2007-2008,43816,44414,598,1.365,571,27,16,11,H1
"Bingham County, ID",2008-2009,44414,45087,673,1.515,581,92,16,11,H1
"Bingham County, ID",2009-2010,45087,45736,649,1.439,538,111,16,11,H1
"Bingham County, ID",2010-2011,45736,45884,148,0.324,420,-272,16,11,H1
"Bingham County, ID",2011-2012,45884,45493,-391,-0.852,407,-798,16,11,H1
"Bingham County, ID",2012-2013,45493,45408,-85,-0.187,477,-562,16,11,H1
"Bingham County, ID",2013-2014,45408,45269,-139,-0.306,452,-591,16,11,H1
"Bingham County, ID",2014-2015,45204,44990,-214,-0.473,380,-594,16,11,H1
"Bingham County, ID",2015-2016,44990,45255,265,0.589,345,-80,16,11,H1
"Bingham County, ID",2016-2017,45255,45927,672,1.485,339,333,16,11,H1
"Blaine County, ID",2000-2001,19115,19755,640,3.348,179,461,16,13,H1
"Blaine County, ID",2001-2002,19755,20189,434,2.197,204,230,16,13,H1
"Blaine County, ID",2002-2003,20189,20557,368,1.823,180,188,16,13,H1
"Blaine County, ID",2003-2004,20557,20811,254,1.236,177,77,16,13,H1
"Blaine County, ID",2004-2005,20811,20897,86,0.413,223,-137,16,13,H1
"Blaine County, ID",2005-2006,20897,21082,185,0.885,224,-39,16,13,H1
"Blaine County, ID",2006-2007,21082,21169,87,0.413,236,-149,16,13,H1
"Blaine County, ID",2007-2008,21169,21477,308,1.455,223,85,16,13,H1
"Blaine County, ID",2008-2009,21477,21590,113,0.526,195,-82,16,13,H1
"Blaine County, ID",2009-2010,21590,21295,-295,-1.366,186,-481,16,13,H1
"Blaine County, ID",2010-2011,21295,21104,-191,-0.897,135,-326,16,13,H1
"Blaine County, ID",2011-2012,21104,21140,36,0.171,141,-105,16,13,H1
"Blaine County, ID",2012-2013,21140,21322,182,0.861,143,39,16,13,H1
"Blaine County, ID",2013-2014,21322,21482,160,0.75,136,24,16,13,H1
"Blaine County, ID",2014-2015,21443,21592,149,0.695,117,32,16,13,H1
"Blaine County, ID",2015-2016,21592,21741,149,0.69,108,41,16,13,H1
"Blaine County, ID",2016-2017,21741,22024,283,1.302,118,165,16,13,H1
"Boise County, ID",2000-2001,6702,6733,31,0.463,32,-1,16,15,H1
"Boise County, ID",2001-2002,6733,6854,121,1.797,36,85,16,15,H1
"Boise County, ID",2002-2003,6854,6977,123,1.795,21,102,16,15,H1
"Boise County, ID",2003-2004,6977,7004,27,0.387,41,-14,16,15,H1
"Boise County, ID",2004-2005,7004,6981,-23,-0.328,8,-31,16,15,H1
"Boise County, ID",2005-2006,6981,7151,170,2.435,1,169,16,15,H1
"Boise County, ID",2006-2007,7151,7229,78,1.091,18,60,16,15,H1
"Boise County, ID",2007-2008,7229,7148,-81,-1.12,9,-90,16,15,H1
"Boise County, ID",2008-2009,7148,7051,-97,-1.357,12,-109,16,15,H1
"Boise County, ID",2009-2010,7051,7019,-32,-0.454,20,-52,16,15,H1
"Boise County, ID",2010-2011,7019,7011,-8,-0.114,-21,13,16,15,H1
"Boise County, ID",2011-2012,7011,6803,-208,-2.967,-12,-196,16,15,H1
"Boise County, ID",2012-2013,6803,6744,-59,-0.867,1,-60,16,15,H1
"Boise County, ID",2013-2014,6744,6824,80,1.186,-13,93,16,15,H1
"Boise County, ID",2014-2015,6826,7058,232,3.399,-4,236,16,15,H1
"Boise County, ID",2015-2016,7058,7088,30,0.425,-4,34,16,15,H1
"Boise County, ID",2016-2017,7088,7290,202,2.85,-12,214,16,15,H1
"Bonner County, ID",2000-2001,36950,36980,30,0.081,69,-39,16,17,H1
"Bonner County, ID",2001-2002,36980,37634,654,1.769,63,591,16,17,H1
"Bonner County, ID",2002-2003,37634,38382,748,1.988,56,692,16,17,H1
"Bonner County, ID",2003-2004,38382,38836,454,1.183,29,425,16,17,H1
"Bonner County, ID",2004-2005,38836,39576,740,1.905,30,710,16,17,H1
"Bonner County, ID",2005-2006,39576,40127,551,1.392,96,455,16,17,H1
"Bonner County, ID",2006-2007,40127,40738,611,1.523,79,532,16,17,H1
"Bonner County, ID",2007-2008,40738,40966,228,0.56,94,134,16,17,H1
"Bonner County, ID",2008-2009,40966,40809,-157,-0.383,78,-235,16,17,H1
"Bonner County, ID",2009-2010,40809,40927,118,0.289,18,100,16,17,H1
"Bonner County, ID",2010-2011,40927,40831,-96,-0.235,13,-109,16,17,H1
"Bonner County, ID",2011-2012,40831,40447,-384,-0.94,-44,-340,16,17,H1
"Bonner County, ID",2012-2013,40447,40703,256,0.633,25,231,16,17,H1
"Bonner County, ID",2013-2014,40703,41585,882,2.167,35,847,16,17,H1
"Bonner County, ID",2014-2015,41533,41859,326,0.785,24,302,16,17,H1
"Bonner County, ID",2015-2016,41859,42343,484,1.156,-1,485,16,17,H1
"Bonner County, ID",2016-2017,42343,43560,1217,2.874,-7,1224,16,17,H1
"Bonneville County, ID",2000-2001,82968,83907,939,1.132,883,56,16,19,H1
"Bonneville County, ID",2001-2002,83907,85060,1153,1.374,888,265,16,19,H1
"Bonneville County, ID",2002-2003,85060,86846,1786,2.1,960,826,16,19,H1
"Bonneville County, ID",2003-2004,86846,89514,2668,3.072,1057,1611,16,19,H1
"Bonneville County, ID",2004-2005,89514,91709,2195,2.452,1184,1011,16,19,H1
"Bonneville County, ID",2005-2006,91709,94756,3047,3.322,1176,1871,16,19,H1
"Bonneville County, ID",2006-2007,94756,97890,3134,3.307,1238,1896,16,19,H1
"Bonneville County, ID",2007-2008,97890,100811,2921,2.984,1378,1543,16,19,H1
"Bonneville County, ID",2008-2009,100811,103016,2205,2.187,1360,845,16,19,H1
"Bonneville County, ID",2009-2010,103016,104666,1650,1.602,1264,386,16,19,H1
"Bonneville County, ID",2010-2011,104666,105797,1131,1.081,1314,-183,16,19,H1
"Bonneville County, ID",2011-2012,105797,106880,1083,1.024,1098,-15,16,19,H1
"Bonneville County, ID",2012-2013,106880,107550,670,0.627,1150,-480,16,19,H1
"Bonneville County, ID",2013-2014,107550,108623,1073,0.998,1186,-113,16,19,H1
"Bonneville County, ID",2014-2015,108526,110089,1563,1.44,1098,465,16,19,H1
"Bonneville County, ID",2015-2016,110089,112025,1936,1.759,1105,831,16,19,H1
"Bonneville County, ID",2016-2017,112025,114595,2570,2.294,1147,1423,16,19,H1
"Boundary County, ID",2000-2001,9913,9816,-97,-0.979,45,-142,16,21,H1
"Boundary County, ID",2001-2002,9816,9834,18,0.183,43,-25,16,21,H1
"Boundary County, ID",2002-2003,9834,9960,126,1.281,48,78,16,21,H1
"Boundary County, ID",2003-2004,9960,10163,203,2.038,12,191,16,21,H1
"Boundary County, ID",2004-2005,10163,10303,140,1.378,20,120,16,21,H1
"Boundary County, ID",2005-2006,10303,10530,227,2.203,38,189,16,21,H1
"Boundary County, ID",2006-2007,10530,10754,224,2.127,48,176,16,21,H1
"Boundary County, ID",2007-2008,10754,10831,77,0.716,18,59,16,21,H1
"Boundary County, ID",2008-2009,10831,10819,-12,-0.111,45,-57,16,21,H1
"Boundary County, ID",2009-2010,10819,11015,196,1.812,24,172,16,21,H1
"Boundary County, ID",2010-2011,11015,10821,-194,-1.761,20,-214,16,21,H1
"Boundary County, ID",2011-2012,10821,10835,14,0.129,29,-15,16,21,H1
"Boundary County, ID",2012-2013,10835,10865,30,0.277,15,15,16,21,H1
"Boundary County, ID",2013-2014,10865,10979,114,1.049,2,112,16,21,H1
"Boundary County, ID",2014-2015,10977,11318,341,3.106,18,323,16,21,H1
"Boundary County, ID",2015-2016,11318,11650,332,2.933,53,279,16,21,H1
"Boundary County, ID",2016-2017,11650,11922,272,2.335,35,237,16,21,H1
"Butte County, ID",2000-2001,2894,2853,-41,-1.417,8,-49,16,23,H1
"Butte County, ID",2001-2002,2853,2906,53,1.858,28,25,16,23,H1
"Butte County, ID",2002-2003,2906,2842,-64,-2.202,4,-68,16,23,H1
"Butte County, ID",2003-2004,2842,2812,-30,-1.056,6,-36,16,23,H1
"Butte County, ID",2004-2005,2812,2825,13,0.462,20,-7,16,23,H1
"Butte County, ID",2005-2006,2825,2786,-39,-1.381,-4,-35,16,23,H1
"Butte County, ID",2006-2007,2786,2838,52,1.866,23,29,16,23,H1
"Butte County, ID",2007-2008,2838,2846,8,0.282,26,-18,16,23,H1
"Butte County, ID",2008-2009,2846,2835,-11,-0.387,26,-37,16,23,H1
"Butte County, ID",2009-2010,2835,2899,64,2.257,28,36,16,23,H1
"Butte County, ID",2010-2011,2899,2798,-101,-3.484,0,-101,16,23,H1
"Butte County, ID",2011-2012,2798,2722,-76,-2.716,7,-83,16,23,H1
"Butte County, ID",2012-2013,2722,2628,-94,-3.453,2,-96,16,23,H1
"Butte County, ID",2013-2014,2628,2622,-6,-0.228,14,-20,16,23,H1
"Butte County, ID",2014-2015,2612,2501,-111,-4.25,13,-124,16,23,H1
"Butte County, ID",2015-2016,2501,2573,72,2.879,8,64,16,23,H1
"Butte County, ID",2016-2017,2573,2602,29,1.127,14,15,16,23,H1
"Camas County, ID",2000-2001,968,1.00E+03,32,3.306,5,27,16,25,H1
"Camas County, ID",2001-2002,1.00E+03,1025,25,2.5,7,18,16,25,H1
"Camas County, ID",2002-2003,1025,1029,4,0.39,-1,5,16,25,H1
"Camas County, ID",2003-2004,1029,1022,-7,-0.68,6,-13,16,25,H1
"Camas County, ID",2004-2005,1022,1069,47,4.599,10,37,16,25,H1
"Camas County, ID",2005-2006,1069,1073,4,0.374,10,-6,16,25,H1
"Camas County, ID",2006-2007,1073,1103,30,2.796,5,25,16,25,H1
"Camas County, ID",2007-2008,1103,1120,17,1.541,12,5,16,25,H1
"Camas County, ID",2008-2009,1120,1133,13,1.161,16,-3,16,25,H1
"Camas County, ID",2009-2010,1133,1108,-25,-2.207,14,-39,16,25,H1
"Camas County, ID",2010-2011,1108,1099,-9,-0.812,7,-16,16,25,H1
"Camas County, ID",2011-2012,1099,1075,-24,-2.184,6,-30,16,25,H1
"Camas County, ID",2012-2013,1075,1039,-36,-3.349,4,-40,16,25,H1
"Camas County, ID",2013-2014,1039,1039,0,0,7,-7,16,25,H1
"Camas County, ID",2014-2015,1038,1066,28,2.697,4,24,16,25,H1
"Camas County, ID",2015-2016,1066,1084,18,1.689,3,15,16,25,H1
"Camas County, ID",2016-2017,1084,1102,18,1.661,5,13,16,25,H1
"Canyon County, ID",2000-2001,133082,139179,6097,4.581,1658,4439,16,27,H1
"Canyon County, ID",2001-2002,139179,145160,5981,4.297,1849,4132,16,27,H1
"Canyon County, ID",2002-2003,145160,151395,6235,4.295,1941,4294,16,27,H1
"Canyon County, ID",2003-2004,151395,157130,5735,3.788,1969,3766,16,27,H1
"Canyon County, ID",2004-2005,157130,163947,6817,4.338,2078,4739,16,27,H1
"Canyon County, ID",2005-2006,163947,172188,8241,5.027,2206,6035,16,27,H1
"Canyon County, ID",2006-2007,172188,179645,7457,4.331,2462,4995,16,27,H1
"Canyon County, ID",2007-2008,179645,184996,5351,2.979,2386,2965,16,27,H1
"Canyon County, ID",2008-2009,184996,187357,2361,1.276,2316,45,16,27,H1
"Canyon County, ID",2009-2010,187357,189339,1982,1.058,2094,-112,16,27,H1
"Canyon County, ID",2010-2011,189339,191386,2047,1.081,1900,147,16,27,H1
"Canyon County, ID",2011-2012,191386,193856,2470,1.291,1730,740,16,27,H1
"Canyon County, ID",2012-2013,193856,199040,5184,2.674,1749,3435,16,27,H1
"Canyon County, ID",2013-2014,199040,203143,4103,2.061,1881,2222,16,27,H1
"Canyon County, ID",2014-2015,202951,207478,4527,2.231,1908,2619,16,27,H1
"Canyon County, ID",2015-2016,207478,211111,3633,1.751,1776,1857,16,27,H1
"Canyon County, ID",2016-2017,211111,216699,5588,2.647,1763,3825,16,27,H1
"Caribou County, ID",2000-2001,7281,7326,45,0.618,41,4,16,29,H1
"Caribou County, ID",2001-2002,7326,7161,-165,-2.252,29,-194,16,29,H1
"Caribou County, ID",2002-2003,7161,7105,-56,-0.782,52,-108,16,29,H1
"Caribou County, ID",2003-2004,7105,7106,1,0.014,47,-46,16,29,H1
"Caribou County, ID",2004-2005,7106,6963,-143,-2.012,34,-177,16,29,H1
"Caribou County, ID",2005-2006,6963,6886,-77,-1.106,34,-111,16,29,H1
"Caribou County, ID",2006-2007,6886,6873,-13,-0.189,25,-38,16,29,H1
"Caribou County, ID",2007-2008,6873,6840,-33,-0.48,46,-79,16,29,H1
"Caribou County, ID",2008-2009,6840,6922,82,1.199,53,29,16,29,H1
"Caribou County, ID",2009-2010,6922,6976,54,0.78,50,4,16,29,H1
"Caribou County, ID",2010-2011,6976,6857,-119,-1.706,41,-160,16,29,H1
"Caribou County, ID",2011-2012,6857,6785,-72,-1.05,8,-80,16,29,H1
"Caribou County, ID",2012-2013,6785,6830,45,0.663,34,11,16,29,H1
"Caribou County, ID",2013-2014,6830,6837,7,0.102,30,-23,16,29,H1
"Caribou County, ID",2014-2015,6815,6770,-45,-0.66,31,-76,16,29,H1
"Caribou County, ID",2015-2016,6770,6906,136,2.009,51,85,16,29,H1
"Caribou County, ID",2016-2017,6906,7034,128,1.853,26,102,16,29,H1
"Cassia County, ID",2000-2001,21393,21557,164,0.767,190,-26,16,31,H1
"Cassia County, ID",2001-2002,21557,21504,-53,-0.246,202,-255,16,31,H1
"Cassia County, ID",2002-2003,21504,21466,-38,-0.177,205,-243,16,31,H1
"Cassia County, ID",2003-2004,21466,21323,-143,-0.666,217,-360,16,31,H1
"Cassia County, ID",2004-2005,21323,21372,49,0.23,231,-182,16,31,H1
"Cassia County, ID",2005-2006,21372,21281,-91,-0.426,206,-297,16,31,H1
"Cassia County, ID",2006-2007,21281,21568,287,1.349,194,93,16,31,H1
"Cassia County, ID",2007-2008,21568,22134,566,2.624,239,327,16,31,H1
"Cassia County, ID",2008-2009,22134,22476,342,1.545,258,84,16,31,H1
"Cassia County, ID",2009-2010,22476,23078,602,2.678,246,356,16,31,H1
"Cassia County, ID",2010-2011,23078,23146,68,0.295,188,-120,16,31,H1
"Cassia County, ID",2011-2012,23146,23270,124,0.536,240,-116,16,31,H1
"Cassia County, ID",2012-2013,23270,23342,72,0.309,203,-131,16,31,H1
"Cassia County, ID",2013-2014,23342,23540,198,0.848,223,-25,16,31,H1
"Cassia County, ID",2014-2015,23539,23506,-33,-0.14,207,-240,16,31,H1
"Cassia County, ID",2015-2016,23506,23462,-44,-0.187,181,-225,16,31,H1
"Cassia County, ID",2016-2017,23462,23664,202,0.861,192,10,16,31,H1
"Clark County, ID",2000-2001,1024,965,-59,-5.762,8,-67,16,33,H1
"Clark County, ID",2001-2002,965,948,-17,-1.762,7,-24,16,33,H1
"Clark County, ID",2002-2003,948,892,-56,-5.907,10,-66,16,33,H1
"Clark County, ID",2003-2004,892,923,31,3.475,13,18,16,33,H1
"Clark County, ID",2004-2005,923,925,2,0.217,16,-14,16,33,H1
"Clark County, ID",2005-2006,925,947,22,2.378,19,3,16,33,H1
"Clark County, ID",2006-2007,947,948,1,0.106,10,-9,16,33,H1
"Clark County, ID",2007-2008,948,981,33,3.481,14,19,16,33,H1
"Clark County, ID",2008-2009,981,961,-20,-2.039,23,-43,16,33,H1
"Clark County, ID",2009-2010,961,980,19,1.977,22,-3,16,33,H1
"Clark County, ID",2010-2011,980,954,-26,-2.653,4,-30,16,33,H1
"Clark County, ID",2011-2012,954,873,-81,-8.491,1,-82,16,33,H1
"Clark County, ID",2012-2013,873,861,-12,-1.375,2,-14,16,33,H1
"Clark County, ID",2013-2014,861,867,6,0.697,7,-1,16,33,H1
"Clark County, ID",2014-2015,874,880,6,0.686,7,-1,16,33,H1
"Clark County, ID",2015-2016,880,854,-26,-2.955,0,-26,16,33,H1
"Clark County, ID",2016-2017,854,873,19,2.225,6,13,16,33,H1
"Clearwater County, ID",2000-2001,8930,8689,-241,-2.699,-26,-215,16,35,H1
"Clearwater County, ID",2001-2002,8689,8579,-110,-1.266,-28,-82,16,35,H1
"Clearwater County, ID",2002-2003,8579,8596,17,0.198,-13,30,16,35,H1
"Clearwater County, ID",2003-2004,8596,8610,14,0.163,-15,29,16,35,H1
"Clearwater County, ID",2004-2005,8610,8659,49,0.569,-27,76,16,35,H1
"Clearwater County, ID",2005-2006,8659,8776,117,1.351,-22,139,16,35,H1
"Clearwater County, ID",2006-2007,8776,8788,12,0.137,-5,17,16,35,H1
"Clearwater County, ID",2007-2008,8788,8764,-24,-0.273,-37,13,16,35,H1
"Clearwater County, ID",2008-2009,8764,8761,-3,-0.034,-18,15,16,35,H1
"Clearwater County, ID",2009-2010,8761,8627,-134,-1.53,-16,-118,16,35,H1
"Clearwater County, ID",2010-2011,8627,8626,-1,-0.012,-70,69,16,35,H1
"Clearwater County, ID",2011-2012,8626,8582,-44,-0.51,-22,-22,16,35,H1
"Clearwater County, ID",2012-2013,8582,8604,22,0.256,-41,63,16,35,H1
"Clearwater County, ID",2013-2014,8604,8562,-42,-0.488,-22,-20,16,35,H1
"Clearwater County, ID",2014-2015,8509,8496,-13,-0.153,-24,11,16,35,H1
"Clearwater County, ID",2015-2016,8496,8555,59,0.694,-52,111,16,35,H1
"Clearwater County, ID",2016-2017,8555,8546,-9,-0.105,-37,28,16,35,H1
"Custer County, ID",2000-2001,4336,4223,-113,-2.606,12,-125,16,37,H1
"Custer County, ID",2001-2002,4223,4143,-80,-1.894,-5,-75,16,37,H1
"Custer County, ID",2002-2003,4143,4116,-27,-0.652,1,-28,16,37,H1
"Custer County, ID",2003-2004,4116,4129,13,0.316,-12,25,16,37,H1
"Custer County, ID",2004-2005,4129,4084,-45,-1.09,-4,-41,16,37,H1
"Custer County, ID",2005-2006,4084,4155,71,1.738,8,63,16,37,H1
"Custer County, ID",2006-2007,4155,4200,45,1.083,7,38,16,37,H1
"Custer County, ID",2007-2008,4200,4300,100,2.381,17,83,16,37,H1
"Custer County, ID",2008-2009,4300,4363,63,1.465,6,57,16,37,H1
"Custer County, ID",2009-2010,4363,4358,-5,-0.115,3,-8,16,37,H1
"Custer County, ID",2010-2011,4358,4351,-7,-0.161,1,-8,16,37,H1
"Custer County, ID",2011-2012,4351,4338,-13,-0.299,-5,-8,16,37,H1
"Custer County, ID",2012-2013,4338,4235,-103,-2.374,10,-113,16,37,H1
"Custer County, ID",2013-2014,4235,4140,-95,-2.243,7,-102,16,37,H1
"Custer County, ID",2014-2015,4145,4087,-58,-1.399,11,-69,16,37,H1
"Custer County, ID",2015-2016,4087,4109,22,0.538,4,18,16,37,H1
"Custer County, ID",2016-2017,4109,4172,63,1.533,10,53,16,37,H1
"Elmore County, ID",2000-2001,28610,27613,-997,-3.485,359,-1356,16,39,H1
"Elmore County, ID",2001-2002,27613,27047,-566,-2.05,373,-939,16,39,H1
"Elmore County, ID",2002-2003,27047,25972,-1075,-3.975,371,-1446,16,39,H1
"Elmore County, ID",2003-2004,25972,26355,383,1.475,378,5,16,39,H1
"Elmore County, ID",2004-2005,26355,25919,-436,-1.654,370,-806,16,39,H1
"Elmore County, ID",2005-2006,25919,25927,8,0.031,389,-381,16,39,H1
"Elmore County, ID",2006-2007,25927,26595,668,2.576,406,262,16,39,H1
"Elmore County, ID",2007-2008,26595,26930,335,1.26,351,-16,16,39,H1
"Elmore County, ID",2008-2009,26930,26769,-161,-0.598,345,-506,16,39,H1
"Elmore County, ID",2009-2010,26769,27108,339,1.266,469,-130,16,39,H1
"Elmore County, ID",2010-2011,27108,26187,-921,-3.398,296,-1217,16,39,H1
"Elmore County, ID",2011-2012,26187,26199,12,0.046,301,-289,16,39,H1
"Elmore County, ID",2012-2013,26199,26156,-43,-0.164,314,-357,16,39,H1
"Elmore County, ID",2013-2014,26156,26094,-62,-0.237,267,-329,16,39,H1
"Elmore County, ID",2014-2015,26262,25876,-386,-1.47,320,-706,16,39,H1
"Elmore County, ID",2015-2016,25876,26090,214,0.827,270,-56,16,39,H1
"Elmore County, ID",2016-2017,26090,26823,733,2.81,263,470,16,39,H1
"Franklin County, ID",2000-2001,11350,11463,113,0.996,109,4,16,41,H1
"Franklin County, ID",2001-2002,11463,11687,224,1.954,159,65,16,41,H1
"Franklin County, ID",2002-2003,11687,11718,31,0.265,99,-68,16,41,H1
"Franklin County, ID",2003-2004,11718,11959,241,2.057,127,114,16,41,H1
"Franklin County, ID",2004-2005,11959,12079,120,1.003,153,-33,16,41,H1
"Franklin County, ID",2005-2006,12079,12085,6,0.05,139,-133,16,41,H1
"Franklin County, ID",2006-2007,12085,12277,192,1.589,117,75,16,41,H1
"Franklin County, ID",2007-2008,12277,12570,293,2.387,141,152,16,41,H1
"Franklin County, ID",2008-2009,12570,12757,187,1.488,148,39,16,41,H1
"Franklin County, ID",2009-2010,12757,12777,20,0.157,129,-109,16,41,H1
"Franklin County, ID",2010-2011,12777,12806,29,0.227,135,-106,16,41,H1
"Franklin County, ID",2011-2012,12806,12811,5,0.039,107,-102,16,41,H1
"Franklin County, ID",2012-2013,12811,12849,38,0.297,89,-51,16,41,H1
"Franklin County, ID",2013-2014,12849,13021,172,1.339,125,47,16,41,H1
"Franklin County, ID",2014-2015,12994,13074,80,0.616,109,-29,16,41,H1
"Franklin County, ID",2015-2016,13074,13347,273,2.088,119,154,16,41,H1
"Franklin County, ID",2016-2017,13347,13564,217,1.626,128,89,16,41,H1
"Fremont County, ID",2000-2001,11769,11891,122,1.037,102,20,16,43,H1
"Fremont County, ID",2001-2002,11891,12029,138,1.161,120,18,16,43,H1
"Fremont County, ID",2002-2003,12029,12370,341,2.835,117,224,16,43,H1
"Fremont County, ID",2003-2004,12370,12640,270,2.183,144,126,16,43,H1
"Fremont County, ID",2004-2005,12640,12610,-30,-0.237,146,-176,16,43,H1
"Fremont County, ID",2005-2006,12610,12770,160,1.269,129,31,16,43,H1
"Fremont County, ID",2006-2007,12770,13005,235,1.84,172,63,16,43,H1
"Fremont County, ID",2007-2008,13005,13112,107,0.823,123,-16,16,43,H1
"Fremont County, ID",2008-2009,13112,13173,61,0.465,141,-80,16,43,H1
"Fremont County, ID",2009-2010,13173,13237,64,0.486,147,-83,16,43,H1
"Fremont County, ID",2010-2011,13237,13126,-111,-0.839,96,-207,16,43,H1
"Fremont County, ID",2011-2012,13126,12979,-147,-1.12,100,-247,16,43,H1
"Fremont County, ID",2012-2013,12979,12912,-67,-0.516,105,-172,16,43,H1
"Fremont County, ID",2013-2014,12912,12867,-45,-0.349,98,-143,16,43,H1
"Fremont County, ID",2014-2015,12870,12819,-51,-0.396,92,-143,16,43,H1
"Fremont County, ID",2015-2016,12819,12888,69,0.538,58,11,16,43,H1
"Fremont County, ID",2016-2017,12888,13094,206,1.598,79,127,16,43,H1
"Gem County, ID",2000-2001,15215,15393,178,1.17,24,154,16,45,H1
"Gem County, ID",2001-2002,15393,15488,95,0.617,41,54,16,45,H1
"Gem County, ID",2002-2003,15488,15693,205,1.324,20,185,16,45,H1
"Gem County, ID",2003-2004,15693,15925,232,1.478,24,208,16,45,H1
"Gem County, ID",2004-2005,15925,16304,379,2.38,30,349,16,45,H1
"Gem County, ID",2005-2006,16304,16632,328,2.012,58,270,16,45,H1
"Gem County, ID",2006-2007,16632,16833,201,1.209,76,125,16,45,H1
"Gem County, ID",2007-2008,16833,16941,108,0.642,53,55,16,45,H1
"Gem County, ID",2008-2009,16941,16809,-132,-0.779,32,-164,16,45,H1
"Gem County, ID",2009-2010,16809,16681,-128,-0.761,6,-134,16,45,H1
"Gem County, ID",2010-2011,16681,16727,46,0.276,-29,75,16,45,H1
"Gem County, ID",2011-2012,16727,16692,-35,-0.209,40,-75,16,45,H1
"Gem County, ID",2012-2013,16692,16694,2,0.012,23,-21,16,45,H1
"Gem County, ID",2013-2014,16694,16866,172,1.03,27,145,16,45,H1
"Gem County, ID",2014-2015,16774,16852,78,0.465,6,72,16,45,H1
"Gem County, ID",2015-2016,16852,16979,127,0.754,18,109,16,45,H1
"Gem County, ID",2016-2017,16979,17379,400,2.356,26,374,16,45,H1
"Gooding County, ID",2000-2001,14196,14215,19,0.134,100,-81,16,47,H1
"Gooding County, ID",2001-2002,14215,14342,127,0.893,45,82,16,47,H1
"Gooding County, ID",2002-2003,14342,14483,141,0.983,101,40,16,47,H1
"Gooding County, ID",2003-2004,14483,14562,79,0.545,124,-45,16,47,H1
"Gooding County, ID",2004-2005,14562,14614,52,0.357,126,-74,16,47,H1
"Gooding County, ID",2005-2006,14614,14749,135,0.924,74,61,16,47,H1
"Gooding County, ID",2006-2007,14749,14963,214,1.451,117,97,16,47,H1
"Gooding County, ID",2007-2008,14963,15216,253,1.691,121,132,16,47,H1
"Gooding County, ID",2008-2009,15216,15270,54,0.355,126,-72,16,47,H1
"Gooding County, ID",2009-2010,15270,15470,200,1.31,142,58,16,47,H1
"Gooding County, ID",2010-2011,15470,15363,-107,-0.692,67,-174,16,47,H1
"Gooding County, ID",2011-2012,15363,15216,-147,-0.957,61,-208,16,47,H1
"Gooding County, ID",2012-2013,15216,15094,-122,-0.802,62,-184,16,47,H1
"Gooding County, ID",2013-2014,15094,15064,-30,-0.199,85,-115,16,47,H1
"Gooding County, ID",2014-2015,15115,15284,169,1.118,89,80,16,47,H1
"Gooding County, ID",2015-2016,15284,15094,-190,-1.243,83,-273,16,47,H1
"Gooding County, ID",2016-2017,15094,15124,30,0.199,87,-57,16,47,H1
"Idaho County, ID",2000-2001,15470,15447,-23,-0.149,14,-37,16,49,H1
"Idaho County, ID",2001-2002,15447,15495,48,0.311,11,37,16,49,H1
"Idaho County, ID",2002-2003,15495,15410,-85,-0.549,-34,-51,16,49,H1
"Idaho County, ID",2003-2004,15410,15555,145,0.941,11,134,16,49,H1
"Idaho County, ID",2004-2005,15555,15522,-33,-0.212,-17,-16,16,49,H1
"Idaho County, ID",2005-2006,15522,15638,116,0.747,17,99,16,49,H1
"Idaho County, ID",2006-2007,15638,15770,132,0.844,5,127,16,49,H1
"Idaho County, ID",2007-2008,15770,15896,126,0.799,-16,142,16,49,H1
"Idaho County, ID",2008-2009,15896,16138,242,1.522,-4,246,16,49,H1
"Idaho County, ID",2009-2010,16138,16297,159,0.985,8,151,16,49,H1
"Idaho County, ID",2010-2011,16297,16462,165,1.012,-4,169,16,49,H1
"Idaho County, ID",2011-2012,16462,16399,-63,-0.383,-8,-55,16,49,H1
"Idaho County, ID",2012-2013,16399,16201,-198,-1.207,-22,-176,16,49,H1
"Idaho County, ID",2013-2014,16201,16215,14,0.086,-11,25,16,49,H1
"Idaho County, ID",2014-2015,16206,16272,66,0.407,-30,96,16,49,H1
"Idaho County, ID",2015-2016,16272,16228,-44,-0.27,-25,-19,16,49,H1
"Idaho County, ID",2016-2017,16228,16369,141,0.869,-11,152,16,49,H1
"Jefferson County, ID",2000-2001,19193,19322,129,0.672,245,-116,16,51,H1
"Jefferson County, ID",2001-2002,19322,19802,480,2.484,211,269,16,51,H1
"Jefferson County, ID",2002-2003,19802,20249,447,2.257,243,204,16,51,H1
"Jefferson County, ID",2003-2004,20249,20842,593,2.929,265,328,16,51,H1
"Jefferson County, ID",2004-2005,20842,21674,832,3.992,319,513,16,51,H1
"Jefferson County, ID",2005-2006,21674,22439,765,3.53,331,434,16,51,H1
"Jefferson County, ID",2006-2007,22439,23475,1036,4.617,395,641,16,51,H1
"Jefferson County, ID",2007-2008,23475,24696,1221,5.201,426,795,16,51,H1
"Jefferson County, ID",2008-2009,24696,25770,1074,4.349,438,636,16,51,H1
"Jefferson County, ID",2009-2010,25770,26226,456,1.769,400,56,16,51,H1
"Jefferson County, ID",2010-2011,26226,26327,101,0.385,355,-254,16,51,H1
"Jefferson County, ID",2011-2012,26327,26657,330,1.253,360,-30,16,51,H1
"Jefferson County, ID",2012-2013,26657,26868,211,0.792,373,-162,16,51,H1
"Jefferson County, ID",2013-2014,26868,27021,153,0.569,352,-199,16,51,H1
"Jefferson County, ID",2014-2015,26988,27157,169,0.626,330,-161,16,51,H1
"Jefferson County, ID",2015-2016,27157,27807,650,2.393,318,332,16,51,H1
"Jefferson County, ID",2016-2017,27807,28446,639,2.298,323,316,16,51,H1
"Jerome County, ID",2000-2001,18493,18579,86,0.465,177,-91,16,53,H1
"Jerome County, ID",2001-2002,18579,18730,151,0.813,156,-5,16,53,H1
"Jerome County, ID",2002-2003,18730,18971,241,1.287,206,35,16,53,H1
"Jerome County, ID",2003-2004,18971,19331,360,1.898,201,159,16,53,H1
"Jerome County, ID",2004-2005,19331,19654,323,1.671,232,91,16,53,H1
"Jerome County, ID",2005-2006,19654,20111,457,2.325,230,227,16,53,H1
"Jerome County, ID",2006-2007,20111,20572,461,2.292,255,206,16,53,H1
"Jerome County, ID",2007-2008,20572,21217,645,3.135,291,354,16,53,H1
"Jerome County, ID",2008-2009,21217,22039,822,3.874,283,539,16,53,H1
"Jerome County, ID",2009-2010,22039,22449,410,1.86,288,122,16,53,H1
"Jerome County, ID",2010-2011,22449,22514,65,0.29,243,-178,16,53,H1
"Jerome County, ID",2011-2012,22514,22515,1,0.004,259,-258,16,53,H1
"Jerome County, ID",2012-2013,22515,22606,91,0.404,263,-172,16,53,H1
"Jerome County, ID",2013-2014,22606,22818,212,0.938,259,-47,16,53,H1
"Jerome County, ID",2014-2015,22789,22814,25,0.11,247,-222,16,53,H1
"Jerome County, ID",2015-2016,22814,23257,443,1.942,261,182,16,53,H1
"Jerome County, ID",2016-2017,23257,23627,370,1.591,257,113,16,53,H1
"Kootenai County, ID",2000-2001,109487,111542,2055,1.877,683,1372,16,55,H1
"Kootenai County, ID",2001-2002,111542,113667,2125,1.905,558,1567,16,55,H1
"Kootenai County, ID",2002-2003,113667,116512,2845,2.503,642,2203,16,55,H1
"Kootenai County, ID",2003-2004,116512,121002,4490,3.854,623,3867,16,55,H1
"Kootenai County, ID",2004-2005,121002,125972,4970,4.107,557,4413,16,55,H1
"Kootenai County, ID",2005-2006,125972,129510,3538,2.809,680,2858,16,55,H1
"Kootenai County, ID",2006-2007,129510,132811,3301,2.549,822,2479,16,55,H1
"Kootenai County, ID",2007-2008,132811,135627,2816,2.12,743,2073,16,55,H1
"Kootenai County, ID",2008-2009,135627,137407,1780,1.312,717,1063,16,55,H1
"Kootenai County, ID",2009-2010,137407,138890,1483,1.079,635,848,16,55,H1
"Kootenai County, ID",2010-2011,138890,141045,2155,1.552,496,1659,16,55,H1
"Kootenai County, ID",2011-2012,141045,142297,1252,0.888,455,797,16,55,H1
"Kootenai County, ID",2012-2013,142297,144357,2060,1.448,549,1511,16,55,H1
"Kootenai County, ID",2013-2014,144357,147326,2969,2.057,503,2466,16,55,H1
"Kootenai County, ID",2014-2015,147245,150346,3101,2.106,497,2604,16,55,H1
"Kootenai County, ID",2015-2016,150346,153144,2798,1.861,490,2308,16,55,H1
"Kootenai County, ID",2016-2017,153144,157637,4493,2.934,468,4025,16,55,H1
"Latah County, ID",2000-2001,34878,35285,407,1.167,212,195,16,57,H1
"Latah County, ID",2001-2002,35285,35183,-102,-0.289,223,-325,16,57,H1
"Latah County, ID",2002-2003,35183,35473,290,0.824,166,124,16,57,H1
"Latah County, ID",2003-2004,35473,35864,391,1.102,189,202,16,57,H1
"Latah County, ID",2004-2005,35864,35958,94,0.262,178,-84,16,57,H1
"Latah County, ID",2005-2006,35958,36251,293,0.815,264,29,16,57,H1
"Latah County, ID",2006-2007,36251,36179,-72,-0.199,197,-269,16,57,H1
"Latah County, ID",2007-2008,36179,36524,345,0.954,271,74,16,57,H1
"Latah County, ID",2008-2009,36524,36939,415,1.136,217,198,16,57,H1
"Latah County, ID",2009-2010,36939,37274,335,0.907,233,102,16,57,H1
"Latah County, ID",2010-2011,37274,37881,607,1.628,265,342,16,57,H1
"Latah County, ID",2011-2012,37881,38157,276,0.729,213,63,16,57,H1
"Latah County, ID",2012-2013,38157,38221,64,0.168,215,-151,16,57,H1
"Latah County, ID",2013-2014,38221,38411,190,0.497,246,-56,16,57,H1
"Latah County, ID",2014-2015,38585,38778,193,0.5,225,-32,16,57,H1
"Latah County, ID",2015-2016,38778,38792,14,0.036,231,-217,16,57,H1
"Latah County, ID",2016-2017,38792,39333,541,1.395,228,313,16,57,H1
"Lemhi County, ID",2000-2001,7724,7593,-131,-1.696,-13,-118,16,59,H1
"Lemhi County, ID",2001-2002,7593,7590,-3,-0.04,-27,24,16,59,H1
"Lemhi County, ID",2002-2003,7590,7600,10,0.132,-30,40,16,59,H1
"Lemhi County, ID",2003-2004,7600,7660,60,0.789,-18,78,16,59,H1
"Lemhi County, ID",2004-2005,7660,7708,48,0.627,5,43,16,59,H1
"Lemhi County, ID",2005-2006,7708,7795,87,1.129,-1,88,16,59,H1
"Lemhi County, ID",2006-2007,7795,7780,-15,-0.192,9,-24,16,59,H1
"Lemhi County, ID",2007-2008,7780,7902,122,1.568,-24,146,16,59,H1
"Lemhi County, ID",2008-2009,7902,7870,-32,-0.405,-15,-17,16,59,H1
"Lemhi County, ID",2009-2010,7870,7946,76,0.966,-20,96,16,59,H1
"Lemhi County, ID",2010-2011,7946,7979,33,0.415,-8,41,16,59,H1
"Lemhi County, ID",2011-2012,7979,7763,-216,-2.707,-26,-190,16,59,H1
"Lemhi County, ID",2012-2013,7763,7725,-38,-0.49,-13,-25,16,59,H1
"Lemhi County, ID",2013-2014,7725,7726,1,0.013,-13,14,16,59,H1
"Lemhi County, ID",2014-2015,7725,7735,10,0.129,-38,48,16,59,H1
"Lemhi County, ID",2015-2016,7735,7732,-3,-0.039,1,-4,16,59,H1
"Lemhi County, ID",2016-2017,7732,7875,143,1.849,-4,147,16,59,H1
"Lewis County, ID",2000-2001,3740,3599,-141,-3.77,-7,-134,16,61,H1
"Lewis County, ID",2001-2002,3599,3673,74,2.056,1,73,16,61,H1
"Lewis County, ID",2002-2003,3673,3671,-2,-0.054,3,-5,16,61,H1
"Lewis County, ID",2003-2004,3671,3669,-2,-0.054,0,-2,16,61,H1
"Lewis County, ID",2004-2005,3669,3665,-4,-0.109,-3,-1,16,61,H1
"Lewis County, ID",2005-2006,3665,3712,47,1.282,2,45,16,61,H1
"Lewis County, ID",2006-2007,3712,3707,-5,-0.135,-5,0,16,61,H1
"Lewis County, ID",2007-2008,3707,3739,32,0.863,7,25,16,61,H1
"Lewis County, ID",2008-2009,3739,3832,93,2.487,4,89,16,61,H1
"Lewis County, ID",2009-2010,3832,3817,-15,-0.391,5,-20,16,61,H1
"Lewis County, ID",2010-2011,3817,3793,-24,-0.629,0,-24,16,61,H1
"Lewis County, ID",2011-2012,3793,3836,43,1.134,5,38,16,61,H1
"Lewis County, ID",2012-2013,3836,3825,-11,-0.287,14,-25,16,61,H1
"Lewis County, ID",2013-2014,3825,3838,13,0.34,7,6,16,61,H1
"Lewis County, ID",2014-2015,3822,3789,-33,-0.863,8,-41,16,61,H1
"Lewis County, ID",2015-2016,3789,3843,54,1.425,13,41,16,61,H1
"Lewis County, ID",2016-2017,3843,3887,44,1.145,6,38,16,61,H1
"Lincoln County, ID",2000-2001,4051,4159,108,2.666,42,66,16,63,H1
"Lincoln County, ID",2001-2002,4159,4242,83,1.996,41,42,16,63,H1
"Lincoln County, ID",2002-2003,4242,4372,130,3.065,38,92,16,63,H1
"Lincoln County, ID",2003-2004,4372,4441,69,1.578,36,33,16,63,H1
"Lincoln County, ID",2004-2005,4441,4694,253,5.697,40,213,16,63,H1
"Lincoln County, ID",2005-2006,4694,4762,68,1.449,43,25,16,63,H1
"Lincoln County, ID",2006-2007,4762,4938,176,3.696,41,135,16,63,H1
"Lincoln County, ID",2007-2008,4938,5041,103,2.086,71,32,16,63,H1
"Lincoln County, ID",2008-2009,5041,5151,110,2.182,69,41,16,63,H1
"Lincoln County, ID",2009-2010,5151,5213,62,1.204,60,2,16,63,H1
"Lincoln County, ID",2010-2011,5213,5138,-75,-1.439,45,-120,16,63,H1
"Lincoln County, ID",2011-2012,5138,5256,118,2.297,40,78,16,63,H1
"Lincoln County, ID",2012-2013,5256,5307,51,0.97,40,11,16,63,H1
"Lincoln County, ID",2013-2014,5307,5316,9,0.17,41,-32,16,63,H1
"Lincoln County, ID",2014-2015,5304,5297,-7,-0.132,44,-51,16,63,H1
"Lincoln County, ID",2015-2016,5297,5267,-30,-0.566,40,-70,16,63,H1
"Lincoln County, ID",2016-2017,5267,5318,51,0.968,39,12,16,63,H1
"Madison County, ID",2000-2001,27519,27699,180,0.654,413,-233,16,65,H1
"Madison County, ID",2001-2002,27699,28478,779,2.812,413,366,16,65,H1
"Madison County, ID",2002-2003,28478,29997,1519,5.334,502,1017,16,65,H1
"Madison County, ID",2003-2004,29997,31990,1993,6.644,632,1361,16,65,H1
"Madison County, ID",2004-2005,31990,33807,1817,5.68,730,1087,16,65,H1
"Madison County, ID",2005-2006,33807,34984,1177,3.482,845,332,16,65,H1
"Madison County, ID",2006-2007,34984,35771,787,2.25,877,-90,16,65,H1
"Madison County, ID",2007-2008,35771,36564,793,2.217,966,-173,16,65,H1
"Madison County, ID",2008-2009,36564,37121,557,1.523,857,-300,16,65,H1
"Madison County, ID",2009-2010,37121,37595,474,1.277,942,-468,16,65,H1
"Madison County, ID",2010-2011,37595,37884,289,0.769,889,-600,16,65,H1
"Madison County, ID",2011-2012,37884,37680,-204,-0.538,937,-1141,16,65,H1
"Madison County, ID",2012-2013,37680,37572,-108,-0.287,987,-1095,16,65,H1
"Madison County, ID",2013-2014,37572,38038,466,1.24,948,-482,16,65,H1
"Madison County, ID",2014-2015,38068,38273,205,0.539,1016,-811,16,65,H1
"Madison County, ID",2015-2016,38273,38781,508,1.327,973,-465,16,65,H1
"Madison County, ID",2016-2017,38781,39141,360,0.928,981,-621,16,65,H1
"Minidoka County, ID",2000-2001,20103,19603,-500,-2.487,142,-642,16,67,H1
"Minidoka County, ID",2001-2002,19603,19542,-61,-0.311,166,-227,16,67,H1
"Minidoka County, ID",2002-2003,19542,19389,-153,-0.783,151,-304,16,67,H1
"Minidoka County, ID",2003-2004,19389,19167,-222,-1.145,150,-372,16,67,H1
"Minidoka County, ID",2004-2005,19167,19013,-154,-0.803,164,-318,16,67,H1
"Minidoka County, ID",2005-2006,19013,19046,33,0.174,112,-79,16,67,H1
"Minidoka County, ID",2006-2007,19046,19184,138,0.725,127,11,16,67,H1
"Minidoka County, ID",2007-2008,19184,19393,209,1.089,194,15,16,67,H1
"Minidoka County, ID",2008-2009,19393,19884,491,2.532,166,325,16,67,H1
"Minidoka County, ID",2009-2010,19884,20065,181,0.91,178,3,16,67,H1
"Minidoka County, ID",2010-2011,20065,20167,102,0.508,144,-42,16,67,H1
"Minidoka County, ID",2011-2012,20167,20089,-78,-0.387,120,-198,16,67,H1
"Minidoka County, ID",2012-2013,20089,20310,221,1.1,194,27,16,67,H1
"Minidoka County, ID",2013-2014,20310,20323,13,0.064,193,-180,16,67,H1
"Minidoka County, ID",2014-2015,20304,20461,157,0.773,166,-9,16,67,H1
"Minidoka County, ID",2015-2016,20461,20583,122,0.596,176,-54,16,67,H1
"Minidoka County, ID",2016-2017,20583,20729,146,0.709,156,-10,16,67,H1
"Nez Perce County, ID",2000-2001,37398,36999,-399,-1.067,20,-419,16,69,H1
"Nez Perce County, ID",2001-2002,36999,37111,112,0.303,63,49,16,69,H1
"Nez Perce County, ID",2002-2003,37111,37696,585,1.576,5,580,16,69,H1
"Nez Perce County, ID",2003-2004,37696,37798,102,0.271,42,60,16,69,H1
"Nez Perce County, ID",2004-2005,37798,38071,273,0.722,53,220,16,69,H1
"Nez Perce County, ID",2005-2006,38071,38513,442,1.161,28,414,16,69,H1
"Nez Perce County, ID",2006-2007,38513,38720,207,0.537,64,143,16,69,H1
"Nez Perce County, ID",2007-2008,38720,38810,90,0.232,26,64,16,69,H1
"Nez Perce County, ID",2008-2009,38810,39049,239,0.616,42,197,16,69,H1
"Nez Perce County, ID",2009-2010,39049,39321,272,0.697,31,241,16,69,H1
"Nez Perce County, ID",2010-2011,39321,39431,110,0.28,-43,153,16,69,H1
"Nez Perce County, ID",2011-2012,39431,39577,146,0.37,-21,167,16,69,H1
"Nez Perce County, ID",2012-2013,39577,39938,361,0.912,3,358,16,69,H1
"Nez Perce County, ID",2013-2014,39938,40007,69,0.173,43,26,16,69,H1
"Nez Perce County, ID",2014-2015,39932,40048,116,0.29,40,76,16,69,H1
"Nez Perce County, ID",2015-2016,40048,40096,48,0.12,-54,102,16,69,H1
"Nez Perce County, ID",2016-2017,40096,40385,289,0.721,27,262,16,69,H1
"Oneida County, ID",2000-2001,4135,4176,41,0.992,31,10,16,71,H1
"Oneida County, ID",2001-2002,4176,4125,-51,-1.221,12,-63,16,71,H1
"Oneida County, ID",2002-2003,4125,4089,-36,-0.873,-4,-32,16,71,H1
"Oneida County, ID",2003-2004,4089,4086,-3,-0.073,26,-29,16,71,H1
"Oneida County, ID",2004-2005,4086,4137,51,1.248,9,42,16,71,H1
"Oneida County, ID",2005-2006,4137,4146,9,0.218,10,-1,16,71,H1
"Oneida County, ID",2006-2007,4146,4167,21,0.507,22,-1,16,71,H1
"Oneida County, ID",2007-2008,4167,4201,34,0.816,35,-1,16,71,H1
"Oneida County, ID",2008-2009,4201,4248,47,1.119,37,10,16,71,H1
"Oneida County, ID",2009-2010,4248,4296,48,1.13,20,28,16,71,H1
"Oneida County, ID",2010-2011,4296,4233,-63,-1.466,17,-80,16,71,H1
"Oneida County, ID",2011-2012,4233,4223,-10,-0.236,12,-22,16,71,H1
"Oneida County, ID",2012-2013,4223,4269,46,1.089,26,20,16,71,H1
"Oneida County, ID",2013-2014,4269,4184,-85,-1.991,16,-101,16,71,H1
"Oneida County, ID",2014-2015,4205,4281,76,1.807,1,75,16,71,H1
"Oneida County, ID",2015-2016,4281,4321,40,0.934,24,16,16,71,H1
"Oneida County, ID",2016-2017,4321,4427,106,2.453,24,82,16,71,H1
"Owyhee County, ID",2000-2001,10690,10877,187,1.749,107,80,16,73,H1
"Owyhee County, ID",2001-2002,10877,10876,-1,-0.009,96,-97,16,73,H1
"Owyhee County, ID",2002-2003,10876,11033,157,1.444,98,59,16,73,H1
"Owyhee County, ID",2003-2004,11033,10990,-43,-0.39,108,-151,16,73,H1
"Owyhee County, ID",2004-2005,10990,10993,3,0.027,68,-65,16,73,H1
"Owyhee County, ID",2005-2006,10993,11114,121,1.101,91,30,16,73,H1
"Owyhee County, ID",2006-2007,11114,11255,141,1.269,64,77,16,73,H1
"Owyhee County, ID",2007-2008,11255,11515,260,2.31,114,146,16,73,H1
"Owyhee County, ID",2008-2009,11515,11547,32,0.278,92,-60,16,73,H1
"Owyhee County, ID",2009-2010,11547,11472,-75,-0.65,82,-157,16,73,H1
"Owyhee County, ID",2010-2011,11472,11403,-69,-0.601,31,-100,16,73,H1
"Owyhee County, ID",2011-2012,11403,11409,6,0.053,61,-55,16,73,H1
"Owyhee County, ID",2012-2013,11409,11423,14,0.123,65,-51,16,73,H1
"Owyhee County, ID",2013-2014,11423,11353,-70,-0.613,67,-137,16,73,H1
"Owyhee County, ID",2014-2015,11309,11310,1,0.009,45,-44,16,73,H1
"Owyhee County, ID",2015-2016,11310,11363,53,0.469,60,-7,16,73,H1
"Owyhee County, ID",2016-2017,11363,11628,265,2.332,47,218,16,73,H1
"Payette County, ID",2000-2001,20624,20796,172,0.834,141,31,16,75,H1
"Payette County, ID",2001-2002,20796,20966,170,0.817,117,53,16,75,H1
"Payette County, ID",2002-2003,20966,21133,167,0.797,140,27,16,75,H1
"Payette County, ID",2003-2004,21133,21139,6,0.028,141,-135,16,75,H1
"Payette County, ID",2004-2005,21139,21484,345,1.632,123,222,16,75,H1
"Payette County, ID",2005-2006,21484,21916,432,2.011,159,273,16,75,H1
"Payette County, ID",2006-2007,21916,22437,521,2.377,170,351,16,75,H1
"Payette County, ID",2007-2008,22437,22618,181,0.807,157,24,16,75,H1
"Payette County, ID",2008-2009,22618,22665,47,0.208,154,-107,16,75,H1
"Payette County, ID",2009-2010,22665,22638,-27,-0.119,151,-178,16,75,H1
"Payette County, ID",2010-2011,22638,22550,-88,-0.389,118,-206,16,75,H1
"Payette County, ID",2011-2012,22550,22673,123,0.545,117,6,16,75,H1
"Payette County, ID",2012-2013,22673,22591,-82,-0.362,126,-208,16,75,H1
"Payette County, ID",2013-2014,22591,22836,245,1.085,123,122,16,75,H1
"Payette County, ID",2014-2015,22820,22896,76,0.333,117,-41,16,75,H1
"Payette County, ID",2015-2016,22896,22920,24,0.105,87,-63,16,75,H1
"Payette County, ID",2016-2017,22920,23215,295,1.287,93,202,16,75,H1
"Power County, ID",2000-2001,7484,7422,-62,-0.828,62,-124,16,77,H1
"Power County, ID",2001-2002,7422,7371,-51,-0.687,71,-122,16,77,H1
"Power County, ID",2002-2003,7371,7293,-78,-1.058,52,-130,16,77,H1
"Power County, ID",2003-2004,7293,7432,139,1.906,78,61,16,77,H1
"Power County, ID",2004-2005,7432,7426,-6,-0.081,62,-68,16,77,H1
"Power County, ID",2005-2006,7426,7564,138,1.858,93,45,16,77,H1
"Power County, ID",2006-2007,7564,7532,-32,-0.423,71,-103,16,77,H1
"Power County, ID",2007-2008,7532,7564,32,0.425,106,-74,16,77,H1
"Power County, ID",2008-2009,7564,7628,64,0.846,89,-25,16,77,H1
"Power County, ID",2009-2010,7628,7851,223,2.923,78,145,16,77,H1
"Power County, ID",2010-2011,7851,7768,-83,-1.057,79,-162,16,77,H1
"Power County, ID",2011-2012,7768,7779,11,0.142,67,-56,16,77,H1
"Power County, ID",2012-2013,7779,7694,-85,-1.093,89,-174,16,77,H1
"Power County, ID",2013-2014,7694,7617,-77,-1.001,81,-158,16,77,H1
"Power County, ID",2014-2015,7678,7648,-30,-0.391,73,-103,16,77,H1
"Power County, ID",2015-2016,7648,7661,13,0.17,61,-48,16,77,H1
"Power County, ID",2016-2017,7661,7600,-61,-0.796,62,-123,16,77,H1
"Shoshone County, ID",2000-2001,13762,13464,-298,-2.165,-57,-241,16,79,H1
"Shoshone County, ID",2001-2002,13464,13044,-420,-3.119,-33,-387,16,79,H1
"Shoshone County, ID",2002-2003,13044,12897,-147,-1.127,-35,-112,16,79,H1
"Shoshone County, ID",2003-2004,12897,12781,-116,-0.899,-26,-90,16,79,H1
"Shoshone County, ID",2004-2005,12781,12912,131,1.025,-55,186,16,79,H1
"Shoshone County, ID",2005-2006,12912,13014,102,0.79,-30,132,16,79,H1
"Shoshone County, ID",2006-2007,13014,12949,-65,-0.499,-38,-27,16,79,H1
"Shoshone County, ID",2007-2008,12949,13031,82,0.633,-72,154,16,79,H1
"Shoshone County, ID",2008-2009,13031,12862,-169,-1.297,-21,-148,16,79,H1
"Shoshone County, ID",2009-2010,12862,12718,-144,-1.12,-15,-129,16,79,H1
"Shoshone County, ID",2010-2011,12718,12655,-63,-0.495,-62,-1,16,79,H1
"Shoshone County, ID",2011-2012,12655,12699,44,0.348,-79,123,16,79,H1
"Shoshone County, ID",2012-2013,12699,12685,-14,-0.11,-46,32,16,79,H1
"Shoshone County, ID",2013-2014,12685,12390,-295,-2.326,-34,-261,16,79,H1
"Shoshone County, ID",2014-2015,12390,12432,42,0.339,-35,77,16,79,H1
"Shoshone County, ID",2015-2016,12432,12413,-19,-0.153,-26,7,16,79,H1
"Shoshone County, ID",2016-2017,12413,12542,129,1.039,-19,148,16,79,H1
"Teton County, ID",2000-2001,6098,6455,357,5.854,103,254,16,81,H1
"Teton County, ID",2001-2002,6455,6849,394,6.104,98,296,16,81,H1
"Teton County, ID",2002-2003,6849,7193,344,5.023,121,223,16,81,H1
"Teton County, ID",2003-2004,7193,7460,267,3.712,121,146,16,81,H1
"Teton County, ID",2004-2005,7460,7814,354,4.745,106,248,16,81,H1
"Teton County, ID",2005-2006,7814,8270,456,5.836,97,359,16,81,H1
"Teton County, ID",2006-2007,8270,8932,662,8.005,149,513,16,81,H1
"Teton County, ID",2007-2008,8932,9627,695,7.781,196,499,16,81,H1
"Teton County, ID",2008-2009,9627,10041,414,4.3,180,234,16,81,H1
"Teton County, ID",2009-2010,10041,10154,113,1.125,184,-71,16,81,H1
"Teton County, ID",2010-2011,10154,10179,25,0.246,124,-99,16,81,H1
"Teton County, ID",2011-2012,10179,10087,-92,-0.904,118,-210,16,81,H1
"Teton County, ID",2012-2013,10087,10301,214,2.122,139,75,16,81,H1
"Teton County, ID",2013-2014,10301,10341,40,0.388,134,-94,16,81,H1
"Teton County, ID",2014-2015,10307,10564,257,2.493,106,151,16,81,H1
"Teton County, ID",2015-2016,10564,11086,522,4.941,122,400,16,81,H1
"Teton County, ID",2016-2017,11086,11381,295,2.661,123,172,16,81,H1
"Twin Falls County, ID",2000-2001,64360,64556,196,0.305,402,-206,16,83,H1
"Twin Falls County, ID",2001-2002,64556,65473,917,1.42,356,561,16,83,H1
"Twin Falls County, ID",2002-2003,65473,67092,1619,2.473,382,1237,16,83,H1
"Twin Falls County, ID",2003-2004,67092,68309,1217,1.814,426,791,16,83,H1
"Twin Falls County, ID",2004-2005,68309,69833,1524,2.231,444,1080,16,83,H1
"Twin Falls County, ID",2005-2006,69833,71974,2141,3.066,501,1640,16,83,H1
"Twin Falls County, ID",2006-2007,71974,73738,1764,2.451,553,1211,16,83,H1
"Twin Falls County, ID",2007-2008,73738,75143,1405,1.905,575,830,16,83,H1
"Twin Falls County, ID",2008-2009,75143,76271,1128,1.501,590,538,16,83,H1
"Twin Falls County, ID",2009-2010,76271,77527,1256,1.647,578,678,16,83,H1
"Twin Falls County, ID",2010-2011,77527,77993,466,0.601,461,5,16,83,H1
"Twin Falls County, ID",2011-2012,77993,78392,399,0.512,526,-127,16,83,H1
"Twin Falls County, ID",2012-2013,78392,79839,1447,1.846,515,932,16,83,H1
"Twin Falls County, ID",2013-2014,79839,80914,1075,1.346,521,554,16,83,H1
"Twin Falls County, ID",2014-2015,81109,82375,1266,1.561,497,769,16,83,H1
"Twin Falls County, ID",2015-2016,82375,83536,1161,1.409,448,713,16,83,H1
"Twin Falls County, ID",2016-2017,83536,85124,1588,1.901,464,1124,16,83,H1
"Valley County, ID",2000-2001,7659,7773,114,1.488,2,112,16,85,H1
"Valley County, ID",2001-2002,7773,7762,-11,-0.142,20,-31,16,85,H1
"Valley County, ID",2002-2003,7762,8003,241,3.105,21,220,16,85,H1
"Valley County, ID",2003-2004,8003,8283,280,3.499,10,270,16,85,H1
"Valley County, ID",2004-2005,8283,8779,496,5.988,9,487,16,85,H1
"Valley County, ID",2005-2006,8779,9480,701,7.985,43,658,16,85,H1
"Valley County, ID",2006-2007,9480,9929,449,4.736,59,390,16,85,H1
"Valley County, ID",2007-2008,9929,10060,131,1.319,86,45,16,85,H1
"Valley County, ID",2008-2009,10060,9975,-85,-0.845,66,-151,16,85,H1
"Valley County, ID",2009-2010,9975,9781,-194,-1.945,36,-230,16,85,H1
"Valley County, ID",2010-2011,9781,9606,-175,-1.789,18,-193,16,85,H1
"Valley County, ID",2011-2012,9606,9511,-95,-0.989,21,-116,16,85,H1
"Valley County, ID",2012-2013,9511,9586,75,0.789,45,30,16,85,H1
"Valley County, ID",2013-2014,9586,9826,240,2.504,32,208,16,85,H1
"Valley County, ID",2014-2015,9804,10103,299,3.05,31,268,16,85,H1
"Valley County, ID",2015-2016,10103,10417,314,3.108,15,299,16,85,H1
"Valley County, ID",2016-2017,10417,10687,270,2.592,17,253,16,85,H1
"Washington County, ID",2000-2001,9970,9936,-34,-0.341,9,-43,16,87,H1
"Washington County, ID",2001-2002,9936,9904,-32,-0.322,35,-67,16,87,H1
"Washington County, ID",2002-2003,9904,9904,0,0,16,-16,16,87,H1
"Washington County, ID",2003-2004,9904,9947,43,0.434,27,16,16,87,H1
"Washington County, ID",2004-2005,9947,9995,48,0.483,0,48,16,87,H1
"Washington County, ID",2005-2006,9995,10025,30,0.3,37,-7,16,87,H1
"Washington County, ID",2006-2007,10025,10027,2,0.02,17,-15,16,87,H1
"Washington County, ID",2007-2008,10027,10095,68,0.678,-17,85,16,87,H1
"Washington County, ID",2008-2009,10095,10173,78,0.773,8,70,16,87,H1
"Washington County, ID",2009-2010,10173,10190,17,0.167,7,10,16,87,H1
"Washington County, ID",2010-2011,10190,10134,-56,-0.55,-1,-55,16,87,H1
"Washington County, ID",2011-2012,10134,10041,-93,-0.918,-30,-63,16,87,H1
"Washington County, ID",2012-2013,10041,9954,-87,-0.866,-8,-79,16,87,H1
"Washington County, ID",2013-2014,9954,10021,67,0.673,14,53,16,87,H1
"Washington County, ID",2014-2015,10008,9984,-24,-0.24,27,-51,16,87,H1
"Washington County, ID",2015-2016,9984,10064,80,0.801,0,80,16,87,H1
"Washington County, ID",2016-2017,10064,10121,57,0.566,26,31,16,87,H1
Illinois,2000-2001,12434161,12488445,54284,0.437,79144,-24860,17,0,STATE
Illinois,2001-2002,12488445,12525556,37111,0.297,75558,-38447,17,0,STATE
Illinois,2002-2003,12525556,12556006,30450,0.243,75897,-45447,17,0,STATE
Illinois,2003-2004,12556006,12589773,33767,0.269,78865,-45098,17,0,STATE
Illinois,2004-2005,12589773,12609903,20130,0.16,74963,-54833,17,0,STATE
Illinois,2005-2006,12609903,12643955,34052,0.27,76962,-42910,17,0,STATE
Illinois,2006-2007,12643955,12695866,51911,0.411,79727,-27816,17,0,STATE
Illinois,2007-2008,12695866,12747038,51172,0.403,79691,-28519,17,0,STATE
Illinois,2008-2009,12747038,12796778,49740,0.39,79802,-30062,17,0,STATE
Illinois,2009-2010,12796778,12841249,44471,0.348,70792,-26321,17,0,STATE
Illinois,2010-2011,12841249,12861882,20633,0.161,60814,-40181,17,0,STATE
Illinois,2011-2012,12861882,12875167,13285,0.103,58844,-45559,17,0,STATE
Illinois,2012-2013,12875167,12889580,14413,0.112,53204,-38791,17,0,STATE
Illinois,2013-2014,12889580,12882189,-7391,-0.057,53077,-60468,17,0,STATE
Illinois,2014-2015,12882189,12859995,-22194,-0.172,52207,-74401,17,0,STATE
Illinois,2015-2016,12859995,12835726,-24269,-0.189,49406,-73675,17,0,STATE
Illinois,2016-2017,12835726,12802023,-33703,-0.263,47161,-80864,17,0,STATE
"Adams County, IL",2000-2001,68183,68014,-169,-0.248,5,-174,17,1,H1
"Adams County, IL",2001-2002,68014,67776,-238,-0.35,-19,-219,17,1,H1
"Adams County, IL",2002-2003,67776,67267,-509,-0.751,-80,-429,17,1,H1
"Adams County, IL",2003-2004,67267,66818,-449,-0.667,-63,-386,17,1,H1
"Adams County, IL",2004-2005,66818,66920,102,0.153,-4,106,17,1,H1
"Adams County, IL",2005-2006,66920,67106,186,0.278,20,166,17,1,H1
"Adams County, IL",2006-2007,67106,66943,-163,-0.243,84,-247,17,1,H1
"Adams County, IL",2007-2008,66943,66943,0,0,46,-46,17,1,H1
"Adams County, IL",2008-2009,66943,67039,96,0.143,40,56,17,1,H1
"Adams County, IL",2009-2010,67039,67162,123,0.183,-23,146,17,1,H1
"Adams County, IL",2010-2011,67162,67172,10,0.015,44,-34,17,1,H1
"Adams County, IL",2011-2012,67172,67199,27,0.04,10,17,17,1,H1
"Adams County, IL",2012-2013,67199,67046,-153,-0.228,1,-154,17,1,H1
"Adams County, IL",2013-2014,67046,66988,-58,-0.087,-21,-37,17,1,H1
"Adams County, IL",2014-2015,67018,67013,-5,-0.007,45,-50,17,1,H1
"Adams County, IL",2015-2016,67013,66673,-340,-0.507,12,-352,17,1,H1
"Adams County, IL",2016-2017,66673,66234,-439,-0.658,12,-451,17,1,H1
"Alexander County, IL",2000-2001,9684,9592,-92,-0.95,15,-107,17,3,H1
"Alexander County, IL",2001-2002,9592,9592,0,0,9,-9,17,3,H1
"Alexander County, IL",2002-2003,9592,9254,-338,-3.524,14,-352,17,3,H1
"Alexander County, IL",2003-2004,9254,9186,-68,-0.735,-18,-50,17,3,H1
"Alexander County, IL",2004-2005,9186,8914,-272,-2.961,0,-272,17,3,H1
"Alexander County, IL",2005-2006,8914,8730,-184,-2.064,-5,-179,17,3,H1
"Alexander County, IL",2006-2007,8730,8552,-178,-2.039,-24,-154,17,3,H1
"Alexander County, IL",2007-2008,8552,8461,-91,-1.064,20,-111,17,3,H1
"Alexander County, IL",2008-2009,8461,8295,-166,-1.962,10,-176,17,3,H1
"Alexander County, IL",2009-2010,8295,8206,-89,-1.073,-3,-86,17,3,H1
"Alexander County, IL",2010-2011,8206,8013,-193,-2.352,-3,-190,17,3,H1
"Alexander County, IL",2011-2012,8013,7750,-263,-3.282,27,-290,17,3,H1
"Alexander County, IL",2012-2013,7750,7643,-107,-1.381,28,-135,17,3,H1
"Alexander County, IL",2013-2014,7643,7492,-151,-1.976,-2,-149,17,3,H1
"Alexander County, IL",2014-2015,7098,6780,-318,-4.48,3,-321,17,3,H1
"Alexander County, IL",2015-2016,6780,6491,-289,-4.263,16,-305,17,3,H1
"Alexander County, IL",2016-2017,6491,6315,-176,-2.711,-11,-165,17,3,H1
"Bond County, IL",2000-2001,17659,17586,-73,-0.413,5,-78,17,5,H1
"Bond County, IL",2001-2002,17586,17735,149,0.847,5,144,17,5,H1
"Bond County, IL",2002-2003,17735,17960,225,1.269,31,194,17,5,H1
"Bond County, IL",2003-2004,17960,18101,141,0.785,40,101,17,5,H1
"Bond County, IL",2004-2005,18101,17988,-113,-0.624,19,-132,17,5,H1
"Bond County, IL",2005-2006,17988,18004,16,0.089,60,-44,17,5,H1
"Bond County, IL",2006-2007,18004,18077,73,0.405,27,46,17,5,H1
"Bond County, IL",2007-2008,18077,17916,-161,-0.891,17,-178,17,5,H1
"Bond County, IL",2008-2009,17916,17747,-169,-0.943,41,-210,17,5,H1
"Bond County, IL",2009-2010,17747,17773,26,0.147,11,15,17,5,H1
"Bond County, IL",2010-2011,17773,17731,-42,-0.236,8,-50,17,5,H1
"Bond County, IL",2011-2012,17731,17621,-110,-0.62,12,-122,17,5,H1
"Bond County, IL",2012-2013,17621,17461,-160,-0.908,-27,-133,17,5,H1
"Bond County, IL",2013-2014,17461,17269,-192,-1.1,-12,-180,17,5,H1
"Bond County, IL",2014-2015,17124,16950,-174,-1.016,5,-179,17,5,H1
"Bond County, IL",2015-2016,16950,16841,-109,-0.643,-34,-75,17,5,H1
"Bond County, IL",2016-2017,16841,16948,107,0.635,-21,128,17,5,H1
"Boone County, IL",2000-2001,42052,43220,1168,2.778,328,840,17,7,H1
"Boone County, IL",2001-2002,43220,44585,1365,3.158,318,1047,17,7,H1
"Boone County, IL",2002-2003,44585,46242,1657,3.716,368,1289,17,7,H1
"Boone County, IL",2003-2004,46242,47893,1651,3.57,306,1345,17,7,H1
"Boone County, IL",2004-2005,47893,49725,1832,3.825,339,1493,17,7,H1
"Boone County, IL",2005-2006,49725,51797,2072,4.167,422,1650,17,7,H1
"Boone County, IL",2006-2007,51797,53512,1715,3.311,403,1312,17,7,H1
"Boone County, IL",2007-2008,53512,54211,699,1.306,419,280,17,7,H1
"Boone County, IL",2008-2009,54211,54154,-57,-0.105,482,-539,17,7,H1
"Boone County, IL",2009-2010,54154,54144,-10,-0.018,299,-309,17,7,H1
"Boone County, IL",2010-2011,54144,54223,79,0.146,268,-189,17,7,H1
"Boone County, IL",2011-2012,54223,53880,-343,-0.633,251,-594,17,7,H1
"Boone County, IL",2012-2013,53880,53910,30,0.056,156,-126,17,7,H1
"Boone County, IL",2013-2014,53910,53869,-41,-0.076,233,-274,17,7,H1
"Boone County, IL",2014-2015,53793,53585,-208,-0.387,235,-443,17,7,H1
"Boone County, IL",2015-2016,53585,53562,-23,-0.043,173,-196,17,7,H1
"Boone County, IL",2016-2017,53562,53513,-49,-0.091,211,-260,17,7,H1
"Brown County, IL",2000-2001,6977,6984,7,0.1,11,-4,17,9,H1
"Brown County, IL",2001-2002,6984,6925,-59,-0.845,-8,-51,17,9,H1
"Brown County, IL",2002-2003,6925,6997,72,1.04,7,65,17,9,H1
"Brown County, IL",2003-2004,6997,6968,-29,-0.414,-5,-24,17,9,H1
"Brown County, IL",2004-2005,6968,6917,-51,-0.732,-16,-35,17,9,H1
"Brown County, IL",2005-2006,6917,6875,-42,-0.607,-13,-29,17,9,H1
"Brown County, IL",2006-2007,6875,6833,-42,-0.611,-1,-41,17,9,H1
"Brown County, IL",2007-2008,6833,6896,63,0.922,3,60,17,9,H1
"Brown County, IL",2008-2009,6896,6963,67,0.972,20,47,17,9,H1
"Brown County, IL",2009-2010,6963,6911,-52,-0.747,10,-62,17,9,H1
"Brown County, IL",2010-2011,6911,6877,-34,-0.492,-12,-22,17,9,H1
"Brown County, IL",2011-2012,6877,6912,35,0.509,15,20,17,9,H1
"Brown County, IL",2012-2013,6912,6857,-55,-0.796,-9,-46,17,9,H1
"Brown County, IL",2013-2014,6857,6832,-25,-0.365,-7,-18,17,9,H1
"Brown County, IL",2014-2015,6843,6829,-14,-0.205,-3,-11,17,9,H1
"Brown County, IL",2015-2016,6829,6744,-85,-1.245,10,-95,17,9,H1
"Brown County, IL",2016-2017,6744,6716,-28,-0.415,-9,-19,17,9,H1
"Bureau County, IL",2000-2001,35456,35181,-275,-0.776,41,-316,17,11,H1
"Bureau County, IL",2001-2002,35181,35057,-124,-0.352,-10,-114,17,11,H1
"Bureau County, IL",2002-2003,35057,35080,23,0.066,33,-10,17,11,H1
"Bureau County, IL",2003-2004,35080,34951,-129,-0.368,22,-151,17,11,H1
"Bureau County, IL",2004-2005,34951,34977,26,0.074,6,20,17,11,H1
"Bureau County, IL",2005-2006,34977,35183,206,0.589,33,173,17,11,H1
"Bureau County, IL",2006-2007,35183,35153,-30,-0.085,5,-35,17,11,H1
"Bureau County, IL",2007-2008,35153,35078,-75,-0.213,33,-108,17,11,H1
"Bureau County, IL",2008-2009,35078,35058,-20,-0.057,61,-81,17,11,H1
"Bureau County, IL",2009-2010,35058,34905,-153,-0.436,19,-172,17,11,H1
"Bureau County, IL",2010-2011,34905,34640,-265,-0.759,-63,-202,17,11,H1
"Bureau County, IL",2011-2012,34640,34337,-303,-0.875,-45,-258,17,11,H1
"Bureau County, IL",2012-2013,34337,34084,-253,-0.737,12,-265,17,11,H1
"Bureau County, IL",2013-2014,34084,33840,-244,-0.716,-40,-204,17,11,H1
"Bureau County, IL",2014-2015,33906,33587,-319,-0.941,15,-334,17,11,H1
"Bureau County, IL",2015-2016,33587,33433,-154,-0.459,11,-165,17,11,H1
"Bureau County, IL",2016-2017,33433,33243,-190,-0.568,-13,-177,17,11,H1
"Calhoun County, IL",2000-2001,5086,5045,-41,-0.806,-19,-22,17,13,H1
"Calhoun County, IL",2001-2002,5045,4987,-58,-1.15,-20,-38,17,13,H1
"Calhoun County, IL",2002-2003,4987,5122,135,2.707,0,135,17,13,H1
"Calhoun County, IL",2003-2004,5122,5138,16,0.312,-19,35,17,13,H1
"Calhoun County, IL",2004-2005,5138,5163,25,0.487,-18,43,17,13,H1
"Calhoun County, IL",2005-2006,5163,5174,11,0.213,5,6,17,13,H1
"Calhoun County, IL",2006-2007,5174,5160,-14,-0.271,-11,-3,17,13,H1
"Calhoun County, IL",2007-2008,5160,5084,-76,-1.473,-8,-68,17,13,H1
"Calhoun County, IL",2008-2009,5084,5082,-2,-0.039,-1,-1,17,13,H1
"Calhoun County, IL",2009-2010,5082,5079,-3,-0.059,-6,3,17,13,H1
"Calhoun County, IL",2010-2011,5079,5067,-12,-0.236,8,-20,17,13,H1
"Calhoun County, IL",2011-2012,5067,5022,-45,-0.888,-6,-39,17,13,H1
"Calhoun County, IL",2012-2013,5022,5042,20,0.398,-14,34,17,13,H1
"Calhoun County, IL",2013-2014,5042,4956,-86,-1.706,-17,-69,17,13,H1
"Calhoun County, IL",2014-2015,4963,4899,-64,-1.29,-12,-52,17,13,H1
"Calhoun County, IL",2015-2016,4899,4859,-40,-0.816,-12,-28,17,13,H1
"Calhoun County, IL",2016-2017,4859,4833,-26,-0.535,-20,-6,17,13,H1
"Carroll County, IL",2000-2001,16611,16405,-206,-1.24,-21,-185,17,15,H1
"Carroll County, IL",2001-2002,16405,16312,-93,-0.567,-36,-57,17,15,H1
"Carroll County, IL",2002-2003,16312,16267,-45,-0.276,-20,-25,17,15,H1
"Carroll County, IL",2003-2004,16267,16102,-165,-1.014,-11,-154,17,15,H1
"Carroll County, IL",2004-2005,16102,15914,-188,-1.168,-47,-141,17,15,H1
"Carroll County, IL",2005-2006,15914,15866,-48,-0.302,-90,42,17,15,H1
"Carroll County, IL",2006-2007,15866,15734,-132,-0.832,-48,-84,17,15,H1
"Carroll County, IL",2007-2008,15734,15638,-96,-0.61,-26,-70,17,15,H1
"Carroll County, IL",2008-2009,15638,15476,-162,-1.036,-22,-140,17,15,H1
"Carroll County, IL",2009-2010,15476,15364,-112,-0.724,-48,-64,17,15,H1
"Carroll County, IL",2010-2011,15364,15185,-179,-1.165,-59,-120,17,15,H1
"Carroll County, IL",2011-2012,15185,15003,-182,-1.199,-76,-106,17,15,H1
"Carroll County, IL",2012-2013,15003,14868,-135,-0.9,-52,-83,17,15,H1
"Carroll County, IL",2013-2014,14868,14715,-153,-1.029,-42,-111,17,15,H1
"Carroll County, IL",2014-2015,14790,14616,-174,-1.176,-53,-121,17,15,H1
"Carroll County, IL",2015-2016,14616,14611,-5,-0.034,-31,26,17,15,H1
"Carroll County, IL",2016-2017,14611,14518,-93,-0.637,-33,-60,17,15,H1
"Cass County, IL",2000-2001,13675,13677,2,0.015,29,-27,17,17,H1
"Cass County, IL",2001-2002,13677,13549,-128,-0.936,37,-165,17,17,H1
"Cass County, IL",2002-2003,13549,13674,125,0.923,44,81,17,17,H1
"Cass County, IL",2003-2004,13674,13640,-34,-0.249,48,-82,17,17,H1
"Cass County, IL",2004-2005,13640,13670,30,0.22,28,2,17,17,H1
"Cass County, IL",2005-2006,13670,13611,-59,-0.432,48,-107,17,17,H1
"Cass County, IL",2006-2007,13611,13699,88,0.647,32,56,17,17,H1
"Cass County, IL",2007-2008,13699,13660,-39,-0.285,36,-75,17,17,H1
"Cass County, IL",2008-2009,13660,13623,-37,-0.271,57,-94,17,17,H1
"Cass County, IL",2009-2010,13623,13639,16,0.117,37,-21,17,17,H1
"Cass County, IL",2010-2011,13639,13647,8,0.059,47,-39,17,17,H1
"Cass County, IL",2011-2012,13647,13422,-225,-1.649,35,-260,17,17,H1
"Cass County, IL",2012-2013,13422,13335,-87,-0.648,41,-128,17,17,H1
"Cass County, IL",2013-2014,13335,13156,-179,-1.342,52,-231,17,17,H1
"Cass County, IL",2014-2015,13082,12847,-235,-1.796,9,-244,17,17,H1
"Cass County, IL",2015-2016,12847,12681,-166,-1.292,16,-182,17,17,H1
"Cass County, IL",2016-2017,12681,12505,-176,-1.388,35,-211,17,17,H1
"Champaign County, IL",2000-2001,180041,181956,1915,1.064,1190,725,17,19,H1
"Champaign County, IL",2001-2002,181956,184198,2242,1.232,1118,1124,17,19,H1
"Champaign County, IL",2002-2003,184198,187013,2815,1.528,1074,1741,17,19,H1
"Champaign County, IL",2003-2004,187013,188617,1604,0.858,1103,501,17,19,H1
"Champaign County, IL",2004-2005,188617,190659,2042,1.083,1155,887,17,19,H1
"Champaign County, IL",2005-2006,190659,193844,3185,1.671,1400,1785,17,19,H1
"Champaign County, IL",2006-2007,193844,196621,2777,1.433,1348,1429,17,19,H1
"Champaign County, IL",2007-2008,196621,197570,949,0.483,1320,-371,17,19,H1
"Champaign County, IL",2008-2009,197570,199968,2398,1.214,1276,1122,17,19,H1
"Champaign County, IL",2009-2010,199968,201460,1492,0.746,1165,327,17,19,H1
"Champaign County, IL",2010-2011,201460,202706,1246,0.618,1092,154,17,19,H1
"Champaign County, IL",2011-2012,202706,204009,1303,0.643,1281,22,17,19,H1
"Champaign County, IL",2012-2013,204009,205761,1752,0.859,1136,616,17,19,H1
"Champaign County, IL",2013-2014,205761,207133,1372,0.667,1115,257,17,19,H1
"Champaign County, IL",2014-2015,207424,208861,1437,0.693,1134,303,17,19,H1
"Champaign County, IL",2015-2016,208861,209267,406,0.194,1041,-635,17,19,H1
"Champaign County, IL",2016-2017,209267,209399,132,0.063,1022,-890,17,19,H1
"Christian County, IL",2000-2001,35383,35240,-143,-0.404,-63,-80,17,21,H1
"Christian County, IL",2001-2002,35240,35181,-59,-0.167,-43,-16,17,21,H1
"Christian County, IL",2002-2003,35181,35172,-9,-0.026,-16,7,17,21,H1
"Christian County, IL",2003-2004,35172,35308,136,0.387,29,107,17,21,H1
"Christian County, IL",2004-2005,35308,35165,-143,-0.405,2,-145,17,21,H1
"Christian County, IL",2005-2006,35165,35076,-89,-0.253,-16,-73,17,21,H1
"Christian County, IL",2006-2007,35076,35034,-42,-0.12,7,-49,17,21,H1
"Christian County, IL",2007-2008,35034,34974,-60,-0.171,21,-81,17,21,H1
"Christian County, IL",2008-2009,34974,34808,-166,-0.475,-4,-162,17,21,H1
"Christian County, IL",2009-2010,34808,34783,-25,-0.072,-48,23,17,21,H1
"Christian County, IL",2010-2011,34783,34720,-63,-0.181,-66,3,17,21,H1
"Christian County, IL",2011-2012,34720,34511,-209,-0.602,-37,-172,17,21,H1
"Christian County, IL",2012-2013,34511,34171,-340,-0.985,-42,-298,17,21,H1
"Christian County, IL",2013-2014,34171,33892,-279,-0.816,-31,-248,17,21,H1
"Christian County, IL",2014-2015,33917,33642,-275,-0.811,-15,-260,17,21,H1
"Christian County, IL",2015-2016,33642,33271,-371,-1.103,-47,-324,17,21,H1
"Christian County, IL",2016-2017,33271,33102,-169,-0.508,-26,-143,17,21,H1
"Clark County, IL",2000-2001,16969,16829,-140,-0.825,-30,-110,17,23,H1
"Clark County, IL",2001-2002,16829,16844,15,0.089,-14,29,17,23,H1
"Clark County, IL",2002-2003,16844,16750,-94,-0.558,-54,-40,17,23,H1
"Clark County, IL",2003-2004,16750,16718,-32,-0.191,-43,11,17,23,H1
"Clark County, IL",2004-2005,16718,16728,10,0.06,-6,16,17,23,H1
"Clark County, IL",2005-2006,16728,16669,-59,-0.353,-3,-56,17,23,H1
"Clark County, IL",2006-2007,16669,16682,13,0.078,-16,29,17,23,H1
"Clark County, IL",2007-2008,16682,16634,-48,-0.288,-48,0,17,23,H1
"Clark County, IL",2008-2009,16634,16431,-203,-1.22,-23,-180,17,23,H1
"Clark County, IL",2009-2010,16431,16296,-135,-0.822,-42,-93,17,23,H1
"Clark County, IL",2010-2011,16296,16219,-77,-0.473,-10,-67,17,23,H1
"Clark County, IL",2011-2012,16219,16304,85,0.524,26,59,17,23,H1
"Clark County, IL",2012-2013,16304,16203,-101,-0.619,26,-127,17,23,H1
"Clark County, IL",2013-2014,16203,16180,-23,-0.142,-1,-22,17,23,H1
"Clark County, IL",2014-2015,16138,15979,-159,-0.985,-3,-156,17,23,H1
"Clark County, IL",2015-2016,15979,15848,-131,-0.82,-29,-102,17,23,H1
"Clark County, IL",2016-2017,15848,15767,-81,-0.511,-30,-51,17,23,H1
"Clay County, IL",2000-2001,14409,14260,-149,-1.034,26,-175,17,25,H1
"Clay County, IL",2001-2002,14260,14228,-32,-0.224,-11,-21,17,25,H1
"Clay County, IL",2002-2003,14228,14194,-34,-0.239,-35,1,17,25,H1
"Clay County, IL",2003-2004,14194,14142,-52,-0.366,-9,-43,17,25,H1
"Clay County, IL",2004-2005,14142,14134,-8,-0.057,3,-11,17,25,H1
"Clay County, IL",2005-2006,14134,14061,-73,-0.516,-9,-64,17,25,H1
"Clay County, IL",2006-2007,14061,13975,-86,-0.612,32,-118,17,25,H1
"Clay County, IL",2007-2008,13975,13971,-4,-0.029,4,-8,17,25,H1
"Clay County, IL",2008-2009,13971,13826,-145,-1.038,6,-151,17,25,H1
"Clay County, IL",2009-2010,13826,13818,-8,-0.058,-18,10,17,25,H1
"Clay County, IL",2010-2011,13818,13731,-87,-0.63,-37,-50,17,25,H1
"Clay County, IL",2011-2012,13731,13733,2,0.015,29,-27,17,25,H1
"Clay County, IL",2012-2013,13733,13572,-161,-1.172,-4,-157,17,25,H1
"Clay County, IL",2013-2014,13572,13520,-52,-0.383,8,-60,17,25,H1
"Clay County, IL",2014-2015,13463,13428,-35,-0.26,-36,1,17,25,H1
"Clay County, IL",2015-2016,13428,13311,-117,-0.871,-23,-94,17,25,H1
"Clay County, IL",2016-2017,13311,13269,-42,-0.316,-18,-24,17,25,H1
"Clinton County, IL",2000-2001,35565,35792,227,0.638,84,143,17,27,H1
"Clinton County, IL",2001-2002,35792,36003,211,0.59,60,151,17,27,H1
"Clinton County, IL",2002-2003,36003,36231,228,0.633,41,187,17,27,H1
"Clinton County, IL",2003-2004,36231,36495,264,0.729,80,184,17,27,H1
"Clinton County, IL",2004-2005,36495,36681,186,0.51,137,49,17,27,H1
"Clinton County, IL",2005-2006,36681,37051,370,1.009,39,331,17,27,H1
"Clinton County, IL",2006-2007,37051,37160,109,0.294,128,-19,17,27,H1
"Clinton County, IL",2007-2008,37160,37472,312,0.84,95,217,17,27,H1
"Clinton County, IL",2008-2009,37472,37459,-13,-0.035,129,-142,17,27,H1
"Clinton County, IL",2009-2010,37459,37819,360,0.961,64,296,17,27,H1
"Clinton County, IL",2010-2011,37819,38130,311,0.822,108,203,17,27,H1
"Clinton County, IL",2011-2012,38130,38057,-73,-0.191,99,-172,17,27,H1
"Clinton County, IL",2012-2013,38057,37895,-162,-0.426,72,-234,17,27,H1
"Clinton County, IL",2013-2014,37895,37857,-38,-0.1,59,-97,17,27,H1
"Clinton County, IL",2014-2015,37802,37786,-16,-0.042,34,-50,17,27,H1
"Clinton County, IL",2015-2016,37786,37565,-221,-0.585,84,-305,17,27,H1
"Clinton County, IL",2016-2017,37565,37614,49,0.13,67,-18,17,27,H1
"Coles County, IL",2000-2001,53114,52549,-565,-1.064,92,-657,17,29,H1
"Coles County, IL",2001-2002,52549,52454,-95,-0.181,102,-197,17,29,H1
"Coles County, IL",2002-2003,52454,52974,520,0.991,49,471,17,29,H1
"Coles County, IL",2003-2004,52974,53182,208,0.393,59,149,17,29,H1
"Coles County, IL",2004-2005,53182,53016,-166,-0.312,55,-221,17,29,H1
"Coles County, IL",2005-2006,53016,53359,343,0.647,64,279,17,29,H1
"Coles County, IL",2006-2007,53359,53492,133,0.249,102,31,17,29,H1
"Coles County, IL",2007-2008,53492,53454,-38,-0.071,123,-161,17,29,H1
"Coles County, IL",2008-2009,53454,53612,158,0.296,100,58,17,29,H1
"Coles County, IL",2009-2010,53612,53931,319,0.595,86,233,17,29,H1
"Coles County, IL",2010-2011,53931,53751,-180,-0.334,-7,-173,17,29,H1
"Coles County, IL",2011-2012,53751,53631,-120,-0.223,27,-147,17,29,H1
"Coles County, IL",2012-2013,53631,53641,10,0.019,21,-11,17,29,H1
"Coles County, IL",2013-2014,53641,53320,-321,-0.598,35,-356,17,29,H1
"Coles County, IL",2014-2015,52697,52521,-176,-0.334,27,-203,17,29,H1
"Coles County, IL",2015-2016,52521,52412,-109,-0.208,48,-157,17,29,H1
"Coles County, IL",2016-2017,52412,51979,-433,-0.826,31,-464,17,29,H1
"Cook County, IL",2000-2001,5373418,5360562,-12856,-0.239,39062,-51918,17,31,H1
"Cook County, IL",2001-2002,5360562,5328775,-31787,-0.593,37373,-69160,17,31,H1
"Cook County, IL",2002-2003,5328775,5294739,-34036,-0.639,37725,-71761,17,31,H1
"Cook County, IL",2003-2004,5294739,5252021,-42718,-0.807,38872,-81590,17,31,H1
"Cook County, IL",2004-2005,5252021,5207615,-44406,-0.846,36623,-81029,17,31,H1
"Cook County, IL",2005-2006,5207615,5165495,-42120,-0.809,36969,-79089,17,31,H1
"Cook County, IL",2006-2007,5165495,5154235,-11260,-0.218,38258,-49518,17,31,H1
"Cook County, IL",2007-2008,5154235,5161831,7596,0.147,37913,-30317,17,31,H1
"Cook County, IL",2008-2009,5161831,5181728,19897,0.385,36831,-16934,17,31,H1
"Cook County, IL",2009-2010,5181728,5198716,16988,0.328,39022,-22034,17,31,H1
"Cook County, IL",2010-2011,5198716,5214988,16272,0.313,32951,-16679,17,31,H1
"Cook County, IL",2011-2012,5214988,5232340,17352,0.333,31871,-14519,17,31,H1
"Cook County, IL",2012-2013,5232340,5246635,14295,0.273,29473,-15178,17,31,H1
"Cook County, IL",2013-2014,5246635,5246456,-179,-0.003,28798,-28977,17,31,H1
"Cook County, IL",2014-2015,5248704,5238216,-10488,-0.2,27868,-38356,17,31,H1
"Cook County, IL",2015-2016,5238216,5231356,-6860,-0.131,26795,-33655,17,31,H1
"Cook County, IL",2016-2017,5231356,5211263,-20093,-0.384,25168,-45261,17,31,H1
"Crawford County, IL",2000-2001,20411,20363,-48,-0.235,0,-48,17,33,H1
"Crawford County, IL",2001-2002,20363,20204,-159,-0.781,-50,-109,17,33,H1
"Crawford County, IL",2002-2003,20204,20106,-98,-0.485,-62,-36,17,33,H1
"Crawford County, IL",2003-2004,20106,20059,-47,-0.234,-46,-1,17,33,H1
"Crawford County, IL",2004-2005,20059,20051,-8,-0.04,-42,34,17,33,H1
"Crawford County, IL",2005-2006,20051,19966,-85,-0.424,-22,-63,17,33,H1
"Crawford County, IL",2006-2007,19966,19886,-80,-0.401,-39,-41,17,33,H1
"Crawford County, IL",2007-2008,19886,19831,-55,-0.277,-38,-17,17,33,H1
"Crawford County, IL",2008-2009,19831,19845,14,0.071,-38,52,17,33,H1
"Crawford County, IL",2009-2010,19845,19808,-37,-0.186,-51,14,17,33,H1
"Crawford County, IL",2010-2011,19808,19783,-25,-0.126,-17,-8,17,33,H1
"Crawford County, IL",2011-2012,19783,19627,-156,-0.789,17,-173,17,33,H1
"Crawford County, IL",2012-2013,19627,19514,-113,-0.576,-41,-72,17,33,H1
"Crawford County, IL",2013-2014,19514,19393,-121,-0.62,-46,-75,17,33,H1
"Crawford County, IL",2014-2015,19375,19414,39,0.201,-42,81,17,33,H1
"Crawford County, IL",2015-2016,19414,19142,-272,-1.401,-21,-251,17,33,H1
"Crawford County, IL",2016-2017,19142,18961,-181,-0.946,-37,-144,17,33,H1
"Cumberland County, IL",2000-2001,11318,11238,-80,-0.707,-8,-72,17,35,H1
"Cumberland County, IL",2001-2002,11238,11171,-67,-0.596,-10,-57,17,35,H1
"Cumberland County, IL",2002-2003,11171,11066,-105,-0.94,-10,-95,17,35,H1
"Cumberland County, IL",2003-2004,11066,11078,12,0.108,-13,25,17,35,H1
"Cumberland County, IL",2004-2005,11078,11057,-21,-0.19,20,-41,17,35,H1
"Cumberland County, IL",2005-2006,11057,11103,46,0.416,6,40,17,35,H1
"Cumberland County, IL",2006-2007,11103,11077,-26,-0.234,8,-34,17,35,H1
"Cumberland County, IL",2007-2008,11077,11100,23,0.208,13,10,17,35,H1
"Cumberland County, IL",2008-2009,11100,11044,-56,-0.505,9,-65,17,35,H1
"Cumberland County, IL",2009-2010,11044,11041,-3,-0.027,4,-7,17,35,H1
"Cumberland County, IL",2010-2011,11041,11068,27,0.245,-6,33,17,35,H1
"Cumberland County, IL",2011-2012,11068,10936,-132,-1.193,7,-139,17,35,H1
"Cumberland County, IL",2012-2013,10936,10871,-65,-0.594,-11,-54,17,35,H1
"Cumberland County, IL",2013-2014,10871,10833,-38,-0.35,-11,-27,17,35,H1
"Cumberland County, IL",2014-2015,10906,10898,-8,-0.073,36,-44,17,35,H1
"Cumberland County, IL",2015-2016,10898,10892,-6,-0.055,15,-21,17,35,H1
"Cumberland County, IL",2016-2017,10892,10908,16,0.147,23,-7,17,35,H1
"DeKalb County, IL",2000-2001,89237,90545,1308,1.466,573,735,17,37,H1
"DeKalb County, IL",2001-2002,90545,91951,1406,1.553,541,865,17,37,H1
"DeKalb County, IL",2002-2003,91951,94096,2145,2.333,569,1576,17,37,H1
"DeKalb County, IL",2003-2004,94096,96106,2010,2.136,553,1457,17,37,H1
"DeKalb County, IL",2004-2005,96106,98438,2332,2.426,529,1803,17,37,H1
"DeKalb County, IL",2005-2006,98438,101437,2999,3.047,653,2346,17,37,H1
"DeKalb County, IL",2006-2007,101437,103746,2309,2.276,734,1575,17,37,H1
"DeKalb County, IL",2007-2008,103746,104601,855,0.824,704,151,17,37,H1
"DeKalb County, IL",2008-2009,104601,105146,545,0.521,789,-244,17,37,H1
"DeKalb County, IL",2009-2010,105146,105119,-27,-0.026,621,-648,17,37,H1
"DeKalb County, IL",2010-2011,105119,104520,-599,-0.57,594,-1193,17,37,H1
"DeKalb County, IL",2011-2012,104520,104693,173,0.166,513,-340,17,37,H1
"DeKalb County, IL",2012-2013,104693,104802,109,0.104,476,-367,17,37,H1
"DeKalb County, IL",2013-2014,104802,105462,660,0.63,495,165,17,37,H1
"DeKalb County, IL",2014-2015,104693,104352,-341,-0.326,513,-854,17,37,H1
"DeKalb County, IL",2015-2016,104352,104447,95,0.091,499,-404,17,37,H1
"DeKalb County, IL",2016-2017,104447,104733,286,0.274,471,-185,17,37,H1
"De Witt County, IL",2000-2001,16800,16792,-8,-0.048,41,-49,17,39,H1
"De Witt County, IL",2001-2002,16792,16673,-119,-0.709,9,-128,17,39,H1
"De Witt County, IL",2002-2003,16673,16686,13,0.078,-37,50,17,39,H1
"De Witt County, IL",2003-2004,16686,16671,-15,-0.09,23,-38,17,39,H1
"De Witt County, IL",2004-2005,16671,16716,45,0.27,-28,73,17,39,H1
"De Witt County, IL",2005-2006,16716,16792,76,0.455,-22,98,17,39,H1
"De Witt County, IL",2006-2007,16792,16742,-50,-0.298,14,-64,17,39,H1
"De Witt County, IL",2007-2008,16742,16733,-9,-0.054,0,-9,17,39,H1
"De Witt County, IL",2008-2009,16733,16538,-195,-1.165,-4,-191,17,39,H1
"De Witt County, IL",2009-2010,16538,16578,40,0.242,-23,63,17,39,H1
"De Witt County, IL",2010-2011,16578,16548,-30,-0.181,-1,-29,17,39,H1
"De Witt County, IL",2011-2012,16548,16492,-56,-0.338,35,-91,17,39,H1
"De Witt County, IL",2012-2013,16492,16401,-91,-0.552,-14,-77,17,39,H1
"De Witt County, IL",2013-2014,16401,16284,-117,-0.713,-31,-86,17,39,H1
"De Witt County, IL",2014-2015,16246,16247,1,0.006,-52,53,17,39,H1
"De Witt County, IL",2015-2016,16247,16159,-88,-0.542,2,-90,17,39,H1
"De Witt County, IL",2016-2017,16159,15942,-217,-1.343,-17,-200,17,39,H1
"Douglas County, IL",2000-2001,19964,20032,68,0.341,109,-41,17,41,H1
"Douglas County, IL",2001-2002,20032,20017,-15,-0.075,70,-85,17,41,H1
"Douglas County, IL",2002-2003,20017,20010,-7,-0.035,124,-131,17,41,H1
"Douglas County, IL",2003-2004,20010,20100,90,0.45,125,-35,17,41,H1
"Douglas County, IL",2004-2005,20100,20101,1,0.005,91,-90,17,41,H1
"Douglas County, IL",2005-2006,20101,20111,10,0.05,38,-28,17,41,H1
"Douglas County, IL",2006-2007,20111,20061,-50,-0.249,68,-118,17,41,H1
"Douglas County, IL",2007-2008,20061,19970,-91,-0.454,91,-182,17,41,H1
"Douglas County, IL",2008-2009,19970,19949,-21,-0.105,105,-126,17,41,H1
"Douglas County, IL",2009-2010,19949,19957,8,0.04,92,-84,17,41,H1
"Douglas County, IL",2010-2011,19957,19826,-131,-0.656,70,-201,17,41,H1
"Douglas County, IL",2011-2012,19826,19832,6,0.03,56,-50,17,41,H1
"Douglas County, IL",2012-2013,19832,19829,-3,-0.015,83,-86,17,41,H1
"Douglas County, IL",2013-2014,19829,19889,60,0.303,80,-20,17,41,H1
"Douglas County, IL",2014-2015,19864,19823,-41,-0.206,98,-139,17,41,H1
"Douglas County, IL",2015-2016,19823,19769,-54,-0.272,105,-159,17,41,H1
"Douglas County, IL",2016-2017,19769,19748,-21,-0.106,117,-138,17,41,H1
"DuPage County, IL",2000-2001,906284,911474,5190,0.573,7794,-2604,17,43,H1
"DuPage County, IL",2001-2002,911474,913880,2406,0.264,7346,-4940,17,43,H1
"DuPage County, IL",2002-2003,913880,914078,198,0.022,7248,-7050,17,43,H1
"DuPage County, IL",2003-2004,914078,913940,-138,-0.015,7247,-7385,17,43,H1
"DuPage County, IL",2004-2005,913940,911378,-2562,-0.28,6727,-9289,17,43,H1
"DuPage County, IL",2005-2006,911378,908685,-2693,-0.295,6364,-9057,17,43,H1
"DuPage County, IL",2006-2007,908685,907426,-1259,-0.139,6117,-7376,17,43,H1
"DuPage County, IL",2007-2008,907426,909798,2372,0.261,5976,-3604,17,43,H1
"DuPage County, IL",2008-2009,909798,912732,2934,0.322,5932,-2998,17,43,H1
"DuPage County, IL",2009-2010,912732,917911,5179,0.567,5674,-495,17,43,H1
"DuPage County, IL",2010-2011,917911,923352,5441,0.593,4883,558,17,43,H1
"DuPage County, IL",2011-2012,923352,926933,3581,0.388,4871,-1290,17,43,H1
"DuPage County, IL",2012-2013,926933,931522,4589,0.495,4474,115,17,43,H1
"DuPage County, IL",2013-2014,931522,932708,1186,0.127,4327,-3141,17,43,H1
"DuPage County, IL",2014-2015,933769,933736,-33,-0.004,4429,-4462,17,43,H1
"DuPage County, IL",2015-2016,933736,931153,-2583,-0.277,4428,-7011,17,43,H1
"DuPage County, IL",2016-2017,931153,930128,-1025,-0.11,4201,-5226,17,43,H1
"Edgar County, IL",2000-2001,19582,19465,-117,-0.597,-17,-100,17,45,H1
"Edgar County, IL",2001-2002,19465,19249,-216,-1.11,8,-224,17,45,H1
"Edgar County, IL",2002-2003,19249,19085,-164,-0.852,-97,-67,17,45,H1
"Edgar County, IL",2003-2004,19085,19041,-44,-0.231,-52,8,17,45,H1
"Edgar County, IL",2004-2005,19041,18987,-54,-0.284,-4,-50,17,45,H1
"Edgar County, IL",2005-2006,18987,18986,-1,-0.005,-20,19,17,45,H1
"Edgar County, IL",2006-2007,18986,18929,-57,-0.3,-21,-36,17,45,H1
"Edgar County, IL",2007-2008,18929,18768,-161,-0.851,-31,-130,17,45,H1
"Edgar County, IL",2008-2009,18768,18668,-100,-0.533,-30,-70,17,45,H1
"Edgar County, IL",2009-2010,18668,18505,-163,-0.873,-63,-100,17,45,H1
"Edgar County, IL",2010-2011,18505,18396,-109,-0.589,-40,-69,17,45,H1
"Edgar County, IL",2011-2012,18396,18153,-243,-1.321,-33,-210,17,45,H1
"Edgar County, IL",2012-2013,18153,17958,-195,-1.074,-44,-151,17,45,H1
"Edgar County, IL",2013-2014,17958,17841,-117,-0.652,-38,-79,17,45,H1
"Edgar County, IL",2014-2015,17800,17664,-136,-0.764,-23,-113,17,45,H1
"Edgar County, IL",2015-2016,17664,17472,-192,-1.087,-65,-127,17,45,H1
"Edgar County, IL",2016-2017,17472,17328,-144,-0.824,-61,-83,17,45,H1
"Edwards County, IL",2000-2001,6963,6879,-84,-1.206,-2,-82,17,47,H1
"Edwards County, IL",2001-2002,6879,6856,-23,-0.334,7,-30,17,47,H1
"Edwards County, IL",2002-2003,6856,6883,27,0.394,-1,28,17,47,H1
"Edwards County, IL",2003-2004,6883,6825,-58,-0.843,-9,-49,17,47,H1
"Edwards County, IL",2004-2005,6825,6796,-29,-0.425,-19,-10,17,47,H1
"Edwards County, IL",2005-2006,6796,6694,-102,-1.501,-32,-70,17,47,H1
"Edwards County, IL",2006-2007,6694,6728,34,0.508,-38,72,17,47,H1
"Edwards County, IL",2007-2008,6728,6710,-18,-0.268,19,-37,17,47,H1
"Edwards County, IL",2008-2009,6710,6675,-35,-0.522,-3,-32,17,47,H1
"Edwards County, IL",2009-2010,6675,6726,51,0.764,-15,66,17,47,H1
"Edwards County, IL",2010-2011,6726,6684,-42,-0.624,11,-53,17,47,H1
"Edwards County, IL",2011-2012,6684,6731,47,0.703,10,37,17,47,H1
"Edwards County, IL",2012-2013,6731,6678,-53,-0.787,12,-65,17,47,H1
"Edwards County, IL",2013-2014,6678,6617,-61,-0.913,9,-70,17,47,H1
"Edwards County, IL",2014-2015,6621,6534,-87,-1.314,16,-103,17,47,H1
"Edwards County, IL",2015-2016,6534,6545,11,0.168,24,-13,17,47,H1
"Edwards County, IL",2016-2017,6545,6486,-59,-0.901,12,-71,17,47,H1
"Effingham County, IL",2000-2001,34248,34334,86,0.251,142,-56,17,49,H1
"Effingham County, IL",2001-2002,34334,34281,-53,-0.154,98,-151,17,49,H1
"Effingham County, IL",2002-2003,34281,34408,127,0.37,127,0,17,49,H1
"Effingham County, IL",2003-2004,34408,34497,89,0.259,152,-63,17,49,H1
"Effingham County, IL",2004-2005,34497,34365,-132,-0.383,140,-272,17,49,H1
"Effingham County, IL",2005-2006,34365,34289,-76,-0.221,190,-266,17,49,H1
"Effingham County, IL",2006-2007,34289,34191,-98,-0.286,143,-241,17,49,H1
"Effingham County, IL",2007-2008,34191,34173,-18,-0.053,118,-136,17,49,H1
"Effingham County, IL",2008-2009,34173,34275,102,0.298,138,-36,17,49,H1
"Effingham County, IL",2009-2010,34275,34197,-78,-0.228,103,-181,17,49,H1
"Effingham County, IL",2010-2011,34197,34253,56,0.164,88,-32,17,49,H1
"Effingham County, IL",2011-2012,34253,34322,69,0.201,95,-26,17,49,H1
"Effingham County, IL",2012-2013,34322,34306,-16,-0.047,115,-131,17,49,H1
"Effingham County, IL",2013-2014,34306,34320,14,0.041,117,-103,17,49,H1
"Effingham County, IL",2014-2015,34321,34371,50,0.146,86,-36,17,49,H1
"Effingham County, IL",2015-2016,34371,34182,-189,-0.55,108,-297,17,49,H1
"Effingham County, IL",2016-2017,34182,34132,-50,-0.146,128,-178,17,49,H1
"Fayette County, IL",2000-2001,21827,21695,-132,-0.605,-12,-120,17,51,H1
"Fayette County, IL",2001-2002,21695,21814,119,0.549,6,113,17,51,H1
"Fayette County, IL",2002-2003,21814,21514,-300,-1.375,-22,-278,17,51,H1
"Fayette County, IL",2003-2004,21514,21056,-458,-2.129,-21,-437,17,51,H1
"Fayette County, IL",2004-2005,21056,21848,792,3.761,30,762,17,51,H1
"Fayette County, IL",2005-2006,21848,21925,77,0.352,-1,78,17,51,H1
"Fayette County, IL",2006-2007,21925,21890,-35,-0.16,31,-66,17,51,H1
"Fayette County, IL",2007-2008,21890,22006,116,0.53,37,79,17,51,H1
"Fayette County, IL",2008-2009,22006,22089,83,0.377,26,57,17,51,H1
"Fayette County, IL",2009-2010,22089,22116,27,0.122,-10,37,17,51,H1
"Fayette County, IL",2010-2011,22116,22160,44,0.199,56,-12,17,51,H1
"Fayette County, IL",2011-2012,22160,22022,-138,-0.623,11,-149,17,51,H1
"Fayette County, IL",2012-2013,22022,22037,15,0.068,19,-4,17,51,H1
"Fayette County, IL",2013-2014,22037,21870,-167,-0.758,25,-192,17,51,H1
"Fayette County, IL",2014-2015,21993,22043,50,0.227,39,11,17,51,H1
"Fayette County, IL",2015-2016,22043,21816,-227,-1.03,7,-234,17,51,H1
"Fayette County, IL",2016-2017,21816,21784,-32,-0.147,31,-63,17,51,H1
"Ford County, IL",2000-2001,14195,14148,-47,-0.331,-19,-28,17,53,H1
"Ford County, IL",2001-2002,14148,14118,-30,-0.212,-56,26,17,53,H1
"Ford County, IL",2002-2003,14118,14095,-23,-0.163,-46,23,17,53,H1
"Ford County, IL",2003-2004,14095,14135,40,0.284,-42,82,17,53,H1
"Ford County, IL",2004-2005,14135,14092,-43,-0.304,-30,-13,17,53,H1
"Ford County, IL",2005-2006,14092,14096,4,0.028,-43,47,17,53,H1
"Ford County, IL",2006-2007,14096,14213,117,0.83,-47,164,17,53,H1
"Ford County, IL",2007-2008,14213,14095,-118,-0.83,-16,-102,17,53,H1
"Ford County, IL",2008-2009,14095,14084,-11,-0.078,-20,9,17,53,H1
"Ford County, IL",2009-2010,14084,14078,-6,-0.043,-31,25,17,53,H1
"Ford County, IL",2010-2011,14078,13954,-124,-0.881,-87,-37,17,53,H1
"Ford County, IL",2011-2012,13954,13998,44,0.315,-38,82,17,53,H1
"Ford County, IL",2012-2013,13998,13814,-184,-1.314,-65,-119,17,53,H1
"Ford County, IL",2013-2014,13814,13688,-126,-0.912,-65,-61,17,53,H1
"Ford County, IL",2014-2015,13708,13736,28,0.204,-35,63,17,53,H1
"Ford County, IL",2015-2016,13736,13342,-394,-2.868,-46,-348,17,53,H1
"Ford County, IL",2016-2017,13342,13280,-62,-0.465,-60,-2,17,53,H1
"Franklin County, IL",2000-2001,39003,38798,-205,-0.526,-91,-114,17,55,H1
"Franklin County, IL",2001-2002,38798,38893,95,0.245,-116,211,17,55,H1
"Franklin County, IL",2002-2003,38893,39066,173,0.445,-107,280,17,55,H1
"Franklin County, IL",2003-2004,39066,39298,232,0.594,-69,301,17,55,H1
"Franklin County, IL",2004-2005,39298,39587,289,0.735,-63,352,17,55,H1
"Franklin County, IL",2005-2006,39587,39560,-27,-0.068,-103,76,17,55,H1
"Franklin County, IL",2006-2007,39560,39473,-87,-0.22,-31,-56,17,55,H1
"Franklin County, IL",2007-2008,39473,39546,73,0.185,-23,96,17,55,H1
"Franklin County, IL",2008-2009,39546,39482,-64,-0.162,-54,-10,17,55,H1
"Franklin County, IL",2009-2010,39482,40023,541,1.37,-122,663,17,55,H1
"Franklin County, IL",2010-2011,40023,40002,-21,-0.052,-88,67,17,55,H1
"Franklin County, IL",2011-2012,40002,39862,-140,-0.35,-67,-73,17,55,H1
"Franklin County, IL",2012-2013,39862,39572,-290,-0.728,-44,-246,17,55,H1
"Franklin County, IL",2013-2014,39572,39411,-161,-0.407,-79,-82,17,55,H1
"Franklin County, IL",2014-2015,39514,39485,-29,-0.073,-15,-14,17,55,H1
"Franklin County, IL",2015-2016,39485,39092,-393,-0.995,-59,-334,17,55,H1
"Franklin County, IL",2016-2017,39092,39041,-51,-0.13,-43,-8,17,55,H1
"Fulton County, IL",2000-2001,38216,37880,-336,-0.879,-67,-269,17,57,H1
"Fulton County, IL",2001-2002,37880,37587,-293,-0.773,-69,-224,17,57,H1
"Fulton County, IL",2002-2003,37587,37705,118,0.314,-80,198,17,57,H1
"Fulton County, IL",2003-2004,37705,37630,-75,-0.199,-67,-8,17,57,H1
"Fulton County, IL",2004-2005,37630,37452,-178,-0.473,-76,-102,17,57,H1
"Fulton County, IL",2005-2006,37452,37387,-65,-0.174,-49,-16,17,57,H1
"Fulton County, IL",2006-2007,37387,37272,-115,-0.308,-83,-32,17,57,H1
"Fulton County, IL",2007-2008,37272,37224,-48,-0.129,-119,71,17,57,H1
"Fulton County, IL",2008-2009,37224,37090,-134,-0.36,-35,-99,17,57,H1
"Fulton County, IL",2009-2010,37090,37071,-19,-0.051,-85,66,17,57,H1
"Fulton County, IL",2010-2011,37071,36973,-98,-0.264,-87,-11,17,57,H1
"Fulton County, IL",2011-2012,36973,36659,-314,-0.849,-110,-204,17,57,H1
"Fulton County, IL",2012-2013,36659,36369,-290,-0.791,-99,-191,17,57,H1
"Fulton County, IL",2013-2014,36369,36007,-362,-0.995,-109,-253,17,57,H1
"Fulton County, IL",2014-2015,35965,35699,-266,-0.74,-142,-124,17,57,H1
"Fulton County, IL",2015-2016,35699,35517,-182,-0.51,-123,-59,17,57,H1
"Fulton County, IL",2016-2017,35517,35110,-407,-1.146,-138,-269,17,57,H1
"Gallatin County, IL",2000-2001,6405,6279,-126,-1.967,2,-128,17,59,H1
"Gallatin County, IL",2001-2002,6279,6144,-135,-2.15,-27,-108,17,59,H1
"Gallatin County, IL",2002-2003,6144,6117,-27,-0.439,-33,6,17,59,H1
"Gallatin County, IL",2003-2004,6117,6071,-46,-0.752,-11,-35,17,59,H1
"Gallatin County, IL",2004-2005,6071,6030,-41,-0.675,-17,-24,17,59,H1
"Gallatin County, IL",2005-2006,6030,5980,-50,-0.829,-27,-23,17,59,H1
"Gallatin County, IL",2006-2007,5980,5883,-97,-1.622,-12,-85,17,59,H1
"Gallatin County, IL",2007-2008,5883,5796,-87,-1.479,-15,-72,17,59,H1
"Gallatin County, IL",2008-2009,5796,5631,-165,-2.847,-19,-146,17,59,H1
"Gallatin County, IL",2009-2010,5631,5578,-53,-0.941,-29,-24,17,59,H1
"Gallatin County, IL",2010-2011,5578,5510,-68,-1.219,-30,-38,17,59,H1
"Gallatin County, IL",2011-2012,5510,5414,-96,-1.742,-21,-75,17,59,H1
"Gallatin County, IL",2012-2013,5414,5401,-13,-0.24,-22,9,17,59,H1
"Gallatin County, IL",2013-2014,5401,5291,-110,-2.037,-29,-81,17,59,H1
"Gallatin County, IL",2014-2015,5318,5265,-53,-0.997,-22,-31,17,59,H1
"Gallatin County, IL",2015-2016,5265,5163,-102,-1.937,-4,-98,17,59,H1
"Gallatin County, IL",2016-2017,5163,5080,-83,-1.608,-20,-63,17,59,H1
"Greene County, IL",2000-2001,14752,14620,-132,-0.895,29,-161,17,61,H1
"Greene County, IL",2001-2002,14620,14622,2,0.014,-2,4,17,61,H1
"Greene County, IL",2002-2003,14622,14558,-64,-0.438,-18,-46,17,61,H1
"Greene County, IL",2003-2004,14558,14411,-147,-1.01,-7,-140,17,61,H1
"Greene County, IL",2004-2005,14411,14382,-29,-0.201,-5,-24,17,61,H1
"Greene County, IL",2005-2006,14382,14167,-215,-1.495,7,-222,17,61,H1
"Greene County, IL",2006-2007,14167,14001,-166,-1.172,-14,-152,17,61,H1
"Greene County, IL",2007-2008,14001,13956,-45,-0.321,-13,-32,17,61,H1
"Greene County, IL",2008-2009,13956,13926,-30,-0.215,9,-39,17,61,H1
"Greene County, IL",2009-2010,13926,13877,-49,-0.352,-13,-36,17,61,H1
"Greene County, IL",2010-2011,13877,13841,-36,-0.259,16,-52,17,61,H1
"Greene County, IL",2011-2012,13841,13616,-225,-1.626,-9,-216,17,61,H1
"Greene County, IL",2012-2013,13616,13617,1,0.007,0,1,17,61,H1
"Greene County, IL",2013-2014,13617,13434,-183,-1.344,-14,-169,17,61,H1
"Greene County, IL",2014-2015,13296,13241,-55,-0.414,-33,-22,17,61,H1
"Greene County, IL",2015-2016,13241,13119,-122,-0.921,-44,-78,17,61,H1
"Greene County, IL",2016-2017,13119,13174,55,0.419,-37,92,17,61,H1
"Grundy County, IL",2000-2001,37704,38320,616,1.634,171,445,17,63,H1
"Grundy County, IL",2001-2002,38320,38865,545,1.422,181,364,17,63,H1
"Grundy County, IL",2002-2003,38865,39819,954,2.455,193,761,17,63,H1
"Grundy County, IL",2003-2004,39819,41410,1591,3.996,223,1368,17,63,H1
"Grundy County, IL",2004-2005,41410,44181,2771,6.692,294,2477,17,63,H1
"Grundy County, IL",2005-2006,44181,46534,2353,5.326,379,1974,17,63,H1
"Grundy County, IL",2006-2007,46534,48175,1641,3.526,405,1236,17,63,H1
"Grundy County, IL",2007-2008,48175,49166,991,2.057,437,554,17,63,H1
"Grundy County, IL",2008-2009,49166,49702,536,1.09,443,93,17,63,H1
"Grundy County, IL",2009-2010,49702,50098,396,0.797,314,82,17,63,H1
"Grundy County, IL",2010-2011,50098,50045,-53,-0.106,257,-310,17,63,H1
"Grundy County, IL",2011-2012,50045,50150,105,0.21,247,-142,17,63,H1
"Grundy County, IL",2012-2013,50150,50149,-1,-0.002,215,-216,17,63,H1
"Grundy County, IL",2013-2014,50149,50425,276,0.55,230,46,17,63,H1
"Grundy County, IL",2014-2015,50433,50541,108,0.214,224,-116,17,63,H1
"Grundy County, IL",2015-2016,50541,50269,-272,-0.538,203,-475,17,63,H1
"Grundy County, IL",2016-2017,50269,50586,317,0.631,205,112,17,63,H1
"Hamilton County, IL",2000-2001,8602,8527,-75,-0.872,-11,-64,17,65,H1
"Hamilton County, IL",2001-2002,8527,8440,-87,-1.02,-15,-72,17,65,H1
"Hamilton County, IL",2002-2003,8440,8431,-9,-0.107,-10,1,17,65,H1
"Hamilton County, IL",2003-2004,8431,8525,94,1.115,-10,104,17,65,H1
"Hamilton County, IL",2004-2005,8525,8471,-54,-0.633,-27,-27,17,65,H1
"Hamilton County, IL",2005-2006,8471,8497,26,0.307,-28,54,17,65,H1
"Hamilton County, IL",2006-2007,8497,8416,-81,-0.953,-17,-64,17,65,H1
"Hamilton County, IL",2007-2008,8416,8454,38,0.452,-21,59,17,65,H1
"Hamilton County, IL",2008-2009,8454,8448,-6,-0.071,-10,4,17,65,H1
"Hamilton County, IL",2009-2010,8448,8449,1,0.012,-18,19,17,65,H1
"Hamilton County, IL",2010-2011,8449,8416,-33,-0.391,-22,-11,17,65,H1
"Hamilton County, IL",2011-2012,8416,8364,-52,-0.618,-16,-36,17,65,H1
"Hamilton County, IL",2012-2013,8364,8329,-35,-0.418,-26,-9,17,65,H1
"Hamilton County, IL",2013-2014,8329,8296,-33,-0.396,-36,3,17,65,H1
"Hamilton County, IL",2014-2015,8298,8200,-98,-1.181,-29,-69,17,65,H1
"Hamilton County, IL",2015-2016,8200,8199,-1,-0.012,4,-5,17,65,H1
"Hamilton County, IL",2016-2017,8199,8194,-5,-0.061,-10,5,17,65,H1
"Hancock County, IL",2000-2001,20148,20069,-79,-0.392,21,-100,17,67,H1
"Hancock County, IL",2001-2002,20069,19794,-275,-1.37,-24,-251,17,67,H1
"Hancock County, IL",2002-2003,19794,19673,-121,-0.611,-18,-103,17,67,H1
"Hancock County, IL",2003-2004,19673,19577,-96,-0.488,-27,-69,17,67,H1
"Hancock County, IL",2004-2005,19577,19479,-98,-0.501,3,-101,17,67,H1
"Hancock County, IL",2005-2006,19479,19412,-67,-0.344,41,-108,17,67,H1
"Hancock County, IL",2006-2007,19412,19359,-53,-0.273,14,-67,17,67,H1
"Hancock County, IL",2007-2008,19359,19192,-167,-0.863,2,-169,17,67,H1
"Hancock County, IL",2008-2009,19192,19080,-112,-0.584,-10,-102,17,67,H1
"Hancock County, IL",2009-2010,19080,19093,13,0.068,-28,41,17,67,H1
"Hancock County, IL",2010-2011,19093,19019,-74,-0.388,-4,-70,17,67,H1
"Hancock County, IL",2011-2012,19019,18835,-184,-0.967,-66,-118,17,67,H1
"Hancock County, IL",2012-2013,18835,18531,-304,-1.614,-27,-277,17,67,H1
"Hancock County, IL",2013-2014,18531,18564,33,0.178,-9,42,17,67,H1
"Hancock County, IL",2014-2015,18626,18543,-83,-0.446,-23,-60,17,67,H1
"Hancock County, IL",2015-2016,18543,18219,-324,-1.747,3,-327,17,67,H1
"Hancock County, IL",2016-2017,18219,18020,-199,-1.092,-2,-197,17,67,H1
"Hardin County, IL",2000-2001,4777,4765,-12,-0.251,-41,29,17,69,H1
"Hardin County, IL",2001-2002,4765,4723,-42,-0.881,-20,-22,17,69,H1
"Hardin County, IL",2002-2003,4723,4724,1,0.021,4,-3,17,69,H1
"Hardin County, IL",2003-2004,4724,4664,-60,-1.27,-25,-35,17,69,H1
"Hardin County, IL",2004-2005,4664,4615,-49,-1.051,-32,-17,17,69,H1
"Hardin County, IL",2005-2006,4615,4508,-107,-2.319,-30,-77,17,69,H1
"Hardin County, IL",2006-2007,4508,4462,-46,-1.02,-21,-25,17,69,H1
"Hardin County, IL",2007-2008,4462,4386,-76,-1.703,2,-78,17,69,H1
"Hardin County, IL",2008-2009,4386,4344,-42,-0.958,-20,-22,17,69,H1
"Hardin County, IL",2009-2010,4344,4304,-40,-0.921,-25,-15,17,69,H1
"Hardin County, IL",2010-2011,4304,4281,-23,-0.534,-18,-5,17,69,H1
"Hardin County, IL",2011-2012,4281,4257,-24,-0.561,-10,-14,17,69,H1
"Hardin County, IL",2012-2013,4257,4158,-99,-2.326,-25,-74,17,69,H1
"Hardin County, IL",2013-2014,4158,4129,-29,-0.697,-31,2,17,69,H1
"Hardin County, IL",2014-2015,4219,4135,-84,-1.991,-24,-60,17,69,H1
"Hardin County, IL",2015-2016,4135,4099,-36,-0.871,-11,-25,17,69,H1
"Hardin County, IL",2016-2017,4099,4046,-53,-1.293,-26,-27,17,69,H1
"Henderson County, IL",2000-2001,8172,8150,-22,-0.269,3,-25,17,71,H1
"Henderson County, IL",2001-2002,8150,8078,-72,-0.883,-29,-43,17,71,H1
"Henderson County, IL",2002-2003,8078,7935,-143,-1.77,-40,-103,17,71,H1
"Henderson County, IL",2003-2004,7935,7912,-23,-0.29,-13,-10,17,71,H1
"Henderson County, IL",2004-2005,7912,7786,-126,-1.593,-28,-98,17,71,H1
"Henderson County, IL",2005-2006,7786,7614,-172,-2.209,-38,-134,17,71,H1
"Henderson County, IL",2006-2007,7614,7565,-49,-0.644,-31,-18,17,71,H1
"Henderson County, IL",2007-2008,7565,7463,-102,-1.348,-6,-96,17,71,H1
"Henderson County, IL",2008-2009,7463,7340,-123,-1.648,-23,-100,17,71,H1
"Henderson County, IL",2009-2010,7340,7325,-15,-0.204,-38,23,17,71,H1
"Henderson County, IL",2010-2011,7325,7201,-124,-1.693,-36,-88,17,71,H1
"Henderson County, IL",2011-2012,7201,7019,-182,-2.527,-42,-140,17,71,H1
"Henderson County, IL",2012-2013,7019,6909,-110,-1.567,-42,-68,17,71,H1
"Henderson County, IL",2013-2014,6909,6916,7,0.101,-36,43,17,71,H1
"Henderson County, IL",2014-2015,6994,6995,1,0.014,-1,2,17,71,H1
"Henderson County, IL",2015-2016,6995,6874,-121,-1.73,-27,-94,17,71,H1
"Henderson County, IL",2016-2017,6874,6795,-79,-1.149,-32,-47,17,71,H1
"Henry County, IL",2000-2001,51078,50714,-364,-0.713,26,-390,17,73,H1
"Henry County, IL",2001-2002,50714,50454,-260,-0.513,-13,-247,17,73,H1
"Henry County, IL",2002-2003,50454,50714,260,0.515,-1,261,17,73,H1
"Henry County, IL",2003-2004,50714,50509,-205,-0.404,20,-225,17,73,H1
"Henry County, IL",2004-2005,50509,50572,63,0.125,33,30,17,73,H1
"Henry County, IL",2005-2006,50572,50392,-180,-0.356,80,-260,17,73,H1
"Henry County, IL",2006-2007,50392,50528,136,0.27,48,88,17,73,H1
"Henry County, IL",2007-2008,50528,50492,-36,-0.071,76,-112,17,73,H1
"Henry County, IL",2008-2009,50492,50536,44,0.087,67,-23,17,73,H1
"Henry County, IL",2009-2010,50536,50432,-104,-0.206,-4,-100,17,73,H1
"Henry County, IL",2010-2011,50432,50267,-165,-0.327,9,-174,17,73,H1
"Henry County, IL",2011-2012,50267,50071,-196,-0.39,-26,-170,17,73,H1
"Henry County, IL",2012-2013,50071,49750,-321,-0.641,2,-323,17,73,H1
"Henry County, IL",2013-2014,49750,49635,-115,-0.231,2,-117,17,73,H1
"Henry County, IL",2014-2015,49677,49489,-188,-0.378,26,-214,17,73,H1
"Henry County, IL",2015-2016,49489,49524,35,0.071,28,7,17,73,H1
"Henry County, IL",2016-2017,49524,49328,-196,-0.396,30,-226,17,73,H1
"Iroquois County, IL",2000-2001,31386,31022,-364,-1.16,-17,-347,17,75,H1
"Iroquois County, IL",2001-2002,31022,30805,-217,-0.7,-41,-176,17,75,H1
"Iroquois County, IL",2002-2003,30805,30688,-117,-0.38,-66,-51,17,75,H1
"Iroquois County, IL",2003-2004,30688,30493,-195,-0.635,-26,-169,17,75,H1
"Iroquois County, IL",2004-2005,30493,30548,55,0.18,-31,86,17,75,H1
"Iroquois County, IL",2005-2006,30548,30308,-240,-0.786,-60,-180,17,75,H1
"Iroquois County, IL",2006-2007,30308,30282,-26,-0.086,-43,17,17,75,H1
"Iroquois County, IL",2007-2008,30282,30228,-54,-0.178,-7,-47,17,75,H1
"Iroquois County, IL",2008-2009,30228,29863,-365,-1.207,-6,-359,17,75,H1
"Iroquois County, IL",2009-2010,29863,29663,-200,-0.67,-77,-123,17,75,H1
"Iroquois County, IL",2010-2011,29663,29510,-153,-0.516,-73,-80,17,75,H1
"Iroquois County, IL",2011-2012,29510,29289,-221,-0.749,-68,-153,17,75,H1
"Iroquois County, IL",2012-2013,29289,29017,-272,-0.929,-40,-232,17,75,H1
"Iroquois County, IL",2013-2014,29017,28879,-138,-0.476,-19,-119,17,75,H1
"Iroquois County, IL",2014-2015,28802,28672,-130,-0.451,-44,-86,17,75,H1
"Iroquois County, IL",2015-2016,28672,28214,-458,-1.597,-63,-395,17,75,H1
"Iroquois County, IL",2016-2017,28214,27876,-338,-1.198,-44,-294,17,75,H1
"Jackson County, IL",2000-2001,59633,59530,-103,-0.173,163,-266,17,77,H1
"Jackson County, IL",2001-2002,59530,58949,-581,-0.976,202,-783,17,77,H1
"Jackson County, IL",2002-2003,58949,59282,333,0.565,228,105,17,77,H1
"Jackson County, IL",2003-2004,59282,59462,180,0.304,205,-25,17,77,H1
"Jackson County, IL",2004-2005,59462,60006,544,0.915,148,396,17,77,H1
"Jackson County, IL",2005-2006,60006,60170,164,0.273,301,-137,17,77,H1
"Jackson County, IL",2006-2007,60170,59518,-652,-1.084,226,-878,17,77,H1
"Jackson County, IL",2007-2008,59518,59605,87,0.146,166,-79,17,77,H1
"Jackson County, IL",2008-2009,59605,59664,59,0.099,275,-216,17,77,H1
"Jackson County, IL",2009-2010,59664,60386,722,1.21,206,516,17,77,H1
"Jackson County, IL",2010-2011,60386,60366,-20,-0.033,177,-197,17,77,H1
"Jackson County, IL",2011-2012,60366,60214,-152,-0.252,199,-351,17,77,H1
"Jackson County, IL",2012-2013,60214,59981,-233,-0.387,204,-437,17,77,H1
"Jackson County, IL",2013-2014,59981,59677,-304,-0.507,200,-504,17,77,H1
"Jackson County, IL",2014-2015,59388,59362,-26,-0.044,240,-266,17,77,H1
"Jackson County, IL",2015-2016,59362,59032,-330,-0.556,288,-618,17,77,H1
"Jackson County, IL",2016-2017,59032,58284,-748,-1.267,250,-998,17,77,H1
"Jasper County, IL",2000-2001,10067,10056,-11,-0.109,-1,-10,17,79,H1
"Jasper County, IL",2001-2002,10056,10015,-41,-0.408,9,-50,17,79,H1
"Jasper County, IL",2002-2003,10015,9970,-45,-0.449,19,-64,17,79,H1
"Jasper County, IL",2003-2004,9970,10010,40,0.401,28,12,17,79,H1
"Jasper County, IL",2004-2005,10010,9905,-105,-1.049,28,-133,17,79,H1
"Jasper County, IL",2005-2006,9905,9807,-98,-0.989,13,-111,17,79,H1
"Jasper County, IL",2006-2007,9807,9776,-31,-0.316,-3,-28,17,79,H1
"Jasper County, IL",2007-2008,9776,9786,10,0.102,16,-6,17,79,H1
"Jasper County, IL",2008-2009,9786,9701,-85,-0.869,23,-108,17,79,H1
"Jasper County, IL",2009-2010,9701,9706,5,0.052,5,0,17,79,H1
"Jasper County, IL",2010-2011,9706,9740,34,0.35,17,17,17,79,H1
"Jasper County, IL",2011-2012,9740,9644,-96,-0.986,-3,-93,17,79,H1
"Jasper County, IL",2012-2013,9644,9577,-67,-0.695,28,-95,17,79,H1
"Jasper County, IL",2013-2014,9577,9623,46,0.48,26,20,17,79,H1
"Jasper County, IL",2014-2015,9619,9607,-12,-0.125,35,-47,17,79,H1
"Jasper County, IL",2015-2016,9607,9593,-14,-0.146,9,-23,17,79,H1
"Jasper County, IL",2016-2017,9593,9578,-15,-0.156,23,-38,17,79,H1
"Jefferson County, IL",2000-2001,40041,39874,-167,-0.417,43,-210,17,81,H1
"Jefferson County, IL",2001-2002,39874,39805,-69,-0.173,76,-145,17,81,H1
"Jefferson County, IL",2002-2003,39805,39730,-75,-0.188,18,-93,17,81,H1
"Jefferson County, IL",2003-2004,39730,39638,-92,-0.232,48,-140,17,81,H1
"Jefferson County, IL",2004-2005,39638,39624,-14,-0.035,43,-57,17,81,H1
"Jefferson County, IL",2005-2006,39624,39545,-79,-0.199,55,-134,17,81,H1
"Jefferson County, IL",2006-2007,39545,39412,-133,-0.336,67,-200,17,81,H1
"Jefferson County, IL",2007-2008,39412,39277,-135,-0.343,76,-211,17,81,H1
"Jefferson County, IL",2008-2009,39277,38970,-307,-0.782,80,-387,17,81,H1
"Jefferson County, IL",2009-2010,38970,38804,-166,-0.426,37,-203,17,81,H1
"Jefferson County, IL",2010-2011,38804,38791,-13,-0.034,6,-19,17,81,H1
"Jefferson County, IL",2011-2012,38791,38730,-61,-0.157,44,-105,17,81,H1
"Jefferson County, IL",2012-2013,38730,38721,-9,-0.023,39,-48,17,81,H1
"Jefferson County, IL",2013-2014,38721,38534,-187,-0.483,36,-223,17,81,H1
"Jefferson County, IL",2014-2015,38446,38353,-93,-0.242,34,-127,17,81,H1
"Jefferson County, IL",2015-2016,38353,38308,-45,-0.117,54,-99,17,81,H1
"Jefferson County, IL",2016-2017,38308,38179,-129,-0.337,53,-182,17,81,H1
"Jersey County, IL",2000-2001,21642,21751,109,0.504,-11,120,17,83,H1
"Jersey County, IL",2001-2002,21751,22001,250,1.149,49,201,17,83,H1
"Jersey County, IL",2002-2003,22001,22126,125,0.568,-2,127,17,83,H1
"Jersey County, IL",2003-2004,22126,22374,248,1.121,5,243,17,83,H1
"Jersey County, IL",2004-2005,22374,22500,126,0.563,-10,136,17,83,H1
"Jersey County, IL",2005-2006,22500,22736,236,1.049,29,207,17,83,H1
"Jersey County, IL",2006-2007,22736,22838,102,0.449,8,94,17,83,H1
"Jersey County, IL",2007-2008,22838,23084,246,1.077,17,229,17,83,H1
"Jersey County, IL",2008-2009,23084,23060,-24,-0.104,36,-60,17,83,H1
"Jersey County, IL",2009-2010,23060,22964,-96,-0.416,-20,-76,17,83,H1
"Jersey County, IL",2010-2011,22964,22850,-114,-0.496,-36,-78,17,83,H1
"Jersey County, IL",2011-2012,22850,22732,-118,-0.516,-22,-96,17,83,H1
"Jersey County, IL",2012-2013,22732,22638,-94,-0.414,5,-99,17,83,H1
"Jersey County, IL",2013-2014,22638,22571,-67,-0.296,30,-97,17,83,H1
"Jersey County, IL",2014-2015,22552,22372,-180,-0.798,25,-205,17,83,H1
"Jersey County, IL",2015-2016,22372,21945,-427,-1.909,-12,-415,17,83,H1
"Jersey County, IL",2016-2017,21945,21941,-4,-0.018,-15,11,17,83,H1
"Jo Daviess County, IL",2000-2001,22296,22486,190,0.852,35,155,17,85,H1
"Jo Daviess County, IL",2001-2002,22486,22480,-6,-0.027,-6,0,17,85,H1
"Jo Daviess County, IL",2002-2003,22480,22701,221,0.983,22,199,17,85,H1
"Jo Daviess County, IL",2003-2004,22701,22646,-55,-0.242,15,-70,17,85,H1
"Jo Daviess County, IL",2004-2005,22646,22680,34,0.15,-41,75,17,85,H1
"Jo Daviess County, IL",2005-2006,22680,22828,148,0.653,-6,154,17,85,H1
"Jo Daviess County, IL",2006-2007,22828,22758,-70,-0.307,-7,-63,17,85,H1
"Jo Daviess County, IL",2007-2008,22758,22715,-43,-0.189,4,-47,17,85,H1
"Jo Daviess County, IL",2008-2009,22715,22685,-30,-0.132,-5,-25,17,85,H1
"Jo Daviess County, IL",2009-2010,22685,22660,-25,-0.11,-39,14,17,85,H1
"Jo Daviess County, IL",2010-2011,22660,22621,-39,-0.172,-105,66,17,85,H1
"Jo Daviess County, IL",2011-2012,22621,22380,-241,-1.065,-112,-129,17,85,H1
"Jo Daviess County, IL",2012-2013,22380,22218,-162,-0.724,-61,-101,17,85,H1
"Jo Daviess County, IL",2013-2014,22218,22254,36,0.162,-29,65,17,85,H1
"Jo Daviess County, IL",2014-2015,22357,22086,-271,-1.212,-76,-195,17,85,H1
"Jo Daviess County, IL",2015-2016,22086,21861,-225,-1.019,-38,-187,17,85,H1
"Jo Daviess County, IL",2016-2017,21861,21594,-267,-1.221,-67,-200,17,85,H1
"Johnson County, IL",2000-2001,12836,12794,-42,-0.327,22,-64,17,87,H1
"Johnson County, IL",2001-2002,12794,12454,-340,-2.657,5,-345,17,87,H1
"Johnson County, IL",2002-2003,12454,12969,515,4.135,1,514,17,87,H1
"Johnson County, IL",2003-2004,12969,12903,-66,-0.509,1,-67,17,87,H1
"Johnson County, IL",2004-2005,12903,12816,-87,-0.674,15,-102,17,87,H1
"Johnson County, IL",2005-2006,12816,12889,73,0.57,4,69,17,87,H1
"Johnson County, IL",2006-2007,12889,12792,-97,-0.753,0,-97,17,87,H1
"Johnson County, IL",2007-2008,12792,12671,-121,-0.946,4,-125,17,87,H1
"Johnson County, IL",2008-2009,12671,12604,-67,-0.529,9,-76,17,87,H1
"Johnson County, IL",2009-2010,12604,12610,6,0.048,-14,20,17,87,H1
"Johnson County, IL",2010-2011,12610,12635,25,0.198,4,21,17,87,H1
"Johnson County, IL",2011-2012,12635,12756,121,0.958,-9,130,17,87,H1
"Johnson County, IL",2012-2013,12756,12648,-108,-0.847,-4,-104,17,87,H1
"Johnson County, IL",2013-2014,12648,12601,-47,-0.372,-7,-40,17,87,H1
"Johnson County, IL",2014-2015,12783,12762,-21,-0.164,-27,6,17,87,H1
"Johnson County, IL",2015-2016,12762,12961,199,1.559,-26,225,17,87,H1
"Johnson County, IL",2016-2017,12961,12900,-61,-0.471,-35,-26,17,87,H1
"Kane County, IL",2000-2001,407847,423975,16128,3.954,5532,10596,17,89,H1
"Kane County, IL",2001-2002,423975,440437,16462,3.883,5667,10795,17,89,H1
"Kane County, IL",2002-2003,440437,453929,13492,3.063,5602,7890,17,89,H1
"Kane County, IL",2003-2004,453929,466884,12955,2.854,6127,6828,17,89,H1
"Kane County, IL",2004-2005,466884,475384,8500,1.821,5877,2623,17,89,H1
"Kane County, IL",2005-2006,475384,485179,9795,2.06,6014,3781,17,89,H1
"Kane County, IL",2006-2007,485179,495752,10573,2.179,5802,4771,17,89,H1
"Kane County, IL",2007-2008,495752,504437,8685,1.752,5865,2820,17,89,H1
"Kane County, IL",2008-2009,504437,511273,6836,1.355,6008,828,17,89,H1
"Kane County, IL",2009-2010,511273,516020,4747,0.928,4848,-101,17,89,H1
"Kane County, IL",2010-2011,516020,519923,3903,0.756,4311,-408,17,89,H1
"Kane County, IL",2011-2012,519923,521843,1920,0.369,4097,-2177,17,89,H1
"Kane County, IL",2012-2013,521843,524277,2434,0.466,3593,-1159,17,89,H1
"Kane County, IL",2013-2014,524277,527306,3029,0.578,3585,-556,17,89,H1
"Kane County, IL",2014-2015,527501,530847,3346,0.634,3584,-238,17,89,H1
"Kane County, IL",2015-2016,530847,532553,1706,0.321,3383,-1677,17,89,H1
"Kane County, IL",2016-2017,532553,534667,2114,0.397,3208,-1094,17,89,H1
"Kankakee County, IL",2000-2001,103842,104490,648,0.624,384,264,17,91,H1
"Kankakee County, IL",2001-2002,104490,104932,442,0.423,440,2,17,91,H1
"Kankakee County, IL",2002-2003,104932,105794,862,0.821,481,381,17,91,H1
"Kankakee County, IL",2003-2004,105794,106744,950,0.898,411,539,17,91,H1
"Kankakee County, IL",2004-2005,106744,107917,1173,1.099,391,782,17,91,H1
"Kankakee County, IL",2005-2006,107917,109735,1818,1.685,515,1303,17,91,H1
"Kankakee County, IL",2006-2007,109735,111499,1764,1.608,689,1075,17,91,H1
"Kankakee County, IL",2007-2008,111499,112658,1159,1.039,608,551,17,91,H1
"Kankakee County, IL",2008-2009,112658,113107,449,0.399,622,-173,17,91,H1
"Kankakee County, IL",2009-2010,113107,113462,355,0.314,422,-67,17,91,H1
"Kankakee County, IL",2010-2011,113462,113453,-9,-0.008,329,-338,17,91,H1
"Kankakee County, IL",2011-2012,113453,112926,-527,-0.465,365,-892,17,91,H1
"Kankakee County, IL",2012-2013,112926,112193,-733,-0.649,237,-970,17,91,H1
"Kankakee County, IL",2013-2014,112193,111375,-818,-0.729,214,-1032,17,91,H1
"Kankakee County, IL",2014-2015,111473,110879,-594,-0.533,230,-824,17,91,H1
"Kankakee County, IL",2015-2016,110879,110053,-826,-0.745,152,-978,17,91,H1
"Kankakee County, IL",2016-2017,110053,109605,-448,-0.407,169,-617,17,91,H1
"Kendall County, IL",2000-2001,55311,58437,3126,5.652,593,2533,17,93,H1
"Kendall County, IL",2001-2002,58437,62523,4086,6.992,704,3382,17,93,H1
"Kendall County, IL",2002-2003,62523,67740,5217,8.344,806,4411,17,93,H1
"Kendall County, IL",2003-2004,67740,73723,5983,8.832,871,5112,17,93,H1
"Kendall County, IL",2004-2005,73723,81107,7384,10.016,1048,6336,17,93,H1
"Kendall County, IL",2005-2006,81107,90740,9633,11.877,1139,8494,17,93,H1
"Kendall County, IL",2006-2007,90740,100917,10177,11.216,1384,8793,17,93,H1
"Kendall County, IL",2007-2008,100917,108559,7642,7.573,1593,6049,17,93,H1
"Kendall County, IL",2008-2009,108559,112490,3931,3.621,1735,2196,17,93,H1
"Kendall County, IL",2009-2010,112490,115240,2750,2.445,1364,1386,17,93,H1
"Kendall County, IL",2010-2011,115240,116711,1471,1.276,1233,238,17,93,H1
"Kendall County, IL",2011-2012,116711,118145,1434,1.229,1208,226,17,93,H1
"Kendall County, IL",2012-2013,118145,119525,1380,1.168,1211,169,17,93,H1
"Kendall County, IL",2013-2014,119525,121350,1825,1.527,1167,658,17,93,H1
"Kendall County, IL",2014-2015,121816,123355,1539,1.263,1151,388,17,93,H1
"Kendall County, IL",2015-2016,123355,124573,1218,0.987,1023,195,17,93,H1
"Kendall County, IL",2016-2017,124573,126218,1645,1.321,1042,603,17,93,H1
"Knox County, IL",2000-2001,55783,55329,-454,-0.814,-75,-379,17,95,H1
"Knox County, IL",2001-2002,55329,54963,-366,-0.661,-87,-279,17,95,H1
"Knox County, IL",2002-2003,54963,54425,-538,-0.979,-82,-456,17,95,H1
"Knox County, IL",2003-2004,54425,53909,-516,-0.948,-108,-408,17,95,H1
"Knox County, IL",2004-2005,53909,53513,-396,-0.735,-107,-289,17,95,H1
"Knox County, IL",2005-2006,53513,53196,-317,-0.592,-140,-177,17,95,H1
"Knox County, IL",2006-2007,53196,52894,-302,-0.568,-92,-210,17,95,H1
"Knox County, IL",2007-2008,52894,52836,-58,-0.11,-104,46,17,95,H1
"Knox County, IL",2008-2009,52836,52817,-19,-0.036,-74,55,17,95,H1
"Knox County, IL",2009-2010,52817,52919,102,0.193,-124,226,17,95,H1
"Knox County, IL",2010-2011,52919,52700,-219,-0.414,-174,-45,17,95,H1
"Knox County, IL",2011-2012,52700,52314,-386,-0.732,-149,-237,17,95,H1
"Knox County, IL",2012-2013,52314,52235,-79,-0.151,-46,-33,17,95,H1
"Knox County, IL",2013-2014,52235,52069,-166,-0.318,-38,-128,17,95,H1
"Knox County, IL",2014-2015,51977,51441,-536,-1.031,-20,-516,17,95,H1
"Knox County, IL",2015-2016,51441,50945,-496,-0.964,-87,-409,17,95,H1
"Knox County, IL",2016-2017,50945,50638,-307,-0.603,-40,-267,17,95,H1
"Lake County, IL",2000-2001,648150,658986,10836,1.672,7064,3772,17,97,H1
"Lake County, IL",2001-2002,658986,668022,9036,1.371,6611,2425,17,97,H1
"Lake County, IL",2002-2003,668022,668760,738,0.11,6602,-5864,17,97,H1
"Lake County, IL",2003-2004,668760,677735,8975,1.342,6603,2372,17,97,H1
"Lake County, IL",2004-2005,677735,684419,6684,0.986,6031,653,17,97,H1
"Lake County, IL",2005-2006,684419,689891,5472,0.8,6116,-644,17,97,H1
"Lake County, IL",2006-2007,689891,692995,3104,0.45,5997,-2893,17,97,H1
"Lake County, IL",2007-2008,692995,697369,4374,0.631,5879,-1505,17,97,H1
"Lake County, IL",2008-2009,697369,701042,3673,0.527,5948,-2275,17,97,H1
"Lake County, IL",2009-2010,701042,704141,3099,0.442,4771,-1672,17,97,H1
"Lake County, IL",2010-2011,704141,701012,-3129,-0.444,4144,-7273,17,97,H1
"Lake County, IL",2011-2012,701012,701513,501,0.071,3869,-3368,17,97,H1
"Lake County, IL",2012-2013,701513,7.04E+05,2487,0.355,3591,-1104,17,97,H1
"Lake County, IL",2013-2014,7.04E+05,705186,1186,0.168,3611,-2425,17,97,H1
"Lake County, IL",2014-2015,704149,703910,-239,-0.034,3477,-3716,17,97,H1
"Lake County, IL",2015-2016,703910,704935,1025,0.146,3032,-2007,17,97,H1
"Lake County, IL",2016-2017,704935,703520,-1415,-0.201,3009,-4424,17,97,H1
"LaSalle County, IL",2000-2001,111600,112212,612,0.548,283,329,17,99,H1
"LaSalle County, IL",2001-2002,112212,111904,-308,-0.274,123,-431,17,99,H1
"LaSalle County, IL",2002-2003,111904,110949,-955,-0.853,163,-1118,17,99,H1
"LaSalle County, IL",2003-2004,110949,112135,1186,1.069,4,1182,17,99,H1
"LaSalle County, IL",2004-2005,112135,112565,430,0.383,26,404,17,99,H1
"LaSalle County, IL",2005-2006,112565,113139,574,0.51,-37,611,17,99,H1
"LaSalle County, IL",2006-2007,113139,113794,655,0.579,87,568,17,99,H1
"LaSalle County, IL",2007-2008,113794,114171,377,0.331,154,223,17,99,H1
"LaSalle County, IL",2008-2009,114171,113999,-172,-0.151,244,-416,17,99,H1
"LaSalle County, IL",2009-2010,113999,113866,-133,-0.117,62,-195,17,99,H1
"LaSalle County, IL",2010-2011,113866,113463,-403,-0.354,-59,-344,17,99,H1
"LaSalle County, IL",2011-2012,113463,112882,-581,-0.512,-149,-432,17,99,H1
"LaSalle County, IL",2012-2013,112882,112039,-843,-0.747,-157,-686,17,99,H1
"LaSalle County, IL",2013-2014,112039,111241,-798,-0.712,-117,-681,17,99,H1
"LaSalle County, IL",2014-2015,112001,111333,-668,-0.596,-80,-588,17,99,H1
"LaSalle County, IL",2015-2016,111333,110507,-826,-0.742,-18,-808,17,99,H1
"LaSalle County, IL",2016-2017,110507,110067,-440,-0.398,39,-479,17,99,H1
"Lawrence County, IL",2000-2001,15432,15527,95,0.616,-68,163,17,101,H1
"Lawrence County, IL",2001-2002,15527,16045,518,3.336,-48,566,17,101,H1
"Lawrence County, IL",2002-2003,16045,16455,410,2.555,-97,507,17,101,H1
"Lawrence County, IL",2003-2004,16455,16562,107,0.65,-93,200,17,101,H1
"Lawrence County, IL",2004-2005,16562,16910,348,2.101,-34,382,17,101,H1
"Lawrence County, IL",2005-2006,16910,16730,-180,-1.064,-59,-121,17,101,H1
"Lawrence County, IL",2006-2007,16730,16952,222,1.327,-49,271,17,101,H1
"Lawrence County, IL",2007-2008,16952,16935,-17,-0.1,-35,18,17,101,H1
"Lawrence County, IL",2008-2009,16935,16802,-133,-0.785,-65,-68,17,101,H1
"Lawrence County, IL",2009-2010,16802,16916,114,0.678,-89,203,17,101,H1
"Lawrence County, IL",2010-2011,16916,16814,-102,-0.603,-61,-41,17,101,H1
"Lawrence County, IL",2011-2012,16814,16698,-116,-0.69,-50,-66,17,101,H1
"Lawrence County, IL",2012-2013,16698,16683,-15,-0.09,-20,5,17,101,H1
"Lawrence County, IL",2013-2014,16683,16519,-164,-0.983,-40,-124,17,101,H1
"Lawrence County, IL",2014-2015,16596,16491,-105,-0.633,-49,-56,17,101,H1
"Lawrence County, IL",2015-2016,16491,16343,-148,-0.897,-69,-79,17,101,H1
"Lawrence County, IL",2016-2017,16343,16168,-175,-1.071,-65,-110,17,101,H1
"Lee County, IL",2000-2001,36092,36100,8,0.022,-15,23,17,103,H1
"Lee County, IL",2001-2002,36100,35825,-275,-0.762,-28,-247,17,103,H1
"Lee County, IL",2002-2003,35825,35586,-239,-0.667,-12,-227,17,103,H1
"Lee County, IL",2003-2004,35586,35704,118,0.332,26,92,17,103,H1
"Lee County, IL",2004-2005,35704,35635,-69,-0.193,5,-74,17,103,H1
"Lee County, IL",2005-2006,35635,35905,270,0.758,56,214,17,103,H1
"Lee County, IL",2006-2007,35905,36191,286,0.797,78,208,17,103,H1
"Lee County, IL",2007-2008,36191,36272,81,0.224,40,41,17,103,H1
"Lee County, IL",2008-2009,36272,36189,-83,-0.229,45,-128,17,103,H1
"Lee County, IL",2009-2010,36189,35970,-219,-0.605,-15,-204,17,103,H1
"Lee County, IL",2010-2011,35970,35515,-455,-1.265,-18,-437,17,103,H1
"Lee County, IL",2011-2012,35515,35141,-374,-1.053,38,-412,17,103,H1
"Lee County, IL",2012-2013,35141,34881,-260,-0.74,15,-275,17,103,H1
"Lee County, IL",2013-2014,34881,34735,-146,-0.419,-22,-124,17,103,H1
"Lee County, IL",2014-2015,34886,34584,-302,-0.866,-4,-298,17,103,H1
"Lee County, IL",2015-2016,34584,34399,-185,-0.535,-37,-148,17,103,H1
"Lee County, IL",2016-2017,34399,34406,7,0.02,-65,72,17,103,H1
"Livingston County, IL",2000-2001,39751,39881,130,0.327,174,-44,17,105,H1
"Livingston County, IL",2001-2002,39881,39519,-362,-0.908,79,-441,17,105,H1
"Livingston County, IL",2002-2003,39519,39095,-424,-1.073,84,-508,17,105,H1
"Livingston County, IL",2003-2004,39095,39145,50,0.128,108,-58,17,105,H1
"Livingston County, IL",2004-2005,39145,39062,-83,-0.212,32,-115,17,105,H1
"Livingston County, IL",2005-2006,39062,38978,-84,-0.215,102,-186,17,105,H1
"Livingston County, IL",2006-2007,38978,39069,91,0.233,123,-32,17,105,H1
"Livingston County, IL",2007-2008,39069,39071,2,0.005,77,-75,17,105,H1
"Livingston County, IL",2008-2009,39071,39054,-17,-0.044,91,-108,17,105,H1
"Livingston County, IL",2009-2010,39054,38853,-201,-0.515,50,-251,17,105,H1
"Livingston County, IL",2010-2011,38853,38844,-9,-0.023,56,-65,17,105,H1
"Livingston County, IL",2011-2012,38844,38535,-309,-0.795,-29,-280,17,105,H1
"Livingston County, IL",2012-2013,38535,38243,-292,-0.758,80,-372,17,105,H1
"Livingston County, IL",2013-2014,38243,37903,-340,-0.889,99,-439,17,105,H1
"Livingston County, IL",2014-2015,3.70E+04,36671,-329,-0.889,22,-351,17,105,H1
"Livingston County, IL",2015-2016,36671,36475,-196,-0.534,3,-199,17,105,H1
"Livingston County, IL",2016-2017,36475,36518,43,0.118,39,4,17,105,H1
"Logan County, IL",2000-2001,31161,30934,-227,-0.728,0,-227,17,107,H1
"Logan County, IL",2001-2002,30934,30873,-61,-0.197,-22,-39,17,107,H1
"Logan County, IL",2002-2003,30873,30958,85,0.275,6,79,17,107,H1
"Logan County, IL",2003-2004,30958,30981,23,0.074,31,-8,17,107,H1
"Logan County, IL",2004-2005,30981,30795,-186,-0.6,-19,-167,17,107,H1
"Logan County, IL",2005-2006,30795,30562,-233,-0.757,-26,-207,17,107,H1
"Logan County, IL",2006-2007,30562,30498,-64,-0.209,-28,-36,17,107,H1
"Logan County, IL",2007-2008,30498,30513,15,0.049,27,-12,17,107,H1
"Logan County, IL",2008-2009,30513,30342,-171,-0.56,33,-204,17,107,H1
"Logan County, IL",2009-2010,30342,30283,-59,-0.194,-3,-56,17,107,H1
"Logan County, IL",2010-2011,30283,30259,-24,-0.079,-9,-15,17,107,H1
"Logan County, IL",2011-2012,30259,30003,-256,-0.846,-32,-224,17,107,H1
"Logan County, IL",2012-2013,30003,29943,-60,-0.2,-11,-49,17,107,H1
"Logan County, IL",2013-2014,29943,29746,-197,-0.658,-32,-165,17,107,H1
"Logan County, IL",2014-2015,29720,29494,-226,-0.76,0,-226,17,107,H1
"Logan County, IL",2015-2016,29494,29338,-156,-0.529,-19,-137,17,107,H1
"Logan County, IL",2016-2017,29338,29245,-93,-0.317,-10,-83,17,107,H1
"McDonough County, IL",2000-2001,32841,32789,-52,-0.158,5,-57,17,109,H1
"McDonough County, IL",2001-2002,32789,32802,13,0.04,-31,44,17,109,H1
"McDonough County, IL",2002-2003,32802,32971,169,0.515,-13,182,17,109,H1
"McDonough County, IL",2003-2004,32971,32798,-173,-0.525,-16,-157,17,109,H1
"McDonough County, IL",2004-2005,32798,32848,50,0.152,-6,56,17,109,H1
"McDonough County, IL",2005-2006,32848,32868,20,0.061,-11,31,17,109,H1
"McDonough County, IL",2006-2007,32868,32945,77,0.234,33,44,17,109,H1
"McDonough County, IL",2007-2008,32945,32615,-330,-1.002,16,-346,17,109,H1
"McDonough County, IL",2008-2009,32615,32611,-4,-0.012,30,-34,17,109,H1
"McDonough County, IL",2009-2010,32611,32596,-15,-0.046,10,-25,17,109,H1
"McDonough County, IL",2010-2011,32596,32501,-95,-0.291,5,-100,17,109,H1
"McDonough County, IL",2011-2012,32501,32545,44,0.135,7,37,17,109,H1
"McDonough County, IL",2012-2013,32545,32420,-125,-0.384,36,-161,17,109,H1
"McDonough County, IL",2013-2014,32420,31880,-540,-1.666,25,-565,17,109,H1
"McDonough County, IL",2014-2015,31591,31333,-258,-0.817,3,-261,17,109,H1
"McDonough County, IL",2015-2016,31333,31387,54,0.172,-44,98,17,109,H1
"McDonough County, IL",2016-2017,31387,30823,-564,-1.797,-24,-540,17,109,H1
"McHenry County, IL",2000-2001,261084,267632,6548,2.508,2635,3913,17,111,H1
"McHenry County, IL",2001-2002,267632,274441,6809,2.544,2634,4175,17,111,H1
"McHenry County, IL",2002-2003,274441,281743,7302,2.661,2489,4813,17,111,H1
"McHenry County, IL",2003-2004,281743,287997,6254,2.22,2626,3628,17,111,H1
"McHenry County, IL",2004-2005,287997,294280,6283,2.182,2621,3662,17,111,H1
"McHenry County, IL",2005-2006,294280,300630,6350,2.158,2537,3813,17,111,H1
"McHenry County, IL",2006-2007,300630,305117,4487,1.493,2414,2073,17,111,H1
"McHenry County, IL",2007-2008,305117,307246,2129,0.698,2381,-252,17,111,H1
"McHenry County, IL",2008-2009,307246,308067,821,0.267,2447,-1626,17,111,H1
"McHenry County, IL",2009-2010,308067,309114,1047,0.34,1714,-667,17,111,H1
"McHenry County, IL",2010-2011,309114,307899,-1215,-0.393,1464,-2679,17,111,H1
"McHenry County, IL",2011-2012,307899,307775,-124,-0.04,1437,-1561,17,111,H1
"McHenry County, IL",2012-2013,307775,307367,-408,-0.133,1286,-1694,17,111,H1
"McHenry County, IL",2013-2014,307367,307283,-84,-0.027,1299,-1383,17,111,H1
"McHenry County, IL",2014-2015,306975,307343,368,0.12,1278,-910,17,111,H1
"McHenry County, IL",2015-2016,307343,307972,629,0.205,1266,-637,17,111,H1
"McHenry County, IL",2016-2017,307972,309122,1150,0.373,1241,-91,17,111,H1
"McLean County, IL",2000-2001,150844,152713,1869,1.239,1025,844,17,113,H1
"McLean County, IL",2001-2002,152713,155882,3169,2.075,1054,2115,17,113,H1
"McLean County, IL",2002-2003,155882,157795,1913,1.227,1100,813,17,113,H1
"McLean County, IL",2003-2004,157795,159096,1301,0.824,1111,190,17,113,H1
"McLean County, IL",2004-2005,159096,160299,1203,0.756,1236,-33,17,113,H1
"McLean County, IL",2005-2006,160299,162925,2626,1.638,1119,1507,17,113,H1
"McLean County, IL",2006-2007,162925,165223,2298,1.41,1169,1129,17,113,H1
"McLean County, IL",2007-2008,165223,166825,1602,0.97,1216,386,17,113,H1
"McLean County, IL",2008-2009,166825,168727,1902,1.14,1222,680,17,113,H1
"McLean County, IL",2009-2010,168727,169843,1116,0.661,1008,108,17,113,H1
"McLean County, IL",2010-2011,169843,170734,891,0.525,1054,-163,17,113,H1
"McLean County, IL",2011-2012,170734,172418,1684,0.986,1045,639,17,113,H1
"McLean County, IL",2012-2013,172418,174893,2475,1.435,1043,1432,17,113,H1
"McLean County, IL",2013-2014,174893,174061,-832,-0.476,1053,-1885,17,113,H1
"McLean County, IL",2014-2015,174110,173166,-944,-0.542,927,-1871,17,113,H1
"McLean County, IL",2015-2016,173166,172688,-478,-0.276,905,-1383,17,113,H1
"McLean County, IL",2016-2017,172688,172290,-398,-0.23,897,-1295,17,113,H1
"Macon County, IL",2000-2001,114499,113604,-895,-0.782,312,-1207,17,115,H1
"Macon County, IL",2001-2002,113604,112564,-1040,-0.915,282,-1322,17,115,H1
"Macon County, IL",2002-2003,112564,111572,-992,-0.881,268,-1260,17,115,H1
"Macon County, IL",2003-2004,111572,111181,-391,-0.35,104,-495,17,115,H1
"Macon County, IL",2004-2005,111181,111083,-98,-0.088,161,-259,17,115,H1
"Macon County, IL",2005-2006,111083,110808,-275,-0.248,245,-520,17,115,H1
"Macon County, IL",2006-2007,110808,110751,-57,-0.051,212,-269,17,115,H1
"Macon County, IL",2007-2008,110751,110588,-163,-0.147,219,-382,17,115,H1
"Macon County, IL",2008-2009,110588,110732,144,0.13,219,-75,17,115,H1
"Macon County, IL",2009-2010,110732,110757,25,0.023,134,-109,17,115,H1
"Macon County, IL",2010-2011,110757,110582,-175,-0.158,217,-392,17,115,H1
"Macon County, IL",2011-2012,110582,110043,-539,-0.487,137,-676,17,115,H1
"Macon County, IL",2012-2013,110043,109435,-608,-0.553,178,-786,17,115,H1
"Macon County, IL",2013-2014,109435,108350,-1085,-0.991,213,-1298,17,115,H1
"Macon County, IL",2014-2015,108381,107303,-1078,-0.995,173,-1251,17,115,H1
"Macon County, IL",2015-2016,107303,106651,-652,-0.608,142,-794,17,115,H1
"Macon County, IL",2016-2017,106651,105801,-850,-0.797,157,-1007,17,115,H1
"Macoupin County, IL",2000-2001,48972,48788,-184,-0.376,-15,-169,17,117,H1
"Macoupin County, IL",2001-2002,48788,48719,-69,-0.141,-17,-52,17,117,H1
"Macoupin County, IL",2002-2003,48719,48690,-29,-0.06,-75,46,17,117,H1
"Macoupin County, IL",2003-2004,48690,48612,-78,-0.16,12,-90,17,117,H1
"Macoupin County, IL",2004-2005,48612,48418,-194,-0.399,-23,-171,17,117,H1
"Macoupin County, IL",2005-2006,48418,48176,-242,-0.5,-72,-170,17,117,H1
"Macoupin County, IL",2006-2007,48176,48195,19,0.039,3,16,17,117,H1
"Macoupin County, IL",2007-2008,48195,48092,-103,-0.214,-3,-100,17,117,H1
"Macoupin County, IL",2008-2009,48092,47630,-462,-0.961,24,-486,17,117,H1
"Macoupin County, IL",2009-2010,47630,47784,154,0.323,-62,216,17,117,H1
"Macoupin County, IL",2010-2011,47784,47807,23,0.048,-35,58,17,117,H1
"Macoupin County, IL",2011-2012,47807,47208,-599,-1.253,-109,-490,17,117,H1
"Macoupin County, IL",2012-2013,47208,46892,-316,-0.669,-118,-198,17,117,H1
"Macoupin County, IL",2013-2014,46892,46453,-439,-0.936,-125,-314,17,117,H1
"Macoupin County, IL",2014-2015,46354,46045,-309,-0.667,-151,-158,17,117,H1
"Macoupin County, IL",2015-2016,46045,45653,-392,-0.851,-113,-279,17,117,H1
"Macoupin County, IL",2016-2017,45653,45446,-207,-0.453,-142,-65,17,117,H1
"Madison County, IL",2000-2001,259204,260343,1139,0.439,765,374,17,119,H1
"Madison County, IL",2001-2002,260343,261130,787,0.302,582,205,17,119,H1
"Madison County, IL",2002-2003,261130,262566,1436,0.55,663,773,17,119,H1
"Madison County, IL",2003-2004,262566,263722,1156,0.44,641,515,17,119,H1
"Madison County, IL",2004-2005,263722,264759,1037,0.393,793,244,17,119,H1
"Madison County, IL",2005-2006,264759,266164,1405,0.531,702,703,17,119,H1
"Madison County, IL",2006-2007,266164,267382,1218,0.458,753,465,17,119,H1
"Madison County, IL",2007-2008,267382,268232,850,0.318,855,-5,17,119,H1
"Madison County, IL",2008-2009,268232,268978,746,0.278,948,-202,17,119,H1
"Madison County, IL",2009-2010,268978,269341,363,0.135,591,-228,17,119,H1
"Madison County, IL",2010-2011,269341,268500,-841,-0.312,595,-1436,17,119,H1
"Madison County, IL",2011-2012,268500,268039,-461,-0.172,662,-1123,17,119,H1
"Madison County, IL",2012-2013,268039,267247,-792,-0.295,421,-1213,17,119,H1
"Madison County, IL",2013-2014,267247,266560,-687,-0.257,342,-1029,17,119,H1
"Madison County, IL",2014-2015,266635,266209,-426,-0.16,341,-767,17,119,H1
"Madison County, IL",2015-2016,266209,265598,-611,-0.23,188,-799,17,119,H1
"Madison County, IL",2016-2017,265598,265428,-170,-0.064,217,-387,17,119,H1
"Marion County, IL",2000-2001,41665,41393,-272,-0.653,31,-303,17,121,H1
"Marion County, IL",2001-2002,41393,40971,-422,-1.019,-14,-408,17,121,H1
"Marion County, IL",2002-2003,40971,40602,-369,-0.901,-33,-336,17,121,H1
"Marion County, IL",2003-2004,40602,40229,-373,-0.919,-58,-315,17,121,H1
"Marion County, IL",2004-2005,40229,39941,-288,-0.716,18,-306,17,121,H1
"Marion County, IL",2005-2006,39941,40037,96,0.24,30,66,17,121,H1
"Marion County, IL",2006-2007,40037,39898,-139,-0.347,104,-243,17,121,H1
"Marion County, IL",2007-2008,39898,39794,-104,-0.261,31,-135,17,121,H1
"Marion County, IL",2008-2009,39794,39465,-329,-0.827,-6,-323,17,121,H1
"Marion County, IL",2009-2010,39465,39455,-10,-0.025,-39,29,17,121,H1
"Marion County, IL",2010-2011,39455,39014,-441,-1.118,-63,-378,17,121,H1
"Marion County, IL",2011-2012,39014,38923,-91,-0.233,15,-106,17,121,H1
"Marion County, IL",2012-2013,38923,38646,-277,-0.712,73,-350,17,121,H1
"Marion County, IL",2013-2014,38646,38571,-75,-0.194,88,-163,17,121,H1
"Marion County, IL",2014-2015,38483,38339,-144,-0.374,77,-221,17,121,H1
"Marion County, IL",2015-2016,38339,38066,-273,-0.712,9,-282,17,121,H1
"Marion County, IL",2016-2017,38066,37902,-164,-0.431,74,-238,17,121,H1
"Marshall County, IL",2000-2001,13137,12917,-220,-1.675,-44,-176,17,123,H1
"Marshall County, IL",2001-2002,12917,12939,22,0.17,-53,75,17,123,H1
"Marshall County, IL",2002-2003,12939,12911,-28,-0.216,-19,-9,17,123,H1
"Marshall County, IL",2003-2004,12911,13007,96,0.744,-41,137,17,123,H1
"Marshall County, IL",2004-2005,13007,12952,-55,-0.423,-48,-7,17,123,H1
"Marshall County, IL",2005-2006,12952,12896,-56,-0.432,-40,-16,17,123,H1
"Marshall County, IL",2006-2007,12896,12896,0,0,-19,19,17,123,H1
"Marshall County, IL",2007-2008,12896,12725,-171,-1.326,-33,-138,17,123,H1
"Marshall County, IL",2008-2009,12725,12671,-54,-0.424,-28,-26,17,123,H1
"Marshall County, IL",2009-2010,12671,12630,-41,-0.324,-34,-7,17,123,H1
"Marshall County, IL",2010-2011,12630,12508,-122,-0.966,-48,-74,17,123,H1
"Marshall County, IL",2011-2012,12508,12301,-207,-1.655,-67,-140,17,123,H1
"Marshall County, IL",2012-2013,12301,12140,-161,-1.309,-21,-140,17,123,H1
"Marshall County, IL",2013-2014,12140,12014,-126,-1.038,-38,-88,17,123,H1
"Marshall County, IL",2014-2015,11998,11982,-16,-0.133,-10,-6,17,123,H1
"Marshall County, IL",2015-2016,11982,11898,-84,-0.701,-10,-74,17,123,H1
"Marshall County, IL",2016-2017,11898,11730,-168,-1.412,-3,-165,17,123,H1
"Mason County, IL",2000-2001,16001,15960,-41,-0.256,-12,-29,17,125,H1
"Mason County, IL",2001-2002,15960,15847,-113,-0.708,-19,-94,17,125,H1
"Mason County, IL",2002-2003,15847,15717,-130,-0.82,4,-134,17,125,H1
"Mason County, IL",2003-2004,15717,15671,-46,-0.293,16,-62,17,125,H1
"Mason County, IL",2004-2005,15671,15471,-200,-1.276,-19,-181,17,125,H1
"Mason County, IL",2005-2006,15471,15153,-318,-2.055,-23,-295,17,125,H1
"Mason County, IL",2006-2007,15153,15078,-75,-0.495,-50,-25,17,125,H1
"Mason County, IL",2007-2008,15078,14962,-116,-0.769,-31,-85,17,125,H1
"Mason County, IL",2008-2009,14962,14787,-175,-1.17,-11,-164,17,125,H1
"Mason County, IL",2009-2010,14787,14645,-142,-0.96,-37,-105,17,125,H1
"Mason County, IL",2010-2011,14645,14475,-170,-1.161,-49,-121,17,125,H1
"Mason County, IL",2011-2012,14475,14339,-136,-0.94,-58,-78,17,125,H1
"Mason County, IL",2012-2013,14339,14187,-152,-1.06,-56,-96,17,125,H1
"Mason County, IL",2013-2014,14187,13898,-289,-2.037,-57,-232,17,125,H1
"Mason County, IL",2014-2015,13914,13701,-213,-1.531,-27,-186,17,125,H1
"Mason County, IL",2015-2016,13701,13706,5,0.036,-30,35,17,125,H1
"Mason County, IL",2016-2017,13706,13715,9,0.066,-27,36,17,125,H1
"Massac County, IL",2000-2001,15136,15077,-59,-0.39,-34,-25,17,127,H1
"Massac County, IL",2001-2002,15077,15206,129,0.856,-2,131,17,127,H1
"Massac County, IL",2002-2003,15206,15205,-1,-0.007,-34,33,17,127,H1
"Massac County, IL",2003-2004,15205,15444,239,1.572,-3,242,17,127,H1
"Massac County, IL",2004-2005,15444,15477,33,0.214,19,14,17,127,H1
"Massac County, IL",2005-2006,15477,15397,-80,-0.517,-12,-68,17,127,H1
"Massac County, IL",2006-2007,15397,15471,74,0.481,2,72,17,127,H1
"Massac County, IL",2007-2008,15471,15408,-63,-0.407,-7,-56,17,127,H1
"Massac County, IL",2008-2009,15408,15435,27,0.175,2,25,17,127,H1
"Massac County, IL",2009-2010,15435,15400,-35,-0.227,-3,-32,17,127,H1
"Massac County, IL",2010-2011,15400,15312,-88,-0.571,-34,-54,17,127,H1
"Massac County, IL",2011-2012,15312,15143,-169,-1.104,-33,-136,17,127,H1
"Massac County, IL",2012-2013,15143,14980,-163,-1.076,-55,-108,17,127,H1
"Massac County, IL",2013-2014,14980,14905,-75,-0.501,-15,-60,17,127,H1
"Massac County, IL",2014-2015,14876,14766,-110,-0.739,-18,-92,17,127,H1
"Massac County, IL",2015-2016,14766,14469,-297,-2.011,-28,-269,17,127,H1
"Massac County, IL",2016-2017,14469,14344,-125,-0.864,-28,-97,17,127,H1
"Menard County, IL",2000-2001,12476,12503,27,0.216,34,-7,17,129,H1
"Menard County, IL",2001-2002,12503,12525,22,0.176,-17,39,17,129,H1
"Menard County, IL",2002-2003,12525,12562,37,0.295,28,9,17,129,H1
"Menard County, IL",2003-2004,12562,12641,79,0.629,-11,90,17,129,H1
"Menard County, IL",2004-2005,12641,12556,-85,-0.672,3,-88,17,129,H1
"Menard County, IL",2005-2006,12556,12570,14,0.112,-2,16,17,129,H1
"Menard County, IL",2006-2007,12570,12746,176,1.4,28,148,17,129,H1
"Menard County, IL",2007-2008,12746,12780,34,0.267,19,15,17,129,H1
"Menard County, IL",2008-2009,12780,12720,-60,-0.469,3,-63,17,129,H1
"Menard County, IL",2009-2010,12720,12693,-27,-0.212,-18,-9,17,129,H1
"Menard County, IL",2010-2011,12693,12709,16,0.126,18,-2,17,129,H1
"Menard County, IL",2011-2012,12709,12709,0,0,-4,4,17,129,H1
"Menard County, IL",2012-2013,12709,12608,-101,-0.795,-17,-84,17,129,H1
"Menard County, IL",2013-2014,12608,12570,-38,-0.301,-6,-32,17,129,H1
"Menard County, IL",2014-2015,12566,12444,-122,-0.971,-18,-104,17,129,H1
"Menard County, IL",2015-2016,12444,12399,-45,-0.362,-2,-43,17,129,H1
"Menard County, IL",2016-2017,12399,12245,-154,-1.242,-30,-124,17,129,H1
"Mercer County, IL",2000-2001,16937,16910,-27,-0.159,10,-37,17,131,H1
"Mercer County, IL",2001-2002,16910,16914,4,0.024,44,-40,17,131,H1
"Mercer County, IL",2002-2003,16914,16829,-85,-0.503,-9,-76,17,131,H1
"Mercer County, IL",2003-2004,16829,16795,-34,-0.202,19,-53,17,131,H1
"Mercer County, IL",2004-2005,16795,16694,-101,-0.601,10,-111,17,131,H1
"Mercer County, IL",2005-2006,16694,16642,-52,-0.311,-35,-17,17,131,H1
"Mercer County, IL",2006-2007,16642,16598,-44,-0.264,2,-46,17,131,H1
"Mercer County, IL",2007-2008,16598,16650,52,0.313,1,51,17,131,H1
"Mercer County, IL",2008-2009,16650,16438,-212,-1.273,2,-214,17,131,H1
"Mercer County, IL",2009-2010,16438,16425,-13,-0.079,-41,28,17,131,H1
"Mercer County, IL",2010-2011,16425,16350,-75,-0.457,-24,-51,17,131,H1
"Mercer County, IL",2011-2012,16350,16176,-174,-1.064,-40,-134,17,131,H1
"Mercer County, IL",2012-2013,16176,16123,-53,-0.328,-43,-10,17,131,H1
"Mercer County, IL",2013-2014,16123,15945,-178,-1.104,-30,-148,17,131,H1
"Mercer County, IL",2014-2015,15978,15858,-120,-0.751,-20,-100,17,131,H1
"Mercer County, IL",2015-2016,15858,15630,-228,-1.438,-35,-193,17,131,H1
"Mercer County, IL",2016-2017,15630,15618,-12,-0.077,-57,45,17,131,H1
"Monroe County, IL",2000-2001,27764,28302,538,1.938,119,419,17,133,H1
"Monroe County, IL",2001-2002,28302,29070,768,2.714,102,666,17,133,H1
"Monroe County, IL",2002-2003,29070,29771,701,2.411,109,592,17,133,H1
"Monroe County, IL",2003-2004,29771,30422,651,2.187,91,560,17,133,H1
"Monroe County, IL",2004-2005,30422,31007,585,1.923,142,443,17,133,H1
"Monroe County, IL",2005-2006,31007,31644,637,2.054,57,580,17,133,H1
"Monroe County, IL",2006-2007,31644,32139,495,1.564,133,362,17,133,H1
"Monroe County, IL",2007-2008,32139,32533,394,1.226,121,273,17,133,H1
"Monroe County, IL",2008-2009,32533,32848,315,0.968,140,175,17,133,H1
"Monroe County, IL",2009-2010,32848,33009,161,0.49,41,120,17,133,H1
"Monroe County, IL",2010-2011,33009,33233,224,0.679,41,183,17,133,H1
"Monroe County, IL",2011-2012,33233,33331,98,0.295,83,15,17,133,H1
"Monroe County, IL",2012-2013,33331,33570,239,0.717,79,160,17,133,H1
"Monroe County, IL",2013-2014,33570,33722,152,0.453,40,112,17,133,H1
"Monroe County, IL",2014-2015,33695,33879,184,0.546,19,165,17,133,H1
"Monroe County, IL",2015-2016,33879,33878,-1,-0.003,60,-61,17,133,H1
"Monroe County, IL",2016-2017,33878,34097,219,0.646,43,176,17,133,H1
"Montgomery County, IL",2000-2001,30657,30516,-141,-0.46,-32,-109,17,135,H1
"Montgomery County, IL",2001-2002,30516,30550,34,0.111,-27,61,17,135,H1
"Montgomery County, IL",2002-2003,30550,30355,-195,-0.638,-23,-172,17,135,H1
"Montgomery County, IL",2003-2004,30355,30394,39,0.128,-25,64,17,135,H1
"Montgomery County, IL",2004-2005,30394,30288,-106,-0.349,-55,-51,17,135,H1
"Montgomery County, IL",2005-2006,30288,30378,90,0.297,-35,125,17,135,H1
"Montgomery County, IL",2006-2007,30378,30295,-83,-0.273,3,-86,17,135,H1
"Montgomery County, IL",2007-2008,30295,30276,-19,-0.063,-5,-14,17,135,H1
"Montgomery County, IL",2008-2009,30276,30124,-152,-0.502,-25,-127,17,135,H1
"Montgomery County, IL",2009-2010,30124,30095,-29,-0.096,-65,36,17,135,H1
"Montgomery County, IL",2010-2011,30095,29839,-256,-0.851,-62,-194,17,135,H1
"Montgomery County, IL",2011-2012,29839,29725,-114,-0.382,-19,-95,17,135,H1
"Montgomery County, IL",2012-2013,29725,29671,-54,-0.182,-55,1,17,135,H1
"Montgomery County, IL",2013-2014,29671,29359,-312,-1.052,-78,-234,17,135,H1
"Montgomery County, IL",2014-2015,29058,28898,-160,-0.551,-69,-91,17,135,H1
"Montgomery County, IL",2015-2016,28898,29079,181,0.626,-50,231,17,135,H1
"Montgomery County, IL",2016-2017,29079,28790,-289,-0.994,-63,-226,17,135,H1
"Morgan County, IL",2000-2001,36638,36403,-235,-0.641,39,-274,17,137,H1
"Morgan County, IL",2001-2002,36403,36262,-141,-0.387,-1,-140,17,137,H1
"Morgan County, IL",2002-2003,36262,36241,-21,-0.058,-25,4,17,137,H1
"Morgan County, IL",2003-2004,36241,36332,91,0.251,32,59,17,137,H1
"Morgan County, IL",2004-2005,36332,36101,-231,-0.636,11,-242,17,137,H1
"Morgan County, IL",2005-2006,36101,35966,-135,-0.374,-35,-100,17,137,H1
"Morgan County, IL",2006-2007,35966,35936,-30,-0.083,0,-30,17,137,H1
"Morgan County, IL",2007-2008,35936,35761,-175,-0.487,6,-181,17,137,H1
"Morgan County, IL",2008-2009,35761,35602,-159,-0.445,13,-172,17,137,H1
"Morgan County, IL",2009-2010,35602,35553,-49,-0.138,-9,-40,17,137,H1
"Morgan County, IL",2010-2011,35553,35561,8,0.023,-10,18,17,137,H1
"Morgan County, IL",2011-2012,35561,35279,-282,-0.793,-35,-247,17,137,H1
"Morgan County, IL",2012-2013,35279,35038,-241,-0.683,-10,-231,17,137,H1
"Morgan County, IL",2013-2014,35038,34929,-109,-0.311,12,-121,17,137,H1
"Morgan County, IL",2014-2015,34924,34828,-96,-0.275,30,-126,17,137,H1
"Morgan County, IL",2015-2016,34828,34194,-634,-1.82,-26,-608,17,137,H1
"Morgan County, IL",2016-2017,34194,33798,-396,-1.158,-16,-380,17,137,H1
"Moultrie County, IL",2000-2001,14327,14324,-3,-0.021,20,-23,17,139,H1
"Moultrie County, IL",2001-2002,14324,14362,38,0.265,-12,50,17,139,H1
"Moultrie County, IL",2002-2003,14362,14432,70,0.487,-36,106,17,139,H1
"Moultrie County, IL",2003-2004,14432,14521,89,0.617,-13,102,17,139,H1
"Moultrie County, IL",2004-2005,14521,14587,66,0.455,-30,96,17,139,H1
"Moultrie County, IL",2005-2006,14587,14565,-22,-0.151,-28,6,17,139,H1
"Moultrie County, IL",2006-2007,14565,14666,101,0.693,18,83,17,139,H1
"Moultrie County, IL",2007-2008,14666,14743,77,0.525,-3,80,17,139,H1
"Moultrie County, IL",2008-2009,14743,14787,44,0.298,0,44,17,139,H1
"Moultrie County, IL",2009-2010,14787,14853,66,0.446,-32,98,17,139,H1
"Moultrie County, IL",2010-2011,14853,14916,63,0.424,-45,108,17,139,H1
"Moultrie County, IL",2011-2012,14916,14973,57,0.382,9,48,17,139,H1
"Moultrie County, IL",2012-2013,14973,14903,-70,-0.468,-6,-64,17,139,H1
"Moultrie County, IL",2013-2014,14903,14837,-66,-0.443,3,-69,17,139,H1
"Moultrie County, IL",2014-2015,14892,14931,39,0.262,46,-7,17,139,H1
"Moultrie County, IL",2015-2016,14931,14599,-332,-2.224,-1,-331,17,139,H1
"Moultrie County, IL",2016-2017,14599,14688,89,0.61,15,74,17,139,H1
"Ogle County, IL",2000-2001,51275,51468,193,0.376,166,27,17,141,H1
"Ogle County, IL",2001-2002,51468,51758,290,0.563,78,212,17,141,H1
"Ogle County, IL",2002-2003,51758,52227,469,0.906,125,344,17,141,H1
"Ogle County, IL",2003-2004,52227,52536,309,0.592,90,219,17,141,H1
"Ogle County, IL",2004-2005,52536,52893,357,0.68,114,243,17,141,H1
"Ogle County, IL",2005-2006,52893,53358,465,0.879,112,353,17,141,H1
"Ogle County, IL",2006-2007,53358,53634,276,0.517,185,91,17,141,H1
"Ogle County, IL",2007-2008,53634,53802,168,0.313,139,29,17,141,H1
"Ogle County, IL",2008-2009,53802,53621,-181,-0.336,160,-341,17,141,H1
"Ogle County, IL",2009-2010,53621,53448,-173,-0.323,50,-223,17,141,H1
"Ogle County, IL",2010-2011,53448,53160,-288,-0.539,75,-363,17,141,H1
"Ogle County, IL",2011-2012,53160,52839,-321,-0.604,47,-368,17,141,H1
"Ogle County, IL",2012-2013,52839,52377,-462,-0.874,66,-528,17,141,H1
"Ogle County, IL",2013-2014,52377,52085,-292,-0.557,40,-332,17,141,H1
"Ogle County, IL",2014-2015,52023,51659,-364,-0.7,47,-411,17,141,H1
"Ogle County, IL",2015-2016,51659,51168,-491,-0.95,16,-507,17,141,H1
"Ogle County, IL",2016-2017,51168,51063,-105,-0.205,40,-145,17,141,H1
"Peoria County, IL",2000-2001,183186,182348,-838,-0.457,842,-1680,17,143,H1
"Peoria County, IL",2001-2002,182348,182685,337,0.185,874,-537,17,143,H1
"Peoria County, IL",2002-2003,182685,182338,-347,-0.19,839,-1186,17,143,H1
"Peoria County, IL",2003-2004,182338,182613,275,0.151,776,-501,17,143,H1
"Peoria County, IL",2004-2005,182613,182868,255,0.14,750,-495,17,143,H1
"Peoria County, IL",2005-2006,182868,183446,578,0.316,1005,-427,17,143,H1
"Peoria County, IL",2006-2007,183446,184048,602,0.328,1026,-424,17,143,H1
"Peoria County, IL",2007-2008,184048,184803,755,0.41,1044,-289,17,143,H1
"Peoria County, IL",2008-2009,184803,186930,2127,1.151,995,1132,17,143,H1
"Peoria County, IL",2009-2010,186930,186270,-660,-0.353,911,-1571,17,143,H1
"Peoria County, IL",2010-2011,186270,186675,405,0.217,772,-367,17,143,H1
"Peoria County, IL",2011-2012,186675,187193,518,0.277,845,-327,17,143,H1
"Peoria County, IL",2012-2013,187193,188529,1336,0.714,1040,296,17,143,H1
"Peoria County, IL",2013-2014,188529,187319,-1210,-0.642,968,-2178,17,143,H1
"Peoria County, IL",2014-2015,187185,186221,-964,-0.515,909,-1873,17,143,H1
"Peoria County, IL",2015-2016,186221,185296,-925,-0.497,839,-1764,17,143,H1
"Peoria County, IL",2016-2017,185296,183011,-2285,-1.233,820,-3105,17,143,H1
"Perry County, IL",2000-2001,23055,23006,-49,-0.213,-31,-18,17,145,H1
"Perry County, IL",2001-2002,23006,22708,-298,-1.295,-23,-275,17,145,H1
"Perry County, IL",2002-2003,22708,22631,-77,-0.339,-27,-50,17,145,H1
"Perry County, IL",2003-2004,22631,22630,-1,-0.004,-15,14,17,145,H1
"Perry County, IL",2004-2005,22630,22608,-22,-0.097,-2,-20,17,145,H1
"Perry County, IL",2005-2006,22608,22692,84,0.372,28,56,17,145,H1
"Perry County, IL",2006-2007,22692,22596,-96,-0.423,-5,-91,17,145,H1
"Perry County, IL",2007-2008,22596,22434,-162,-0.717,19,-181,17,145,H1
"Perry County, IL",2008-2009,22434,22374,-60,-0.267,11,-71,17,145,H1
"Perry County, IL",2009-2010,22374,22331,-43,-0.192,-15,-28,17,145,H1
"Perry County, IL",2010-2011,22331,22236,-95,-0.425,-42,-53,17,145,H1
"Perry County, IL",2011-2012,22236,22070,-166,-0.747,-21,-145,17,145,H1
"Perry County, IL",2012-2013,22070,21861,-209,-0.947,-8,-201,17,145,H1
"Perry County, IL",2013-2014,21861,21672,-189,-0.865,-21,-168,17,145,H1
"Perry County, IL",2014-2015,21602,21543,-59,-0.273,12,-71,17,145,H1
"Perry County, IL",2015-2016,21543,21382,-161,-0.747,11,-172,17,145,H1
"Perry County, IL",2016-2017,21382,21285,-97,-0.454,-9,-88,17,145,H1
"Piatt County, IL",2000-2001,16387,16357,-30,-0.183,43,-73,17,147,H1
"Piatt County, IL",2001-2002,16357,16216,-141,-0.862,-18,-123,17,147,H1
"Piatt County, IL",2002-2003,16216,16375,159,0.981,21,138,17,147,H1
"Piatt County, IL",2003-2004,16375,16463,88,0.537,51,37,17,147,H1
"Piatt County, IL",2004-2005,16463,16649,186,1.13,37,149,17,147,H1
"Piatt County, IL",2005-2006,16649,16682,33,0.198,13,20,17,147,H1
"Piatt County, IL",2006-2007,16682,16664,-18,-0.108,-4,-14,17,147,H1
"Piatt County, IL",2007-2008,16664,16716,52,0.312,37,15,17,147,H1
"Piatt County, IL",2008-2009,16716,16774,58,0.347,50,8,17,147,H1
"Piatt County, IL",2009-2010,16774,16712,-62,-0.37,22,-84,17,147,H1
"Piatt County, IL",2010-2011,16712,16672,-40,-0.239,5,-45,17,147,H1
"Piatt County, IL",2011-2012,16672,16507,-165,-0.99,-2,-163,17,147,H1
"Piatt County, IL",2012-2013,16507,16440,-67,-0.406,-4,-63,17,147,H1
"Piatt County, IL",2013-2014,16440,16431,-9,-0.055,2,-11,17,147,H1
"Piatt County, IL",2014-2015,16447,16387,-60,-0.365,21,-81,17,147,H1
"Piatt County, IL",2015-2016,16387,16526,139,0.848,22,117,17,147,H1
"Piatt County, IL",2016-2017,16526,16445,-81,-0.49,8,-89,17,147,H1
"Pike County, IL",2000-2001,17320,17178,-142,-0.82,-32,-110,17,149,H1
"Pike County, IL",2001-2002,17178,17031,-147,-0.856,-29,-118,17,149,H1
"Pike County, IL",2002-2003,17031,16866,-165,-0.969,-39,-126,17,149,H1
"Pike County, IL",2003-2004,16866,16910,44,0.261,-27,71,17,149,H1
"Pike County, IL",2004-2005,16910,16862,-48,-0.284,-39,-9,17,149,H1
"Pike County, IL",2005-2006,16862,16632,-230,-1.364,-10,-220,17,149,H1
"Pike County, IL",2006-2007,16632,16772,140,0.842,10,130,17,149,H1
"Pike County, IL",2007-2008,16772,16615,-157,-0.936,-9,-148,17,149,H1
"Pike County, IL",2008-2009,16615,16473,-142,-0.855,-17,-125,17,149,H1
"Pike County, IL",2009-2010,16473,16400,-73,-0.443,-42,-31,17,149,H1
"Pike County, IL",2010-2011,16400,16377,-23,-0.14,-23,0,17,149,H1
"Pike County, IL",2011-2012,16377,16279,-98,-0.598,-34,-64,17,149,H1
"Pike County, IL",2012-2013,16279,16142,-137,-0.842,-10,-127,17,149,H1
"Pike County, IL",2013-2014,16142,16022,-120,-0.743,-1,-119,17,149,H1
"Pike County, IL",2014-2015,15989,15989,0,0,-10,10,17,149,H1
"Pike County, IL",2015-2016,15989,15882,-107,-0.669,-25,-82,17,149,H1
"Pike County, IL",2016-2017,15882,15821,-61,-0.384,-5,-56,17,149,H1
"Pope County, IL",2000-2001,4411,4376,-35,-0.793,-15,-20,17,151,H1
"Pope County, IL",2001-2002,4376,4334,-42,-0.96,-10,-32,17,151,H1
"Pope County, IL",2002-2003,4334,4393,59,1.361,-16,75,17,151,H1
"Pope County, IL",2003-2004,4393,4424,31,0.706,-13,44,17,151,H1
"Pope County, IL",2004-2005,4424,4346,-78,-1.763,-20,-58,17,151,H1
"Pope County, IL",2005-2006,4346,4397,51,1.173,-7,58,17,151,H1
"Pope County, IL",2006-2007,4397,4439,42,0.955,-13,55,17,151,H1
"Pope County, IL",2007-2008,4439,4393,-46,-1.036,-11,-35,17,151,H1
"Pope County, IL",2008-2009,4393,4431,38,0.865,0,38,17,151,H1
"Pope County, IL",2009-2010,4431,4460,29,0.654,-12,41,17,151,H1
"Pope County, IL",2010-2011,4460,4452,-8,-0.179,-25,17,17,151,H1
"Pope County, IL",2011-2012,4452,4289,-163,-3.661,-26,-137,17,151,H1
"Pope County, IL",2012-2013,4289,4332,43,1.003,-1,44,17,151,H1
"Pope County, IL",2013-2014,4332,4276,-56,-1.293,11,-67,17,151,H1
"Pope County, IL",2014-2015,4269,4226,-43,-1.007,0,-43,17,151,H1
"Pope County, IL",2015-2016,4226,4295,69,1.633,-16,85,17,151,H1
"Pope County, IL",2016-2017,4295,4325,30,0.698,1,29,17,151,H1
"Pulaski County, IL",2000-2001,7294,7118,-176,-2.413,-3,-173,17,153,H1
"Pulaski County, IL",2001-2002,7118,7001,-117,-1.644,-1,-116,17,153,H1
"Pulaski County, IL",2002-2003,7001,6859,-142,-2.028,10,-152,17,153,H1
"Pulaski County, IL",2003-2004,6859,6733,-126,-1.837,0,-126,17,153,H1
"Pulaski County, IL",2004-2005,6733,6575,-158,-2.347,-5,-153,17,153,H1
"Pulaski County, IL",2005-2006,6575,6434,-141,-2.144,11,-152,17,153,H1
"Pulaski County, IL",2006-2007,6434,6359,-75,-1.166,3,-78,17,153,H1
"Pulaski County, IL",2007-2008,6359,6198,-161,-2.532,13,-174,17,153,H1
"Pulaski County, IL",2008-2009,6198,6164,-34,-0.549,5,-39,17,153,H1
"Pulaski County, IL",2009-2010,6164,6140,-24,-0.389,8,-32,17,153,H1
"Pulaski County, IL",2010-2011,6140,6007,-133,-2.166,-14,-119,17,153,H1
"Pulaski County, IL",2011-2012,6007,5971,-36,-0.599,-17,-19,17,153,H1
"Pulaski County, IL",2012-2013,5971,5904,-67,-1.122,-12,-55,17,153,H1
"Pulaski County, IL",2013-2014,5904,5815,-89,-1.507,-11,-78,17,153,H1
"Pulaski County, IL",2014-2015,5816,5678,-138,-2.373,-5,-133,17,153,H1
"Pulaski County, IL",2015-2016,5678,5603,-75,-1.321,-17,-58,17,153,H1
"Pulaski County, IL",2016-2017,5603,5509,-94,-1.678,-9,-85,17,153,H1
"Putnam County, IL",2000-2001,6065,6052,-13,-0.214,3,-16,17,155,H1
"Putnam County, IL",2001-2002,6052,6061,9,0.149,8,1,17,155,H1
"Putnam County, IL",2002-2003,6061,6074,13,0.214,9,4,17,155,H1
"Putnam County, IL",2003-2004,6074,6015,-59,-0.971,2,-61,17,155,H1
"Putnam County, IL",2004-2005,6015,5977,-38,-0.632,-2,-36,17,155,H1
"Putnam County, IL",2005-2006,5977,5931,-46,-0.77,14,-60,17,155,H1
"Putnam County, IL",2006-2007,5931,5987,56,0.944,6,50,17,155,H1
"Putnam County, IL",2007-2008,5987,5989,2,0.033,16,-14,17,155,H1
"Putnam County, IL",2008-2009,5989,5997,8,0.134,5,3,17,155,H1
"Putnam County, IL",2009-2010,5997,5994,-3,-0.05,-7,4,17,155,H1
"Putnam County, IL",2010-2011,5994,5968,-26,-0.434,-3,-23,17,155,H1
"Putnam County, IL",2011-2012,5968,5875,-93,-1.558,1,-94,17,155,H1
"Putnam County, IL",2012-2013,5875,5825,-50,-0.851,10,-60,17,155,H1
"Putnam County, IL",2013-2014,5825,5814,-11,-0.189,-7,-4,17,155,H1
"Putnam County, IL",2014-2015,5795,5644,-151,-2.606,-21,-130,17,155,H1
"Putnam County, IL",2015-2016,5644,5717,73,1.293,-5,78,17,155,H1
"Putnam County, IL",2016-2017,5717,5727,10,0.175,-4,14,17,155,H1
"Randolph County, IL",2000-2001,33910,34127,217,0.64,-30,247,17,157,H1
"Randolph County, IL",2001-2002,34127,33512,-615,-1.802,-29,-586,17,157,H1
"Randolph County, IL",2002-2003,33512,33410,-102,-0.304,-2,-100,17,157,H1
"Randolph County, IL",2003-2004,33410,33714,304,0.91,17,287,17,157,H1
"Randolph County, IL",2004-2005,33714,33588,-126,-0.374,-50,-76,17,157,H1
"Randolph County, IL",2005-2006,33588,33688,100,0.298,2,98,17,157,H1
"Randolph County, IL",2006-2007,33688,33598,-90,-0.267,13,-103,17,157,H1
"Randolph County, IL",2007-2008,33598,33584,-14,-0.042,29,-43,17,157,H1
"Randolph County, IL",2008-2009,33584,33528,-56,-0.167,24,-80,17,157,H1
"Randolph County, IL",2009-2010,33528,33456,-72,-0.215,-27,-45,17,157,H1
"Randolph County, IL",2010-2011,33456,33269,-187,-0.559,-13,-174,17,157,H1
"Randolph County, IL",2011-2012,33269,32947,-322,-0.968,-28,-294,17,157,H1
"Randolph County, IL",2012-2013,32947,32915,-32,-0.097,-1,-31,17,157,H1
"Randolph County, IL",2013-2014,32915,32869,-46,-0.14,-27,-19,17,157,H1
"Randolph County, IL",2014-2015,33048,32852,-196,-0.593,-36,-160,17,157,H1
"Randolph County, IL",2015-2016,32852,32597,-255,-0.776,-63,-192,17,157,H1
"Randolph County, IL",2016-2017,32597,32423,-174,-0.534,-72,-102,17,157,H1
"Richland County, IL",2000-2001,16259,16162,-97,-0.597,26,-123,17,159,H1
"Richland County, IL",2001-2002,16162,16326,164,1.015,-22,186,17,159,H1
"Richland County, IL",2002-2003,16326,16305,-21,-0.129,-10,-11,17,159,H1
"Richland County, IL",2003-2004,16305,16270,-35,-0.215,-2,-33,17,159,H1
"Richland County, IL",2004-2005,16270,16258,-12,-0.074,-21,9,17,159,H1
"Richland County, IL",2005-2006,16258,16171,-87,-0.535,-53,-34,17,159,H1
"Richland County, IL",2006-2007,16171,16153,-18,-0.111,-29,11,17,159,H1
"Richland County, IL",2007-2008,16153,16061,-92,-0.57,-30,-62,17,159,H1
"Richland County, IL",2008-2009,16061,16229,168,1.046,-37,205,17,159,H1
"Richland County, IL",2009-2010,16229,16207,-22,-0.136,-41,19,17,159,H1
"Richland County, IL",2010-2011,16207,16219,12,0.074,31,-19,17,159,H1
"Richland County, IL",2011-2012,16219,16165,-54,-0.333,16,-70,17,159,H1
"Richland County, IL",2012-2013,16165,16068,-97,-0.6,-13,-84,17,159,H1
"Richland County, IL",2013-2014,16068,16061,-7,-0.044,-10,3,17,159,H1
"Richland County, IL",2014-2015,16103,16029,-74,-0.46,16,-90,17,159,H1
"Richland County, IL",2015-2016,16029,15858,-171,-1.067,-10,-161,17,159,H1
"Richland County, IL",2016-2017,15858,15901,43,0.271,6,37,17,159,H1
"Rock Island County, IL",2000-2001,149134,148734,-400,-0.268,478,-878,17,161,H1
"Rock Island County, IL",2001-2002,148734,148286,-448,-0.301,428,-876,17,161,H1
"Rock Island County, IL",2002-2003,148286,147384,-902,-0.608,440,-1342,17,161,H1
"Rock Island County, IL",2003-2004,147384,147291,-93,-0.063,541,-634,17,161,H1
"Rock Island County, IL",2004-2005,147291,147067,-224,-0.152,516,-740,17,161,H1
"Rock Island County, IL",2005-2006,147067,147131,64,0.044,606,-542,17,161,H1
"Rock Island County, IL",2006-2007,147131,147918,787,0.535,502,285,17,161,H1
"Rock Island County, IL",2007-2008,147918,147501,-417,-0.282,559,-976,17,161,H1
"Rock Island County, IL",2008-2009,147501,147552,51,0.035,531,-480,17,161,H1
"Rock Island County, IL",2009-2010,147552,147632,80,0.054,350,-270,17,161,H1
"Rock Island County, IL",2010-2011,147632,147256,-376,-0.255,169,-545,17,161,H1
"Rock Island County, IL",2011-2012,147256,147065,-191,-0.13,30,-221,17,161,H1
"Rock Island County, IL",2012-2013,147065,146804,-261,-0.177,275,-536,17,161,H1
"Rock Island County, IL",2013-2014,146804,146063,-741,-0.505,421,-1162,17,161,H1
"Rock Island County, IL",2014-2015,146903,146133,-770,-0.524,342,-1112,17,161,H1
"Rock Island County, IL",2015-2016,146133,145472,-661,-0.452,451,-1112,17,161,H1
"Rock Island County, IL",2016-2017,145472,144808,-664,-0.456,450,-1114,17,161,H1
"St. Clair County, IL",2000-2001,256462,256540,78,0.03,1166,-1088,17,163,H1
"St. Clair County, IL",2001-2002,256540,257952,1412,0.55,1148,264,17,163,H1
"St. Clair County, IL",2002-2003,257952,258448,496,0.192,944,-448,17,163,H1
"St. Clair County, IL",2003-2004,258448,260214,1766,0.683,1124,642,17,163,H1
"St. Clair County, IL",2004-2005,260214,261255,1041,0.4,1154,-113,17,163,H1
"St. Clair County, IL",2005-2006,261255,263445,2190,0.838,1273,917,17,163,H1
"St. Clair County, IL",2006-2007,263445,264764,1319,0.501,1396,-77,17,163,H1
"St. Clair County, IL",2007-2008,264764,266518,1754,0.662,1365,389,17,163,H1
"St. Clair County, IL",2008-2009,266518,268489,1971,0.74,1397,574,17,163,H1
"St. Clair County, IL",2009-2010,268489,270406,1917,0.714,1049,868,17,163,H1
"St. Clair County, IL",2010-2011,270406,270088,-318,-0.118,1116,-1434,17,163,H1
"St. Clair County, IL",2011-2012,270088,268785,-1303,-0.482,1037,-2340,17,163,H1
"St. Clair County, IL",2012-2013,268785,267065,-1720,-0.64,881,-2601,17,163,H1
"St. Clair County, IL",2013-2014,267065,265729,-1336,-0.5,735,-2071,17,163,H1
"St. Clair County, IL",2014-2015,265552,264052,-1500,-0.565,730,-2230,17,163,H1
"St. Clair County, IL",2015-2016,264052,263120,-932,-0.353,774,-1706,17,163,H1
"St. Clair County, IL",2016-2017,263120,262479,-641,-0.244,668,-1309,17,163,H1
"Saline County, IL",2000-2001,26603,26249,-354,-1.331,-177,-177,17,165,H1
"Saline County, IL",2001-2002,26249,26060,-189,-0.72,-80,-109,17,165,H1
"Saline County, IL",2002-2003,26060,25832,-228,-0.875,-63,-165,17,165,H1
"Saline County, IL",2003-2004,25832,25763,-69,-0.267,-95,26,17,165,H1
"Saline County, IL",2004-2005,25763,25526,-237,-0.92,-64,-173,17,165,H1
"Saline County, IL",2005-2006,25526,25482,-44,-0.172,-87,43,17,165,H1
"Saline County, IL",2006-2007,25482,25390,-92,-0.361,-50,-42,17,165,H1
"Saline County, IL",2007-2008,25390,25140,-250,-0.985,-72,-178,17,165,H1
"Saline County, IL",2008-2009,25140,24911,-229,-0.911,-58,-171,17,165,H1
"Saline County, IL",2009-2010,24911,24937,26,0.104,-89,115,17,165,H1
"Saline County, IL",2010-2011,24937,24959,22,0.088,-47,69,17,165,H1
"Saline County, IL",2011-2012,24959,24981,22,0.088,-9,31,17,165,H1
"Saline County, IL",2012-2013,24981,24892,-89,-0.356,-8,-81,17,165,H1
"Saline County, IL",2013-2014,24892,24612,-280,-1.125,-21,-259,17,165,H1
"Saline County, IL",2014-2015,24579,24548,-31,-0.126,-20,-11,17,165,H1
"Saline County, IL",2015-2016,24548,24253,-295,-1.202,-21,-274,17,165,H1
"Saline County, IL",2016-2017,24253,24102,-151,-0.623,3,-154,17,165,H1
"Sangamon County, IL",2000-2001,189152,189924,772,0.408,818,-46,17,167,H1
"Sangamon County, IL",2001-2002,189924,190756,832,0.438,650,182,17,167,H1
"Sangamon County, IL",2002-2003,190756,191339,583,0.306,753,-170,17,167,H1
"Sangamon County, IL",2003-2004,191339,191885,546,0.285,751,-205,17,167,H1
"Sangamon County, IL",2004-2005,191885,192432,547,0.285,712,-165,17,167,H1
"Sangamon County, IL",2005-2006,192432,193317,885,0.46,589,296,17,167,H1
"Sangamon County, IL",2006-2007,193317,194025,708,0.366,775,-67,17,167,H1
"Sangamon County, IL",2007-2008,194025,195094,1069,0.551,824,245,17,167,H1
"Sangamon County, IL",2008-2009,195094,196180,1086,0.557,786,300,17,167,H1
"Sangamon County, IL",2009-2010,196180,197833,1653,0.843,632,1021,17,167,H1
"Sangamon County, IL",2010-2011,197833,198925,1092,0.552,612,480,17,167,H1
"Sangamon County, IL",2011-2012,198925,199247,322,0.162,493,-171,17,167,H1
"Sangamon County, IL",2012-2013,199247,199037,-210,-0.105,380,-590,17,167,H1
"Sangamon County, IL",2013-2014,199037,198997,-40,-0.02,269,-309,17,167,H1
"Sangamon County, IL",2014-2015,199103,198712,-391,-0.196,245,-636,17,167,H1
"Sangamon County, IL",2015-2016,198712,197591,-1121,-0.564,150,-1271,17,167,H1
"Sangamon County, IL",2016-2017,197591,196452,-1139,-0.576,138,-1277,17,167,H1
"Schuyler County, IL",2000-2001,7199,7123,-76,-1.056,-14,-62,17,169,H1
"Schuyler County, IL",2001-2002,7123,7175,52,0.73,-27,79,17,169,H1
"Schuyler County, IL",2002-2003,7175,7236,61,0.85,-34,95,17,169,H1
"Schuyler County, IL",2003-2004,7236,7374,138,1.907,-5,143,17,169,H1
"Schuyler County, IL",2004-2005,7374,7508,134,1.817,-9,143,17,169,H1
"Schuyler County, IL",2005-2006,7508,7513,5,0.067,-3,8,17,169,H1
"Schuyler County, IL",2006-2007,7513,7545,32,0.426,6,26,17,169,H1
"Schuyler County, IL",2007-2008,7545,7543,-2,-0.027,-7,5,17,169,H1
"Schuyler County, IL",2008-2009,7543,7489,-54,-0.716,-16,-38,17,169,H1
"Schuyler County, IL",2009-2010,7489,7545,56,0.748,-32,88,17,169,H1
"Schuyler County, IL",2010-2011,7545,7485,-60,-0.795,-28,-32,17,169,H1
"Schuyler County, IL",2011-2012,7485,7486,1,0.013,-6,7,17,169,H1
"Schuyler County, IL",2012-2013,7486,7425,-61,-0.815,-17,-44,17,169,H1
"Schuyler County, IL",2013-2014,7425,7330,-95,-1.279,-6,-89,17,169,H1
"Schuyler County, IL",2014-2015,7238,7032,-206,-2.846,-24,-182,17,169,H1
"Schuyler County, IL",2015-2016,7032,7053,21,0.299,-19,40,17,169,H1
"Schuyler County, IL",2016-2017,7053,7035,-18,-0.255,-7,-11,17,169,H1
"Scott County, IL",2000-2001,5549,5541,-8,-0.144,7,-15,17,171,H1
"Scott County, IL",2001-2002,5541,5505,-36,-0.65,-6,-30,17,171,H1
"Scott County, IL",2002-2003,5505,5507,2,0.036,-3,5,17,171,H1
"Scott County, IL",2003-2004,5507,5467,-40,-0.726,18,-58,17,171,H1
"Scott County, IL",2004-2005,5467,5457,-10,-0.183,-2,-8,17,171,H1
"Scott County, IL",2005-2006,5457,5392,-65,-1.191,10,-75,17,171,H1
"Scott County, IL",2006-2007,5392,5388,-4,-0.074,11,-15,17,171,H1
"Scott County, IL",2007-2008,5388,5373,-15,-0.278,16,-31,17,171,H1
"Scott County, IL",2008-2009,5373,5373,0,0,2,-2,17,171,H1
"Scott County, IL",2009-2010,5373,5335,-38,-0.707,-6,-32,17,171,H1
"Scott County, IL",2010-2011,5335,5232,-103,-1.931,-14,-89,17,171,H1
"Scott County, IL",2011-2012,5232,5295,63,1.204,0,63,17,171,H1
"Scott County, IL",2012-2013,5295,5234,-61,-1.152,9,-70,17,171,H1
"Scott County, IL",2013-2014,5234,5204,-30,-0.573,8,-38,17,171,H1
"Scott County, IL",2014-2015,5166,5092,-74,-1.432,-12,-62,17,171,H1
"Scott County, IL",2015-2016,5092,5055,-37,-0.727,11,-48,17,171,H1
"Scott County, IL",2016-2017,5055,5002,-53,-1.048,10,-63,17,171,H1
"Shelby County, IL",2000-2001,22850,22702,-148,-0.648,-7,-141,17,173,H1
"Shelby County, IL",2001-2002,22702,22656,-46,-0.203,-67,21,17,173,H1
"Shelby County, IL",2002-2003,22656,22625,-31,-0.137,5,-36,17,173,H1
"Shelby County, IL",2003-2004,22625,22484,-141,-0.623,11,-152,17,173,H1
"Shelby County, IL",2004-2005,22484,22445,-39,-0.173,-2,-37,17,173,H1
"Shelby County, IL",2005-2006,22445,22379,-66,-0.294,28,-94,17,173,H1
"Shelby County, IL",2006-2007,22379,22314,-65,-0.29,10,-75,17,173,H1
"Shelby County, IL",2007-2008,22314,22398,84,0.376,27,57,17,173,H1
"Shelby County, IL",2008-2009,22398,22386,-12,-0.054,34,-46,17,173,H1
"Shelby County, IL",2009-2010,22386,22344,-42,-0.188,4,-46,17,173,H1
"Shelby County, IL",2010-2011,22344,22290,-54,-0.242,1,-55,17,173,H1
"Shelby County, IL",2011-2012,22290,22233,-57,-0.256,10,-67,17,173,H1
"Shelby County, IL",2012-2013,22233,22164,-69,-0.31,-9,-60,17,173,H1
"Shelby County, IL",2013-2014,22164,22048,-116,-0.523,-10,-106,17,173,H1
"Shelby County, IL",2014-2015,22069,21775,-294,-1.332,-8,-286,17,173,H1
"Shelby County, IL",2015-2016,21775,21727,-48,-0.22,-9,-39,17,173,H1
"Shelby County, IL",2016-2017,21727,21719,-8,-0.037,-13,5,17,173,H1
"Stark County, IL",2000-2001,6317,6308,-9,-0.142,-13,4,17,175,H1
"Stark County, IL",2001-2002,6308,6268,-40,-0.634,-28,-12,17,175,H1
"Stark County, IL",2002-2003,6268,6196,-72,-1.149,-26,-46,17,175,H1
"Stark County, IL",2003-2004,6196,6172,-24,-0.387,-4,-20,17,175,H1
"Stark County, IL",2004-2005,6172,6136,-36,-0.583,-11,-25,17,175,H1
"Stark County, IL",2005-2006,6136,6156,20,0.326,-26,46,17,175,H1
"Stark County, IL",2006-2007,6156,6143,-13,-0.211,-29,16,17,175,H1
"Stark County, IL",2007-2008,6143,6109,-34,-0.553,-2,-32,17,175,H1
"Stark County, IL",2008-2009,6109,6043,-66,-1.08,-4,-62,17,175,H1
"Stark County, IL",2009-2010,6043,5967,-76,-1.258,-21,-55,17,175,H1
"Stark County, IL",2010-2011,5967,5839,-128,-2.145,-16,-112,17,175,H1
"Stark County, IL",2011-2012,5839,5937,98,1.678,-22,120,17,175,H1
"Stark County, IL",2012-2013,5937,5883,-54,-0.91,-43,-11,17,175,H1
"Stark County, IL",2013-2014,5883,5813,-70,-1.19,-29,-41,17,175,H1
"Stark County, IL",2014-2015,5835,5788,-47,-0.805,-17,-30,17,175,H1
"Stark County, IL",2015-2016,5788,5506,-282,-4.872,-31,-251,17,175,H1
"Stark County, IL",2016-2017,5506,5434,-72,-1.308,-19,-53,17,175,H1
"Stephenson County, IL",2000-2001,48920,48625,-295,-0.603,67,-362,17,177,H1
"Stephenson County, IL",2001-2002,48625,48367,-258,-0.531,58,-316,17,177,H1
"Stephenson County, IL",2002-2003,48367,48503,136,0.281,60,76,17,177,H1
"Stephenson County, IL",2003-2004,48503,48479,-24,-0.049,64,-88,17,177,H1
"Stephenson County, IL",2004-2005,48479,48105,-374,-0.771,-104,-270,17,177,H1
"Stephenson County, IL",2005-2006,48105,47917,-188,-0.391,83,-271,17,177,H1
"Stephenson County, IL",2006-2007,47917,47794,-123,-0.257,94,-217,17,177,H1
"Stephenson County, IL",2007-2008,47794,47805,11,0.023,57,-46,17,177,H1
"Stephenson County, IL",2008-2009,47805,47792,-13,-0.027,32,-45,17,177,H1
"Stephenson County, IL",2009-2010,47792,47680,-112,-0.234,-12,-100,17,177,H1
"Stephenson County, IL",2010-2011,47680,47396,-284,-0.596,-33,-251,17,177,H1
"Stephenson County, IL",2011-2012,47396,46973,-423,-0.892,-2,-421,17,177,H1
"Stephenson County, IL",2012-2013,46973,46782,-191,-0.407,-28,-163,17,177,H1
"Stephenson County, IL",2013-2014,46782,46435,-347,-0.742,-34,-313,17,177,H1
"Stephenson County, IL",2014-2015,46352,45749,-603,-1.301,-52,-551,17,177,H1
"Stephenson County, IL",2015-2016,45749,45540,-209,-0.457,-18,-191,17,177,H1
"Stephenson County, IL",2016-2017,45540,45054,-486,-1.067,-56,-430,17,177,H1
"Tazewell County, IL",2000-2001,128520,128468,-52,-0.04,409,-461,17,179,H1
"Tazewell County, IL",2001-2002,128468,128722,254,0.198,273,-19,17,179,H1
"Tazewell County, IL",2002-2003,128722,128770,48,0.037,274,-226,17,179,H1
"Tazewell County, IL",2003-2004,128770,129656,886,0.688,372,514,17,179,H1
"Tazewell County, IL",2004-2005,129656,130784,1128,0.87,272,856,17,179,H1
"Tazewell County, IL",2005-2006,130784,131804,1020,0.78,386,634,17,179,H1
"Tazewell County, IL",2006-2007,131804,133131,1327,1.007,455,872,17,179,H1
"Tazewell County, IL",2007-2008,133131,133893,762,0.572,394,368,17,179,H1
"Tazewell County, IL",2008-2009,133893,135054,1161,0.867,411,750,17,179,H1
"Tazewell County, IL",2009-2010,135054,135447,393,0.291,229,164,17,179,H1
"Tazewell County, IL",2010-2011,135447,135742,295,0.218,271,24,17,179,H1
"Tazewell County, IL",2011-2012,135742,136094,352,0.259,237,115,17,179,H1
"Tazewell County, IL",2012-2013,136094,136372,278,0.204,301,-23,17,179,H1
"Tazewell County, IL",2013-2014,136372,135707,-665,-0.488,241,-906,17,179,H1
"Tazewell County, IL",2014-2015,135532,134800,-732,-0.54,180,-912,17,179,H1
"Tazewell County, IL",2015-2016,134800,133967,-833,-0.618,57,-890,17,179,H1
"Tazewell County, IL",2016-2017,133967,133526,-441,-0.329,71,-512,17,179,H1
"Union County, IL",2000-2001,18267,18116,-151,-0.827,-61,-90,17,181,H1
"Union County, IL",2001-2002,18116,18092,-24,-0.132,-61,37,17,181,H1
"Union County, IL",2002-2003,18092,18116,24,0.133,-33,57,17,181,H1
"Union County, IL",2003-2004,18116,18048,-68,-0.375,-23,-45,17,181,H1
"Union County, IL",2004-2005,18048,18071,23,0.127,4,19,17,181,H1
"Union County, IL",2005-2006,18071,18082,11,0.061,25,-14,17,181,H1
"Union County, IL",2006-2007,18082,18066,-16,-0.088,3,-19,17,181,H1
"Union County, IL",2007-2008,18066,17965,-101,-0.559,-7,-94,17,181,H1
"Union County, IL",2008-2009,17965,17909,-56,-0.312,12,-68,17,181,H1
"Union County, IL",2009-2010,17909,17760,-149,-0.832,-17,-132,17,181,H1
"Union County, IL",2010-2011,17760,17702,-58,-0.327,-10,-48,17,181,H1
"Union County, IL",2011-2012,17702,17632,-70,-0.395,-49,-21,17,181,H1
"Union County, IL",2012-2013,17632,17559,-73,-0.414,-34,-39,17,181,H1
"Union County, IL",2013-2014,17559,17447,-112,-0.638,-33,-79,17,181,H1
"Union County, IL",2014-2015,17471,17408,-63,-0.361,-25,-38,17,181,H1
"Union County, IL",2015-2016,17408,17115,-293,-1.683,-11,-282,17,181,H1
"Union County, IL",2016-2017,17115,1.70E+04,-115,-0.672,-34,-81,17,181,H1
"Vermilion County, IL",2000-2001,83821,83646,-175,-0.209,244,-419,17,183,H1
"Vermilion County, IL",2001-2002,83646,83299,-347,-0.415,134,-481,17,183,H1
"Vermilion County, IL",2002-2003,83299,82996,-303,-0.364,115,-418,17,183,H1
"Vermilion County, IL",2003-2004,82996,82955,-41,-0.049,107,-148,17,183,H1
"Vermilion County, IL",2004-2005,82955,82728,-227,-0.274,113,-340,17,183,H1
"Vermilion County, IL",2005-2006,82728,82715,-13,-0.016,193,-206,17,183,H1
"Vermilion County, IL",2006-2007,82715,82258,-457,-0.552,197,-654,17,183,H1
"Vermilion County, IL",2007-2008,82258,81930,-328,-0.399,206,-534,17,183,H1
"Vermilion County, IL",2008-2009,81930,81710,-220,-0.269,117,-337,17,183,H1
"Vermilion County, IL",2009-2010,81710,81595,-115,-0.141,12,-127,17,183,H1
"Vermilion County, IL",2010-2011,81595,81358,-237,-0.29,61,-298,17,183,H1
"Vermilion County, IL",2011-2012,81358,80764,-594,-0.73,147,-741,17,183,H1
"Vermilion County, IL",2012-2013,80764,80418,-346,-0.428,152,-498,17,183,H1
"Vermilion County, IL",2013-2014,80418,79728,-690,-0.858,161,-851,17,183,H1
"Vermilion County, IL",2014-2015,79837,79282,-555,-0.695,152,-707,17,183,H1
"Vermilion County, IL",2015-2016,79282,78560,-722,-0.911,113,-835,17,183,H1
"Vermilion County, IL",2016-2017,78560,77909,-651,-0.829,122,-773,17,183,H1
"Wabash County, IL",2000-2001,12895,12755,-140,-1.086,6,-146,17,185,H1
"Wabash County, IL",2001-2002,12755,12640,-115,-0.902,-5,-110,17,185,H1
"Wabash County, IL",2002-2003,12640,12561,-79,-0.625,22,-101,17,185,H1
"Wabash County, IL",2003-2004,12561,12486,-75,-0.597,25,-100,17,185,H1
"Wabash County, IL",2004-2005,12486,12451,-35,-0.28,32,-67,17,185,H1
"Wabash County, IL",2005-2006,12451,12354,-97,-0.779,6,-103,17,185,H1
"Wabash County, IL",2006-2007,12354,12237,-117,-0.947,-5,-112,17,185,H1
"Wabash County, IL",2007-2008,12237,12158,-79,-0.646,12,-91,17,185,H1
"Wabash County, IL",2008-2009,12158,12040,-118,-0.971,7,-125,17,185,H1
"Wabash County, IL",2009-2010,12040,11933,-107,-0.889,-11,-96,17,185,H1
"Wabash County, IL",2010-2011,11933,11829,-104,-0.872,-23,-81,17,185,H1
"Wabash County, IL",2011-2012,11829,11716,-113,-0.955,6,-119,17,185,H1
"Wabash County, IL",2012-2013,11716,11624,-92,-0.785,38,-130,17,185,H1
"Wabash County, IL",2013-2014,11624,11549,-75,-0.645,37,-112,17,185,H1
"Wabash County, IL",2014-2015,11549,11542,-7,-0.061,10,-17,17,185,H1
"Wabash County, IL",2015-2016,11542,11511,-31,-0.269,14,-45,17,185,H1
"Wabash County, IL",2016-2017,11511,11489,-22,-0.191,8,-30,17,185,H1
"Warren County, IL",2000-2001,18680,18471,-209,-1.119,-13,-196,17,187,H1
"Warren County, IL",2001-2002,18471,18388,-83,-0.449,6,-89,17,187,H1
"Warren County, IL",2002-2003,18388,18227,-161,-0.876,-1,-160,17,187,H1
"Warren County, IL",2003-2004,18227,17894,-333,-1.827,-10,-323,17,187,H1
"Warren County, IL",2004-2005,17894,17874,-20,-0.112,1,-21,17,187,H1
"Warren County, IL",2005-2006,17874,17839,-35,-0.196,17,-52,17,187,H1
"Warren County, IL",2006-2007,17839,17828,-11,-0.062,-37,26,17,187,H1
"Warren County, IL",2007-2008,17828,17665,-163,-0.914,-4,-159,17,187,H1
"Warren County, IL",2008-2009,17665,17689,24,0.136,21,3,17,187,H1
"Warren County, IL",2009-2010,17689,17716,27,0.153,1,26,17,187,H1
"Warren County, IL",2010-2011,17716,17843,127,0.717,10,117,17,187,H1
"Warren County, IL",2011-2012,17843,17785,-58,-0.325,23,-81,17,187,H1
"Warren County, IL",2012-2013,17785,17704,-81,-0.455,20,-101,17,187,H1
"Warren County, IL",2013-2014,17704,17874,170,0.96,34,136,17,187,H1
"Warren County, IL",2014-2015,17801,17527,-274,-1.539,53,-327,17,187,H1
"Warren County, IL",2015-2016,17527,17307,-220,-1.255,56,-276,17,187,H1
"Warren County, IL",2016-2017,17307,17167,-140,-0.809,55,-195,17,187,H1
"Washington County, IL",2000-2001,15162,15258,96,0.633,6,90,17,189,H1
"Washington County, IL",2001-2002,15258,15129,-129,-0.845,16,-145,17,189,H1
"Washington County, IL",2002-2003,15129,15189,60,0.397,-23,83,17,189,H1
"Washington County, IL",2003-2004,15189,15106,-83,-0.546,7,-90,17,189,H1
"Washington County, IL",2004-2005,15106,14950,-156,-1.033,28,-184,17,189,H1
"Washington County, IL",2005-2006,14950,15008,58,0.388,-5,63,17,189,H1
"Washington County, IL",2006-2007,15008,14890,-118,-0.786,-9,-109,17,189,H1
"Washington County, IL",2007-2008,14890,14855,-35,-0.235,-12,-23,17,189,H1
"Washington County, IL",2008-2009,14855,14755,-100,-0.673,29,-129,17,189,H1
"Washington County, IL",2009-2010,14755,14699,-56,-0.38,18,-74,17,189,H1
"Washington County, IL",2010-2011,14699,14586,-113,-0.769,-6,-107,17,189,H1
"Washington County, IL",2011-2012,14586,14611,25,0.171,-8,33,17,189,H1
"Washington County, IL",2012-2013,14611,14404,-207,-1.417,-10,-197,17,189,H1
"Washington County, IL",2013-2014,14404,14337,-67,-0.465,-5,-62,17,189,H1
"Washington County, IL",2014-2015,14394,14270,-124,-0.861,33,-157,17,189,H1
"Washington County, IL",2015-2016,14270,14210,-60,-0.42,38,-98,17,189,H1
"Washington County, IL",2016-2017,14210,14030,-180,-1.267,45,-225,17,189,H1
"Wayne County, IL",2000-2001,17112,17068,-44,-0.257,-5,-39,17,191,H1
"Wayne County, IL",2001-2002,17068,17007,-61,-0.357,27,-88,17,191,H1
"Wayne County, IL",2002-2003,17007,16947,-60,-0.353,-12,-48,17,191,H1
"Wayne County, IL",2003-2004,16947,16881,-66,-0.389,-34,-32,17,191,H1
"Wayne County, IL",2004-2005,16881,16910,29,0.172,-39,68,17,191,H1
"Wayne County, IL",2005-2006,16910,16829,-81,-0.479,-29,-52,17,191,H1
"Wayne County, IL",2006-2007,16829,16951,122,0.725,14,108,17,191,H1
"Wayne County, IL",2007-2008,16951,16930,-21,-0.124,-5,-16,17,191,H1
"Wayne County, IL",2008-2009,16930,16788,-142,-0.839,-12,-130,17,191,H1
"Wayne County, IL",2009-2010,16788,16736,-52,-0.31,-38,-14,17,191,H1
"Wayne County, IL",2010-2011,16736,16620,-116,-0.693,-3,-113,17,191,H1
"Wayne County, IL",2011-2012,16620,16621,1,0.006,6,-5,17,191,H1
"Wayne County, IL",2012-2013,16621,16616,-5,-0.03,-8,3,17,191,H1
"Wayne County, IL",2013-2014,16616,16543,-73,-0.439,-11,-62,17,191,H1
"Wayne County, IL",2014-2015,16515,16423,-92,-0.557,-2,-90,17,191,H1
"Wayne County, IL",2015-2016,16423,16573,150,0.913,56,94,17,191,H1
"Wayne County, IL",2016-2017,16573,16495,-78,-0.471,29,-107,17,191,H1
"White County, IL",2000-2001,15333,15286,-47,-0.307,-70,23,17,193,H1
"White County, IL",2001-2002,15286,15138,-148,-0.968,-61,-87,17,193,H1
"White County, IL",2002-2003,15138,15011,-127,-0.839,-59,-68,17,193,H1
"White County, IL",2003-2004,15011,15089,78,0.52,-29,107,17,193,H1
"White County, IL",2004-2005,15089,15074,-15,-0.099,-125,110,17,193,H1
"White County, IL",2005-2006,15074,14942,-132,-0.876,-50,-82,17,193,H1
"White County, IL",2006-2007,14942,14796,-146,-0.977,-49,-97,17,193,H1
"White County, IL",2007-2008,14796,14868,72,0.487,-41,113,17,193,H1
"White County, IL",2008-2009,14868,14767,-101,-0.679,-35,-66,17,193,H1
"White County, IL",2009-2010,14767,14642,-125,-0.846,-82,-43,17,193,H1
"White County, IL",2010-2011,14642,14622,-20,-0.137,-44,24,17,193,H1
"White County, IL",2011-2012,14622,14582,-40,-0.274,-43,3,17,193,H1
"White County, IL",2012-2013,14582,14526,-56,-0.384,-45,-11,17,193,H1
"White County, IL",2013-2014,14526,14374,-152,-1.046,-53,-99,17,193,H1
"White County, IL",2014-2015,14346,14327,-19,-0.132,-55,36,17,193,H1
"White County, IL",2015-2016,14327,14088,-239,-1.668,-56,-183,17,193,H1
"White County, IL",2016-2017,14088,13938,-150,-1.065,-56,-94,17,193,H1
"Whiteside County, IL",2000-2001,60615,60511,-104,-0.172,146,-250,17,195,H1
"Whiteside County, IL",2001-2002,60511,60022,-489,-0.808,135,-624,17,195,H1
"Whiteside County, IL",2002-2003,60022,59489,-533,-0.888,136,-669,17,195,H1
"Whiteside County, IL",2003-2004,59489,59352,-137,-0.23,82,-219,17,195,H1
"Whiteside County, IL",2004-2005,59352,59094,-258,-0.435,35,-293,17,195,H1
"Whiteside County, IL",2005-2006,59094,59033,-61,-0.103,74,-135,17,195,H1
"Whiteside County, IL",2006-2007,59033,58819,-214,-0.363,50,-264,17,195,H1
"Whiteside County, IL",2007-2008,58819,58784,-35,-0.06,122,-157,17,195,H1
"Whiteside County, IL",2008-2009,58784,58667,-117,-0.199,109,-226,17,195,H1
"Whiteside County, IL",2009-2010,58667,58472,-195,-0.332,24,-219,17,195,H1
"Whiteside County, IL",2010-2011,58472,58151,-321,-0.549,-36,-285,17,195,H1
"Whiteside County, IL",2011-2012,58151,57627,-524,-0.901,-136,-388,17,195,H1
"Whiteside County, IL",2012-2013,57627,57274,-353,-0.613,-48,-305,17,195,H1
"Whiteside County, IL",2013-2014,57274,56876,-398,-0.695,0,-398,17,195,H1
"Whiteside County, IL",2014-2015,57084,57079,-5,-0.009,52,-57,17,195,H1
"Whiteside County, IL",2015-2016,57079,56541,-538,-0.943,-1,-537,17,195,H1
"Whiteside County, IL",2016-2017,56541,56118,-423,-0.748,25,-448,17,195,H1
"Will County, IL",2000-2001,507629,530086,22457,4.424,5333,17124,17,197,H1
"Will County, IL",2001-2002,530086,553714,23628,4.457,5703,17925,17,197,H1
"Will County, IL",2002-2003,553714,579547,25833,4.665,5878,19955,17,197,H1
"Will County, IL",2003-2004,579547,605934,26387,4.553,6473,19914,17,197,H1
"Will County, IL",2004-2005,605934,627610,21676,3.577,6276,15400,17,197,H1
"Will County, IL",2005-2006,627610,650779,23169,3.692,6438,16731,17,197,H1
"Will County, IL",2006-2007,650779,664048,13269,2.039,6628,6641,17,197,H1
"Will County, IL",2007-2008,664048,671392,7344,1.106,6732,612,17,197,H1
"Will County, IL",2008-2009,671392,674970,3578,0.533,7074,-3496,17,197,H1
"Will County, IL",2009-2010,674970,678828,3858,0.572,5320,-1462,17,197,H1
"Will County, IL",2010-2011,678828,680400,1572,0.232,4307,-2735,17,197,H1
"Will County, IL",2011-2012,680400,682187,1787,0.263,4223,-2436,17,197,H1
"Will County, IL",2012-2013,682187,683708,1521,0.223,3811,-2290,17,197,H1
"Will County, IL",2013-2014,683708,685419,1711,0.25,3694,-1983,17,197,H1
"Will County, IL",2014-2015,685621,687263,1642,0.239,3408,-1766,17,197,H1
"Will County, IL",2015-2016,687263,689731,2468,0.359,3325,-857,17,197,H1
"Will County, IL",2016-2017,689731,692661,2930,0.425,3226,-296,17,197,H1
"Williamson County, IL",2000-2001,61279,61737,458,0.747,-2,460,17,199,H1
"Williamson County, IL",2001-2002,61737,62137,400,0.648,-3,403,17,199,H1
"Williamson County, IL",2002-2003,62137,62510,373,0.6,45,328,17,199,H1
"Williamson County, IL",2003-2004,62510,63379,869,1.39,10,859,17,199,H1
"Williamson County, IL",2004-2005,63379,63875,496,0.783,-53,549,17,199,H1
"Williamson County, IL",2005-2006,63875,64424,549,0.859,20,529,17,199,H1
"Williamson County, IL",2006-2007,64424,65201,777,1.206,48,729,17,199,H1
"Williamson County, IL",2007-2008,65201,65674,473,0.725,106,367,17,199,H1
"Williamson County, IL",2008-2009,65674,66229,555,0.845,89,466,17,199,H1
"Williamson County, IL",2009-2010,66229,66433,204,0.308,-6,210,17,199,H1
"Williamson County, IL",2010-2011,66433,66741,308,0.464,45,263,17,199,H1
"Williamson County, IL",2011-2012,66741,66770,29,0.043,5,24,17,199,H1
"Williamson County, IL",2012-2013,66770,67088,318,0.476,68,250,17,199,H1
"Williamson County, IL",2013-2014,67088,67008,-80,-0.119,54,-134,17,199,H1
"Williamson County, IL",2014-2015,67263,67466,203,0.302,15,188,17,199,H1
"Williamson County, IL",2015-2016,67466,67640,174,0.258,85,89,17,199,H1
"Williamson County, IL",2016-2017,67640,67328,-312,-0.461,42,-354,17,199,H1
"Winnebago County, IL",2000-2001,278981,280009,1028,0.368,1393,-365,17,201,H1
"Winnebago County, IL",2001-2002,280009,281162,1153,0.412,1490,-337,17,201,H1
"Winnebago County, IL",2002-2003,281162,283230,2068,0.736,1447,621,17,201,H1
"Winnebago County, IL",2003-2004,283230,284337,1107,0.391,1490,-383,17,201,H1
"Winnebago County, IL",2004-2005,284337,286178,1841,0.647,1378,463,17,201,H1
"Winnebago County, IL",2005-2006,286178,289405,3227,1.128,1533,1694,17,201,H1
"Winnebago County, IL",2006-2007,289405,293991,4586,1.585,1806,2780,17,201,H1
"Winnebago County, IL",2007-2008,293991,295726,1735,0.59,1686,49,17,201,H1
"Winnebago County, IL",2008-2009,295726,295612,-114,-0.039,1646,-1760,17,201,H1
"Winnebago County, IL",2009-2010,295612,295151,-461,-0.156,1216,-1677,17,201,H1
"Winnebago County, IL",2010-2011,295151,293667,-1484,-0.503,1019,-2503,17,201,H1
"Winnebago County, IL",2011-2012,293667,291923,-1744,-0.594,929,-2673,17,201,H1
"Winnebago County, IL",2012-2013,291923,290845,-1078,-0.369,894,-1972,17,201,H1
"Winnebago County, IL",2013-2014,290845,288542,-2303,-0.792,850,-3153,17,201,H1
"Winnebago County, IL",2014-2015,288574,287078,-1496,-0.518,832,-2328,17,201,H1
"Winnebago County, IL",2015-2016,287078,286088,-990,-0.345,783,-1773,17,201,H1
"Winnebago County, IL",2016-2017,286088,284778,-1310,-0.458,807,-2117,17,201,H1
"Woodford County, IL",2000-2001,35499,35559,60,0.169,102,-42,17,203,H1
"Woodford County, IL",2001-2002,35559,35698,139,0.391,66,73,17,203,H1
"Woodford County, IL",2002-2003,35698,36041,343,0.961,91,252,17,203,H1
"Woodford County, IL",2003-2004,36041,36514,473,1.312,48,425,17,203,H1
"Woodford County, IL",2004-2005,36514,37032,518,1.419,82,436,17,203,H1
"Woodford County, IL",2005-2006,37032,37385,353,0.953,86,267,17,203,H1
"Woodford County, IL",2006-2007,37385,37961,576,1.541,121,455,17,203,H1
"Woodford County, IL",2007-2008,37961,38452,491,1.293,164,327,17,203,H1
"Woodford County, IL",2008-2009,38452,38675,223,0.58,200,23,17,203,H1
"Woodford County, IL",2009-2010,38675,38640,-35,-0.09,84,-119,17,203,H1
"Woodford County, IL",2010-2011,38640,38913,273,0.707,126,147,17,203,H1
"Woodford County, IL",2011-2012,38913,38925,12,0.031,60,-48,17,203,H1
"Woodford County, IL",2012-2013,38925,39155,230,0.591,50,180,17,203,H1
"Woodford County, IL",2013-2014,39155,39187,32,0.082,50,-18,17,203,H1
"Woodford County, IL",2014-2015,39234,39227,-7,-0.018,79,-86,17,203,H1
"Woodford County, IL",2015-2016,39227,38933,-294,-0.749,45,-339,17,203,H1
"Woodford County, IL",2016-2017,38933,38726,-207,-0.532,26,-233,17,203,H1
Indiana,2000-2001,6091866,6127760,35894,0.589,32287,3607,18,0,STATE
Indiana,2001-2002,6127760,6155967,28207,0.46,29530,-1323,18,0,STATE
Indiana,2002-2003,6155967,6196638,40671,0.661,30421,10250,18,0,STATE
Indiana,2003-2004,6196638,6233007,36369,0.587,31760,4609,18,0,STATE
Indiana,2004-2005,6233007,6278616,45609,0.732,31094,14515,18,0,STATE
Indiana,2005-2006,6278616,6332669,54053,0.861,33331,20722,18,0,STATE
Indiana,2006-2007,6332669,6379599,46930,0.741,34185,12745,18,0,STATE
Indiana,2007-2008,6379599,6424806,45207,0.709,34429,10778,18,0,STATE
Indiana,2008-2009,6424806,6459325,34519,0.537,32591,1928,18,0,STATE
Indiana,2009-2010,6459325,6490590,31265,0.484,29712,1553,18,0,STATE
Indiana,2010-2011,6490590,6516845,26255,0.405,25565,690,18,0,STATE
Indiana,2011-2012,6516845,6538283,21438,0.329,24435,-2997,18,0,STATE
Indiana,2012-2013,6538283,6570518,32235,0.493,22675,9560,18,0,STATE
Indiana,2013-2014,6570518,6597880,27362,0.416,24062,3300,18,0,STATE
Indiana,2014-2015,6597880,6619680,21800,0.33,25260,-3460,18,0,STATE
Indiana,2015-2016,6619680,6634007,14327,0.216,22480,-8153,18,0,STATE
Indiana,2016-2017,6634007,6666818,32811,0.495,22545,10266,18,0,STATE
"Adams County, IN",2000-2001,33597,33556,-41,-0.122,253,-294,18,1,H1
"Adams County, IN",2001-2002,33556,33523,-33,-0.098,304,-337,18,1,H1
"Adams County, IN",2002-2003,33523,33746,223,0.665,343,-120,18,1,H1
"Adams County, IN",2003-2004,33746,33822,76,0.225,292,-216,18,1,H1
"Adams County, IN",2004-2005,33822,33867,45,0.133,326,-281,18,1,H1
"Adams County, IN",2005-2006,33867,33887,20,0.059,356,-336,18,1,H1
"Adams County, IN",2006-2007,33887,33962,75,0.221,382,-307,18,1,H1
"Adams County, IN",2007-2008,33962,34214,252,0.742,372,-120,18,1,H1
"Adams County, IN",2008-2009,34214,34351,137,0.4,338,-201,18,1,H1
"Adams County, IN",2009-2010,34351,34435,84,0.245,295,-211,18,1,H1
"Adams County, IN",2010-2011,34435,34351,-84,-0.244,320,-404,18,1,H1
"Adams County, IN",2011-2012,34351,34401,50,0.146,362,-312,18,1,H1
"Adams County, IN",2012-2013,34401,34685,284,0.826,423,-139,18,1,H1
"Adams County, IN",2013-2014,34685,34791,106,0.306,443,-337,18,1,H1
"Adams County, IN",2014-2015,34756,34980,224,0.644,412,-188,18,1,H1
"Adams County, IN",2015-2016,34980,35232,252,0.72,401,-149,18,1,H1
"Adams County, IN",2016-2017,35232,35491,259,0.735,418,-159,18,1,H1
"Allen County, IN",2000-2001,332786,334956,2170,0.652,2755,-585,18,3,H1
"Allen County, IN",2001-2002,334956,337124,2168,0.647,2640,-472,18,3,H1
"Allen County, IN",2002-2003,337124,339569,2445,0.725,2597,-152,18,3,H1
"Allen County, IN",2003-2004,339569,340916,1347,0.397,2655,-1308,18,3,H1
"Allen County, IN",2004-2005,340916,343238,2322,0.681,2762,-440,18,3,H1
"Allen County, IN",2005-2006,343238,346314,3076,0.896,2767,309,18,3,H1
"Allen County, IN",2006-2007,346314,349534,3220,0.93,2801,419,18,3,H1
"Allen County, IN",2007-2008,349534,351264,1730,0.495,2800,-1070,18,3,H1
"Allen County, IN",2008-2009,351264,353693,2429,0.692,2620,-191,18,3,H1
"Allen County, IN",2009-2010,353693,355857,2164,0.612,2663,-499,18,3,H1
"Allen County, IN",2010-2011,355857,358745,2888,0.812,2418,470,18,3,H1
"Allen County, IN",2011-2012,358745,360832,2087,0.582,2275,-188,18,3,H1
"Allen County, IN",2012-2013,360832,363596,2764,0.766,2393,371,18,3,H1
"Allen County, IN",2013-2014,363596,365918,2322,0.639,2322,0,18,3,H1
"Allen County, IN",2014-2015,365701,368450,2749,0.752,2146,603,18,3,H1
"Allen County, IN",2015-2016,368450,369972,1522,0.413,2172,-650,18,3,H1
"Allen County, IN",2016-2017,369972,372877,2905,0.785,2167,738,18,3,H1
"Bartholomew County, IN",2000-2001,71763,72110,347,0.484,394,-47,18,5,H1
"Bartholomew County, IN",2001-2002,72110,71890,-220,-0.305,355,-575,18,5,H1
"Bartholomew County, IN",2002-2003,71890,72299,409,0.569,389,20,18,5,H1
"Bartholomew County, IN",2003-2004,72299,72882,583,0.806,352,231,18,5,H1
"Bartholomew County, IN",2004-2005,72882,73660,778,1.067,346,432,18,5,H1
"Bartholomew County, IN",2005-2006,73660,74508,848,1.151,438,410,18,5,H1
"Bartholomew County, IN",2006-2007,74508,75265,757,1.016,419,338,18,5,H1
"Bartholomew County, IN",2007-2008,75265,76080,815,1.083,435,380,18,5,H1
"Bartholomew County, IN",2008-2009,76080,76566,486,0.639,401,85,18,5,H1
"Bartholomew County, IN",2009-2010,76566,76848,282,0.368,318,-36,18,5,H1
"Bartholomew County, IN",2010-2011,76848,77621,773,1.006,269,504,18,5,H1
"Bartholomew County, IN",2011-2012,77621,78903,1282,1.652,364,918,18,5,H1
"Bartholomew County, IN",2012-2013,78903,79549,646,0.819,414,232,18,5,H1
"Bartholomew County, IN",2013-2014,79549,80217,668,0.84,415,253,18,5,H1
"Bartholomew County, IN",2014-2015,80220,81162,942,1.174,428,514,18,5,H1
"Bartholomew County, IN",2015-2016,81162,81873,711,0.876,354,357,18,5,H1
"Bartholomew County, IN",2016-2017,81873,82040,167,0.204,409,-242,18,5,H1
"Benton County, IN",2000-2001,9412,9313,-99,-1.052,34,-133,18,7,H1
"Benton County, IN",2001-2002,9313,9163,-150,-1.611,-3,-147,18,7,H1
"Benton County, IN",2002-2003,9163,9148,-15,-0.164,34,-49,18,7,H1
"Benton County, IN",2003-2004,9148,9016,-132,-1.443,38,-170,18,7,H1
"Benton County, IN",2004-2005,9016,8915,-101,-1.12,37,-138,18,7,H1
"Benton County, IN",2005-2006,8915,8871,-44,-0.494,24,-68,18,7,H1
"Benton County, IN",2006-2007,8871,8805,-66,-0.744,12,-78,18,7,H1
"Benton County, IN",2007-2008,8805,8801,-4,-0.045,40,-44,18,7,H1
"Benton County, IN",2008-2009,8801,8735,-66,-0.75,36,-102,18,7,H1
"Benton County, IN",2009-2010,8735,8883,148,1.694,47,101,18,7,H1
"Benton County, IN",2010-2011,8883,8883,0,0,15,-15,18,7,H1
"Benton County, IN",2011-2012,8883,8834,-49,-0.552,19,-68,18,7,H1
"Benton County, IN",2012-2013,8834,8748,-86,-0.974,15,-101,18,7,H1
"Benton County, IN",2013-2014,8748,8700,-48,-0.549,14,-62,18,7,H1
"Benton County, IN",2014-2015,8697,8681,-16,-0.184,28,-44,18,7,H1
"Benton County, IN",2015-2016,8681,8655,-26,-0.3,23,-49,18,7,H1
"Benton County, IN",2016-2017,8655,8613,-42,-0.485,26,-68,18,7,H1
"Blackford County, IN",2000-2001,13988,13735,-253,-1.809,15,-268,18,9,H1
"Blackford County, IN",2001-2002,13735,13696,-39,-0.284,29,-68,18,9,H1
"Blackford County, IN",2002-2003,13696,13642,-54,-0.394,18,-72,18,9,H1
"Blackford County, IN",2003-2004,13642,13496,-146,-1.07,4,-150,18,9,H1
"Blackford County, IN",2004-2005,13496,13392,-104,-0.771,-26,-78,18,9,H1
"Blackford County, IN",2005-2006,13392,13161,-231,-1.725,11,-242,18,9,H1
"Blackford County, IN",2006-2007,13161,13078,-83,-0.631,23,-106,18,9,H1
"Blackford County, IN",2007-2008,13078,12971,-107,-0.818,5,-112,18,9,H1
"Blackford County, IN",2008-2009,12971,12844,-127,-0.979,-28,-99,18,9,H1
"Blackford County, IN",2009-2010,12844,12763,-81,-0.631,-10,-71,18,9,H1
"Blackford County, IN",2010-2011,12763,12680,-83,-0.65,0,-83,18,9,H1
"Blackford County, IN",2011-2012,12680,12548,-132,-1.041,7,-139,18,9,H1
"Blackford County, IN",2012-2013,12548,12490,-58,-0.462,-15,-43,18,9,H1
"Blackford County, IN",2013-2014,12490,12401,-89,-0.713,-27,-62,18,9,H1
"Blackford County, IN",2014-2015,12401,12298,-103,-0.831,-15,-88,18,9,H1
"Blackford County, IN",2015-2016,12298,12075,-223,-1.813,-48,-175,18,9,H1
"Blackford County, IN",2016-2017,12075,11976,-99,-0.82,-47,-52,18,9,H1
"Boone County, IN",2000-2001,46390,47035,645,1.39,236,409,18,11,H1
"Boone County, IN",2001-2002,47035,48071,1036,2.203,202,834,18,11,H1
"Boone County, IN",2002-2003,48071,49047,976,2.03,230,746,18,11,H1
"Boone County, IN",2003-2004,49047,50158,1111,2.265,258,853,18,11,H1
"Boone County, IN",2004-2005,50158,51261,1103,2.199,340,763,18,11,H1
"Boone County, IN",2005-2006,51261,52750,1489,2.905,258,1231,18,11,H1
"Boone County, IN",2006-2007,52750,53778,1028,1.949,235,793,18,11,H1
"Boone County, IN",2007-2008,53778,54648,870,1.618,279,591,18,11,H1
"Boone County, IN",2008-2009,54648,55915,1267,2.318,329,938,18,11,H1
"Boone County, IN",2009-2010,55915,56836,921,1.647,205,716,18,11,H1
"Boone County, IN",2010-2011,56836,57886,1050,1.847,261,789,18,11,H1
"Boone County, IN",2011-2012,57886,59076,1190,2.056,224,966,18,11,H1
"Boone County, IN",2012-2013,59076,60519,1443,2.443,285,1158,18,11,H1
"Boone County, IN",2013-2014,60519,61915,1396,2.307,314,1082,18,11,H1
"Boone County, IN",2014-2015,61805,63344,1539,2.49,316,1223,18,11,H1
"Boone County, IN",2015-2016,63344,64239,895,1.413,314,581,18,11,H1
"Boone County, IN",2016-2017,64239,65875,1636,2.547,331,1305,18,11,H1
"Brown County, IN",2000-2001,14998,15200,202,1.347,50,152,18,13,H1
"Brown County, IN",2001-2002,15200,15339,139,0.914,-4,143,18,13,H1
"Brown County, IN",2002-2003,15339,15375,36,0.235,24,12,18,13,H1
"Brown County, IN",2003-2004,15375,15390,15,0.098,1,14,18,13,H1
"Brown County, IN",2004-2005,15390,15283,-107,-0.695,-26,-81,18,13,H1
"Brown County, IN",2005-2006,15283,15329,46,0.301,-39,85,18,13,H1
"Brown County, IN",2006-2007,15329,15274,-55,-0.359,-24,-31,18,13,H1
"Brown County, IN",2007-2008,15274,15274,0,0,0,0,18,13,H1
"Brown County, IN",2008-2009,15274,15261,-13,-0.085,-35,22,18,13,H1
"Brown County, IN",2009-2010,15261,15209,-52,-0.341,-54,2,18,13,H1
"Brown County, IN",2010-2011,15209,15075,-134,-0.881,-29,-105,18,13,H1
"Brown County, IN",2011-2012,15075,15068,-7,-0.046,-29,22,18,13,H1
"Brown County, IN",2012-2013,15068,15054,-14,-0.093,-28,14,18,13,H1
"Brown County, IN",2013-2014,15054,14962,-92,-0.611,-9,-83,18,13,H1
"Brown County, IN",2014-2015,14932,14977,45,0.301,-2,47,18,13,H1
"Brown County, IN",2015-2016,14977,15008,31,0.207,-54,85,18,13,H1
"Brown County, IN",2016-2017,15008,15035,27,0.18,-17,44,18,13,H1
"Carroll County, IN",2000-2001,20150,20298,148,0.734,82,66,18,15,H1
"Carroll County, IN",2001-2002,20298,20270,-28,-0.138,57,-85,18,15,H1
"Carroll County, IN",2002-2003,20270,20433,163,0.804,58,105,18,15,H1
"Carroll County, IN",2003-2004,20433,20148,-285,-1.395,70,-355,18,15,H1
"Carroll County, IN",2004-2005,20148,20274,126,0.625,65,61,18,15,H1
"Carroll County, IN",2005-2006,20274,20179,-95,-0.469,26,-121,18,15,H1
"Carroll County, IN",2006-2007,20179,20118,-61,-0.302,41,-102,18,15,H1
"Carroll County, IN",2007-2008,20118,20114,-4,-0.02,76,-80,18,15,H1
"Carroll County, IN",2008-2009,20114,20103,-11,-0.055,55,-66,18,15,H1
"Carroll County, IN",2009-2010,20103,20161,58,0.289,31,27,18,15,H1
"Carroll County, IN",2010-2011,20161,20066,-95,-0.471,13,-108,18,15,H1
"Carroll County, IN",2011-2012,20066,20096,30,0.15,51,-21,18,15,H1
"Carroll County, IN",2012-2013,20096,20096,0,0,71,-71,18,15,H1
"Carroll County, IN",2013-2014,20096,19923,-173,-0.861,47,-220,18,15,H1
"Carroll County, IN",2014-2015,19904,19856,-48,-0.241,29,-77,18,15,H1
"Carroll County, IN",2015-2016,19856,19967,111,0.559,28,83,18,15,H1
"Carroll County, IN",2016-2017,19967,20039,72,0.361,2,70,18,15,H1
"Cass County, IN",2000-2001,40939,40859,-80,-0.195,151,-231,18,17,H1
"Cass County, IN",2001-2002,40859,40389,-470,-1.15,125,-595,18,17,H1
"Cass County, IN",2002-2003,40389,40218,-171,-0.423,104,-275,18,17,H1
"Cass County, IN",2003-2004,40218,39921,-297,-0.738,170,-467,18,17,H1
"Cass County, IN",2004-2005,39921,39637,-284,-0.711,170,-454,18,17,H1
"Cass County, IN",2005-2006,39637,39255,-382,-0.964,186,-568,18,17,H1
"Cass County, IN",2006-2007,39255,39033,-222,-0.566,166,-388,18,17,H1
"Cass County, IN",2007-2008,39033,39070,37,0.095,147,-110,18,17,H1
"Cass County, IN",2008-2009,39070,38968,-102,-0.261,160,-262,18,17,H1
"Cass County, IN",2009-2010,38968,39002,34,0.087,150,-116,18,17,H1
"Cass County, IN",2010-2011,39002,38920,-82,-0.21,174,-256,18,17,H1
"Cass County, IN",2011-2012,38920,38746,-174,-0.447,100,-274,18,17,H1
"Cass County, IN",2012-2013,38746,38542,-204,-0.527,100,-304,18,17,H1
"Cass County, IN",2013-2014,38542,38438,-104,-0.27,104,-208,18,17,H1
"Cass County, IN",2014-2015,38336,37979,-357,-0.931,70,-427,18,17,H1
"Cass County, IN",2015-2016,37979,38013,34,0.09,94,-60,18,17,H1
"Cass County, IN",2016-2017,38013,37994,-19,-0.05,64,-83,18,17,H1
"Clark County, IN",2000-2001,96714,97228,514,0.531,369,145,18,19,H1
"Clark County, IN",2001-2002,97228,97935,707,0.727,295,412,18,19,H1
"Clark County, IN",2002-2003,97935,99349,1414,1.444,304,1110,18,19,H1
"Clark County, IN",2003-2004,99349,100435,1086,1.093,343,743,18,19,H1
"Clark County, IN",2004-2005,100435,101781,1346,1.34,378,968,18,19,H1
"Clark County, IN",2005-2006,101781,104148,2367,2.326,479,1888,18,19,H1
"Clark County, IN",2006-2007,104148,105672,1524,1.463,534,990,18,19,H1
"Clark County, IN",2007-2008,105672,107406,1734,1.641,496,1238,18,19,H1
"Clark County, IN",2008-2009,107406,109067,1661,1.546,396,1265,18,19,H1
"Clark County, IN",2009-2010,109067,110547,1480,1.357,368,1112,18,19,H1
"Clark County, IN",2010-2011,110547,111534,987,0.893,423,564,18,19,H1
"Clark County, IN",2011-2012,111534,111919,385,0.345,376,9,18,19,H1
"Clark County, IN",2012-2013,111919,112800,881,0.787,321,560,18,19,H1
"Clark County, IN",2013-2014,112800,114262,1462,1.296,367,1095,18,19,H1
"Clark County, IN",2014-2015,114301,115371,1070,0.936,499,571,18,19,H1
"Clark County, IN",2015-2016,115371,115800,429,0.372,267,162,18,19,H1
"Clark County, IN",2016-2017,115800,116973,1173,1.013,320,853,18,19,H1
"Clay County, IN",2000-2001,26565,26605,40,0.151,25,15,18,21,H1
"Clay County, IN",2001-2002,26605,26486,-119,-0.447,51,-170,18,21,H1
"Clay County, IN",2002-2003,26486,26788,302,1.14,56,246,18,21,H1
"Clay County, IN",2003-2004,26788,27015,227,0.847,28,199,18,21,H1
"Clay County, IN",2004-2005,27015,27097,82,0.304,44,38,18,21,H1
"Clay County, IN",2005-2006,27097,27096,-1,-0.004,60,-61,18,21,H1
"Clay County, IN",2006-2007,27096,26983,-113,-0.417,13,-126,18,21,H1
"Clay County, IN",2007-2008,26983,27058,75,0.278,9,66,18,21,H1
"Clay County, IN",2008-2009,27058,26901,-157,-0.58,38,-195,18,21,H1
"Clay County, IN",2009-2010,26901,26870,-31,-0.115,11,-42,18,21,H1
"Clay County, IN",2010-2011,26870,26902,32,0.119,32,0,18,21,H1
"Clay County, IN",2011-2012,26902,26855,-47,-0.175,27,-74,18,21,H1
"Clay County, IN",2012-2013,26855,26797,-58,-0.216,44,-102,18,21,H1
"Clay County, IN",2013-2014,26797,26562,-235,-0.877,34,-269,18,21,H1
"Clay County, IN",2014-2015,26483,26503,20,0.076,29,-9,18,21,H1
"Clay County, IN",2015-2016,26503,26203,-300,-1.132,41,-341,18,21,H1
"Clay County, IN",2016-2017,26203,26198,-5,-0.019,38,-43,18,21,H1
"Clinton County, IN",2000-2001,33942,33809,-133,-0.392,180,-313,18,23,H1
"Clinton County, IN",2001-2002,33809,33610,-199,-0.589,188,-387,18,23,H1
"Clinton County, IN",2002-2003,33610,33383,-227,-0.675,135,-362,18,23,H1
"Clinton County, IN",2003-2004,33383,33342,-41,-0.123,141,-182,18,23,H1
"Clinton County, IN",2004-2005,33342,33237,-105,-0.315,148,-253,18,23,H1
"Clinton County, IN",2005-2006,33237,33298,61,0.184,173,-112,18,23,H1
"Clinton County, IN",2006-2007,33298,33188,-110,-0.33,148,-258,18,23,H1
"Clinton County, IN",2007-2008,33188,33352,164,0.494,183,-19,18,23,H1
"Clinton County, IN",2008-2009,33352,33280,-72,-0.216,180,-252,18,23,H1
"Clinton County, IN",2009-2010,33280,33203,-77,-0.231,147,-224,18,23,H1
"Clinton County, IN",2010-2011,33203,33043,-160,-0.482,89,-249,18,23,H1
"Clinton County, IN",2011-2012,33043,32957,-86,-0.26,49,-135,18,23,H1
"Clinton County, IN",2012-2013,32957,32958,1,0.003,133,-132,18,23,H1
"Clinton County, IN",2013-2014,32958,32776,-182,-0.552,168,-350,18,23,H1
"Clinton County, IN",2014-2015,32672,32609,-63,-0.193,109,-172,18,23,H1
"Clinton County, IN",2015-2016,32609,32267,-342,-1.049,100,-442,18,23,H1
"Clinton County, IN",2016-2017,32267,32317,50,0.155,137,-87,18,23,H1
"Crawford County, IN",2000-2001,10786,10922,136,1.261,36,100,18,25,H1
"Crawford County, IN",2001-2002,10922,10976,54,0.494,17,37,18,25,H1
"Crawford County, IN",2002-2003,10976,11007,31,0.282,18,13,18,25,H1
"Crawford County, IN",2003-2004,11007,11029,22,0.2,18,4,18,25,H1
"Crawford County, IN",2004-2005,11029,11012,-17,-0.154,5,-22,18,25,H1
"Crawford County, IN",2005-2006,11012,11008,-4,-0.036,20,-24,18,25,H1
"Crawford County, IN",2006-2007,11008,10933,-75,-0.681,23,-98,18,25,H1
"Crawford County, IN",2007-2008,10933,10792,-141,-1.29,9,-150,18,25,H1
"Crawford County, IN",2008-2009,10792,10664,-128,-1.186,-6,-122,18,25,H1
"Crawford County, IN",2009-2010,10664,10714,50,0.469,-20,70,18,25,H1
"Crawford County, IN",2010-2011,10714,10606,-108,-1.008,-10,-98,18,25,H1
"Crawford County, IN",2011-2012,10606,10645,39,0.368,23,16,18,25,H1
"Crawford County, IN",2012-2013,10645,10611,-34,-0.319,6,-40,18,25,H1
"Crawford County, IN",2013-2014,10611,10655,44,0.415,7,37,18,25,H1
"Crawford County, IN",2014-2015,10627,10483,-144,-1.355,0,-144,18,25,H1
"Crawford County, IN",2015-2016,10483,10581,98,0.935,-4,102,18,25,H1
"Crawford County, IN",2016-2017,10581,10566,-15,-0.142,-2,-13,18,25,H1
"Daviess County, IN",2000-2001,29882,29755,-127,-0.425,132,-259,18,27,H1
"Daviess County, IN",2001-2002,29755,29860,105,0.353,171,-66,18,27,H1
"Daviess County, IN",2002-2003,29860,30108,248,0.831,189,59,18,27,H1
"Daviess County, IN",2003-2004,30108,30300,192,0.638,224,-32,18,27,H1
"Daviess County, IN",2004-2005,30300,30452,152,0.502,193,-41,18,27,H1
"Daviess County, IN",2005-2006,30452,30469,17,0.056,210,-193,18,27,H1
"Daviess County, IN",2006-2007,30469,30702,233,0.765,207,26,18,27,H1
"Daviess County, IN",2007-2008,30702,30947,245,0.798,247,-2,18,27,H1
"Daviess County, IN",2008-2009,30947,31389,442,1.428,225,217,18,27,H1
"Daviess County, IN",2009-2010,31389,31713,324,1.032,222,102,18,27,H1
"Daviess County, IN",2010-2011,31713,31918,205,0.646,193,12,18,27,H1
"Daviess County, IN",2011-2012,31918,32116,198,0.62,185,13,18,27,H1
"Daviess County, IN",2012-2013,32116,32303,187,0.582,246,-59,18,27,H1
"Daviess County, IN",2013-2014,32303,32729,426,1.319,220,206,18,27,H1
"Daviess County, IN",2014-2015,32745,32906,161,0.492,230,-69,18,27,H1
"Daviess County, IN",2015-2016,32906,32997,91,0.277,212,-121,18,27,H1
"Daviess County, IN",2016-2017,32997,33113,116,0.352,205,-89,18,27,H1
"Dearborn County, IN",2000-2001,46349,46726,377,0.813,257,120,18,29,H1
"Dearborn County, IN",2001-2002,46726,47052,326,0.698,193,133,18,29,H1
"Dearborn County, IN",2002-2003,47052,47631,579,1.231,180,399,18,29,H1
"Dearborn County, IN",2003-2004,47631,48135,504,1.058,275,229,18,29,H1
"Dearborn County, IN",2004-2005,48135,48421,286,0.594,275,11,18,29,H1
"Dearborn County, IN",2005-2006,48421,48879,458,0.946,227,231,18,29,H1
"Dearborn County, IN",2006-2007,48879,49348,469,0.96,193,276,18,29,H1
"Dearborn County, IN",2007-2008,49348,49643,295,0.598,247,48,18,29,H1
"Dearborn County, IN",2008-2009,49643,49931,288,0.58,252,36,18,29,H1
"Dearborn County, IN",2009-2010,49931,50093,162,0.324,202,-40,18,29,H1
"Dearborn County, IN",2010-2011,50093,50020,-73,-0.146,84,-157,18,29,H1
"Dearborn County, IN",2011-2012,50020,49782,-238,-0.476,72,-310,18,29,H1
"Dearborn County, IN",2012-2013,49782,49799,17,0.034,114,-97,18,29,H1
"Dearborn County, IN",2013-2014,49799,49506,-293,-0.588,104,-397,18,29,H1
"Dearborn County, IN",2014-2015,49423,49455,32,0.065,60,-28,18,29,H1
"Dearborn County, IN",2015-2016,49455,49471,16,0.032,74,-58,18,29,H1
"Dearborn County, IN",2016-2017,49471,49741,270,0.546,84,186,18,29,H1
"Decatur County, IN",2000-2001,24572,24585,13,0.053,157,-144,18,31,H1
"Decatur County, IN",2001-2002,24585,24793,208,0.846,165,43,18,31,H1
"Decatur County, IN",2002-2003,24793,24946,153,0.617,126,27,18,31,H1
"Decatur County, IN",2003-2004,24946,25208,262,1.05,162,100,18,31,H1
"Decatur County, IN",2004-2005,25208,25374,166,0.659,82,84,18,31,H1
"Decatur County, IN",2005-2006,25374,25469,95,0.374,117,-22,18,31,H1
"Decatur County, IN",2006-2007,25469,25486,17,0.067,106,-89,18,31,H1
"Decatur County, IN",2007-2008,25486,25600,114,0.447,117,-3,18,31,H1
"Decatur County, IN",2008-2009,25600,25595,-5,-0.02,125,-130,18,31,H1
"Decatur County, IN",2009-2010,25595,25795,200,0.781,99,101,18,31,H1
"Decatur County, IN",2010-2011,25795,25895,100,0.388,60,40,18,31,H1
"Decatur County, IN",2011-2012,25895,26083,188,0.726,45,143,18,31,H1
"Decatur County, IN",2012-2013,26083,26262,179,0.686,79,100,18,31,H1
"Decatur County, IN",2013-2014,26262,26524,262,0.998,73,189,18,31,H1
"Decatur County, IN",2014-2015,26511,26521,10,0.038,126,-116,18,31,H1
"Decatur County, IN",2015-2016,26521,26641,120,0.452,84,36,18,31,H1
"Decatur County, IN",2016-2017,26641,26737,96,0.36,79,17,18,31,H1
"DeKalb County, IN",2000-2001,40537,40576,39,0.096,241,-202,18,33,H1
"DeKalb County, IN",2001-2002,40576,40732,156,0.384,297,-141,18,33,H1
"DeKalb County, IN",2002-2003,40732,41047,315,0.773,231,84,18,33,H1
"DeKalb County, IN",2003-2004,41047,41283,236,0.575,227,9,18,33,H1
"DeKalb County, IN",2004-2005,41283,41494,211,0.511,249,-38,18,33,H1
"DeKalb County, IN",2005-2006,41494,41594,100,0.241,173,-73,18,33,H1
"DeKalb County, IN",2006-2007,41594,41876,282,0.678,256,26,18,33,H1
"DeKalb County, IN",2007-2008,41876,42033,157,0.375,217,-60,18,33,H1
"DeKalb County, IN",2008-2009,42033,42053,20,0.048,208,-188,18,33,H1
"DeKalb County, IN",2009-2010,42053,42254,201,0.478,165,36,18,33,H1
"DeKalb County, IN",2010-2011,42254,42413,159,0.376,128,31,18,33,H1
"DeKalb County, IN",2011-2012,42413,42255,-158,-0.373,156,-314,18,33,H1
"DeKalb County, IN",2012-2013,42255,42302,47,0.111,84,-37,18,33,H1
"DeKalb County, IN",2013-2014,42302,42383,81,0.191,104,-23,18,33,H1
"DeKalb County, IN",2014-2015,42508,42589,81,0.191,151,-70,18,33,H1
"DeKalb County, IN",2015-2016,42589,42620,31,0.073,136,-105,18,33,H1
"DeKalb County, IN",2016-2017,42620,42836,216,0.507,116,100,18,33,H1
"Delaware County, IN",2000-2001,118776,120281,1505,1.267,257,1248,18,35,H1
"Delaware County, IN",2001-2002,120281,119949,-332,-0.276,191,-523,18,35,H1
"Delaware County, IN",2002-2003,119949,119935,-14,-0.012,98,-112,18,35,H1
"Delaware County, IN",2003-2004,119935,118938,-997,-0.831,178,-1175,18,35,H1
"Delaware County, IN",2004-2005,118938,118170,-768,-0.646,166,-934,18,35,H1
"Delaware County, IN",2005-2006,118170,117326,-844,-0.714,49,-893,18,35,H1
"Delaware County, IN",2006-2007,117326,117229,-97,-0.083,53,-150,18,35,H1
"Delaware County, IN",2007-2008,117229,117007,-222,-0.189,225,-447,18,35,H1
"Delaware County, IN",2008-2009,117007,117490,483,0.413,144,339,18,35,H1
"Delaware County, IN",2009-2010,117490,117672,182,0.155,75,107,18,35,H1
"Delaware County, IN",2010-2011,117672,117797,125,0.106,99,26,18,35,H1
"Delaware County, IN",2011-2012,117797,117309,-488,-0.414,-11,-477,18,35,H1
"Delaware County, IN",2012-2013,117309,117355,46,0.039,99,-53,18,35,H1
"Delaware County, IN",2013-2014,117355,117074,-281,-0.239,67,-348,18,35,H1
"Delaware County, IN",2014-2015,117201,116852,-349,-0.298,117,-466,18,35,H1
"Delaware County, IN",2015-2016,116852,115483,-1369,-1.172,47,-1416,18,35,H1
"Delaware County, IN",2016-2017,115483,115184,-299,-0.259,-13,-286,18,35,H1
"Dubois County, IN",2000-2001,39892,40142,250,0.627,175,75,18,37,H1
"Dubois County, IN",2001-2002,40142,40244,102,0.254,179,-77,18,37,H1
"Dubois County, IN",2002-2003,40244,40547,303,0.753,160,143,18,37,H1
"Dubois County, IN",2003-2004,40547,40950,403,0.994,195,208,18,37,H1
"Dubois County, IN",2004-2005,40950,41265,315,0.769,231,84,18,37,H1
"Dubois County, IN",2005-2006,41265,41589,324,0.785,141,183,18,37,H1
"Dubois County, IN",2006-2007,41589,41728,139,0.334,209,-70,18,37,H1
"Dubois County, IN",2007-2008,41728,41955,227,0.544,206,21,18,37,H1
"Dubois County, IN",2008-2009,41955,41897,-58,-0.138,212,-270,18,37,H1
"Dubois County, IN",2009-2010,41897,41898,1,0.002,173,-172,18,37,H1
"Dubois County, IN",2010-2011,41898,42193,295,0.704,107,188,18,37,H1
"Dubois County, IN",2011-2012,42193,42094,-99,-0.235,97,-196,18,37,H1
"Dubois County, IN",2012-2013,42094,42318,224,0.532,146,78,18,37,H1
"Dubois County, IN",2013-2014,42318,42345,27,0.064,131,-104,18,37,H1
"Dubois County, IN",2014-2015,42364,42461,97,0.229,170,-73,18,37,H1
"Dubois County, IN",2015-2016,42461,42456,-5,-0.012,185,-190,18,37,H1
"Dubois County, IN",2016-2017,42456,42558,102,0.24,169,-67,18,37,H1
"Elkhart County, IN",2000-2001,183412,184708,1296,0.707,1936,-640,18,39,H1
"Elkhart County, IN",2001-2002,184708,184543,-165,-0.089,1494,-1659,18,39,H1
"Elkhart County, IN",2002-2003,184543,187149,2606,1.412,1727,879,18,39,H1
"Elkhart County, IN",2003-2004,187149,189316,2167,1.158,1801,366,18,39,H1
"Elkhart County, IN",2004-2005,189316,192242,2926,1.546,1912,1014,18,39,H1
"Elkhart County, IN",2005-2006,192242,195047,2805,1.459,2114,691,18,39,H1
"Elkhart County, IN",2006-2007,195047,196304,1257,0.644,2180,-923,18,39,H1
"Elkhart County, IN",2007-2008,196304,197762,1458,0.743,1978,-520,18,39,H1
"Elkhart County, IN",2008-2009,197762,197514,-248,-0.125,1943,-2191,18,39,H1
"Elkhart County, IN",2009-2010,197514,197441,-73,-0.037,1836,-1909,18,39,H1
"Elkhart County, IN",2010-2011,197441,198480,1039,0.526,1538,-499,18,39,H1
"Elkhart County, IN",2011-2012,198480,199236,756,0.381,1325,-569,18,39,H1
"Elkhart County, IN",2012-2013,199236,200591,1355,0.68,1506,-151,18,39,H1
"Elkhart County, IN",2013-2014,200591,201971,1380,0.688,1500,-120,18,39,H1
"Elkhart County, IN",2014-2015,201739,203474,1735,0.86,1471,264,18,39,H1
"Elkhart County, IN",2015-2016,203474,204146,672,0.33,1545,-873,18,39,H1
"Elkhart County, IN",2016-2017,204146,205032,886,0.434,1524,-638,18,39,H1
"Fayette County, IN",2000-2001,25556,25263,-293,-1.147,35,-328,18,41,H1
"Fayette County, IN",2001-2002,25263,25094,-169,-0.669,-22,-147,18,41,H1
"Fayette County, IN",2002-2003,25094,24953,-141,-0.562,7,-148,18,41,H1
"Fayette County, IN",2003-2004,24953,24844,-109,-0.437,19,-128,18,41,H1
"Fayette County, IN",2004-2005,24844,24700,-144,-0.58,38,-182,18,41,H1
"Fayette County, IN",2005-2006,24700,24508,-192,-0.777,34,-226,18,41,H1
"Fayette County, IN",2006-2007,24508,24413,-95,-0.388,16,-111,18,41,H1
"Fayette County, IN",2007-2008,24413,24384,-29,-0.119,20,-49,18,41,H1
"Fayette County, IN",2008-2009,24384,24247,-137,-0.562,14,-151,18,41,H1
"Fayette County, IN",2009-2010,24247,24341,94,0.388,-17,111,18,41,H1
"Fayette County, IN",2010-2011,24341,24163,-178,-0.731,-89,-89,18,41,H1
"Fayette County, IN",2011-2012,24163,23965,-198,-0.819,-74,-124,18,41,H1
"Fayette County, IN",2012-2013,23965,23839,-126,-0.526,-74,-52,18,41,H1
"Fayette County, IN",2013-2014,23839,23468,-371,-1.556,-47,-324,18,41,H1
"Fayette County, IN",2014-2015,23466,23434,-32,-0.136,-33,1,18,41,H1
"Fayette County, IN",2015-2016,23434,23257,-177,-0.755,-69,-108,18,41,H1
"Fayette County, IN",2016-2017,23257,23209,-48,-0.206,-45,-3,18,41,H1
"Floyd County, IN",2000-2001,70879,71441,562,0.793,191,371,18,43,H1
"Floyd County, IN",2001-2002,71441,71407,-34,-0.048,189,-223,18,43,H1
"Floyd County, IN",2002-2003,71407,71219,-188,-0.263,128,-316,18,43,H1
"Floyd County, IN",2003-2004,71219,71465,246,0.345,175,71,18,43,H1
"Floyd County, IN",2004-2005,71465,71905,440,0.616,210,230,18,43,H1
"Floyd County, IN",2005-2006,71905,72358,453,0.63,213,240,18,43,H1
"Floyd County, IN",2006-2007,72358,72876,518,0.716,174,344,18,43,H1
"Floyd County, IN",2007-2008,72876,73775,899,1.234,221,678,18,43,H1
"Floyd County, IN",2008-2009,73775,74284,509,0.69,270,239,18,43,H1
"Floyd County, IN",2009-2010,74284,74660,376,0.506,210,166,18,43,H1
"Floyd County, IN",2010-2011,74660,74975,315,0.422,152,163,18,43,H1
"Floyd County, IN",2011-2012,74975,75284,309,0.412,169,140,18,43,H1
"Floyd County, IN",2012-2013,75284,76059,775,1.029,180,595,18,43,H1
"Floyd County, IN",2013-2014,76059,76179,120,0.158,187,-67,18,43,H1
"Floyd County, IN",2014-2015,76233,76778,545,0.715,158,387,18,43,H1
"Floyd County, IN",2015-2016,76778,76723,-55,-0.072,176,-231,18,43,H1
"Floyd County, IN",2016-2017,76723,77071,348,0.454,162,186,18,43,H1
"Fountain County, IN",2000-2001,17929,17752,-177,-0.987,-20,-157,18,45,H1
"Fountain County, IN",2001-2002,17752,17825,73,0.411,60,13,18,45,H1
"Fountain County, IN",2002-2003,17825,17738,-87,-0.488,35,-122,18,45,H1
"Fountain County, IN",2003-2004,17738,17578,-160,-0.902,0,-160,18,45,H1
"Fountain County, IN",2004-2005,17578,17436,-142,-0.808,23,-165,18,45,H1
"Fountain County, IN",2005-2006,17436,17459,23,0.132,10,13,18,45,H1
"Fountain County, IN",2006-2007,17459,17396,-63,-0.361,4,-67,18,45,H1
"Fountain County, IN",2007-2008,17396,17356,-40,-0.23,20,-60,18,45,H1
"Fountain County, IN",2008-2009,17356,17183,-173,-0.997,16,-189,18,45,H1
"Fountain County, IN",2009-2010,17183,17258,75,0.436,-4,79,18,45,H1
"Fountain County, IN",2010-2011,17258,17130,-128,-0.742,-16,-112,18,45,H1
"Fountain County, IN",2011-2012,17130,17100,-30,-0.175,-23,-7,18,45,H1
"Fountain County, IN",2012-2013,17100,16863,-237,-1.386,-20,-217,18,45,H1
"Fountain County, IN",2013-2014,16863,16658,-205,-1.216,-12,-193,18,45,H1
"Fountain County, IN",2014-2015,16723,16591,-132,-0.789,31,-163,18,45,H1
"Fountain County, IN",2015-2016,16591,16477,-114,-0.687,-4,-110,18,45,H1
"Fountain County, IN",2016-2017,16477,16505,28,0.17,18,10,18,45,H1
"Franklin County, IN",2000-2001,22252,22315,63,0.283,95,-32,18,47,H1
"Franklin County, IN",2001-2002,22315,22475,160,0.717,87,73,18,47,H1
"Franklin County, IN",2002-2003,22475,22700,225,1.001,38,187,18,47,H1
"Franklin County, IN",2003-2004,22700,22852,152,0.67,134,18,18,47,H1
"Franklin County, IN",2004-2005,22852,23049,197,0.862,143,54,18,47,H1
"Franklin County, IN",2005-2006,23049,23122,73,0.317,89,-16,18,47,H1
"Franklin County, IN",2006-2007,23122,23276,154,0.666,131,23,18,47,H1
"Franklin County, IN",2007-2008,23276,23330,54,0.232,95,-41,18,47,H1
"Franklin County, IN",2008-2009,23330,23195,-135,-0.579,104,-239,18,47,H1
"Franklin County, IN",2009-2010,23195,23056,-139,-0.599,69,-208,18,47,H1
"Franklin County, IN",2010-2011,23056,22997,-59,-0.256,54,-113,18,47,H1
"Franklin County, IN",2011-2012,22997,22986,-11,-0.048,21,-32,18,47,H1
"Franklin County, IN",2012-2013,22986,22929,-57,-0.248,48,-105,18,47,H1
"Franklin County, IN",2013-2014,22929,22934,5,0.022,67,-62,18,47,H1
"Franklin County, IN",2014-2015,22898,22872,-26,-0.114,51,-77,18,47,H1
"Franklin County, IN",2015-2016,22872,22725,-147,-0.643,22,-169,18,47,H1
"Franklin County, IN",2016-2017,22725,22619,-106,-0.466,14,-120,18,47,H1
"Fulton County, IN",2000-2001,20549,20509,-40,-0.195,45,-85,18,49,H1
"Fulton County, IN",2001-2002,20509,20464,-45,-0.219,30,-75,18,49,H1
"Fulton County, IN",2002-2003,20464,20379,-85,-0.415,21,-106,18,49,H1
"Fulton County, IN",2003-2004,20379,20466,87,0.427,-13,100,18,49,H1
"Fulton County, IN",2004-2005,20466,20540,74,0.362,35,39,18,49,H1
"Fulton County, IN",2005-2006,20540,20563,23,0.112,30,-7,18,49,H1
"Fulton County, IN",2006-2007,20563,20571,8,0.039,-10,18,18,49,H1
"Fulton County, IN",2007-2008,20571,20670,99,0.481,51,48,18,49,H1
"Fulton County, IN",2008-2009,20670,20772,102,0.493,37,65,18,49,H1
"Fulton County, IN",2009-2010,20772,20820,48,0.231,23,25,18,49,H1
"Fulton County, IN",2010-2011,20820,20751,-69,-0.331,-13,-56,18,49,H1
"Fulton County, IN",2011-2012,20751,20664,-87,-0.419,9,-96,18,49,H1
"Fulton County, IN",2012-2013,20664,20455,-209,-1.011,21,-230,18,49,H1
"Fulton County, IN",2013-2014,20455,20500,45,0.22,44,1,18,49,H1
"Fulton County, IN",2014-2015,20483,20315,-168,-0.82,71,-239,18,49,H1
"Fulton County, IN",2015-2016,20315,20137,-178,-0.876,32,-210,18,49,H1
"Fulton County, IN",2016-2017,20137,20059,-78,-0.387,48,-126,18,49,H1
"Gibson County, IN",2000-2001,32491,32647,156,0.48,49,107,18,51,H1
"Gibson County, IN",2001-2002,32647,32684,37,0.113,54,-17,18,51,H1
"Gibson County, IN",2002-2003,32684,32934,250,0.765,92,158,18,51,H1
"Gibson County, IN",2003-2004,32934,33198,264,0.802,58,206,18,51,H1
"Gibson County, IN",2004-2005,33198,33268,70,0.211,56,14,18,51,H1
"Gibson County, IN",2005-2006,33268,33429,161,0.484,113,48,18,51,H1
"Gibson County, IN",2006-2007,33429,33290,-139,-0.416,134,-273,18,51,H1
"Gibson County, IN",2007-2008,33290,33331,41,0.123,122,-81,18,51,H1
"Gibson County, IN",2008-2009,33331,33345,14,0.042,91,-77,18,51,H1
"Gibson County, IN",2009-2010,33345,33527,182,0.546,65,117,18,51,H1
"Gibson County, IN",2010-2011,33527,33540,13,0.039,103,-90,18,51,H1
"Gibson County, IN",2011-2012,33540,33551,11,0.033,79,-68,18,51,H1
"Gibson County, IN",2012-2013,33551,33554,3,0.009,47,-44,18,51,H1
"Gibson County, IN",2013-2014,33554,33759,205,0.611,20,185,18,51,H1
"Gibson County, IN",2014-2015,33845,33775,-70,-0.207,56,-126,18,51,H1
"Gibson County, IN",2015-2016,33775,33579,-196,-0.58,43,-239,18,51,H1
"Gibson County, IN",2016-2017,33579,33576,-3,-0.009,-1,-2,18,51,H1
"Grant County, IN",2000-2001,73325,72905,-420,-0.573,70,-490,18,53,H1
"Grant County, IN",2001-2002,72905,72425,-480,-0.658,93,-573,18,53,H1
"Grant County, IN",2002-2003,72425,72113,-312,-0.431,-30,-282,18,53,H1
"Grant County, IN",2003-2004,72113,71479,-634,-0.879,36,-670,18,53,H1
"Grant County, IN",2004-2005,71479,70803,-676,-0.946,-82,-594,18,53,H1
"Grant County, IN",2005-2006,70803,70448,-355,-0.501,97,-452,18,53,H1
"Grant County, IN",2006-2007,70448,70012,-436,-0.619,109,-545,18,53,H1
"Grant County, IN",2007-2008,70012,70250,238,0.34,70,168,18,53,H1
"Grant County, IN",2008-2009,70250,70195,-55,-0.078,-3,-52,18,53,H1
"Grant County, IN",2009-2010,70195,70002,-193,-0.275,-18,-175,18,53,H1
"Grant County, IN",2010-2011,70002,69669,-333,-0.476,-41,-292,18,53,H1
"Grant County, IN",2011-2012,69669,69283,-386,-0.554,20,-406,18,53,H1
"Grant County, IN",2012-2013,69283,69044,-239,-0.345,-21,-218,18,53,H1
"Grant County, IN",2013-2014,69044,68569,-475,-0.688,-59,-416,18,53,H1
"Grant County, IN",2014-2015,68631,67979,-652,-0.95,36,-688,18,53,H1
"Grant County, IN",2015-2016,67979,66802,-1177,-1.731,-89,-1088,18,53,H1
"Grant County, IN",2016-2017,66802,66491,-311,-0.466,-60,-251,18,53,H1
"Greene County, IN",2000-2001,33191,33195,4,0.012,63,-59,18,55,H1
"Greene County, IN",2001-2002,33195,33052,-143,-0.431,8,-151,18,55,H1
"Greene County, IN",2002-2003,33052,33287,235,0.711,71,164,18,55,H1
"Greene County, IN",2003-2004,33287,33384,97,0.291,44,53,18,55,H1
"Greene County, IN",2004-2005,33384,33320,-64,-0.192,32,-96,18,55,H1
"Greene County, IN",2005-2006,33320,33223,-97,-0.291,28,-125,18,55,H1
"Greene County, IN",2006-2007,33223,33020,-203,-0.611,34,-237,18,55,H1
"Greene County, IN",2007-2008,33020,32977,-43,-0.13,13,-56,18,55,H1
"Greene County, IN",2008-2009,32977,32995,18,0.055,38,-20,18,55,H1
"Greene County, IN",2009-2010,32995,33197,202,0.612,15,187,18,55,H1
"Greene County, IN",2010-2011,33197,33119,-78,-0.235,16,-94,18,55,H1
"Greene County, IN",2011-2012,33119,33029,-90,-0.272,-18,-72,18,55,H1
"Greene County, IN",2012-2013,33029,32817,-212,-0.642,-44,-168,18,55,H1
"Greene County, IN",2013-2014,32817,32726,-91,-0.277,-63,-28,18,55,H1
"Greene County, IN",2014-2015,32733,32441,-292,-0.892,-80,-212,18,55,H1
"Greene County, IN",2015-2016,32441,32223,-218,-0.672,-27,-191,18,55,H1
"Greene County, IN",2016-2017,32223,32177,-46,-0.143,-77,31,18,55,H1
"Hamilton County, IN",2000-2001,185221,194664,9443,5.098,2305,7138,18,57,H1
"Hamilton County, IN",2001-2002,194664,204721,10057,5.166,2335,7722,18,57,H1
"Hamilton County, IN",2002-2003,204721,215152,10431,5.095,2569,7862,18,57,H1
"Hamilton County, IN",2003-2004,215152,225319,10167,4.725,2752,7415,18,57,H1
"Hamilton County, IN",2004-2005,225319,235039,9720,4.314,2586,7134,18,57,H1
"Hamilton County, IN",2005-2006,235039,244738,9699,4.127,2676,7023,18,57,H1
"Hamilton County, IN",2006-2007,244738,253725,8987,3.672,2666,6321,18,57,H1
"Hamilton County, IN",2007-2008,253725,261974,8249,3.251,2878,5371,18,57,H1
"Hamilton County, IN",2008-2009,261974,269394,7420,2.832,3047,4373,18,57,H1
"Hamilton County, IN",2009-2010,269394,276377,6983,2.592,2725,4258,18,57,H1
"Hamilton County, IN",2010-2011,276377,283213,6836,2.473,2578,4258,18,57,H1
"Hamilton County, IN",2011-2012,283213,289570,6357,2.245,2423,3934,18,57,H1
"Hamilton County, IN",2012-2013,289570,296828,7258,2.506,2252,5006,18,57,H1
"Hamilton County, IN",2013-2014,296828,302623,5795,1.952,2273,3522,18,57,H1
"Hamilton County, IN",2014-2015,303278,309697,6419,2.117,2400,4019,18,57,H1
"Hamilton County, IN",2015-2016,309697,316296,6599,2.131,2320,4279,18,57,H1
"Hamilton County, IN",2016-2017,316296,323747,7451,2.356,2157,5294,18,57,H1
"Hancock County, IN",2000-2001,55710,56729,1019,1.829,267,752,18,59,H1
"Hancock County, IN",2001-2002,56729,58223,1494,2.634,284,1210,18,59,H1
"Hancock County, IN",2002-2003,58223,59606,1383,2.375,379,1004,18,59,H1
"Hancock County, IN",2003-2004,59606,60922,1316,2.208,362,954,18,59,H1
"Hancock County, IN",2004-2005,60922,63045,2123,3.485,330,1793,18,59,H1
"Hancock County, IN",2005-2006,63045,65402,2357,3.739,456,1901,18,59,H1
"Hancock County, IN",2006-2007,65402,67115,1713,2.619,369,1344,18,59,H1
"Hancock County, IN",2007-2008,67115,68107,992,1.478,459,533,18,59,H1
"Hancock County, IN",2008-2009,68107,69183,1076,1.58,482,594,18,59,H1
"Hancock County, IN",2009-2010,69183,70182,999,1.444,299,700,18,59,H1
"Hancock County, IN",2010-2011,70182,70360,178,0.254,164,14,18,59,H1
"Hancock County, IN",2011-2012,70360,70641,281,0.399,138,143,18,59,H1
"Hancock County, IN",2012-2013,70641,71096,455,0.644,239,216,18,59,H1
"Hancock County, IN",2013-2014,71096,71978,882,1.241,211,671,18,59,H1
"Hancock County, IN",2014-2015,71963,72520,557,0.774,207,350,18,59,H1
"Hancock County, IN",2015-2016,72520,73781,1261,1.739,167,1094,18,59,H1
"Hancock County, IN",2016-2017,73781,74985,1204,1.632,241,963,18,59,H1
"Harrison County, IN",2000-2001,34569,34863,294,0.85,138,156,18,61,H1
"Harrison County, IN",2001-2002,34863,35408,545,1.563,135,410,18,61,H1
"Harrison County, IN",2002-2003,35408,35934,526,1.486,114,412,18,61,H1
"Harrison County, IN",2003-2004,35934,36736,802,2.232,181,621,18,61,H1
"Harrison County, IN",2004-2005,36736,37354,618,1.682,136,482,18,61,H1
"Harrison County, IN",2005-2006,37354,37766,412,1.103,150,262,18,61,H1
"Harrison County, IN",2006-2007,37766,38142,376,0.996,147,229,18,61,H1
"Harrison County, IN",2007-2008,38142,38628,486,1.274,153,333,18,61,H1
"Harrison County, IN",2008-2009,38628,39148,520,1.346,112,408,18,61,H1
"Harrison County, IN",2009-2010,39148,39365,217,0.554,63,154,18,61,H1
"Harrison County, IN",2010-2011,39365,39237,-128,-0.325,31,-159,18,61,H1
"Harrison County, IN",2011-2012,39237,39099,-138,-0.352,52,-190,18,61,H1
"Harrison County, IN",2012-2013,39099,39082,-17,-0.043,41,-58,18,61,H1
"Harrison County, IN",2013-2014,39082,39299,217,0.555,55,162,18,61,H1
"Harrison County, IN",2014-2015,39238,39578,340,0.867,89,251,18,61,H1
"Harrison County, IN",2015-2016,39578,39679,101,0.255,80,21,18,61,H1
"Harrison County, IN",2016-2017,39679,39898,219,0.552,98,121,18,61,H1
"Hendricks County, IN",2000-2001,105378,110144,4766,4.523,817,3949,18,63,H1
"Hendricks County, IN",2001-2002,110144,115206,5062,4.596,838,4224,18,63,H1
"Hendricks County, IN",2002-2003,115206,119340,4134,3.588,670,3464,18,63,H1
"Hendricks County, IN",2003-2004,119340,124115,4775,4.001,861,3914,18,63,H1
"Hendricks County, IN",2004-2005,124115,128082,3967,3.196,763,3204,18,63,H1
"Hendricks County, IN",2005-2006,128082,132350,4268,3.332,835,3433,18,63,H1
"Hendricks County, IN",2006-2007,132350,137267,4917,3.715,928,3989,18,63,H1
"Hendricks County, IN",2007-2008,137267,140710,3443,2.508,947,2496,18,63,H1
"Hendricks County, IN",2008-2009,140710,143944,3234,2.298,942,2292,18,63,H1
"Hendricks County, IN",2009-2010,143944,145849,1905,1.323,716,1189,18,63,H1
"Hendricks County, IN",2010-2011,145849,148613,2764,1.895,794,1970,18,63,H1
"Hendricks County, IN",2011-2012,148613,150722,2109,1.419,784,1325,18,63,H1
"Hendricks County, IN",2012-2013,150722,153644,2922,1.939,665,2257,18,63,H1
"Hendricks County, IN",2013-2014,153644,156056,2412,1.57,734,1678,18,63,H1
"Hendricks County, IN",2014-2015,156083,158192,2109,1.351,775,1334,18,63,H1
"Hendricks County, IN",2015-2016,158192,160336,2144,1.355,705,1439,18,63,H1
"Hendricks County, IN",2016-2017,160336,163685,3349,2.089,723,2626,18,63,H1
"Henry County, IN",2000-2001,48469,48397,-72,-0.149,34,-106,18,65,H1
"Henry County, IN",2001-2002,48397,48258,-139,-0.287,-41,-98,18,65,H1
"Henry County, IN",2002-2003,48258,48145,-113,-0.234,32,-145,18,65,H1
"Henry County, IN",2003-2004,48145,48184,39,0.081,-32,71,18,65,H1
"Henry County, IN",2004-2005,48184,48064,-120,-0.249,-8,-112,18,65,H1
"Henry County, IN",2005-2006,48064,48375,311,0.647,-31,342,18,65,H1
"Henry County, IN",2006-2007,48375,48030,-345,-0.713,-71,-274,18,65,H1
"Henry County, IN",2007-2008,48030,49420,1390,2.894,-5,1395,18,65,H1
"Henry County, IN",2008-2009,49420,49305,-115,-0.233,0,-115,18,65,H1
"Henry County, IN",2009-2010,49305,49474,169,0.343,-21,190,18,65,H1
"Henry County, IN",2010-2011,49474,49343,-131,-0.265,-108,-23,18,65,H1
"Henry County, IN",2011-2012,49343,49259,-84,-0.17,-121,37,18,65,H1
"Henry County, IN",2012-2013,49259,49066,-193,-0.392,-70,-123,18,65,H1
"Henry County, IN",2013-2014,49066,48995,-71,-0.145,-93,22,18,65,H1
"Henry County, IN",2014-2015,49072,48985,-87,-0.177,-32,-55,18,65,H1
"Henry County, IN",2015-2016,48985,48364,-621,-1.268,-109,-512,18,65,H1
"Henry County, IN",2016-2017,48364,48476,112,0.232,-82,194,18,65,H1
"Howard County, IN",2000-2001,84940,84909,-31,-0.036,333,-364,18,67,H1
"Howard County, IN",2001-2002,84909,84563,-346,-0.407,197,-543,18,67,H1
"Howard County, IN",2002-2003,84563,84538,-25,-0.03,303,-328,18,67,H1
"Howard County, IN",2003-2004,84538,84291,-247,-0.292,245,-492,18,67,H1
"Howard County, IN",2004-2005,84291,84382,91,0.108,266,-175,18,67,H1
"Howard County, IN",2005-2006,84382,83943,-439,-0.52,316,-755,18,67,H1
"Howard County, IN",2006-2007,83943,83743,-200,-0.238,278,-478,18,67,H1
"Howard County, IN",2007-2008,83743,83472,-271,-0.324,218,-489,18,67,H1
"Howard County, IN",2008-2009,83472,82701,-771,-0.924,195,-966,18,67,H1
"Howard County, IN",2009-2010,82701,82766,65,0.079,122,-57,18,67,H1
"Howard County, IN",2010-2011,82766,82888,122,0.147,132,-10,18,67,H1
"Howard County, IN",2011-2012,82888,82973,85,0.103,90,-5,18,67,H1
"Howard County, IN",2012-2013,82973,82961,-12,-0.014,126,-138,18,67,H1
"Howard County, IN",2013-2014,82961,82982,21,0.025,128,-107,18,67,H1
"Howard County, IN",2014-2015,82693,82556,-137,-0.166,59,-196,18,67,H1
"Howard County, IN",2015-2016,82556,82339,-217,-0.263,31,-248,18,67,H1
"Howard County, IN",2016-2017,82339,82363,24,0.029,28,-4,18,67,H1
"Huntington County, IN",2000-2001,38068,37877,-191,-0.502,82,-273,18,69,H1
"Huntington County, IN",2001-2002,37877,37992,115,0.304,87,28,18,69,H1
"Huntington County, IN",2002-2003,37992,37875,-117,-0.308,83,-200,18,69,H1
"Huntington County, IN",2003-2004,37875,37768,-107,-0.283,83,-190,18,69,H1
"Huntington County, IN",2004-2005,37768,37650,-118,-0.312,71,-189,18,69,H1
"Huntington County, IN",2005-2006,37650,37601,-49,-0.13,85,-134,18,69,H1
"Huntington County, IN",2006-2007,37601,37447,-154,-0.41,132,-286,18,69,H1
"Huntington County, IN",2007-2008,37447,37244,-203,-0.542,78,-281,18,69,H1
"Huntington County, IN",2008-2009,37244,37205,-39,-0.105,50,-89,18,69,H1
"Huntington County, IN",2009-2010,37205,37096,-109,-0.293,6,-115,18,69,H1
"Huntington County, IN",2010-2011,37096,37171,75,0.202,10,65,18,69,H1
"Huntington County, IN",2011-2012,37171,36979,-192,-0.517,14,-206,18,69,H1
"Huntington County, IN",2012-2013,36979,36841,-138,-0.373,55,-193,18,69,H1
"Huntington County, IN",2013-2014,36841,36706,-135,-0.366,50,-185,18,69,H1
"Huntington County, IN",2014-2015,36686,36630,-56,-0.153,46,-102,18,69,H1
"Huntington County, IN",2015-2016,36630,36368,-262,-0.715,30,-292,18,69,H1
"Huntington County, IN",2016-2017,36368,36337,-31,-0.085,34,-65,18,69,H1
"Jackson County, IN",2000-2001,41428,41343,-85,-0.205,214,-299,18,71,H1
"Jackson County, IN",2001-2002,41343,41335,-8,-0.019,194,-202,18,71,H1
"Jackson County, IN",2002-2003,41335,41403,68,0.165,209,-141,18,71,H1
"Jackson County, IN",2003-2004,41403,41417,14,0.034,202,-188,18,71,H1
"Jackson County, IN",2004-2005,41417,41683,266,0.642,195,71,18,71,H1
"Jackson County, IN",2005-2006,41683,41725,42,0.101,223,-181,18,71,H1
"Jackson County, IN",2006-2007,41725,41693,-32,-0.077,162,-194,18,71,H1
"Jackson County, IN",2007-2008,41693,41705,12,0.029,134,-122,18,71,H1
"Jackson County, IN",2008-2009,41705,41798,93,0.223,150,-57,18,71,H1
"Jackson County, IN",2009-2010,41798,42584,786,1.88,128,658,18,71,H1
"Jackson County, IN",2010-2011,42584,42920,336,0.789,130,206,18,71,H1
"Jackson County, IN",2011-2012,42920,42990,70,0.163,73,-3,18,71,H1
"Jackson County, IN",2012-2013,42990,43436,446,1.037,156,290,18,71,H1
"Jackson County, IN",2013-2014,43436,43705,269,0.619,169,100,18,71,H1
"Jackson County, IN",2014-2015,43803,44069,266,0.607,188,78,18,71,H1
"Jackson County, IN",2015-2016,44069,43933,-136,-0.309,116,-252,18,71,H1
"Jackson County, IN",2016-2017,43933,43884,-49,-0.112,127,-176,18,71,H1
"Jasper County, IN",2000-2001,30334,30417,83,0.274,114,-31,18,73,H1
"Jasper County, IN",2001-2002,30417,30664,247,0.812,124,123,18,73,H1
"Jasper County, IN",2002-2003,30664,31133,469,1.529,171,298,18,73,H1
"Jasper County, IN",2003-2004,31133,31503,370,1.188,148,222,18,73,H1
"Jasper County, IN",2004-2005,31503,31763,260,0.825,204,56,18,73,H1
"Jasper County, IN",2005-2006,31763,32419,656,2.065,150,506,18,73,H1
"Jasper County, IN",2006-2007,32419,32894,475,1.465,186,289,18,73,H1
"Jasper County, IN",2007-2008,32894,33155,261,0.793,189,72,18,73,H1
"Jasper County, IN",2008-2009,33155,33278,123,0.371,172,-49,18,73,H1
"Jasper County, IN",2009-2010,33278,33502,224,0.673,109,115,18,73,H1
"Jasper County, IN",2010-2011,33502,33402,-100,-0.298,100,-200,18,73,H1
"Jasper County, IN",2011-2012,33402,33453,51,0.153,102,-51,18,73,H1
"Jasper County, IN",2012-2013,33453,33381,-72,-0.215,55,-127,18,73,H1
"Jasper County, IN",2013-2014,33381,33475,94,0.282,74,20,18,73,H1
"Jasper County, IN",2014-2015,33464,33470,6,0.018,51,-45,18,73,H1
"Jasper County, IN",2015-2016,33470,33389,-81,-0.242,51,-132,18,73,H1
"Jasper County, IN",2016-2017,33389,33447,58,0.174,62,-4,18,73,H1
"Jay County, IN",2000-2001,21792,21726,-66,-0.303,64,-130,18,75,H1
"Jay County, IN",2001-2002,21726,21713,-13,-0.06,98,-111,18,75,H1
"Jay County, IN",2002-2003,21713,21681,-32,-0.147,63,-95,18,75,H1
"Jay County, IN",2003-2004,21681,21651,-30,-0.138,82,-112,18,75,H1
"Jay County, IN",2004-2005,21651,21595,-56,-0.259,101,-157,18,75,H1
"Jay County, IN",2005-2006,21595,21564,-31,-0.144,31,-62,18,75,H1
"Jay County, IN",2006-2007,21564,21580,16,0.074,76,-60,18,75,H1
"Jay County, IN",2007-2008,21580,21467,-113,-0.524,85,-198,18,75,H1
"Jay County, IN",2008-2009,21467,21399,-68,-0.317,86,-154,18,75,H1
"Jay County, IN",2009-2010,21399,21176,-223,-1.042,76,-299,18,75,H1
"Jay County, IN",2010-2011,21176,21376,200,0.944,123,77,18,75,H1
"Jay County, IN",2011-2012,21376,21370,-6,-0.028,65,-71,18,75,H1
"Jay County, IN",2012-2013,21370,21296,-74,-0.346,73,-147,18,75,H1
"Jay County, IN",2013-2014,21296,21179,-117,-0.549,75,-192,18,75,H1
"Jay County, IN",2014-2015,21147,21121,-26,-0.123,74,-100,18,75,H1
"Jay County, IN",2015-2016,21121,21040,-81,-0.384,82,-163,18,75,H1
"Jay County, IN",2016-2017,21040,20945,-95,-0.452,75,-170,18,75,H1
"Jefferson County, IN",2000-2001,31706,31887,181,0.571,75,106,18,77,H1
"Jefferson County, IN",2001-2002,31887,31871,-16,-0.05,52,-68,18,77,H1
"Jefferson County, IN",2002-2003,31871,31779,-92,-0.289,38,-130,18,77,H1
"Jefferson County, IN",2003-2004,31779,31787,8,0.025,98,-90,18,77,H1
"Jefferson County, IN",2004-2005,31787,31998,211,0.664,56,155,18,77,H1
"Jefferson County, IN",2005-2006,31998,32287,289,0.903,57,232,18,77,H1
"Jefferson County, IN",2006-2007,32287,32140,-147,-0.455,16,-163,18,77,H1
"Jefferson County, IN",2007-2008,32140,32586,446,1.388,96,350,18,77,H1
"Jefferson County, IN",2008-2009,32586,32558,-28,-0.086,58,-86,18,77,H1
"Jefferson County, IN",2009-2010,32558,32425,-133,-0.409,21,-154,18,77,H1
"Jefferson County, IN",2010-2011,32425,32298,-127,-0.392,-36,-91,18,77,H1
"Jefferson County, IN",2011-2012,32298,32506,208,0.644,32,176,18,77,H1
"Jefferson County, IN",2012-2013,32506,32511,5,0.015,27,-22,18,77,H1
"Jefferson County, IN",2013-2014,32511,32494,-17,-0.052,37,-54,18,77,H1
"Jefferson County, IN",2014-2015,32529,32416,-113,-0.347,-2,-111,18,77,H1
"Jefferson County, IN",2015-2016,32416,32249,-167,-0.515,10,-177,18,77,H1
"Jefferson County, IN",2016-2017,32249,32089,-160,-0.496,20,-180,18,77,H1
"Jennings County, IN",2000-2001,27747,27932,185,0.667,169,16,18,79,H1
"Jennings County, IN",2001-2002,27932,28131,199,0.712,136,63,18,79,H1
"Jennings County, IN",2002-2003,28131,28012,-119,-0.423,102,-221,18,79,H1
"Jennings County, IN",2003-2004,28012,28202,190,0.678,168,22,18,79,H1
"Jennings County, IN",2004-2005,28202,28352,150,0.532,204,-54,18,79,H1
"Jennings County, IN",2005-2006,28352,28320,-32,-0.113,147,-179,18,79,H1
"Jennings County, IN",2006-2007,28320,28502,182,0.643,151,31,18,79,H1
"Jennings County, IN",2007-2008,28502,28480,-22,-0.077,122,-144,18,79,H1
"Jennings County, IN",2008-2009,28480,28546,66,0.232,120,-54,18,79,H1
"Jennings County, IN",2009-2010,28546,28465,-81,-0.284,100,-181,18,79,H1
"Jennings County, IN",2010-2011,28465,28196,-269,-0.945,50,-319,18,79,H1
"Jennings County, IN",2011-2012,28196,28182,-14,-0.05,81,-95,18,79,H1
"Jennings County, IN",2012-2013,28182,28272,90,0.319,77,13,18,79,H1
"Jennings County, IN",2013-2014,28272,2.80E+04,-272,-0.962,67,-339,18,79,H1
"Jennings County, IN",2014-2015,27996,27897,-99,-0.354,65,-164,18,79,H1
"Jennings County, IN",2015-2016,27897,27622,-275,-0.986,19,-294,18,79,H1
"Jennings County, IN",2016-2017,27622,27626,4,0.014,1,3,18,79,H1
"Johnson County, IN",2000-2001,115756,117843,2087,1.803,663,1424,18,81,H1
"Johnson County, IN",2001-2002,117843,120447,2604,2.21,707,1897,18,81,H1
"Johnson County, IN",2002-2003,120447,122202,1755,1.457,661,1094,18,81,H1
"Johnson County, IN",2003-2004,122202,124192,1990,1.628,678,1312,18,81,H1
"Johnson County, IN",2004-2005,124192,126769,2577,2.075,594,1983,18,81,H1
"Johnson County, IN",2005-2006,126769,130512,3743,2.953,735,3008,18,81,H1
"Johnson County, IN",2006-2007,130512,133933,3421,2.621,780,2641,18,81,H1
"Johnson County, IN",2007-2008,133933,136933,3.00E+03,2.24,912,2088,18,81,H1
"Johnson County, IN",2008-2009,136933,138584,1651,1.206,799,852,18,81,H1
"Johnson County, IN",2009-2010,138584,140274,1690,1.219,577,1113,18,81,H1
"Johnson County, IN",2010-2011,140274,141767,1493,1.064,654,839,18,81,H1
"Johnson County, IN",2011-2012,141767,143562,1795,1.266,575,1220,18,81,H1
"Johnson County, IN",2012-2013,143562,145806,2244,1.563,710,1534,18,81,H1
"Johnson County, IN",2013-2014,145806,147538,1732,1.188,697,1035,18,81,H1
"Johnson County, IN",2014-2015,147489,149633,2144,1.454,618,1526,18,81,H1
"Johnson County, IN",2015-2016,149633,151543,1910,1.276,585,1325,18,81,H1
"Johnson County, IN",2016-2017,151543,153897,2354,1.553,623,1731,18,81,H1
"Knox County, IN",2000-2001,39195,38840,-355,-0.906,-42,-313,18,83,H1
"Knox County, IN",2001-2002,38840,38832,-8,-0.021,23,-31,18,83,H1
"Knox County, IN",2002-2003,38832,38580,-252,-0.649,-22,-230,18,83,H1
"Knox County, IN",2003-2004,38580,38712,132,0.342,-25,157,18,83,H1
"Knox County, IN",2004-2005,38712,38543,-169,-0.437,-11,-158,18,83,H1
"Knox County, IN",2005-2006,38543,38399,-144,-0.374,47,-191,18,83,H1
"Knox County, IN",2006-2007,38399,38325,-74,-0.193,46,-120,18,83,H1
"Knox County, IN",2007-2008,38325,38497,172,0.449,48,124,18,83,H1
"Knox County, IN",2008-2009,38497,38499,2,0.005,18,-16,18,83,H1
"Knox County, IN",2009-2010,38499,38383,-116,-0.301,-24,-92,18,83,H1
"Knox County, IN",2010-2011,38383,38468,85,0.221,7,78,18,83,H1
"Knox County, IN",2011-2012,38468,38051,-417,-1.084,12,-429,18,83,H1
"Knox County, IN",2012-2013,38051,38064,13,0.034,129,-116,18,83,H1
"Knox County, IN",2013-2014,38064,37938,-126,-0.331,104,-230,18,83,H1
"Knox County, IN",2014-2015,37845,37927,82,0.217,64,18,18,83,H1
"Knox County, IN",2015-2016,37927,37542,-385,-1.015,-6,-379,18,83,H1
"Knox County, IN",2016-2017,37542,37508,-34,-0.091,24,-58,18,83,H1
"Kosciusko County, IN",2000-2001,74211,74756,545,0.734,648,-103,18,85,H1
"Kosciusko County, IN",2001-2002,74756,74861,105,0.14,456,-351,18,85,H1
"Kosciusko County, IN",2002-2003,74861,75176,315,0.421,465,-150,18,85,H1
"Kosciusko County, IN",2003-2004,75176,75447,271,0.36,473,-202,18,85,H1
"Kosciusko County, IN",2004-2005,75447,75934,487,0.645,431,56,18,85,H1
"Kosciusko County, IN",2005-2006,75934,76358,424,0.558,473,-49,18,85,H1
"Kosciusko County, IN",2006-2007,76358,76832,474,0.621,568,-94,18,85,H1
"Kosciusko County, IN",2007-2008,76832,77091,259,0.337,483,-224,18,85,H1
"Kosciusko County, IN",2008-2009,77091,77263,172,0.223,475,-303,18,85,H1
"Kosciusko County, IN",2009-2010,77263,77346,83,0.107,422,-339,18,85,H1
"Kosciusko County, IN",2010-2011,77346,77389,43,0.056,346,-303,18,85,H1
"Kosciusko County, IN",2011-2012,77389,77654,265,0.342,310,-45,18,85,H1
"Kosciusko County, IN",2012-2013,77654,77997,343,0.442,362,-19,18,85,H1
"Kosciusko County, IN",2013-2014,77997,78564,567,0.727,388,179,18,85,H1
"Kosciusko County, IN",2014-2015,78445,78620,175,0.223,399,-224,18,85,H1
"Kosciusko County, IN",2015-2016,78620,78927,307,0.39,273,34,18,85,H1
"Kosciusko County, IN",2016-2017,78927,79206,279,0.353,325,-46,18,85,H1
"LaGrange County, IN",2000-2001,34892,35299,407,1.166,538,-131,18,87,H1
"LaGrange County, IN",2001-2002,35299,35453,154,0.436,484,-330,18,87,H1
"LaGrange County, IN",2002-2003,35453,35711,258,0.728,469,-211,18,87,H1
"LaGrange County, IN",2003-2004,35711,36017,306,0.857,500,-194,18,87,H1
"LaGrange County, IN",2004-2005,36017,36283,266,0.739,509,-243,18,87,H1
"LaGrange County, IN",2005-2006,36283,36613,330,0.91,558,-228,18,87,H1
"LaGrange County, IN",2006-2007,36613,36931,318,0.869,504,-186,18,87,H1
"LaGrange County, IN",2007-2008,36931,37181,250,0.677,515,-265,18,87,H1
"LaGrange County, IN",2008-2009,37181,37119,-62,-0.167,481,-543,18,87,H1
"LaGrange County, IN",2009-2010,37119,37168,49,0.132,417,-368,18,87,H1
"LaGrange County, IN",2010-2011,37168,37491,323,0.869,503,-180,18,87,H1
"LaGrange County, IN",2011-2012,37491,37635,144,0.384,469,-325,18,87,H1
"LaGrange County, IN",2012-2013,37635,38067,432,1.148,490,-58,18,87,H1
"LaGrange County, IN",2013-2014,38067,38436,369,0.969,512,-143,18,87,H1
"LaGrange County, IN",2014-2015,38462,38809,347,0.902,579,-232,18,87,H1
"LaGrange County, IN",2015-2016,38809,39133,324,0.835,496,-172,18,87,H1
"LaGrange County, IN",2016-2017,39133,39303,170,0.434,499,-329,18,87,H1
"Lake County, IN",2000-2001,484514,484454,-60,-0.012,2359,-2419,18,89,H1
"Lake County, IN",2001-2002,484454,484520,66,0.014,1912,-1846,18,89,H1
"Lake County, IN",2002-2003,484520,485596,1076,0.222,2093,-1017,18,89,H1
"Lake County, IN",2003-2004,485596,487405,1809,0.373,2208,-399,18,89,H1
"Lake County, IN",2004-2005,487405,489530,2125,0.436,2182,-57,18,89,H1
"Lake County, IN",2005-2006,489530,491432,1902,0.389,2176,-274,18,89,H1
"Lake County, IN",2006-2007,491432,493403,1971,0.401,2355,-384,18,89,H1
"Lake County, IN",2007-2008,493403,495479,2076,0.421,2304,-228,18,89,H1
"Lake County, IN",2008-2009,495479,495789,310,0.063,2354,-2044,18,89,H1
"Lake County, IN",2009-2010,495789,496055,266,0.054,2082,-1816,18,89,H1
"Lake County, IN",2010-2011,496055,494820,-1235,-0.249,1655,-2890,18,89,H1
"Lake County, IN",2011-2012,494820,493194,-1626,-0.329,1612,-3238,18,89,H1
"Lake County, IN",2012-2013,493194,491403,-1791,-0.363,1222,-3013,18,89,H1
"Lake County, IN",2013-2014,491403,490228,-1175,-0.239,1095,-2270,18,89,H1
"Lake County, IN",2014-2015,490574,487865,-2709,-0.552,1207,-3916,18,89,H1
"Lake County, IN",2015-2016,487865,486592,-1273,-0.261,970,-2243,18,89,H1
"Lake County, IN",2016-2017,486592,485640,-952,-0.196,902,-1854,18,89,H1
"LaPorte County, IN",2000-2001,110121,110077,-44,-0.04,370,-414,18,91,H1
"LaPorte County, IN",2001-2002,110077,109555,-522,-0.474,373,-895,18,91,H1
"LaPorte County, IN",2002-2003,109555,109027,-528,-0.482,259,-787,18,91,H1
"LaPorte County, IN",2003-2004,109027,108914,-113,-0.104,284,-397,18,91,H1
"LaPorte County, IN",2004-2005,108914,109541,627,0.576,278,349,18,91,H1
"LaPorte County, IN",2005-2006,109541,109641,100,0.091,318,-218,18,91,H1
"LaPorte County, IN",2006-2007,109641,110846,1205,1.099,297,908,18,91,H1
"LaPorte County, IN",2007-2008,110846,111267,421,0.38,376,45,18,91,H1
"LaPorte County, IN",2008-2009,111267,111465,198,0.178,302,-104,18,91,H1
"LaPorte County, IN",2009-2010,111465,111421,-44,-0.039,210,-254,18,91,H1
"LaPorte County, IN",2010-2011,111421,111187,-234,-0.21,188,-422,18,91,H1
"LaPorte County, IN",2011-2012,111187,111158,-29,-0.026,145,-174,18,91,H1
"LaPorte County, IN",2012-2013,111158,111256,98,0.088,159,-61,18,91,H1
"LaPorte County, IN",2013-2014,111256,111444,188,0.169,108,80,18,91,H1
"LaPorte County, IN",2014-2015,111695,110884,-811,-0.726,151,-962,18,91,H1
"LaPorte County, IN",2015-2016,110884,110208,-676,-0.61,146,-822,18,91,H1
"LaPorte County, IN",2016-2017,110208,110029,-179,-0.162,130,-309,18,91,H1
"Lawrence County, IN",2000-2001,45915,45965,50,0.109,115,-65,18,93,H1
"Lawrence County, IN",2001-2002,45965,46039,74,0.161,74,0,18,93,H1
"Lawrence County, IN",2002-2003,46039,46178,139,0.302,114,25,18,93,H1
"Lawrence County, IN",2003-2004,46178,46106,-72,-0.156,-8,-64,18,93,H1
"Lawrence County, IN",2004-2005,46106,46233,127,0.275,39,88,18,93,H1
"Lawrence County, IN",2005-2006,46233,46165,-68,-0.147,87,-155,18,93,H1
"Lawrence County, IN",2006-2007,46165,46300,135,0.292,-6,141,18,93,H1
"Lawrence County, IN",2007-2008,46300,46233,-67,-0.145,40,-107,18,93,H1
"Lawrence County, IN",2008-2009,46233,46138,-95,-0.205,32,-127,18,93,H1
"Lawrence County, IN",2009-2010,46138,46138,0,0,-25,25,18,93,H1
"Lawrence County, IN",2010-2011,46138,46088,-50,-0.108,-23,-27,18,93,H1
"Lawrence County, IN",2011-2012,46088,46045,-43,-0.093,-81,38,18,93,H1
"Lawrence County, IN",2012-2013,46045,45873,-172,-0.374,-41,-131,18,93,H1
"Lawrence County, IN",2013-2014,45873,45704,-169,-0.368,-36,-133,18,93,H1
"Lawrence County, IN",2014-2015,45615,45495,-120,-0.263,-72,-48,18,93,H1
"Lawrence County, IN",2015-2016,45495,45575,80,0.176,-53,133,18,93,H1
"Lawrence County, IN",2016-2017,45575,45666,91,0.2,-46,137,18,93,H1
"Madison County, IN",2000-2001,133213,132920,-293,-0.22,135,-428,18,95,H1
"Madison County, IN",2001-2002,132920,132433,-487,-0.366,197,-684,18,95,H1
"Madison County, IN",2002-2003,132433,131740,-693,-0.523,171,-864,18,95,H1
"Madison County, IN",2003-2004,131740,131366,-374,-0.284,201,-575,18,95,H1
"Madison County, IN",2004-2005,131366,130871,-495,-0.377,98,-593,18,95,H1
"Madison County, IN",2005-2006,130871,131240,369,0.282,262,107,18,95,H1
"Madison County, IN",2006-2007,131240,131203,-37,-0.028,166,-203,18,95,H1
"Madison County, IN",2007-2008,131203,131537,334,0.255,315,19,18,95,H1
"Madison County, IN",2008-2009,131537,131599,62,0.047,188,-126,18,95,H1
"Madison County, IN",2009-2010,131599,131665,66,0.05,131,-65,18,95,H1
"Madison County, IN",2010-2011,131665,131051,-614,-0.466,132,-746,18,95,H1
"Madison County, IN",2011-2012,131051,130284,-767,-0.585,39,-806,18,95,H1
"Madison County, IN",2012-2013,130284,130370,86,0.066,15,71,18,95,H1
"Madison County, IN",2013-2014,130370,130069,-301,-0.231,66,-367,18,95,H1
"Madison County, IN",2014-2015,129999,129723,-276,-0.212,132,-408,18,95,H1
"Madison County, IN",2015-2016,129723,129325,-398,-0.307,23,-421,18,95,H1
"Madison County, IN",2016-2017,129325,129498,173,0.134,55,118,18,95,H1
"Marion County, IN",2000-2001,860832,865662,4830,0.561,6761,-1931,18,97,H6
"Marion County, IN",2001-2002,865662,866210,548,0.063,6900,-6352,18,97,H6
"Marion County, IN",2002-2003,866210,868576,2366,0.273,7180,-4814,18,97,H6
"Marion County, IN",2003-2004,868576,870378,1802,0.207,7323,-5521,18,97,H6
"Marion County, IN",2004-2005,870378,873310,2932,0.337,7123,-4191,18,97,H6
"Marion County, IN",2005-2006,873310,878515,5205,0.596,7606,-2401,18,97,H6
"Marion County, IN",2006-2007,878515,883591,5076,0.578,8334,-3258,18,97,H6
"Marion County, IN",2007-2008,883591,889504,5913,0.669,7735,-1822,18,97,H6
"Marion County, IN",2008-2009,889504,898394,8890,0.999,6987,1903,18,97,H6
"Marion County, IN",2009-2010,898394,904710,6316,0.703,8491,-2175,18,97,H6
"Marion County, IN",2010-2011,904710,910798,6088,0.673,7118,-1030,18,97,H6
"Marion County, IN",2011-2012,910798,918581,7783,0.855,6823,960,18,97,H6
"Marion County, IN",2012-2013,918581,928349,9768,1.063,7048,2720,18,97,H6
"Marion County, IN",2013-2014,928349,934243,5894,0.635,6948,-1054,18,97,H6
"Marion County, IN",2014-2015,934531,939020,4489,0.48,6763,-2274,18,97,H6
"Marion County, IN",2015-2016,939020,944034,5014,0.534,6248,-1234,18,97,H6
"Marion County, IN",2016-2017,944034,950082,6048,0.641,6408,-360,18,97,H6
"Marshall County, IN",2000-2001,45243,45534,291,0.643,317,-26,18,99,H1
"Marshall County, IN",2001-2002,45534,45518,-16,-0.035,259,-275,18,99,H1
"Marshall County, IN",2002-2003,45518,45923,405,0.89,258,147,18,99,H1
"Marshall County, IN",2003-2004,45923,46288,365,0.795,272,93,18,99,H1
"Marshall County, IN",2004-2005,46288,46549,261,0.564,239,22,18,99,H1
"Marshall County, IN",2005-2006,46549,46851,302,0.649,313,-11,18,99,H1
"Marshall County, IN",2006-2007,46851,46871,20,0.043,223,-203,18,99,H1
"Marshall County, IN",2007-2008,46871,47012,141,0.301,249,-108,18,99,H1
"Marshall County, IN",2008-2009,47012,47126,114,0.242,251,-137,18,99,H1
"Marshall County, IN",2009-2010,47126,47008,-118,-0.25,183,-301,18,99,H1
"Marshall County, IN",2010-2011,47008,46981,-27,-0.057,117,-144,18,99,H1
"Marshall County, IN",2011-2012,46981,47025,44,0.094,223,-179,18,99,H1
"Marshall County, IN",2012-2013,47025,47037,12,0.026,126,-114,18,99,H1
"Marshall County, IN",2013-2014,47037,47107,70,0.149,135,-65,18,99,H1
"Marshall County, IN",2014-2015,47013,46857,-156,-0.332,126,-282,18,99,H1
"Marshall County, IN",2015-2016,46857,46652,-205,-0.438,156,-361,18,99,H1
"Marshall County, IN",2016-2017,46652,46498,-154,-0.33,115,-269,18,99,H1
"Martin County, IN",2000-2001,10360,10311,-49,-0.473,25,-74,18,101,H1
"Martin County, IN",2001-2002,10311,10341,30,0.291,33,-3,18,101,H1
"Martin County, IN",2002-2003,10341,10309,-32,-0.309,3,-35,18,101,H1
"Martin County, IN",2003-2004,10309,10361,52,0.504,33,19,18,101,H1
"Martin County, IN",2004-2005,10361,10323,-38,-0.367,6,-44,18,101,H1
"Martin County, IN",2005-2006,10323,10344,21,0.203,22,-1,18,101,H1
"Martin County, IN",2006-2007,10344,10334,-10,-0.097,57,-67,18,101,H1
"Martin County, IN",2007-2008,10334,10304,-30,-0.29,4,-34,18,101,H1
"Martin County, IN",2008-2009,10304,10300,-4,-0.039,2,-6,18,101,H1
"Martin County, IN",2009-2010,10300,10376,76,0.738,5,71,18,101,H1
"Martin County, IN",2010-2011,10376,10338,-38,-0.366,13,-51,18,101,H1
"Martin County, IN",2011-2012,10338,10322,-16,-0.155,44,-60,18,101,H1
"Martin County, IN",2012-2013,10322,10230,-92,-0.891,30,-122,18,101,H1
"Martin County, IN",2013-2014,10230,10203,-27,-0.264,46,-73,18,101,H1
"Martin County, IN",2014-2015,10209,10226,17,0.167,61,-44,18,101,H1
"Martin County, IN",2015-2016,10226,10202,-24,-0.235,34,-58,18,101,H1
"Martin County, IN",2016-2017,10202,10215,13,0.127,29,-16,18,101,H1
"Miami County, IN",2000-2001,36184,36475,291,0.804,175,116,18,103,H1
"Miami County, IN",2001-2002,36475,37019,544,1.491,128,416,18,103,H1
"Miami County, IN",2002-2003,37019,37251,232,0.627,111,121,18,103,H1
"Miami County, IN",2003-2004,37251,37120,-131,-0.352,135,-266,18,103,H1
"Miami County, IN",2004-2005,37120,37445,325,0.876,123,202,18,103,H1
"Miami County, IN",2005-2006,37445,37745,300,0.801,151,149,18,103,H1
"Miami County, IN",2006-2007,37745,37580,-165,-0.437,115,-280,18,103,H1
"Miami County, IN",2007-2008,37580,37281,-299,-0.796,87,-386,18,103,H1
"Miami County, IN",2008-2009,37281,37127,-154,-0.413,95,-249,18,103,H1
"Miami County, IN",2009-2010,37127,36795,-332,-0.894,83,-415,18,103,H1
"Miami County, IN",2010-2011,36795,36585,-210,-0.571,66,-276,18,103,H1
"Miami County, IN",2011-2012,36585,36502,-83,-0.227,-6,-77,18,103,H1
"Miami County, IN",2012-2013,36502,36133,-369,-1.011,-19,-350,18,103,H1
"Miami County, IN",2013-2014,36133,35954,-179,-0.495,10,-189,18,103,H1
"Miami County, IN",2014-2015,35983,35862,-121,-0.336,16,-137,18,103,H1
"Miami County, IN",2015-2016,35862,36067,205,0.572,-9,214,18,103,H1
"Miami County, IN",2016-2017,36067,35845,-222,-0.616,17,-239,18,103,H1
"Monroe County, IN",2000-2001,120872,121696,824,0.682,521,303,18,105,H1
"Monroe County, IN",2001-2002,121696,122628,932,0.766,483,449,18,105,H1
"Monroe County, IN",2002-2003,122628,124514,1886,1.538,446,1440,18,105,H1
"Monroe County, IN",2003-2004,124514,126359,1845,1.482,564,1281,18,105,H1
"Monroe County, IN",2004-2005,126359,128121,1762,1.394,526,1236,18,105,H1
"Monroe County, IN",2005-2006,128121,130677,2556,1.995,563,1993,18,105,H1
"Monroe County, IN",2006-2007,130677,132514,1837,1.406,595,1242,18,105,H1
"Monroe County, IN",2007-2008,132514,134401,1887,1.424,615,1272,18,105,H1
"Monroe County, IN",2008-2009,134401,136198,1797,1.337,607,1190,18,105,H1
"Monroe County, IN",2009-2010,136198,138520,2322,1.705,451,1871,18,105,H1
"Monroe County, IN",2010-2011,138520,140339,1819,1.313,371,1448,18,105,H1
"Monroe County, IN",2011-2012,140339,141289,950,0.677,457,493,18,105,H1
"Monroe County, IN",2012-2013,141289,142020,731,0.517,440,291,18,105,H1
"Monroe County, IN",2013-2014,142020,143339,1319,0.929,462,857,18,105,H1
"Monroe County, IN",2014-2015,143571,144705,1134,0.79,421,713,18,105,H1
"Monroe County, IN",2015-2016,144705,145692,987,0.682,435,552,18,105,H1
"Monroe County, IN",2016-2017,145692,146986,1294,0.888,458,836,18,105,H1
"Montgomery County, IN",2000-2001,37601,37793,192,0.511,86,106,18,107,H1
"Montgomery County, IN",2001-2002,37793,37782,-11,-0.029,145,-156,18,107,H1
"Montgomery County, IN",2002-2003,37782,37634,-148,-0.392,100,-248,18,107,H1
"Montgomery County, IN",2003-2004,37634,37795,161,0.428,93,68,18,107,H1
"Montgomery County, IN",2004-2005,37795,38105,310,0.82,123,187,18,107,H1
"Montgomery County, IN",2005-2006,38105,38040,-65,-0.171,113,-178,18,107,H1
"Montgomery County, IN",2006-2007,38040,38172,132,0.347,74,58,18,107,H1
"Montgomery County, IN",2007-2008,38172,38204,32,0.084,108,-76,18,107,H1
"Montgomery County, IN",2008-2009,38204,38180,-24,-0.063,117,-141,18,107,H1
"Montgomery County, IN",2009-2010,38180,38096,-84,-0.22,81,-165,18,107,H1
"Montgomery County, IN",2010-2011,38096,38343,247,0.648,111,136,18,107,H1
"Montgomery County, IN",2011-2012,38343,38202,-141,-0.368,22,-163,18,107,H1
"Montgomery County, IN",2012-2013,38202,38130,-72,-0.188,126,-198,18,107,H1
"Montgomery County, IN",2013-2014,38130,38146,16,0.042,116,-100,18,107,H1
"Montgomery County, IN",2014-2015,38060,38227,167,0.439,92,75,18,107,H1
"Montgomery County, IN",2015-2016,38227,38323,96,0.251,82,14,18,107,H1
"Montgomery County, IN",2016-2017,38323,38525,202,0.527,89,113,18,107,H1
"Morgan County, IN",2000-2001,66838,66884,46,0.069,390,-344,18,109,H1
"Morgan County, IN",2001-2002,66884,67266,382,0.571,338,44,18,109,H1
"Morgan County, IN",2002-2003,67266,67729,463,0.688,311,152,18,109,H1
"Morgan County, IN",2003-2004,67729,67795,66,0.097,318,-252,18,109,H1
"Morgan County, IN",2004-2005,67795,68037,242,0.357,292,-50,18,109,H1
"Morgan County, IN",2005-2006,68037,68308,271,0.398,336,-65,18,109,H1
"Morgan County, IN",2006-2007,68308,68354,46,0.067,246,-200,18,109,H1
"Morgan County, IN",2007-2008,68354,68964,610,0.892,309,301,18,109,H1
"Morgan County, IN",2008-2009,68964,68583,-381,-0.552,309,-690,18,109,H1
"Morgan County, IN",2009-2010,68583,69156,573,0.835,182,391,18,109,H1
"Morgan County, IN",2010-2011,69156,69206,50,0.072,173,-123,18,109,H1
"Morgan County, IN",2011-2012,69206,69216,10,0.014,116,-106,18,109,H1
"Morgan County, IN",2012-2013,69216,69446,230,0.332,149,81,18,109,H1
"Morgan County, IN",2013-2014,69446,69693,247,0.356,131,116,18,109,H1
"Morgan County, IN",2014-2015,69590,69648,58,0.083,104,-46,18,109,H1
"Morgan County, IN",2015-2016,69648,69557,-91,-0.131,69,-160,18,109,H1
"Morgan County, IN",2016-2017,69557,69713,156,0.224,96,60,18,109,H1
"Newton County, IN",2000-2001,14525,14358,-167,-1.15,10,-177,18,111,H1
"Newton County, IN",2001-2002,14358,14343,-15,-0.104,37,-52,18,111,H1
"Newton County, IN",2002-2003,14343,14446,103,0.718,7,96,18,111,H1
"Newton County, IN",2003-2004,14446,14386,-60,-0.415,-10,-50,18,111,H1
"Newton County, IN",2004-2005,14386,14485,99,0.688,-23,122,18,111,H1
"Newton County, IN",2005-2006,14485,14326,-159,-1.098,-22,-137,18,111,H1
"Newton County, IN",2006-2007,14326,14374,48,0.335,0,48,18,111,H1
"Newton County, IN",2007-2008,14374,14348,-26,-0.181,6,-32,18,111,H1
"Newton County, IN",2008-2009,14348,14207,-141,-0.983,1,-142,18,111,H1
"Newton County, IN",2009-2010,14207,14257,50,0.352,-28,78,18,111,H1
"Newton County, IN",2010-2011,14257,14129,-128,-0.898,-38,-90,18,111,H1
"Newton County, IN",2011-2012,14129,14079,-50,-0.354,6,-56,18,111,H1
"Newton County, IN",2012-2013,14079,14079,0,0,12,-12,18,111,H1
"Newton County, IN",2013-2014,14079,14156,77,0.547,16,61,18,111,H1
"Newton County, IN",2014-2015,14072,14008,-64,-0.455,-10,-54,18,111,H1
"Newton County, IN",2015-2016,14008,14049,41,0.293,52,-11,18,111,H1
"Newton County, IN",2016-2017,14049,14130,81,0.577,32,49,18,111,H1
"Noble County, IN",2000-2001,46640,47110,470,1.008,392,78,18,113,H1
"Noble County, IN",2001-2002,47110,46884,-226,-0.48,295,-521,18,113,H1
"Noble County, IN",2002-2003,46884,46917,33,0.07,306,-273,18,113,H1
"Noble County, IN",2003-2004,46917,46996,79,0.168,291,-212,18,113,H1
"Noble County, IN",2004-2005,46996,47292,296,0.63,300,-4,18,113,H1
"Noble County, IN",2005-2006,47292,47470,178,0.376,337,-159,18,113,H1
"Noble County, IN",2006-2007,47470,47419,-51,-0.107,337,-388,18,113,H1
"Noble County, IN",2007-2008,47419,47561,142,0.299,320,-178,18,113,H1
"Noble County, IN",2008-2009,47561,47574,13,0.027,300,-287,18,113,H1
"Noble County, IN",2009-2010,47574,47471,-103,-0.217,279,-382,18,113,H1
"Noble County, IN",2010-2011,47471,47460,-11,-0.023,121,-132,18,113,H1
"Noble County, IN",2011-2012,47460,47424,-36,-0.076,137,-173,18,113,H1
"Noble County, IN",2012-2013,47424,47511,87,0.183,164,-77,18,113,H1
"Noble County, IN",2013-2014,47511,47618,107,0.225,154,-47,18,113,H1
"Noble County, IN",2014-2015,47595,47733,138,0.29,150,-12,18,113,H1
"Noble County, IN",2015-2016,47733,47442,-291,-0.61,213,-504,18,113,H1
"Noble County, IN",2016-2017,47442,47452,10,0.021,193,-183,18,113,H1
"Ohio County, IN",2000-2001,5582,5633,51,0.914,19,32,18,115,H1
"Ohio County, IN",2001-2002,5633,5735,102,1.811,-1,103,18,115,H1
"Ohio County, IN",2002-2003,5735,5779,44,0.767,17,27,18,115,H1
"Ohio County, IN",2003-2004,5779,5868,89,1.54,-3,92,18,115,H1
"Ohio County, IN",2004-2005,5868,5943,75,1.278,15,60,18,115,H1
"Ohio County, IN",2005-2006,5943,6022,79,1.329,-1,80,18,115,H1
"Ohio County, IN",2006-2007,6022,5992,-30,-0.498,19,-49,18,115,H1
"Ohio County, IN",2007-2008,5992,6069,77,1.285,26,51,18,115,H1
"Ohio County, IN",2008-2009,6069,6134,65,1.071,17,48,18,115,H1
"Ohio County, IN",2009-2010,6134,6108,-26,-0.424,3,-29,18,115,H1
"Ohio County, IN",2010-2011,6108,6084,-24,-0.393,-11,-13,18,115,H1
"Ohio County, IN",2011-2012,6084,6103,19,0.312,2,17,18,115,H1
"Ohio County, IN",2012-2013,6103,6035,-68,-1.114,5,-73,18,115,H1
"Ohio County, IN",2013-2014,6035,6035,0,0,-6,6,18,115,H1
"Ohio County, IN",2014-2015,6008,5938,-70,-1.165,-17,-53,18,115,H1
"Ohio County, IN",2015-2016,5938,5888,-50,-0.842,-11,-39,18,115,H1
"Ohio County, IN",2016-2017,5888,5828,-60,-1.019,-24,-36,18,115,H1
"Orange County, IN",2000-2001,19316,19373,57,0.295,59,-2,18,117,H1
"Orange County, IN",2001-2002,19373,19439,66,0.341,39,27,18,117,H1
"Orange County, IN",2002-2003,19439,19622,183,0.941,14,169,18,117,H1
"Orange County, IN",2003-2004,19622,19624,2,0.01,59,-57,18,117,H1
"Orange County, IN",2004-2005,19624,19744,120,0.611,8,112,18,117,H1
"Orange County, IN",2005-2006,19744,19666,-78,-0.395,48,-126,18,117,H1
"Orange County, IN",2006-2007,19666,19868,202,1.027,83,119,18,117,H1
"Orange County, IN",2007-2008,19868,19837,-31,-0.156,25,-56,18,117,H1
"Orange County, IN",2008-2009,19837,19931,94,0.474,30,64,18,117,H1
"Orange County, IN",2009-2010,19931,19815,-116,-0.582,16,-132,18,117,H1
"Orange County, IN",2010-2011,19815,19916,101,0.51,6,95,18,117,H1
"Orange County, IN",2011-2012,19916,19696,-220,-1.105,0,-220,18,117,H1
"Orange County, IN",2012-2013,19696,19727,31,0.157,7,24,18,117,H1
"Orange County, IN",2013-2014,19727,19626,-101,-0.512,3,-104,18,117,H1
"Orange County, IN",2014-2015,19686,19605,-81,-0.411,57,-138,18,117,H1
"Orange County, IN",2015-2016,19605,19481,-124,-0.632,23,-147,18,117,H1
"Orange County, IN",2016-2017,19481,19426,-55,-0.282,18,-73,18,117,H1
"Owen County, IN",2000-2001,21837,21954,117,0.536,62,55,18,119,H1
"Owen County, IN",2001-2002,21954,22079,125,0.569,44,81,18,119,H1
"Owen County, IN",2002-2003,22079,22321,242,1.096,19,223,18,119,H1
"Owen County, IN",2003-2004,22321,22190,-131,-0.587,10,-141,18,119,H1
"Owen County, IN",2004-2005,22190,21975,-215,-0.969,30,-245,18,119,H1
"Owen County, IN",2005-2006,21975,21871,-104,-0.473,56,-160,18,119,H1
"Owen County, IN",2006-2007,21871,21838,-33,-0.151,15,-48,18,119,H1
"Owen County, IN",2007-2008,21838,21763,-75,-0.343,-1,-74,18,119,H1
"Owen County, IN",2008-2009,21763,21642,-121,-0.556,15,-136,18,119,H1
"Owen County, IN",2009-2010,21642,21587,-55,-0.254,-22,-33,18,119,H1
"Owen County, IN",2010-2011,21587,21516,-71,-0.329,24,-95,18,119,H1
"Owen County, IN",2011-2012,21516,21363,-153,-0.711,20,-173,18,119,H1
"Owen County, IN",2012-2013,21363,21170,-193,-0.903,-25,-168,18,119,H1
"Owen County, IN",2013-2014,21170,20969,-201,-0.949,-32,-169,18,119,H1
"Owen County, IN",2014-2015,21034,20872,-162,-0.77,17,-179,18,119,H1
"Owen County, IN",2015-2016,20872,20922,50,0.24,2,48,18,119,H1
"Owen County, IN",2016-2017,20922,20839,-83,-0.397,-1,-82,18,119,H1
"Parke County, IN",2000-2001,17179,17202,23,0.134,14,9,18,121,H1
"Parke County, IN",2001-2002,17202,17274,72,0.419,1,71,18,121,H1
"Parke County, IN",2002-2003,17274,17515,241,1.395,29,212,18,121,H1
"Parke County, IN",2003-2004,17515,17460,-55,-0.314,17,-72,18,121,H1
"Parke County, IN",2004-2005,17460,17396,-64,-0.367,15,-79,18,121,H1
"Parke County, IN",2005-2006,17396,17376,-20,-0.115,35,-55,18,121,H1
"Parke County, IN",2006-2007,17376,17449,73,0.42,6,67,18,121,H1
"Parke County, IN",2007-2008,17449,17488,39,0.224,47,-8,18,121,H1
"Parke County, IN",2008-2009,17488,17326,-162,-0.926,45,-207,18,121,H1
"Parke County, IN",2009-2010,17326,17299,-27,-0.156,27,-54,18,121,H1
"Parke County, IN",2010-2011,17299,17123,-176,-1.017,27,-203,18,121,H1
"Parke County, IN",2011-2012,17123,17112,-11,-0.064,28,-39,18,121,H1
"Parke County, IN",2012-2013,17112,17234,122,0.713,46,76,18,121,H1
"Parke County, IN",2013-2014,17234,17233,-1,-0.006,43,-44,18,121,H1
"Parke County, IN",2014-2015,17227,16901,-326,-1.892,26,-352,18,121,H1
"Parke County, IN",2015-2016,16901,16957,56,0.331,63,-7,18,121,H1
"Parke County, IN",2016-2017,16957,16886,-71,-0.419,43,-114,18,121,H1
"Perry County, IN",2000-2001,18865,18893,28,0.148,77,-49,18,123,H1
"Perry County, IN",2001-2002,18893,18903,10,0.053,-15,25,18,123,H1
"Perry County, IN",2002-2003,18903,18963,60,0.317,9,51,18,123,H1
"Perry County, IN",2003-2004,18963,19148,185,0.976,31,154,18,123,H1
"Perry County, IN",2004-2005,19148,19260,112,0.585,37,75,18,123,H1
"Perry County, IN",2005-2006,19260,19202,-58,-0.301,48,-106,18,123,H1
"Perry County, IN",2006-2007,19202,19379,177,0.922,25,152,18,123,H1
"Perry County, IN",2007-2008,19379,19340,-39,-0.201,32,-71,18,123,H1
"Perry County, IN",2008-2009,19340,19331,-9,-0.047,49,-58,18,123,H1
"Perry County, IN",2009-2010,19331,19419,88,0.455,12,76,18,123,H1
"Perry County, IN",2010-2011,19419,19469,50,0.257,10,40,18,123,H1
"Perry County, IN",2011-2012,19469,19429,-40,-0.205,2,-42,18,123,H1
"Perry County, IN",2012-2013,19429,19488,59,0.304,36,23,18,123,H1
"Perry County, IN",2013-2014,19488,19454,-34,-0.174,28,-62,18,123,H1
"Perry County, IN",2014-2015,19387,19347,-40,-0.206,11,-51,18,123,H1
"Perry County, IN",2015-2016,19347,19010,-337,-1.742,47,-384,18,123,H1
"Perry County, IN",2016-2017,19010,19081,71,0.373,57,14,18,123,H1
"Pike County, IN",2000-2001,12826,12905,79,0.616,20,59,18,125,H1
"Pike County, IN",2001-2002,12905,12984,79,0.612,-11,90,18,125,H1
"Pike County, IN",2002-2003,12984,12970,-14,-0.108,-6,-8,18,125,H1
"Pike County, IN",2003-2004,12970,13047,77,0.594,8,69,18,125,H1
"Pike County, IN",2004-2005,13047,12879,-168,-1.288,11,-179,18,125,H1
"Pike County, IN",2005-2006,12879,13016,137,1.064,29,108,18,125,H1
"Pike County, IN",2006-2007,13016,13047,31,0.238,6,25,18,125,H1
"Pike County, IN",2007-2008,13047,13047,0,0,4,-4,18,125,H1
"Pike County, IN",2008-2009,13047,12836,-211,-1.617,-3,-208,18,125,H1
"Pike County, IN",2009-2010,12836,12847,11,0.086,-20,31,18,125,H1
"Pike County, IN",2010-2011,12847,12755,-92,-0.716,-5,-87,18,125,H1
"Pike County, IN",2011-2012,12755,12774,19,0.149,1,18,18,125,H1
"Pike County, IN",2012-2013,12774,12666,-108,-0.845,0,-108,18,125,H1
"Pike County, IN",2013-2014,12666,12624,-42,-0.332,-13,-29,18,125,H1
"Pike County, IN",2014-2015,12641,12594,-47,-0.372,8,-55,18,125,H1
"Pike County, IN",2015-2016,12594,12428,-166,-1.318,-35,-131,18,125,H1
"Pike County, IN",2016-2017,12428,12365,-63,-0.507,-10,-53,18,125,H1
"Porter County, IN",2000-2001,147137,148372,1235,0.839,726,509,18,127,H1
"Porter County, IN",2001-2002,148372,149992,1620,1.092,733,887,18,127,H1
"Porter County, IN",2002-2003,149992,151731,1739,1.159,622,1117,18,127,H1
"Porter County, IN",2003-2004,151731,153664,1933,1.274,668,1265,18,127,H1
"Porter County, IN",2004-2005,153664,156024,2360,1.536,589,1771,18,127,H1
"Porter County, IN",2005-2006,156024,158595,2571,1.648,623,1948,18,127,H1
"Porter County, IN",2006-2007,158595,160835,2240,1.412,669,1571,18,127,H1
"Porter County, IN",2007-2008,160835,162538,1703,1.059,703,1.00E+03,18,127,H1
"Porter County, IN",2008-2009,162538,163572,1034,0.636,792,242,18,127,H1
"Porter County, IN",2009-2010,163572,164491,919,0.562,558,361,18,127,H1
"Porter County, IN",2010-2011,164491,165442,951,0.578,427,524,18,127,H1
"Porter County, IN",2011-2012,165442,165659,217,0.131,480,-263,18,127,H1
"Porter County, IN",2012-2013,165659,166427,768,0.464,321,447,18,127,H1
"Porter County, IN",2013-2014,166427,167076,649,0.39,283,366,18,127,H1
"Porter County, IN",2014-2015,167308,167688,380,0.227,274,106,18,127,H1
"Porter County, IN",2015-2016,167688,167438,-250,-0.149,182,-432,18,127,H1
"Porter County, IN",2016-2017,167438,168404,966,0.577,88,878,18,127,H1
"Posey County, IN",2000-2001,27070,26933,-137,-0.506,23,-160,18,129,H1
"Posey County, IN",2001-2002,26933,26908,-25,-0.093,38,-63,18,129,H1
"Posey County, IN",2002-2003,26908,26736,-172,-0.639,39,-211,18,129,H1
"Posey County, IN",2003-2004,26736,26664,-72,-0.269,56,-128,18,129,H1
"Posey County, IN",2004-2005,26664,26488,-176,-0.66,8,-184,18,129,H1
"Posey County, IN",2005-2006,26488,26348,-140,-0.529,-4,-136,18,129,H1
"Posey County, IN",2006-2007,26348,26229,-119,-0.452,25,-144,18,129,H1
"Posey County, IN",2007-2008,26229,26080,-149,-0.568,13,-162,18,129,H1
"Posey County, IN",2008-2009,26080,25941,-139,-0.533,49,-188,18,129,H1
"Posey County, IN",2009-2010,25941,25855,-86,-0.332,27,-113,18,129,H1
"Posey County, IN",2010-2011,25855,25680,-175,-0.677,42,-217,18,129,H1
"Posey County, IN",2011-2012,25680,25616,-64,-0.249,81,-145,18,129,H1
"Posey County, IN",2012-2013,25616,25515,-101,-0.394,56,-157,18,129,H1
"Posey County, IN",2013-2014,25515,25540,25,0.098,51,-26,18,129,H1
"Posey County, IN",2014-2015,25520,25512,-8,-0.031,42,-50,18,129,H1
"Posey County, IN",2015-2016,25512,25632,120,0.47,28,92,18,129,H1
"Posey County, IN",2016-2017,25632,25595,-37,-0.144,40,-77,18,129,H1
"Pulaski County, IN",2000-2001,13605,13627,22,0.162,15,7,18,131,H1
"Pulaski County, IN",2001-2002,13627,13606,-21,-0.154,19,-40,18,131,H1
"Pulaski County, IN",2002-2003,13606,13634,28,0.206,-7,35,18,131,H1
"Pulaski County, IN",2003-2004,13634,13667,33,0.242,0,33,18,131,H1
"Pulaski County, IN",2004-2005,13667,13682,15,0.11,9,6,18,131,H1
"Pulaski County, IN",2005-2006,13682,13713,31,0.227,4,27,18,131,H1
"Pulaski County, IN",2006-2007,13713,13724,11,0.08,5,6,18,131,H1
"Pulaski County, IN",2007-2008,13724,13646,-78,-0.568,-7,-71,18,131,H1
"Pulaski County, IN",2008-2009,13646,13548,-98,-0.718,3,-101,18,131,H1
"Pulaski County, IN",2009-2010,13548,13345,-203,-1.498,-19,-184,18,131,H1
"Pulaski County, IN",2010-2011,13345,13280,-65,-0.487,-17,-48,18,131,H1
"Pulaski County, IN",2011-2012,13280,13053,-227,-1.709,-31,-196,18,131,H1
"Pulaski County, IN",2012-2013,13053,13004,-49,-0.375,-3,-46,18,131,H1
"Pulaski County, IN",2013-2014,13004,12967,-37,-0.285,1,-38,18,131,H1
"Pulaski County, IN",2014-2015,12979,12889,-90,-0.693,8,-98,18,131,H1
"Pulaski County, IN",2015-2016,12889,12611,-278,-2.157,-11,-267,18,131,H1
"Pulaski County, IN",2016-2017,12611,12534,-77,-0.611,-7,-70,18,131,H1
"Putnam County, IN",2000-2001,36180,36382,202,0.558,101,101,18,133,H1
"Putnam County, IN",2001-2002,36382,36525,143,0.393,80,63,18,133,H1
"Putnam County, IN",2002-2003,36525,37145,620,1.697,91,529,18,133,H1
"Putnam County, IN",2003-2004,37145,37516,371,0.999,94,277,18,133,H1
"Putnam County, IN",2004-2005,37516,37780,264,0.704,111,153,18,133,H1
"Putnam County, IN",2005-2006,37780,37768,-12,-0.032,79,-91,18,133,H1
"Putnam County, IN",2006-2007,37768,38189,421,1.115,79,342,18,133,H1
"Putnam County, IN",2007-2008,38189,38325,136,0.356,99,37,18,133,H1
"Putnam County, IN",2008-2009,38325,38052,-273,-0.712,108,-381,18,133,H1
"Putnam County, IN",2009-2010,38052,37928,-124,-0.326,52,-176,18,133,H1
"Putnam County, IN",2010-2011,37928,37882,-46,-0.121,27,-73,18,133,H1
"Putnam County, IN",2011-2012,37882,37681,-201,-0.531,5,-206,18,133,H1
"Putnam County, IN",2012-2013,37681,37532,-149,-0.395,-1,-148,18,133,H1
"Putnam County, IN",2013-2014,37532,37618,86,0.229,4,82,18,133,H1
"Putnam County, IN",2014-2015,37660,37585,-75,-0.199,65,-140,18,133,H1
"Putnam County, IN",2015-2016,37585,37265,-320,-0.851,4,-324,18,133,H1
"Putnam County, IN",2016-2017,37265,37702,437,1.173,24,413,18,133,H1
"Randolph County, IN",2000-2001,27363,27166,-197,-0.72,24,-221,18,135,H1
"Randolph County, IN",2001-2002,27166,26989,-177,-0.652,-28,-149,18,135,H1
"Randolph County, IN",2002-2003,26989,26763,-226,-0.837,42,-268,18,135,H1
"Randolph County, IN",2003-2004,26763,26582,-181,-0.676,39,-220,18,135,H1
"Randolph County, IN",2004-2005,26582,26517,-65,-0.245,28,-93,18,135,H1
"Randolph County, IN",2005-2006,26517,26415,-102,-0.385,2,-104,18,135,H1
"Randolph County, IN",2006-2007,26415,26223,-192,-0.727,37,-229,18,135,H1
"Randolph County, IN",2007-2008,26223,26300,77,0.294,8,69,18,135,H1
"Randolph County, IN",2008-2009,26300,26240,-60,-0.228,26,-86,18,135,H1
"Randolph County, IN",2009-2010,26240,26165,-75,-0.286,12,-87,18,135,H1
"Randolph County, IN",2010-2011,26165,26005,-160,-0.612,11,-171,18,135,H1
"Randolph County, IN",2011-2012,26005,25835,-170,-0.654,8,-178,18,135,H1
"Randolph County, IN",2012-2013,25835,25616,-219,-0.848,44,-263,18,135,H1
"Randolph County, IN",2013-2014,25616,25384,-232,-0.906,56,-288,18,135,H1
"Randolph County, IN",2014-2015,25341,25172,-169,-0.667,42,-211,18,135,H1
"Randolph County, IN",2015-2016,25172,25059,-113,-0.449,14,-127,18,135,H1
"Randolph County, IN",2016-2017,25059,24922,-137,-0.547,23,-160,18,135,H1
"Ripley County, IN",2000-2001,26654,27130,476,1.786,205,271,18,137,H1
"Ripley County, IN",2001-2002,27130,27421,291,1.073,147,144,18,137,H1
"Ripley County, IN",2002-2003,27421,27615,194,0.707,129,65,18,137,H1
"Ripley County, IN",2003-2004,27615,27849,234,0.847,116,118,18,137,H1
"Ripley County, IN",2004-2005,27849,28040,191,0.686,117,74,18,137,H1
"Ripley County, IN",2005-2006,28040,28352,312,1.113,123,189,18,137,H1
"Ripley County, IN",2006-2007,28352,28361,9,0.032,117,-108,18,137,H1
"Ripley County, IN",2007-2008,28361,28605,244,0.86,119,125,18,137,H1
"Ripley County, IN",2008-2009,28605,28716,111,0.388,106,5,18,137,H1
"Ripley County, IN",2009-2010,28716,28815,99,0.345,75,24,18,137,H1
"Ripley County, IN",2010-2011,28815,28719,-96,-0.333,21,-117,18,137,H1
"Ripley County, IN",2011-2012,28719,28529,-190,-0.662,48,-238,18,137,H1
"Ripley County, IN",2012-2013,28529,28443,-86,-0.301,49,-135,18,137,H1
"Ripley County, IN",2013-2014,28443,28497,54,0.19,40,14,18,137,H1
"Ripley County, IN",2014-2015,28548,28701,153,0.536,42,111,18,137,H1
"Ripley County, IN",2015-2016,28701,28408,-293,-1.021,34,-327,18,137,H1
"Ripley County, IN",2016-2017,28408,28442,34,0.12,-7,41,18,137,H1
"Rush County, IN",2000-2001,18194,18145,-49,-0.269,70,-119,18,139,H1
"Rush County, IN",2001-2002,18145,18034,-111,-0.612,65,-176,18,139,H1
"Rush County, IN",2002-2003,18034,18090,56,0.311,85,-29,18,139,H1
"Rush County, IN",2003-2004,18090,17869,-221,-1.222,-1,-220,18,139,H1
"Rush County, IN",2004-2005,17869,17826,-43,-0.241,26,-69,18,139,H1
"Rush County, IN",2005-2006,17826,17723,-103,-0.578,41,-144,18,139,H1
"Rush County, IN",2006-2007,17723,17756,33,0.186,102,-69,18,139,H1
"Rush County, IN",2007-2008,17756,17543,-213,-1.2,6,-219,18,139,H1
"Rush County, IN",2008-2009,17543,17461,-82,-0.467,9,-91,18,139,H1
"Rush County, IN",2009-2010,17461,17367,-94,-0.538,11,-105,18,139,H1
"Rush County, IN",2010-2011,17367,17317,-50,-0.288,-33,-17,18,139,H1
"Rush County, IN",2011-2012,17317,17134,-183,-1.057,2,-185,18,139,H1
"Rush County, IN",2012-2013,17134,17025,-109,-0.636,-3,-106,18,139,H1
"Rush County, IN",2013-2014,17025,16892,-133,-0.781,13,-146,18,139,H1
"Rush County, IN",2014-2015,16834,16672,-162,-0.962,-25,-137,18,139,H1
"Rush County, IN",2015-2016,16672,16633,-39,-0.234,3,-42,18,139,H1
"Rush County, IN",2016-2017,16633,16645,12,0.072,-4,16,18,139,H1
"St. Joseph County, IN",2000-2001,265845,265502,-343,-0.129,1461,-1804,18,141,H1
"St. Joseph County, IN",2001-2002,265502,265090,-412,-0.155,1309,-1721,18,141,H1
"St. Joseph County, IN",2002-2003,265090,264762,-328,-0.124,1421,-1749,18,141,H1
"St. Joseph County, IN",2003-2004,264762,264541,-221,-0.083,1381,-1602,18,141,H1
"St. Joseph County, IN",2004-2005,264541,264863,322,0.122,1247,-925,18,141,H1
"St. Joseph County, IN",2005-2006,264863,265496,633,0.239,1498,-865,18,141,H1
"St. Joseph County, IN",2006-2007,265496,266045,549,0.207,1517,-968,18,141,H1
"St. Joseph County, IN",2007-2008,266045,267282,1237,0.465,1471,-234,18,141,H1
"St. Joseph County, IN",2008-2009,267282,266827,-455,-0.17,1458,-1913,18,141,H1
"St. Joseph County, IN",2009-2010,266827,266784,-43,-0.016,1415,-1458,18,141,H1
"St. Joseph County, IN",2010-2011,266784,266756,-28,-0.01,1004,-1032,18,141,H1
"St. Joseph County, IN",2011-2012,266756,266571,-185,-0.069,982,-1167,18,141,H1
"St. Joseph County, IN",2012-2013,266571,266850,279,0.105,1115,-836,18,141,H1
"St. Joseph County, IN",2013-2014,266850,267618,768,0.288,1075,-307,18,141,H1
"St. Joseph County, IN",2014-2015,267679,268441,762,0.285,1178,-416,18,141,H1
"St. Joseph County, IN",2015-2016,268441,269613,1172,0.437,956,216,18,141,H1
"St. Joseph County, IN",2016-2017,269613,270434,821,0.305,1029,-208,18,141,H1
"Scott County, IN",2000-2001,23049,23332,283,1.228,84,199,18,143,H1
"Scott County, IN",2001-2002,23332,23370,38,0.163,59,-21,18,143,H1
"Scott County, IN",2002-2003,23370,23638,268,1.147,79,189,18,143,H1
"Scott County, IN",2003-2004,23638,23626,-12,-0.051,69,-81,18,143,H1
"Scott County, IN",2004-2005,23626,23889,263,1.113,34,229,18,143,H1
"Scott County, IN",2005-2006,23889,23982,93,0.389,98,-5,18,143,H1
"Scott County, IN",2006-2007,23982,24137,155,0.646,105,50,18,143,H1
"Scott County, IN",2007-2008,24137,24089,-48,-0.199,38,-86,18,143,H1
"Scott County, IN",2008-2009,24089,24165,76,0.315,18,58,18,143,H1
"Scott County, IN",2009-2010,24165,24193,28,0.116,1,27,18,143,H1
"Scott County, IN",2010-2011,24193,23945,-248,-1.025,-6,-242,18,143,H1
"Scott County, IN",2011-2012,23945,23784,-161,-0.672,-18,-143,18,143,H1
"Scott County, IN",2012-2013,23784,23852,68,0.286,-2,70,18,143,H1
"Scott County, IN",2013-2014,23852,23712,-140,-0.587,-9,-131,18,143,H1
"Scott County, IN",2014-2015,23678,23744,66,0.279,-12,78,18,143,H1
"Scott County, IN",2015-2016,23744,23707,-37,-0.156,19,-56,18,143,H1
"Scott County, IN",2016-2017,23707,23870,163,0.688,-6,169,18,143,H1
"Shelby County, IN",2000-2001,43479,43746,267,0.614,275,-8,18,145,H1
"Shelby County, IN",2001-2002,43746,43577,-169,-0.386,146,-315,18,145,H1
"Shelby County, IN",2002-2003,43577,43385,-192,-0.441,201,-393,18,145,H1
"Shelby County, IN",2003-2004,43385,43488,103,0.237,162,-59,18,145,H1
"Shelby County, IN",2004-2005,43488,43482,-6,-0.014,117,-123,18,145,H1
"Shelby County, IN",2005-2006,43482,43812,330,0.759,134,196,18,145,H1
"Shelby County, IN",2006-2007,43812,44086,274,0.625,124,150,18,145,H1
"Shelby County, IN",2007-2008,44086,44345,259,0.587,170,89,18,145,H1
"Shelby County, IN",2008-2009,44345,44551,206,0.465,153,53,18,145,H1
"Shelby County, IN",2009-2010,44551,44322,-229,-0.514,86,-315,18,145,H1
"Shelby County, IN",2010-2011,44322,44355,33,0.074,66,-33,18,145,H1
"Shelby County, IN",2011-2012,44355,44382,27,0.061,95,-68,18,145,H1
"Shelby County, IN",2012-2013,44382,44502,120,0.27,78,42,18,145,H1
"Shelby County, IN",2013-2014,44502,44579,77,0.173,61,16,18,145,H1
"Shelby County, IN",2014-2015,44531,44478,-53,-0.119,70,-123,18,145,H1
"Shelby County, IN",2015-2016,44478,44228,-250,-0.562,66,-316,18,145,H1
"Shelby County, IN",2016-2017,44228,44395,167,0.378,47,120,18,145,H1
"Spencer County, IN",2000-2001,20432,20465,33,0.162,101,-68,18,147,H1
"Spencer County, IN",2001-2002,20465,20422,-43,-0.21,20,-63,18,147,H1
"Spencer County, IN",2002-2003,20422,20529,107,0.524,16,91,18,147,H1
"Spencer County, IN",2003-2004,20529,20605,76,0.37,67,9,18,147,H1
"Spencer County, IN",2004-2005,20605,20896,291,1.412,54,237,18,147,H1
"Spencer County, IN",2005-2006,20896,20977,81,0.388,51,30,18,147,H1
"Spencer County, IN",2006-2007,20977,21032,55,0.262,63,-8,18,147,H1
"Spencer County, IN",2007-2008,21032,20978,-54,-0.257,57,-111,18,147,H1
"Spencer County, IN",2008-2009,20978,20992,14,0.067,35,-21,18,147,H1
"Spencer County, IN",2009-2010,20992,20890,-102,-0.486,11,-113,18,147,H1
"Spencer County, IN",2010-2011,20890,21056,166,0.795,49,117,18,147,H1
"Spencer County, IN",2011-2012,21056,20875,-181,-0.86,51,-232,18,147,H1
"Spencer County, IN",2012-2013,20875,20844,-31,-0.149,-19,-12,18,147,H1
"Spencer County, IN",2013-2014,20844,20801,-43,-0.206,-27,-16,18,147,H1
"Spencer County, IN",2014-2015,20831,20715,-116,-0.557,11,-127,18,147,H1
"Spencer County, IN",2015-2016,20715,20493,-222,-1.072,-29,-193,18,147,H1
"Spencer County, IN",2016-2017,20493,20394,-99,-0.483,-53,-46,18,147,H1
"Starke County, IN",2000-2001,23525,23217,-308,-1.309,50,-358,18,149,H1
"Starke County, IN",2001-2002,23217,23361,144,0.62,39,105,18,149,H1
"Starke County, IN",2002-2003,23361,23336,-25,-0.107,59,-84,18,149,H1
"Starke County, IN",2003-2004,23336,23310,-26,-0.111,27,-53,18,149,H1
"Starke County, IN",2004-2005,23310,23394,84,0.36,25,59,18,149,H1
"Starke County, IN",2005-2006,23394,23362,-32,-0.137,-8,-24,18,149,H1
"Starke County, IN",2006-2007,23362,23260,-102,-0.437,3,-105,18,149,H1
"Starke County, IN",2007-2008,23260,23379,119,0.512,71,48,18,149,H1
"Starke County, IN",2008-2009,23379,23343,-36,-0.154,81,-117,18,149,H1
"Starke County, IN",2009-2010,23343,23370,27,0.116,43,-16,18,149,H1
"Starke County, IN",2010-2011,23370,23219,-151,-0.646,6,-157,18,149,H1
"Starke County, IN",2011-2012,23219,23197,-22,-0.095,-8,-14,18,149,H1
"Starke County, IN",2012-2013,23197,23215,18,0.078,23,-5,18,149,H1
"Starke County, IN",2013-2014,23215,23074,-141,-0.607,0,-141,18,149,H1
"Starke County, IN",2014-2015,23037,22958,-79,-0.343,-14,-65,18,149,H1
"Starke County, IN",2015-2016,22958,22992,34,0.148,-11,45,18,149,H1
"Starke County, IN",2016-2017,22992,22893,-99,-0.431,-25,-74,18,149,H1
"Steuben County, IN",2000-2001,33339,33556,217,0.651,161,56,18,151,H1
"Steuben County, IN",2001-2002,33556,33496,-60,-0.179,183,-243,18,151,H1
"Steuben County, IN",2002-2003,33496,33789,293,0.875,177,116,18,151,H1
"Steuben County, IN",2003-2004,33789,33718,-71,-0.21,100,-171,18,151,H1
"Steuben County, IN",2004-2005,33718,33926,208,0.617,166,42,18,151,H1
"Steuben County, IN",2005-2006,33926,34044,118,0.348,152,-34,18,151,H1
"Steuben County, IN",2006-2007,34044,34004,-40,-0.117,103,-143,18,151,H1
"Steuben County, IN",2007-2008,34004,34055,51,0.15,133,-82,18,151,H1
"Steuben County, IN",2008-2009,34055,34194,139,0.408,131,8,18,151,H1
"Steuben County, IN",2009-2010,34194,34135,-59,-0.173,99,-158,18,151,H1
"Steuben County, IN",2010-2011,34135,34058,-77,-0.226,74,-151,18,151,H1
"Steuben County, IN",2011-2012,34058,34155,97,0.285,71,26,18,151,H1
"Steuben County, IN",2012-2013,34155,34294,139,0.407,43,96,18,151,H1
"Steuben County, IN",2013-2014,34294,34308,14,0.041,49,-35,18,151,H1
"Steuben County, IN",2014-2015,34406,34372,-34,-0.099,116,-150,18,151,H1
"Steuben County, IN",2015-2016,34372,34388,16,0.047,89,-73,18,151,H1
"Steuben County, IN",2016-2017,34388,34484,96,0.279,92,4,18,151,H1
"Sullivan County, IN",2000-2001,21756,21771,15,0.069,-11,26,18,153,H1
"Sullivan County, IN",2001-2002,21771,21792,21,0.096,-17,38,18,153,H1
"Sullivan County, IN",2002-2003,21792,21801,9,0.041,-2,11,18,153,H1
"Sullivan County, IN",2003-2004,21801,21809,8,0.037,0,8,18,153,H1
"Sullivan County, IN",2004-2005,21809,21689,-120,-0.55,0,-120,18,153,H1
"Sullivan County, IN",2005-2006,21689,21540,-149,-0.687,-13,-136,18,153,H1
"Sullivan County, IN",2006-2007,21540,21558,18,0.084,-11,29,18,153,H1
"Sullivan County, IN",2007-2008,21558,21550,-8,-0.037,-4,-4,18,153,H1
"Sullivan County, IN",2008-2009,21550,21483,-67,-0.311,-19,-48,18,153,H1
"Sullivan County, IN",2009-2010,21483,21419,-64,-0.298,-34,-30,18,153,H1
"Sullivan County, IN",2010-2011,21419,21246,-173,-0.808,-12,-161,18,153,H1
"Sullivan County, IN",2011-2012,21246,21227,-19,-0.089,12,-31,18,153,H1
"Sullivan County, IN",2012-2013,21227,21193,-34,-0.16,16,-50,18,153,H1
"Sullivan County, IN",2013-2014,21193,21050,-143,-0.675,28,-171,18,153,H1
"Sullivan County, IN",2014-2015,21003,20928,-75,-0.357,39,-114,18,153,H1
"Sullivan County, IN",2015-2016,20928,20737,-191,-0.913,-22,-169,18,153,H1
"Sullivan County, IN",2016-2017,20737,20746,9,0.043,-5,14,18,153,H1
"Switzerland County, IN",2000-2001,9129,9465,336,3.681,16,320,18,155,H1
"Switzerland County, IN",2001-2002,9465,9711,246,2.599,17,229,18,155,H1
"Switzerland County, IN",2002-2003,9711,9722,11,0.113,6,5,18,155,H1
"Switzerland County, IN",2003-2004,9722,9863,141,1.45,26,115,18,155,H1
"Switzerland County, IN",2004-2005,9863,10165,302,3.062,28,274,18,155,H1
"Switzerland County, IN",2005-2006,10165,10151,-14,-0.138,23,-37,18,155,H1
"Switzerland County, IN",2006-2007,10151,10271,120,1.182,44,76,18,155,H1
"Switzerland County, IN",2007-2008,10271,10387,116,1.129,41,75,18,155,H1
"Switzerland County, IN",2008-2009,10387,10541,154,1.483,16,138,18,155,H1
"Switzerland County, IN",2009-2010,10541,10622,81,0.768,-4,85,18,155,H1
"Switzerland County, IN",2010-2011,10622,10567,-55,-0.518,17,-72,18,155,H1
"Switzerland County, IN",2011-2012,10567,10402,-165,-1.561,14,-179,18,155,H1
"Switzerland County, IN",2012-2013,10402,10528,126,1.211,12,114,18,155,H1
"Switzerland County, IN",2013-2014,10528,10452,-76,-0.722,2,-78,18,155,H1
"Switzerland County, IN",2014-2015,10490,10524,34,0.324,25,9,18,155,H1
"Switzerland County, IN",2015-2016,10524,10647,123,1.169,30,93,18,155,H1
"Switzerland County, IN",2016-2017,10647,10696,49,0.46,8,41,18,155,H1
"Tippecanoe County, IN",2000-2001,149359,151095,1736,1.162,952,784,18,157,H1
"Tippecanoe County, IN",2001-2002,151095,152348,1253,0.829,921,332,18,157,H1
"Tippecanoe County, IN",2002-2003,152348,154040,1692,1.111,1010,682,18,157,H1
"Tippecanoe County, IN",2003-2004,154040,155832,1792,1.163,1065,727,18,157,H1
"Tippecanoe County, IN",2004-2005,155832,158834,3002,1.926,1047,1955,18,157,H1
"Tippecanoe County, IN",2005-2006,158834,163010,4176,2.629,1133,3043,18,157,H1
"Tippecanoe County, IN",2006-2007,163010,166226,3216,1.973,1218,1998,18,157,H1
"Tippecanoe County, IN",2007-2008,166226,169039,2813,1.692,1249,1564,18,157,H1
"Tippecanoe County, IN",2008-2009,169039,171937,2898,1.714,1208,1690,18,157,H1
"Tippecanoe County, IN",2009-2010,171937,173011,1074,0.625,1126,-52,18,157,H1
"Tippecanoe County, IN",2010-2011,173011,175485,2474,1.43,1050,1424,18,157,H1
"Tippecanoe County, IN",2011-2012,175485,178180,2695,1.536,1127,1568,18,157,H1
"Tippecanoe County, IN",2012-2013,178180,180925,2745,1.541,1254,1491,18,157,H1
"Tippecanoe County, IN",2013-2014,180925,183074,2149,1.188,1263,886,18,157,H1
"Tippecanoe County, IN",2014-2015,183670,185826,2156,1.174,1159,997,18,157,H1
"Tippecanoe County, IN",2015-2016,185826,188674,2848,1.533,1268,1580,18,157,H1
"Tippecanoe County, IN",2016-2017,188674,190587,1913,1.014,1256,657,18,157,H1
"Tipton County, IN",2000-2001,16582,16508,-74,-0.446,25,-99,18,159,H1
"Tipton County, IN",2001-2002,16508,16529,21,0.127,27,-6,18,159,H1
"Tipton County, IN",2002-2003,16529,16511,-18,-0.109,83,-101,18,159,H1
"Tipton County, IN",2003-2004,16511,16510,-1,-0.006,32,-33,18,159,H1
"Tipton County, IN",2004-2005,16510,16411,-99,-0.6,25,-124,18,159,H1
"Tipton County, IN",2005-2006,16411,16326,-85,-0.518,27,-112,18,159,H1
"Tipton County, IN",2006-2007,16326,16257,-69,-0.423,7,-76,18,159,H1
"Tipton County, IN",2007-2008,16257,16137,-120,-0.738,24,-144,18,159,H1
"Tipton County, IN",2008-2009,16137,16046,-91,-0.564,34,-125,18,159,H1
"Tipton County, IN",2009-2010,16046,15874,-172,-1.072,22,-194,18,159,H1
"Tipton County, IN",2010-2011,15874,15846,-28,-0.176,-11,-17,18,159,H1
"Tipton County, IN",2011-2012,15846,15721,-125,-0.789,-32,-93,18,159,H1
"Tipton County, IN",2012-2013,15721,15584,-137,-0.871,-32,-105,18,159,H1
"Tipton County, IN",2013-2014,15584,15415,-169,-1.084,-28,-141,18,159,H1
"Tipton County, IN",2014-2015,15429,15267,-162,-1.05,-22,-140,18,159,H1
"Tipton County, IN",2015-2016,15267,15154,-113,-0.74,-14,-99,18,159,H1
"Tipton County, IN",2016-2017,15154,15128,-26,-0.172,-17,-9,18,159,H1
"Union County, IN",2000-2001,7343,7323,-20,-0.272,13,-33,18,161,H1
"Union County, IN",2001-2002,7323,7366,43,0.587,13,30,18,161,H1
"Union County, IN",2002-2003,7366,7293,-73,-0.991,11,-84,18,161,H1
"Union County, IN",2003-2004,7293,7291,-2,-0.027,30,-32,18,161,H1
"Union County, IN",2004-2005,7291,7378,87,1.193,13,74,18,161,H1
"Union County, IN",2005-2006,7378,7432,54,0.732,30,24,18,161,H1
"Union County, IN",2006-2007,7432,7467,35,0.471,27,8,18,161,H1
"Union County, IN",2007-2008,7467,7428,-39,-0.522,40,-79,18,161,H1
"Union County, IN",2008-2009,7428,7466,38,0.512,23,15,18,161,H1
"Union County, IN",2009-2010,7466,7538,72,0.964,18,54,18,161,H1
"Union County, IN",2010-2011,7538,7477,-61,-0.809,7,-68,18,161,H1
"Union County, IN",2011-2012,7477,7340,-137,-1.832,13,-150,18,161,H1
"Union County, IN",2012-2013,7340,7309,-31,-0.422,11,-42,18,161,H1
"Union County, IN",2013-2014,7309,7246,-63,-0.862,4,-67,18,161,H1
"Union County, IN",2014-2015,7225,7182,-43,-0.595,8,-51,18,161,H1
"Union County, IN",2015-2016,7182,7168,-14,-0.195,0,-14,18,161,H1
"Union County, IN",2016-2017,7168,7200,32,0.446,-4,36,18,161,H1
"Vanderburgh County, IN",2000-2001,172052,172449,397,0.231,468,-71,18,163,H1
"Vanderburgh County, IN",2001-2002,172449,173067,618,0.358,307,311,18,163,H1
"Vanderburgh County, IN",2002-2003,173067,174239,1172,0.677,498,674,18,163,H1
"Vanderburgh County, IN",2003-2004,174239,175113,874,0.502,497,377,18,163,H1
"Vanderburgh County, IN",2004-2005,175113,175769,656,0.375,629,27,18,163,H1
"Vanderburgh County, IN",2005-2006,175769,176822,1053,0.599,601,452,18,163,H1
"Vanderburgh County, IN",2006-2007,176822,177789,967,0.547,756,211,18,163,H1
"Vanderburgh County, IN",2007-2008,177789,178053,264,0.148,571,-307,18,163,H1
"Vanderburgh County, IN",2008-2009,178053,178995,942,0.529,530,412,18,163,H1
"Vanderburgh County, IN",2009-2010,178995,179790,795,0.444,532,263,18,163,H1
"Vanderburgh County, IN",2010-2011,179790,180285,495,0.275,431,64,18,163,H1
"Vanderburgh County, IN",2011-2012,180285,180781,496,0.275,465,31,18,163,H1
"Vanderburgh County, IN",2012-2013,180781,181524,743,0.411,494,249,18,163,H1
"Vanderburgh County, IN",2013-2014,181524,182006,482,0.266,535,-53,18,163,H1
"Vanderburgh County, IN",2014-2015,181918,181877,-41,-0.023,449,-490,18,163,H1
"Vanderburgh County, IN",2015-2016,181877,181775,-102,-0.056,260,-362,18,163,H1
"Vanderburgh County, IN",2016-2017,181775,181616,-159,-0.087,307,-466,18,163,H1
"Vermillion County, IN",2000-2001,16772,16639,-133,-0.793,-26,-107,18,165,H1
"Vermillion County, IN",2001-2002,16639,16556,-83,-0.499,-46,-37,18,165,H1
"Vermillion County, IN",2002-2003,16556,16493,-63,-0.381,-36,-27,18,165,H1
"Vermillion County, IN",2003-2004,16493,16515,22,0.133,-12,34,18,165,H1
"Vermillion County, IN",2004-2005,16515,16603,88,0.533,14,74,18,165,H1
"Vermillion County, IN",2005-2006,16603,16585,-18,-0.108,-19,1,18,165,H1
"Vermillion County, IN",2006-2007,16585,16561,-24,-0.145,-29,5,18,165,H1
"Vermillion County, IN",2007-2008,16561,16387,-174,-1.051,-11,-163,18,165,H1
"Vermillion County, IN",2008-2009,16387,16377,-10,-0.061,-25,15,18,165,H1
"Vermillion County, IN",2009-2010,16377,16145,-232,-1.417,-34,-198,18,165,H1
"Vermillion County, IN",2010-2011,16145,16112,-33,-0.204,-56,23,18,165,H1
"Vermillion County, IN",2011-2012,16112,15955,-157,-0.974,-63,-94,18,165,H1
"Vermillion County, IN",2012-2013,15955,15855,-100,-0.627,-24,-76,18,165,H1
"Vermillion County, IN",2013-2014,15855,15693,-162,-1.022,-39,-123,18,165,H1
"Vermillion County, IN",2014-2015,15694,15692,-2,-0.013,-23,21,18,165,H1
"Vermillion County, IN",2015-2016,15692,15611,-81,-0.516,-42,-39,18,165,H1
"Vermillion County, IN",2016-2017,15611,15505,-106,-0.679,-34,-72,18,165,H1
"Vigo County, IN",2000-2001,105762,105482,-280,-0.265,95,-375,18,167,H1
"Vigo County, IN",2001-2002,105482,105221,-261,-0.247,120,-381,18,167,H1
"Vigo County, IN",2002-2003,105221,105356,135,0.128,83,52,18,167,H1
"Vigo County, IN",2003-2004,105356,104662,-694,-0.659,99,-793,18,167,H1
"Vigo County, IN",2004-2005,104662,105245,583,0.557,185,398,18,167,H1
"Vigo County, IN",2005-2006,105245,106509,1264,1.201,293,971,18,167,H1
"Vigo County, IN",2006-2007,106509,106885,376,0.353,197,179,18,167,H1
"Vigo County, IN",2007-2008,106885,106972,87,0.081,311,-224,18,167,H1
"Vigo County, IN",2008-2009,106972,107429,457,0.427,212,245,18,167,H1
"Vigo County, IN",2009-2010,107429,107880,451,0.42,269,182,18,167,H1
"Vigo County, IN",2010-2011,107880,108321,441,0.409,187,254,18,167,H1
"Vigo County, IN",2011-2012,108321,108589,268,0.247,180,88,18,167,H1
"Vigo County, IN",2012-2013,108589,108356,-233,-0.215,156,-389,18,167,H1
"Vigo County, IN",2013-2014,108356,108175,-181,-0.167,137,-318,18,167,H1
"Vigo County, IN",2014-2015,108201,107896,-305,-0.282,156,-461,18,167,H1
"Vigo County, IN",2015-2016,107896,107669,-227,-0.21,114,-341,18,167,H1
"Vigo County, IN",2016-2017,107669,107516,-153,-0.142,113,-266,18,167,H1
"Wabash County, IN",2000-2001,34993,34700,-293,-0.837,41,-334,18,169,H1
"Wabash County, IN",2001-2002,34700,34488,-212,-0.611,-20,-192,18,169,H1
"Wabash County, IN",2002-2003,34488,34325,-163,-0.473,19,-182,18,169,H1
"Wabash County, IN",2003-2004,34325,34131,-194,-0.565,-7,-187,18,169,H1
"Wabash County, IN",2004-2005,34131,33806,-325,-0.952,-7,-318,18,169,H1
"Wabash County, IN",2005-2006,33806,33665,-141,-0.417,11,-152,18,169,H1
"Wabash County, IN",2006-2007,33665,33361,-304,-0.903,-35,-269,18,169,H1
"Wabash County, IN",2007-2008,33361,33238,-123,-0.369,2,-125,18,169,H1
"Wabash County, IN",2008-2009,33238,33036,-202,-0.608,-40,-162,18,169,H1
"Wabash County, IN",2009-2010,33036,32852,-184,-0.557,-68,-116,18,169,H1
"Wabash County, IN",2010-2011,32852,32581,-271,-0.825,-43,-228,18,169,H1
"Wabash County, IN",2011-2012,32581,32428,-153,-0.47,-64,-89,18,169,H1
"Wabash County, IN",2012-2013,32428,32348,-80,-0.247,-88,8,18,169,H1
"Wabash County, IN",2013-2014,32348,32252,-96,-0.297,-62,-34,18,169,H1
"Wabash County, IN",2014-2015,32282,32138,-144,-0.446,-30,-114,18,169,H1
"Wabash County, IN",2015-2016,32138,31551,-587,-1.826,-49,-538,18,169,H1
"Wabash County, IN",2016-2017,31551,31443,-108,-0.342,-84,-24,18,169,H1
"Warren County, IN",2000-2001,8435,8553,118,1.399,0,118,18,171,H1
"Warren County, IN",2001-2002,8553,8598,45,0.526,-19,64,18,171,H1
"Warren County, IN",2002-2003,8598,8589,-9,-0.105,14,-23,18,171,H1
"Warren County, IN",2003-2004,8589,8609,20,0.233,6,14,18,171,H1
"Warren County, IN",2004-2005,8609,8626,17,0.197,-14,31,18,171,H1
"Warren County, IN",2005-2006,8626,8625,-1,-0.012,15,-16,18,171,H1
"Warren County, IN",2006-2007,8625,8554,-71,-0.823,12,-83,18,171,H1
"Warren County, IN",2007-2008,8554,8602,48,0.561,-9,57,18,171,H1
"Warren County, IN",2008-2009,8602,8533,-69,-0.802,-11,-58,18,171,H1
"Warren County, IN",2009-2010,8533,8502,-31,-0.363,-12,-19,18,171,H1
"Warren County, IN",2010-2011,8502,8474,-28,-0.329,25,-53,18,171,H1
"Warren County, IN",2011-2012,8474,8386,-88,-1.038,42,-130,18,171,H1
"Warren County, IN",2012-2013,8386,8393,7,0.083,17,-10,18,171,H1
"Warren County, IN",2013-2014,8393,8352,-41,-0.489,13,-54,18,171,H1
"Warren County, IN",2014-2015,8330,8269,-61,-0.732,-3,-58,18,171,H1
"Warren County, IN",2015-2016,8269,8174,-95,-1.149,-2,-93,18,171,H1
"Warren County, IN",2016-2017,8174,8201,27,0.33,-14,41,18,171,H1
"Warrick County, IN",2000-2001,52531,52780,249,0.474,249,0,18,173,H1
"Warrick County, IN",2001-2002,52780,53317,537,1.017,168,369,18,173,H1
"Warrick County, IN",2002-2003,53317,54439,1122,2.104,166,956,18,173,H1
"Warrick County, IN",2003-2004,54439,55171,732,1.345,255,477,18,173,H1
"Warrick County, IN",2004-2005,55171,56066,895,1.622,195,700,18,173,H1
"Warrick County, IN",2005-2006,56066,56746,680,1.213,133,547,18,173,H1
"Warrick County, IN",2006-2007,56746,57754,1008,1.776,235,773,18,173,H1
"Warrick County, IN",2007-2008,57754,58435,681,1.179,222,459,18,173,H1
"Warrick County, IN",2008-2009,58435,59197,762,1.304,224,538,18,173,H1
"Warrick County, IN",2009-2010,59197,59863,666,1.125,123,543,18,173,H1
"Warrick County, IN",2010-2011,59863,60240,377,0.63,164,213,18,173,H1
"Warrick County, IN",2011-2012,60240,60439,199,0.33,175,24,18,173,H1
"Warrick County, IN",2012-2013,60439,61001,562,0.93,48,514,18,173,H1
"Warrick County, IN",2013-2014,61001,61149,148,0.243,64,84,18,173,H1
"Warrick County, IN",2014-2015,61267,61897,630,1.028,54,576,18,173,H1
"Warrick County, IN",2015-2016,61897,62049,152,0.246,94,58,18,173,H1
"Warrick County, IN",2016-2017,62049,62530,481,0.775,67,414,18,173,H1
"Washington County, IN",2000-2001,27247,27484,237,0.87,106,131,18,175,H1
"Washington County, IN",2001-2002,27484,27674,190,0.691,79,111,18,175,H1
"Washington County, IN",2002-2003,27674,27736,62,0.224,93,-31,18,175,H1
"Washington County, IN",2003-2004,27736,27854,118,0.425,67,51,18,175,H1
"Washington County, IN",2004-2005,27854,27893,39,0.14,121,-82,18,175,H1
"Washington County, IN",2005-2006,27893,28164,271,0.972,76,195,18,175,H1
"Washington County, IN",2006-2007,28164,28236,72,0.256,80,-8,18,175,H1
"Washington County, IN",2007-2008,28236,28298,62,0.22,55,7,18,175,H1
"Washington County, IN",2008-2009,28298,28144,-154,-0.544,58,-212,18,175,H1
"Washington County, IN",2009-2010,28144,28290,146,0.519,30,116,18,175,H1
"Washington County, IN",2010-2011,28290,28180,-110,-0.389,-5,-105,18,175,H1
"Washington County, IN",2011-2012,28180,27925,-255,-0.905,1,-256,18,175,H1
"Washington County, IN",2012-2013,27925,27810,-115,-0.412,34,-149,18,175,H1
"Washington County, IN",2013-2014,27810,27878,68,0.245,29,39,18,175,H1
"Washington County, IN",2014-2015,27904,27827,-77,-0.276,59,-136,18,175,H1
"Washington County, IN",2015-2016,27827,27748,-79,-0.284,-15,-64,18,175,H1
"Washington County, IN",2016-2017,27748,27827,79,0.285,33,46,18,175,H1
"Wayne County, IN",2000-2001,71033,70712,-321,-0.452,59,-380,18,177,H1
"Wayne County, IN",2001-2002,70712,70545,-167,-0.236,68,-235,18,177,H1
"Wayne County, IN",2002-2003,70545,70490,-55,-0.078,114,-169,18,177,H1
"Wayne County, IN",2003-2004,70490,70070,-420,-0.596,121,-541,18,177,H1
"Wayne County, IN",2004-2005,70070,69793,-277,-0.395,114,-391,18,177,H1
"Wayne County, IN",2005-2006,69793,69642,-151,-0.216,175,-326,18,177,H1
"Wayne County, IN",2006-2007,69642,69365,-277,-0.398,30,-307,18,177,H1
"Wayne County, IN",2007-2008,69365,69093,-272,-0.392,90,-362,18,177,H1
"Wayne County, IN",2008-2009,69093,68984,-109,-0.158,92,-201,18,177,H1
"Wayne County, IN",2009-2010,68984,68959,-25,-0.036,63,-88,18,177,H1
"Wayne County, IN",2010-2011,68959,68822,-137,-0.199,112,-249,18,177,H1
"Wayne County, IN",2011-2012,68822,68371,-451,-0.655,0,-451,18,177,H1
"Wayne County, IN",2012-2013,68371,67978,-393,-0.575,-33,-360,18,177,H1
"Wayne County, IN",2013-2014,67978,67671,-307,-0.452,-52,-255,18,177,H1
"Wayne County, IN",2014-2015,67447,67001,-446,-0.661,-110,-336,18,177,H1
"Wayne County, IN",2015-2016,67001,66591,-410,-0.612,-75,-335,18,177,H1
"Wayne County, IN",2016-2017,66591,66185,-406,-0.61,-89,-317,18,177,H1
"Wells County, IN",2000-2001,27619,27626,7,0.025,108,-101,18,179,H1
"Wells County, IN",2001-2002,27626,27745,119,0.431,84,35,18,179,H1
"Wells County, IN",2002-2003,27745,27803,58,0.209,115,-57,18,179,H1
"Wells County, IN",2003-2004,27803,27826,23,0.083,89,-66,18,179,H1
"Wells County, IN",2004-2005,27826,27820,-6,-0.022,77,-83,18,179,H1
"Wells County, IN",2005-2006,27820,27872,52,0.187,94,-42,18,179,H1
"Wells County, IN",2006-2007,27872,27836,-36,-0.129,63,-99,18,179,H1
"Wells County, IN",2007-2008,27836,27751,-85,-0.305,92,-177,18,179,H1
"Wells County, IN",2008-2009,27751,27620,-131,-0.472,93,-224,18,179,H1
"Wells County, IN",2009-2010,27620,27658,38,0.138,66,-28,18,179,H1
"Wells County, IN",2010-2011,27658,27724,66,0.239,71,-5,18,179,H1
"Wells County, IN",2011-2012,27724,27678,-46,-0.166,103,-149,18,179,H1
"Wells County, IN",2012-2013,27678,27736,58,0.21,102,-44,18,179,H1
"Wells County, IN",2013-2014,27736,27862,126,0.454,105,21,18,179,H1
"Wells County, IN",2014-2015,27827,27964,137,0.492,92,45,18,179,H1
"Wells County, IN",2015-2016,27964,27840,-124,-0.443,74,-198,18,179,H1
"Wells County, IN",2016-2017,27840,27984,144,0.517,90,54,18,179,H1
"White County, IN",2000-2001,25246,25351,105,0.416,124,-19,18,181,H1
"White County, IN",2001-2002,25351,25240,-111,-0.438,108,-219,18,181,H1
"White County, IN",2002-2003,25240,25060,-180,-0.713,53,-233,18,181,H1
"White County, IN",2003-2004,25060,24976,-84,-0.335,77,-161,18,181,H1
"White County, IN",2004-2005,24976,24861,-115,-0.46,62,-177,18,181,H1
"White County, IN",2005-2006,24861,24830,-31,-0.125,65,-96,18,181,H1
"White County, IN",2006-2007,24830,24762,-68,-0.274,50,-118,18,181,H1
"White County, IN",2007-2008,24762,24871,109,0.44,84,25,18,181,H1
"White County, IN",2008-2009,24871,24573,-298,-1.198,40,-338,18,181,H1
"White County, IN",2009-2010,24573,24680,107,0.435,16,91,18,181,H1
"White County, IN",2010-2011,24680,24506,-174,-0.705,17,-191,18,181,H1
"White County, IN",2011-2012,24506,24408,-98,-0.4,58,-156,18,181,H1
"White County, IN",2012-2013,24408,24376,-32,-0.131,8,-40,18,181,H1
"White County, IN",2013-2014,24376,24453,77,0.316,17,60,18,181,H1
"White County, IN",2014-2015,24408,24293,-115,-0.471,20,-135,18,181,H1
"White County, IN",2015-2016,24293,24101,-192,-0.79,38,-230,18,181,H1
"White County, IN",2016-2017,24101,24182,81,0.336,1,80,18,181,H1
"Whitley County, IN",2000-2001,30634,30998,364,1.188,183,181,18,183,H1
"Whitley County, IN",2001-2002,30998,31278,280,0.903,125,155,18,183,H1
"Whitley County, IN",2002-2003,31278,31621,343,1.097,110,233,18,183,H1
"Whitley County, IN",2003-2004,31621,31841,220,0.696,150,70,18,183,H1
"Whitley County, IN",2004-2005,31841,32182,341,1.071,93,248,18,183,H1
"Whitley County, IN",2005-2006,32182,32597,415,1.29,105,310,18,183,H1
"Whitley County, IN",2006-2007,32597,32853,256,0.785,138,118,18,183,H1
"Whitley County, IN",2007-2008,32853,33047,194,0.591,178,16,18,183,H1
"Whitley County, IN",2008-2009,33047,33125,78,0.236,142,-64,18,183,H1
"Whitley County, IN",2009-2010,33125,33335,210,0.634,85,125,18,183,H1
"Whitley County, IN",2010-2011,33335,33288,-47,-0.141,71,-118,18,183,H1
"Whitley County, IN",2011-2012,33288,33270,-18,-0.054,59,-77,18,183,H1
"Whitley County, IN",2012-2013,33270,33238,-32,-0.096,97,-129,18,183,H1
"Whitley County, IN",2013-2014,33238,33403,165,0.496,91,74,18,183,H1
"Whitley County, IN",2014-2015,33412,33406,-6,-0.018,103,-109,18,183,H1
"Whitley County, IN",2015-2016,33406,33484,78,0.233,117,-39,18,183,H1
"Whitley County, IN",2016-2017,33484,33756,272,0.812,91,181,18,183,H1
Iowa,2000-2001,2929067,2931997,2930,0.1,10183,-7253,19,0,STATE
Iowa,2001-2002,2931997,2934234,2237,0.076,9421,-7184,19,0,STATE
Iowa,2002-2003,2934234,2941999,7765,0.265,10161,-2396,19,0,STATE
Iowa,2003-2004,2941999,2953635,11636,0.396,10630,1006,19,0,STATE
Iowa,2004-2005,2953635,2964454,10819,0.366,10927,-108,19,0,STATE
Iowa,2005-2006,2964454,2982644,18190,0.614,12670,5520,19,0,STATE
Iowa,2006-2007,2982644,2999212,16568,0.555,13117,3451,19,0,STATE
Iowa,2007-2008,2999212,3016734,17522,0.584,13366,4156,19,0,STATE
Iowa,2008-2009,3016734,3032870,16136,0.535,12869,3267,19,0,STATE
Iowa,2009-2010,3032870,3050694,17824,0.588,12559,5265,19,0,STATE
Iowa,2010-2011,3050694,3065389,14695,0.482,9649,5046,19,0,STATE
Iowa,2011-2012,3065389,3076636,11247,0.367,10422,825,19,0,STATE
Iowa,2012-2013,3076636,3092224,15588,0.507,9664,5924,19,0,STATE
Iowa,2013-2014,3092224,3109481,17257,0.558,11445,5812,19,0,STATE
Iowa,2014-2015,3109481,3123899,14418,0.464,11742,2676,19,0,STATE
Iowa,2015-2016,3123899,3130869,6970,0.223,10821,-3851,19,0,STATE
Iowa,2016-2017,3130869,3145711,14842,0.474,10766,4076,19,0,STATE
"Adair County, IA",2000-2001,8223,8132,-91,-1.107,-49,-42,19,1,H1
"Adair County, IA",2001-2002,8132,8059,-73,-0.898,-43,-30,19,1,H1
"Adair County, IA",2002-2003,8059,8050,-9,-0.112,-40,31,19,1,H1
"Adair County, IA",2003-2004,8050,8019,-31,-0.385,-54,23,19,1,H1
"Adair County, IA",2004-2005,8019,7932,-87,-1.085,-47,-40,19,1,H1
"Adair County, IA",2005-2006,7932,7924,-8,-0.101,-3,-5,19,1,H1
"Adair County, IA",2006-2007,7924,7871,-53,-0.669,-38,-15,19,1,H1
"Adair County, IA",2007-2008,7871,7747,-124,-1.575,-18,-106,19,1,H1
"Adair County, IA",2008-2009,7747,7676,-71,-0.916,-28,-43,19,1,H1
"Adair County, IA",2009-2010,7676,7693,17,0.221,-18,35,19,1,H1
"Adair County, IA",2010-2011,7693,7588,-105,-1.365,-50,-55,19,1,H1
"Adair County, IA",2011-2012,7588,7515,-73,-0.962,-24,-49,19,1,H1
"Adair County, IA",2012-2013,7515,7463,-52,-0.692,-42,-10,19,1,H1
"Adair County, IA",2013-2014,7463,7454,-9,-0.121,-23,14,19,1,H1
"Adair County, IA",2014-2015,7417,7228,-189,-2.548,-22,-167,19,1,H1
"Adair County, IA",2015-2016,7228,7010,-218,-3.016,-30,-188,19,1,H1
"Adair County, IA",2016-2017,7010,7054,44,0.628,-21,65,19,1,H1
"Adams County, IA",2000-2001,4476,4402,-74,-1.653,-1,-73,19,3,H1
"Adams County, IA",2001-2002,4402,4370,-32,-0.727,-24,-8,19,3,H1
"Adams County, IA",2002-2003,4370,4365,-5,-0.114,-16,11,19,3,H1
"Adams County, IA",2003-2004,4365,4307,-58,-1.329,-6,-52,19,3,H1
"Adams County, IA",2004-2005,4307,4226,-81,-1.881,-32,-49,19,3,H1
"Adams County, IA",2005-2006,4226,4224,-2,-0.047,7,-9,19,3,H1
"Adams County, IA",2006-2007,4224,4195,-29,-0.687,15,-44,19,3,H1
"Adams County, IA",2007-2008,4195,4151,-44,-1.049,-4,-40,19,3,H1
"Adams County, IA",2008-2009,4151,4047,-104,-2.505,-19,-85,19,3,H1
"Adams County, IA",2009-2010,4047,4023,-24,-0.593,-3,-21,19,3,H1
"Adams County, IA",2010-2011,4023,3993,-30,-0.746,-13,-17,19,3,H1
"Adams County, IA",2011-2012,3993,3904,-89,-2.229,-1,-88,19,3,H1
"Adams County, IA",2012-2013,3904,3892,-12,-0.307,16,-28,19,3,H1
"Adams County, IA",2013-2014,3892,3875,-17,-0.437,12,-29,19,3,H1
"Adams County, IA",2014-2015,3871,3796,-75,-1.937,6,-81,19,3,H1
"Adams County, IA",2015-2016,3796,3716,-80,-2.107,9,-89,19,3,H1
"Adams County, IA",2016-2017,3716,3686,-30,-0.807,-6,-24,19,3,H1
"Allamakee County, IA",2000-2001,14674,14333,-341,-2.324,-29,-312,19,5,H1
"Allamakee County, IA",2001-2002,14333,14289,-44,-0.307,19,-63,19,5,H1
"Allamakee County, IA",2002-2003,14289,14345,56,0.392,31,25,19,5,H1
"Allamakee County, IA",2003-2004,14345,14324,-21,-0.146,30,-51,19,5,H1
"Allamakee County, IA",2004-2005,14324,14371,47,0.328,31,16,19,5,H1
"Allamakee County, IA",2005-2006,14371,14378,7,0.049,45,-38,19,5,H1
"Allamakee County, IA",2006-2007,14378,14335,-43,-0.299,39,-82,19,5,H1
"Allamakee County, IA",2007-2008,14335,14325,-10,-0.07,46,-56,19,5,H1
"Allamakee County, IA",2008-2009,14325,14263,-62,-0.433,66,-128,19,5,H1
"Allamakee County, IA",2009-2010,14263,14344,81,0.568,39,42,19,5,H1
"Allamakee County, IA",2010-2011,14344,14200,-144,-1.004,-11,-133,19,5,H1
"Allamakee County, IA",2011-2012,14200,14131,-69,-0.486,7,-76,19,5,H1
"Allamakee County, IA",2012-2013,14131,14046,-85,-0.602,33,-118,19,5,H1
"Allamakee County, IA",2013-2014,14046,14038,-8,-0.057,11,-19,19,5,H1
"Allamakee County, IA",2014-2015,14061,13886,-175,-1.245,6,-181,19,5,H1
"Allamakee County, IA",2015-2016,13886,13869,-17,-0.122,32,-49,19,5,H1
"Allamakee County, IA",2016-2017,13869,13884,15,0.108,25,-10,19,5,H1
"Appanoose County, IA",2000-2001,13696,13578,-118,-0.862,-17,-101,19,7,H1
"Appanoose County, IA",2001-2002,13578,13420,-158,-1.164,-10,-148,19,7,H1
"Appanoose County, IA",2002-2003,13420,13522,102,0.76,-24,126,19,7,H1
"Appanoose County, IA",2003-2004,13522,13462,-60,-0.444,-36,-24,19,7,H1
"Appanoose County, IA",2004-2005,13462,13453,-9,-0.067,-14,5,19,7,H1
"Appanoose County, IA",2005-2006,13453,13319,-134,-0.996,-8,-126,19,7,H1
"Appanoose County, IA",2006-2007,13319,13105,-214,-1.607,-49,-165,19,7,H1
"Appanoose County, IA",2007-2008,13105,12950,-155,-1.183,2,-157,19,7,H1
"Appanoose County, IA",2008-2009,12950,12896,-54,-0.417,-2,-52,19,7,H1
"Appanoose County, IA",2009-2010,12896,12869,-27,-0.209,-11,-16,19,7,H1
"Appanoose County, IA",2010-2011,12869,12870,1,0.008,1,0,19,7,H1
"Appanoose County, IA",2011-2012,12870,12711,-159,-1.235,3,-162,19,7,H1
"Appanoose County, IA",2012-2013,12711,12659,-52,-0.409,-32,-20,19,7,H1
"Appanoose County, IA",2013-2014,12659,12661,2,0.016,-21,23,19,7,H1
"Appanoose County, IA",2014-2015,12628,12529,-99,-0.784,-22,-77,19,7,H1
"Appanoose County, IA",2015-2016,12529,12497,-32,-0.255,-16,-16,19,7,H1
"Appanoose County, IA",2016-2017,12497,12352,-145,-1.16,-7,-138,19,7,H1
"Audubon County, IA",2000-2001,6804,6664,-140,-2.058,-69,-71,19,9,H1
"Audubon County, IA",2001-2002,6664,6572,-92,-1.381,-48,-44,19,9,H1
"Audubon County, IA",2002-2003,6572,6479,-93,-1.415,-27,-66,19,9,H1
"Audubon County, IA",2003-2004,6479,6430,-49,-0.756,-26,-23,19,9,H1
"Audubon County, IA",2004-2005,6430,6324,-106,-1.649,-44,-62,19,9,H1
"Audubon County, IA",2005-2006,6324,6265,-59,-0.933,-20,-39,19,9,H1
"Audubon County, IA",2006-2007,6265,6222,-43,-0.686,-9,-34,19,9,H1
"Audubon County, IA",2007-2008,6222,6200,-22,-0.354,-27,5,19,9,H1
"Audubon County, IA",2008-2009,6200,6136,-64,-1.032,-12,-52,19,9,H1
"Audubon County, IA",2009-2010,6136,6108,-28,-0.456,-26,-2,19,9,H1
"Audubon County, IA",2010-2011,6108,6016,-92,-1.506,-22,-70,19,9,H1
"Audubon County, IA",2011-2012,6016,5876,-140,-2.327,-41,-99,19,9,H1
"Audubon County, IA",2012-2013,5876,5880,4,0.068,-6,10,19,9,H1
"Audubon County, IA",2013-2014,5880,5794,-86,-1.463,-6,-80,19,9,H1
"Audubon County, IA",2014-2015,5793,5773,-20,-0.345,0,-20,19,9,H1
"Audubon County, IA",2015-2016,5773,5635,-138,-2.39,-10,-128,19,9,H1
"Audubon County, IA",2016-2017,5635,5578,-57,-1.012,-3,-54,19,9,H1
"Benton County, IA",2000-2001,25326,25532,206,0.813,67,139,19,11,H1
"Benton County, IA",2001-2002,25532,25829,297,1.163,92,205,19,11,H1
"Benton County, IA",2002-2003,25829,25946,117,0.453,58,59,19,11,H1
"Benton County, IA",2003-2004,25946,26181,235,0.906,91,144,19,11,H1
"Benton County, IA",2004-2005,26181,26265,84,0.321,81,3,19,11,H1
"Benton County, IA",2005-2006,26265,26137,-128,-0.487,48,-176,19,11,H1
"Benton County, IA",2006-2007,26137,26066,-71,-0.272,93,-164,19,11,H1
"Benton County, IA",2007-2008,26066,26097,31,0.119,81,-50,19,11,H1
"Benton County, IA",2008-2009,26097,26117,20,0.077,91,-71,19,11,H1
"Benton County, IA",2009-2010,26117,26059,-58,-0.222,40,-98,19,11,H1
"Benton County, IA",2010-2011,26059,26137,78,0.299,66,12,19,11,H1
"Benton County, IA",2011-2012,26137,25861,-276,-1.056,56,-332,19,11,H1
"Benton County, IA",2012-2013,25861,25737,-124,-0.479,43,-167,19,11,H1
"Benton County, IA",2013-2014,25737,25680,-57,-0.221,36,-93,19,11,H1
"Benton County, IA",2014-2015,25659,25658,-1,-0.004,82,-83,19,11,H1
"Benton County, IA",2015-2016,25658,25641,-17,-0.066,73,-90,19,11,H1
"Benton County, IA",2016-2017,25641,25642,1,0.004,73,-72,19,11,H1
"Black Hawk County, IA",2000-2001,128019,127765,-254,-0.198,341,-595,19,13,H1
"Black Hawk County, IA",2001-2002,127765,126876,-889,-0.696,462,-1351,19,13,H1
"Black Hawk County, IA",2002-2003,126876,126491,-385,-0.303,507,-892,19,13,H1
"Black Hawk County, IA",2003-2004,126491,126682,191,0.151,516,-325,19,13,H1
"Black Hawk County, IA",2004-2005,126682,127021,339,0.268,539,-200,19,13,H1
"Black Hawk County, IA",2005-2006,127021,127486,465,0.366,620,-155,19,13,H1
"Black Hawk County, IA",2006-2007,127486,127756,270,0.212,660,-390,19,13,H1
"Black Hawk County, IA",2007-2008,127756,129203,1447,1.133,703,744,19,13,H1
"Black Hawk County, IA",2008-2009,129203,130595,1392,1.077,667,725,19,13,H1
"Black Hawk County, IA",2009-2010,130595,131158,563,0.431,664,-101,19,13,H1
"Black Hawk County, IA",2010-2011,131158,131429,271,0.207,523,-252,19,13,H1
"Black Hawk County, IA",2011-2012,131429,131661,232,0.177,485,-253,19,13,H1
"Black Hawk County, IA",2012-2013,131661,132591,930,0.706,538,392,19,13,H1
"Black Hawk County, IA",2013-2014,132591,132897,306,0.231,498,-192,19,13,H1
"Black Hawk County, IA",2014-2015,133121,133455,334,0.251,558,-224,19,13,H1
"Black Hawk County, IA",2015-2016,133455,132813,-642,-0.481,541,-1183,19,13,H1
"Black Hawk County, IA",2016-2017,132813,132648,-165,-0.124,487,-652,19,13,H1
"Boone County, IA",2000-2001,26251,26249,-2,-0.008,-11,9,19,15,H1
"Boone County, IA",2001-2002,26249,26086,-163,-0.621,-3,-160,19,15,H1
"Boone County, IA",2002-2003,26086,26232,146,0.56,59,87,19,15,H1
"Boone County, IA",2003-2004,26232,26372,140,0.534,42,98,19,15,H1
"Boone County, IA",2004-2005,26372,26500,128,0.485,42,86,19,15,H1
"Boone County, IA",2005-2006,26500,26471,-29,-0.109,42,-71,19,15,H1
"Boone County, IA",2006-2007,26471,26553,82,0.31,32,50,19,15,H1
"Boone County, IA",2007-2008,26553,26454,-99,-0.373,2,-101,19,15,H1
"Boone County, IA",2008-2009,26454,26360,-94,-0.355,39,-133,19,15,H1
"Boone County, IA",2009-2010,26360,26276,-84,-0.319,31,-115,19,15,H1
"Boone County, IA",2010-2011,26276,26336,60,0.228,26,34,19,15,H1
"Boone County, IA",2011-2012,26336,26234,-102,-0.387,15,-117,19,15,H1
"Boone County, IA",2012-2013,26234,26352,118,0.45,22,96,19,15,H1
"Boone County, IA",2013-2014,26352,26433,81,0.307,26,55,19,15,H1
"Boone County, IA",2014-2015,26420,26643,223,0.844,5,218,19,15,H1
"Boone County, IA",2015-2016,26643,26419,-224,-0.841,-11,-213,19,15,H1
"Boone County, IA",2016-2017,26419,26484,65,0.246,1,64,19,15,H1
"Bremer County, IA",2000-2001,23312,23506,194,0.832,43,151,19,17,H1
"Bremer County, IA",2001-2002,23506,23386,-120,-0.511,4,-124,19,17,H1
"Bremer County, IA",2002-2003,23386,23549,163,0.697,34,129,19,17,H1
"Bremer County, IA",2003-2004,23549,23728,179,0.76,13,166,19,17,H1
"Bremer County, IA",2004-2005,23728,23833,105,0.443,49,56,19,17,H1
"Bremer County, IA",2005-2006,23833,24054,221,0.927,74,147,19,17,H1
"Bremer County, IA",2006-2007,24054,24237,183,0.761,54,129,19,17,H1
"Bremer County, IA",2007-2008,24237,24162,-75,-0.309,57,-132,19,17,H1
"Bremer County, IA",2008-2009,24162,24183,21,0.087,67,-46,19,17,H1
"Bremer County, IA",2009-2010,24183,24283,100,0.414,53,47,19,17,H1
"Bremer County, IA",2010-2011,24283,24363,80,0.329,22,58,19,17,H1
"Bremer County, IA",2011-2012,24363,24463,100,0.41,67,33,19,17,H1
"Bremer County, IA",2012-2013,24463,24577,114,0.466,37,77,19,17,H1
"Bremer County, IA",2013-2014,24577,24721,144,0.586,49,95,19,17,H1
"Bremer County, IA",2014-2015,24598,24722,124,0.504,52,72,19,17,H1
"Bremer County, IA",2015-2016,24722,24784,62,0.251,64,-2,19,17,H1
"Bremer County, IA",2016-2017,24784,24911,127,0.512,53,74,19,17,H1
"Buchanan County, IA",2000-2001,21064,20952,-112,-0.532,115,-227,19,19,H1
"Buchanan County, IA",2001-2002,20952,20796,-156,-0.745,101,-257,19,19,H1
"Buchanan County, IA",2002-2003,20796,20822,26,0.125,91,-65,19,19,H1
"Buchanan County, IA",2003-2004,20822,20910,88,0.423,104,-16,19,19,H1
"Buchanan County, IA",2004-2005,20910,20831,-79,-0.378,76,-155,19,19,H1
"Buchanan County, IA",2005-2006,20831,20957,126,0.605,155,-29,19,19,H1
"Buchanan County, IA",2006-2007,20957,21069,112,0.534,135,-23,19,19,H1
"Buchanan County, IA",2007-2008,21069,21154,85,0.403,86,-1,19,19,H1
"Buchanan County, IA",2008-2009,21154,21016,-138,-0.652,114,-252,19,19,H1
"Buchanan County, IA",2009-2010,21016,20946,-70,-0.333,85,-155,19,19,H1
"Buchanan County, IA",2010-2011,20946,20879,-67,-0.32,59,-126,19,19,H1
"Buchanan County, IA",2011-2012,20879,20942,63,0.302,98,-35,19,19,H1
"Buchanan County, IA",2012-2013,20942,20932,-10,-0.048,68,-78,19,19,H1
"Buchanan County, IA",2013-2014,20932,21038,106,0.506,88,18,19,19,H1
"Buchanan County, IA",2014-2015,21087,21062,-25,-0.119,92,-117,19,19,H1
"Buchanan County, IA",2015-2016,21062,21034,-28,-0.133,107,-135,19,19,H1
"Buchanan County, IA",2016-2017,21034,21202,168,0.799,99,69,19,19,H1
"Buena Vista County, IA",2000-2001,20361,20241,-120,-0.589,44,-164,19,21,H1
"Buena Vista County, IA",2001-2002,20241,20233,-8,-0.04,46,-54,19,21,H1
"Buena Vista County, IA",2002-2003,20233,20141,-92,-0.455,64,-156,19,21,H1
"Buena Vista County, IA",2003-2004,20141,2.00E+04,-141,-0.7,72,-213,19,21,H1
"Buena Vista County, IA",2004-2005,2.00E+04,19970,-30,-0.15,105,-135,19,21,H1
"Buena Vista County, IA",2005-2006,19970,19909,-61,-0.305,105,-166,19,21,H1
"Buena Vista County, IA",2006-2007,19909,19798,-111,-0.558,63,-174,19,21,H1
"Buena Vista County, IA",2007-2008,19798,19855,57,0.288,126,-69,19,21,H1
"Buena Vista County, IA",2008-2009,19855,20004,149,0.75,109,40,19,21,H1
"Buena Vista County, IA",2009-2010,20004,20328,324,1.62,133,191,19,21,H1
"Buena Vista County, IA",2010-2011,20328,20264,-64,-0.315,67,-131,19,21,H1
"Buena Vista County, IA",2011-2012,20264,20548,284,1.402,154,130,19,21,H1
"Buena Vista County, IA",2012-2013,20548,20584,36,0.175,169,-133,19,21,H1
"Buena Vista County, IA",2013-2014,20584,20578,-6,-0.029,184,-190,19,21,H1
"Buena Vista County, IA",2014-2015,20680,20493,-187,-0.904,180,-367,19,21,H1
"Buena Vista County, IA",2015-2016,20493,20268,-225,-1.098,145,-370,19,21,H1
"Buena Vista County, IA",2016-2017,20268,20110,-158,-0.78,130,-288,19,21,H1
"Butler County, IA",2000-2001,15299,15065,-234,-1.53,-54,-180,19,23,H1
"Butler County, IA",2001-2002,15065,14926,-139,-0.923,-53,-86,19,23,H1
"Butler County, IA",2002-2003,14926,14939,13,0.087,-63,76,19,23,H1
"Butler County, IA",2003-2004,14939,14985,46,0.308,-7,53,19,23,H1
"Butler County, IA",2004-2005,14985,14965,-20,-0.133,-14,-6,19,23,H1
"Butler County, IA",2005-2006,14965,14931,-34,-0.227,-27,-7,19,23,H1
"Butler County, IA",2006-2007,14931,14961,30,0.201,18,12,19,23,H1
"Butler County, IA",2007-2008,14961,14957,-4,-0.027,-4,0,19,23,H1
"Butler County, IA",2008-2009,14957,14699,-258,-1.725,-17,-241,19,23,H1
"Butler County, IA",2009-2010,14699,14902,203,1.381,-6,209,19,23,H1
"Butler County, IA",2010-2011,14902,14948,46,0.309,-31,77,19,23,H1
"Butler County, IA",2011-2012,14948,14977,29,0.194,-2,31,19,23,H1
"Butler County, IA",2012-2013,14977,14998,21,0.14,-16,37,19,23,H1
"Butler County, IA",2013-2014,14998,15006,8,0.053,2,6,19,23,H1
"Butler County, IA",2014-2015,14972,14915,-57,-0.381,-18,-39,19,23,H1
"Butler County, IA",2015-2016,14915,14687,-228,-1.529,-52,-176,19,23,H1
"Butler County, IA",2016-2017,14687,14606,-81,-0.552,-38,-43,19,23,H1
"Calhoun County, IA",2000-2001,11088,10918,-170,-1.533,-48,-122,19,25,H1
"Calhoun County, IA",2001-2002,10918,10683,-235,-2.152,-61,-174,19,25,H1
"Calhoun County, IA",2002-2003,10683,10488,-195,-1.825,-68,-127,19,25,H1
"Calhoun County, IA",2003-2004,10488,10382,-106,-1.011,-20,-86,19,25,H1
"Calhoun County, IA",2004-2005,10382,10228,-154,-1.483,-56,-98,19,25,H1
"Calhoun County, IA",2005-2006,10228,10093,-135,-1.32,-28,-107,19,25,H1
"Calhoun County, IA",2006-2007,10093,9947,-146,-1.447,-26,-120,19,25,H1
"Calhoun County, IA",2007-2008,9947,9845,-102,-1.025,-40,-62,19,25,H1
"Calhoun County, IA",2008-2009,9845,9684,-161,-1.635,-35,-126,19,25,H1
"Calhoun County, IA",2009-2010,9684,10162,478,4.936,-9,487,19,25,H1
"Calhoun County, IA",2010-2011,10162,10054,-108,-1.063,-65,-43,19,25,H1
"Calhoun County, IA",2011-2012,10054,9910,-144,-1.432,-9,-135,19,25,H1
"Calhoun County, IA",2012-2013,9910,9909,-1,-0.01,-18,17,19,25,H1
"Calhoun County, IA",2013-2014,9909,9866,-43,-0.434,-26,-17,19,25,H1
"Calhoun County, IA",2014-2015,9857,9818,-39,-0.396,-15,-24,19,25,H1
"Calhoun County, IA",2015-2016,9818,9799,-19,-0.194,-20,1,19,25,H1
"Calhoun County, IA",2016-2017,9799,9746,-53,-0.541,-24,-29,19,25,H1
"Carroll County, IA",2000-2001,21382,21225,-157,-0.734,0,-157,19,27,H1
"Carroll County, IA",2001-2002,21225,21159,-66,-0.311,49,-115,19,27,H1
"Carroll County, IA",2002-2003,21159,21024,-135,-0.638,-13,-122,19,27,H1
"Carroll County, IA",2003-2004,21024,20936,-88,-0.419,55,-143,19,27,H1
"Carroll County, IA",2004-2005,20936,20973,37,0.177,49,-12,19,27,H1
"Carroll County, IA",2005-2006,20973,20832,-141,-0.672,52,-193,19,27,H1
"Carroll County, IA",2006-2007,20832,20869,37,0.178,34,3,19,27,H1
"Carroll County, IA",2007-2008,20869,20742,-127,-0.609,30,-157,19,27,H1
"Carroll County, IA",2008-2009,20742,20743,1,0.005,44,-43,19,27,H1
"Carroll County, IA",2009-2010,20743,20828,85,0.41,55,30,19,27,H1
"Carroll County, IA",2010-2011,20828,20848,20,0.096,35,-15,19,27,H1
"Carroll County, IA",2011-2012,20848,20674,-174,-0.835,31,-205,19,27,H1
"Carroll County, IA",2012-2013,20674,20599,-75,-0.363,20,-95,19,27,H1
"Carroll County, IA",2013-2014,20599,20562,-37,-0.18,1,-38,19,27,H1
"Carroll County, IA",2014-2015,20554,20498,-56,-0.272,11,-67,19,27,H1
"Carroll County, IA",2015-2016,20498,20366,-132,-0.644,7,-139,19,27,H1
"Carroll County, IA",2016-2017,20366,20320,-46,-0.226,22,-68,19,27,H1
"Cass County, IA",2000-2001,14675,14488,-187,-1.274,-35,-152,19,29,H1
"Cass County, IA",2001-2002,14488,14242,-246,-1.698,-70,-176,19,29,H1
"Cass County, IA",2002-2003,14242,14275,33,0.232,-15,48,19,29,H1
"Cass County, IA",2003-2004,14275,14142,-133,-0.932,-33,-100,19,29,H1
"Cass County, IA",2004-2005,14142,14002,-140,-0.99,-33,-107,19,29,H1
"Cass County, IA",2005-2006,14002,14021,19,0.136,-22,41,19,29,H1
"Cass County, IA",2006-2007,14021,13988,-33,-0.235,3,-36,19,29,H1
"Cass County, IA",2007-2008,13988,13935,-53,-0.379,-1,-52,19,29,H1
"Cass County, IA",2008-2009,13935,13949,14,0.1,-21,35,19,29,H1
"Cass County, IA",2009-2010,13949,13927,-22,-0.158,-17,-5,19,29,H1
"Cass County, IA",2010-2011,13927,13779,-148,-1.063,-34,-114,19,29,H1
"Cass County, IA",2011-2012,13779,13720,-59,-0.428,-48,-11,19,29,H1
"Cass County, IA",2012-2013,13720,13598,-122,-0.889,-28,-94,19,29,H1
"Cass County, IA",2013-2014,13598,13448,-150,-1.103,-17,-133,19,29,H1
"Cass County, IA",2014-2015,13424,13427,3,0.022,-46,49,19,29,H1
"Cass County, IA",2015-2016,13427,13180,-247,-1.84,-45,-202,19,29,H1
"Cass County, IA",2016-2017,13180,13145,-35,-0.266,-42,7,19,29,H1
"Cedar County, IA",2000-2001,18199,18126,-73,-0.401,0,-73,19,31,H1
"Cedar County, IA",2001-2002,18126,18150,24,0.132,6,18,19,31,H1
"Cedar County, IA",2002-2003,18150,18224,74,0.408,27,47,19,31,H1
"Cedar County, IA",2003-2004,18224,18248,24,0.132,10,14,19,31,H1
"Cedar County, IA",2004-2005,18248,18213,-35,-0.192,44,-79,19,31,H1
"Cedar County, IA",2005-2006,18213,18332,119,0.653,62,57,19,31,H1
"Cedar County, IA",2006-2007,18332,18321,-11,-0.06,19,-30,19,31,H1
"Cedar County, IA",2007-2008,18321,18460,139,0.759,39,100,19,31,H1
"Cedar County, IA",2008-2009,18460,18458,-2,-0.011,35,-37,19,31,H1
"Cedar County, IA",2009-2010,18458,18511,53,0.287,44,9,19,31,H1
"Cedar County, IA",2010-2011,18511,18445,-66,-0.357,8,-74,19,31,H1
"Cedar County, IA",2011-2012,18445,18425,-20,-0.108,9,-29,19,31,H1
"Cedar County, IA",2012-2013,18425,18379,-46,-0.25,26,-72,19,31,H1
"Cedar County, IA",2013-2014,18379,18411,32,0.174,8,24,19,31,H1
"Cedar County, IA",2014-2015,18380,18340,-40,-0.218,2,-42,19,31,H1
"Cedar County, IA",2015-2016,18340,18407,67,0.365,-3,70,19,31,H1
"Cedar County, IA",2016-2017,18407,18543,136,0.739,-1,137,19,31,H1
"Cerro Gordo County, IA",2000-2001,46389,45844,-545,-1.175,-39,-506,19,33,H1
"Cerro Gordo County, IA",2001-2002,45844,45430,-414,-0.903,-28,-386,19,33,H1
"Cerro Gordo County, IA",2002-2003,45430,45412,-18,-0.04,-13,-5,19,33,H1
"Cerro Gordo County, IA",2003-2004,45412,44993,-419,-0.923,-22,-397,19,33,H1
"Cerro Gordo County, IA",2004-2005,44993,44741,-252,-0.56,-79,-173,19,33,H1
"Cerro Gordo County, IA",2005-2006,44741,44531,-210,-0.469,4,-214,19,33,H1
"Cerro Gordo County, IA",2006-2007,44531,44461,-70,-0.157,-28,-42,19,33,H1
"Cerro Gordo County, IA",2007-2008,44461,44285,-176,-0.396,81,-257,19,33,H1
"Cerro Gordo County, IA",2008-2009,44285,44239,-46,-0.104,-17,-29,19,33,H1
"Cerro Gordo County, IA",2009-2010,44239,44100,-139,-0.314,-31,-108,19,33,H1
"Cerro Gordo County, IA",2010-2011,44100,43965,-135,-0.306,15,-150,19,33,H1
"Cerro Gordo County, IA",2011-2012,43965,43711,-254,-0.578,-17,-237,19,33,H1
"Cerro Gordo County, IA",2012-2013,43711,43505,-206,-0.471,-17,-189,19,33,H1
"Cerro Gordo County, IA",2013-2014,43505,43254,-251,-0.577,-29,-222,19,33,H1
"Cerro Gordo County, IA",2014-2015,43211,43017,-194,-0.449,-24,-170,19,33,H1
"Cerro Gordo County, IA",2015-2016,43017,43064,47,0.109,-65,112,19,33,H1
"Cerro Gordo County, IA",2016-2017,43064,43006,-58,-0.135,-44,-14,19,33,H1
"Cherokee County, IA",2000-2001,13019,12905,-114,-0.876,-28,-86,19,35,H1
"Cherokee County, IA",2001-2002,12905,12685,-220,-1.705,-59,-161,19,35,H1
"Cherokee County, IA",2002-2003,12685,12579,-106,-0.836,-27,-79,19,35,H1
"Cherokee County, IA",2003-2004,12579,12510,-69,-0.549,-39,-30,19,35,H1
"Cherokee County, IA",2004-2005,12510,12380,-130,-1.039,-38,-92,19,35,H1
"Cherokee County, IA",2005-2006,12380,12215,-165,-1.333,-41,-124,19,35,H1
"Cherokee County, IA",2006-2007,12215,12152,-63,-0.516,6,-69,19,35,H1
"Cherokee County, IA",2007-2008,12152,12014,-138,-1.136,-41,-97,19,35,H1
"Cherokee County, IA",2008-2009,12014,11953,-61,-0.508,-62,1,19,35,H1
"Cherokee County, IA",2009-2010,11953,12131,178,1.489,-40,218,19,35,H1
"Cherokee County, IA",2010-2011,12131,12046,-85,-0.701,-44,-41,19,35,H1
"Cherokee County, IA",2011-2012,12046,11981,-65,-0.54,-34,-31,19,35,H1
"Cherokee County, IA",2012-2013,11981,11918,-63,-0.526,-3,-60,19,35,H1
"Cherokee County, IA",2013-2014,11918,11836,-82,-0.688,-24,-58,19,35,H1
"Cherokee County, IA",2014-2015,11817,11574,-243,-2.056,-30,-213,19,35,H1
"Cherokee County, IA",2015-2016,11574,11404,-170,-1.469,-36,-134,19,35,H1
"Cherokee County, IA",2016-2017,11404,11316,-88,-0.772,-38,-50,19,35,H1
"Chickasaw County, IA",2000-2001,13168,13192,24,0.182,32,-8,19,37,H1
"Chickasaw County, IA",2001-2002,13192,12941,-251,-1.903,-13,-238,19,37,H1
"Chickasaw County, IA",2002-2003,12941,12770,-171,-1.321,-16,-155,19,37,H1
"Chickasaw County, IA",2003-2004,12770,12691,-79,-0.619,-2,-77,19,37,H1
"Chickasaw County, IA",2004-2005,12691,12561,-130,-1.024,-4,-126,19,37,H1
"Chickasaw County, IA",2005-2006,12561,12603,42,0.334,39,3,19,37,H1
"Chickasaw County, IA",2006-2007,12603,12540,-63,-0.5,32,-95,19,37,H1
"Chickasaw County, IA",2007-2008,12540,12471,-69,-0.55,31,-100,19,37,H1
"Chickasaw County, IA",2008-2009,12471,12465,-6,-0.048,30,-36,19,37,H1
"Chickasaw County, IA",2009-2010,12465,12414,-51,-0.409,22,-73,19,37,H1
"Chickasaw County, IA",2010-2011,12414,12408,-6,-0.048,1,-7,19,37,H1
"Chickasaw County, IA",2011-2012,12408,12270,-138,-1.112,24,-162,19,37,H1
"Chickasaw County, IA",2012-2013,12270,12288,18,0.147,6,12,19,37,H1
"Chickasaw County, IA",2013-2014,12288,12264,-24,-0.195,22,-46,19,37,H1
"Chickasaw County, IA",2014-2015,12197,12097,-100,-0.82,16,-116,19,37,H1
"Chickasaw County, IA",2015-2016,12097,12063,-34,-0.281,9,-43,19,37,H1
"Chickasaw County, IA",2016-2017,12063,12005,-58,-0.481,19,-77,19,37,H1
"Clarke County, IA",2000-2001,9194,9207,13,0.141,28,-15,19,39,H1
"Clarke County, IA",2001-2002,9207,9213,6,0.065,22,-16,19,39,H1
"Clarke County, IA",2002-2003,9213,9282,69,0.749,28,41,19,39,H1
"Clarke County, IA",2003-2004,9282,9307,25,0.269,22,3,19,39,H1
"Clarke County, IA",2004-2005,9307,9180,-127,-1.365,17,-144,19,39,H1
"Clarke County, IA",2005-2006,9180,9196,16,0.174,23,-7,19,39,H1
"Clarke County, IA",2006-2007,9196,9149,-47,-0.511,26,-73,19,39,H1
"Clarke County, IA",2007-2008,9149,9217,68,0.743,44,24,19,39,H1
"Clarke County, IA",2008-2009,9217,9228,11,0.119,45,-34,19,39,H1
"Clarke County, IA",2009-2010,9228,9301,73,0.791,35,38,19,39,H1
"Clarke County, IA",2010-2011,9301,9302,1,0.011,5,-4,19,39,H1
"Clarke County, IA",2011-2012,9302,9340,38,0.409,-1,39,19,39,H1
"Clarke County, IA",2012-2013,9340,9259,-81,-0.867,39,-120,19,39,H1
"Clarke County, IA",2013-2014,9259,9217,-42,-0.454,30,-72,19,39,H1
"Clarke County, IA",2014-2015,9223,9259,36,0.39,34,2,19,39,H1
"Clarke County, IA",2015-2016,9259,9286,27,0.292,18,9,19,39,H1
"Clarke County, IA",2016-2017,9286,9374,88,0.948,25,63,19,39,H1
"Clay County, IA",2000-2001,17360,17256,-104,-0.599,34,-138,19,41,H1
"Clay County, IA",2001-2002,17256,17086,-170,-0.985,11,-181,19,41,H1
"Clay County, IA",2002-2003,17086,16985,-101,-0.591,1,-102,19,41,H1
"Clay County, IA",2003-2004,16985,16960,-25,-0.147,54,-79,19,41,H1
"Clay County, IA",2004-2005,16960,16848,-112,-0.66,31,-143,19,41,H1
"Clay County, IA",2005-2006,16848,16812,-36,-0.214,41,-77,19,41,H1
"Clay County, IA",2006-2007,16812,16725,-87,-0.517,3,-90,19,41,H1
"Clay County, IA",2007-2008,16725,16697,-28,-0.167,15,-43,19,41,H1
"Clay County, IA",2008-2009,16697,16708,11,0.066,18,-7,19,41,H1
"Clay County, IA",2009-2010,16708,16624,-84,-0.503,16,-100,19,41,H1
"Clay County, IA",2010-2011,16624,16601,-23,-0.138,4,-27,19,41,H1
"Clay County, IA",2011-2012,16601,16563,-38,-0.229,-14,-24,19,41,H1
"Clay County, IA",2012-2013,16563,16474,-89,-0.537,22,-111,19,41,H1
"Clay County, IA",2013-2014,16474,16515,41,0.249,21,20,19,41,H1
"Clay County, IA",2014-2015,16520,16507,-13,-0.079,41,-54,19,41,H1
"Clay County, IA",2015-2016,16507,16325,-182,-1.103,-1,-181,19,41,H1
"Clay County, IA",2016-2017,16325,16170,-155,-0.949,17,-172,19,41,H1
"Clayton County, IA",2000-2001,18611,18529,-82,-0.441,-28,-54,19,43,H1
"Clayton County, IA",2001-2002,18529,18369,-160,-0.864,-30,-130,19,43,H1
"Clayton County, IA",2002-2003,18369,18357,-12,-0.065,-19,7,19,43,H1
"Clayton County, IA",2003-2004,18357,18358,1,0.005,1,0,19,43,H1
"Clayton County, IA",2004-2005,18358,18269,-89,-0.485,-6,-83,19,43,H1
"Clayton County, IA",2005-2006,18269,18272,3,0.016,30,-27,19,43,H1
"Clayton County, IA",2006-2007,18272,18259,-13,-0.071,21,-34,19,43,H1
"Clayton County, IA",2007-2008,18259,18209,-50,-0.274,-9,-41,19,43,H1
"Clayton County, IA",2008-2009,18209,18185,-24,-0.132,9,-33,19,43,H1
"Clayton County, IA",2009-2010,18185,18090,-95,-0.522,3,-98,19,43,H1
"Clayton County, IA",2010-2011,18090,1.80E+04,-90,-0.498,-28,-62,19,43,H1
"Clayton County, IA",2011-2012,1.80E+04,17934,-66,-0.367,23,-89,19,43,H1
"Clayton County, IA",2012-2013,17934,17785,-149,-0.831,16,-165,19,43,H1
"Clayton County, IA",2013-2014,17785,17692,-93,-0.523,20,-113,19,43,H1
"Clayton County, IA",2014-2015,17702,17644,-58,-0.328,6,-64,19,43,H1
"Clayton County, IA",2015-2016,17644,17647,3,0.017,-5,8,19,43,H1
"Clayton County, IA",2016-2017,17647,17637,-10,-0.057,-13,3,19,43,H1
"Clinton County, IA",2000-2001,50120,49889,-231,-0.461,109,-340,19,45,H1
"Clinton County, IA",2001-2002,49889,49659,-230,-0.461,70,-300,19,45,H1
"Clinton County, IA",2002-2003,49659,49585,-74,-0.149,15,-89,19,45,H1
"Clinton County, IA",2003-2004,49585,49498,-87,-0.175,14,-101,19,45,H1
"Clinton County, IA",2004-2005,49498,49475,-23,-0.046,69,-92,19,45,H1
"Clinton County, IA",2005-2006,49475,49487,12,0.024,104,-92,19,45,H1
"Clinton County, IA",2006-2007,49487,49342,-145,-0.293,90,-235,19,45,H1
"Clinton County, IA",2007-2008,49342,49303,-39,-0.079,123,-162,19,45,H1
"Clinton County, IA",2008-2009,49303,49147,-156,-0.316,66,-222,19,45,H1
"Clinton County, IA",2009-2010,49147,49109,-38,-0.077,57,-95,19,45,H1
"Clinton County, IA",2010-2011,49109,49103,-6,-0.012,58,-64,19,45,H1
"Clinton County, IA",2011-2012,49103,48723,-380,-0.774,41,-421,19,45,H1
"Clinton County, IA",2012-2013,48723,48330,-393,-0.807,32,-425,19,45,H1
"Clinton County, IA",2013-2014,48330,48051,-279,-0.577,58,-337,19,45,H1
"Clinton County, IA",2014-2015,47929,47768,-161,-0.336,36,-197,19,45,H1
"Clinton County, IA",2015-2016,47768,47236,-532,-1.114,11,-543,19,45,H1
"Clinton County, IA",2016-2017,47236,47010,-226,-0.478,60,-286,19,45,H1
"Crawford County, IA",2000-2001,16944,16960,16,0.094,39,-23,19,47,H1
"Crawford County, IA",2001-2002,16960,16981,21,0.124,58,-37,19,47,H1
"Crawford County, IA",2002-2003,16981,16953,-28,-0.165,65,-93,19,47,H1
"Crawford County, IA",2003-2004,16953,16941,-12,-0.071,63,-75,19,47,H1
"Crawford County, IA",2004-2005,16941,16920,-21,-0.124,48,-69,19,47,H1
"Crawford County, IA",2005-2006,16920,16868,-52,-0.307,73,-125,19,47,H1
"Crawford County, IA",2006-2007,16868,16931,63,0.373,91,-28,19,47,H1
"Crawford County, IA",2007-2008,16931,16881,-50,-0.295,82,-132,19,47,H1
"Crawford County, IA",2008-2009,16881,16944,63,0.373,67,-4,19,47,H1
"Crawford County, IA",2009-2010,16944,17127,183,1.08,72,111,19,47,H1
"Crawford County, IA",2010-2011,17127,17210,83,0.485,49,34,19,47,H1
"Crawford County, IA",2011-2012,17210,17306,96,0.558,123,-27,19,47,H1
"Crawford County, IA",2012-2013,17306,17422,116,0.67,79,37,19,47,H1
"Crawford County, IA",2013-2014,17422,17228,-194,-1.114,76,-270,19,47,H1
"Crawford County, IA",2014-2015,17205,17094,-111,-0.645,81,-192,19,47,H1
"Crawford County, IA",2015-2016,17094,17036,-58,-0.339,97,-155,19,47,H1
"Crawford County, IA",2016-2017,17036,17056,20,0.117,90,-70,19,47,H1
"Dallas County, IA",2000-2001,41446,43204,1758,4.242,254,1504,19,49,H1
"Dallas County, IA",2001-2002,43204,44960,1756,4.064,240,1516,19,49,H1
"Dallas County, IA",2002-2003,44960,47118,2158,4.8,290,1868,19,49,H1
"Dallas County, IA",2003-2004,47118,50387,3269,6.938,288,2981,19,49,H1
"Dallas County, IA",2004-2005,50387,53042,2655,5.269,406,2249,19,49,H1
"Dallas County, IA",2005-2006,53042,56158,3116,5.875,546,2570,19,49,H1
"Dallas County, IA",2006-2007,56158,59164,3006,5.353,596,2410,19,49,H1
"Dallas County, IA",2007-2008,59164,62144,2980,5.037,643,2337,19,49,H1
"Dallas County, IA",2008-2009,62144,64489,2345,3.773,662,1683,19,49,H1
"Dallas County, IA",2009-2010,64489,66652,2163,3.354,580,1583,19,49,H1
"Dallas County, IA",2010-2011,66652,69722,3070,4.606,655,2415,19,49,H1
"Dallas County, IA",2011-2012,69722,72121,2399,3.441,756,1643,19,49,H1
"Dallas County, IA",2012-2013,72121,74727,2606,3.613,850,1756,19,49,H1
"Dallas County, IA",2013-2014,74727,77400,2673,3.577,819,1854,19,49,H1
"Dallas County, IA",2014-2015,77516,80133,2617,3.376,849,1768,19,49,H1
"Dallas County, IA",2015-2016,80133,84185,4052,5.057,822,3230,19,49,H1
"Dallas County, IA",2016-2017,84185,87235,3050,3.623,838,2212,19,49,H1
"Davis County, IA",2000-2001,8544,8588,44,0.515,41,3,19,51,H1
"Davis County, IA",2001-2002,8588,8586,-2,-0.023,28,-30,19,51,H1
"Davis County, IA",2002-2003,8586,8534,-52,-0.606,11,-63,19,51,H1
"Davis County, IA",2003-2004,8534,8612,78,0.914,26,52,19,51,H1
"Davis County, IA",2004-2005,8612,8583,-29,-0.337,39,-68,19,51,H1
"Davis County, IA",2005-2006,8583,8619,36,0.419,58,-22,19,51,H1
"Davis County, IA",2006-2007,8619,8676,57,0.661,51,6,19,51,H1
"Davis County, IA",2007-2008,8676,8675,-1,-0.012,63,-64,19,51,H1
"Davis County, IA",2008-2009,8675,8701,26,0.3,54,-28,19,51,H1
"Davis County, IA",2009-2010,8701,8791,90,1.034,35,55,19,51,H1
"Davis County, IA",2010-2011,8791,8774,-17,-0.193,42,-59,19,51,H1
"Davis County, IA",2011-2012,8774,8709,-65,-0.741,54,-119,19,51,H1
"Davis County, IA",2012-2013,8709,8770,61,0.7,45,16,19,51,H1
"Davis County, IA",2013-2014,8770,8781,11,0.125,59,-48,19,51,H1
"Davis County, IA",2014-2015,8752,8769,17,0.194,58,-41,19,51,H1
"Davis County, IA",2015-2016,8769,8901,132,1.505,65,67,19,51,H1
"Davis County, IA",2016-2017,8901,8966,65,0.73,71,-6,19,51,H1
"Decatur County, IA",2000-2001,8645,8669,24,0.278,5,19,19,53,H1
"Decatur County, IA",2001-2002,8669,8603,-66,-0.761,-19,-47,19,53,H1
"Decatur County, IA",2002-2003,8603,8575,-28,-0.325,0,-28,19,53,H1
"Decatur County, IA",2003-2004,8575,8580,5,0.058,0,5,19,53,H1
"Decatur County, IA",2004-2005,8580,8618,38,0.443,29,9,19,53,H1
"Decatur County, IA",2005-2006,8618,8576,-42,-0.487,4,-46,19,53,H1
"Decatur County, IA",2006-2007,8576,8569,-7,-0.082,8,-15,19,53,H1
"Decatur County, IA",2007-2008,8569,8457,-112,-1.307,16,-128,19,53,H1
"Decatur County, IA",2008-2009,8457,8506,49,0.579,21,28,19,53,H1
"Decatur County, IA",2009-2010,8506,8415,-91,-1.07,2,-93,19,53,H1
"Decatur County, IA",2010-2011,8415,8257,-158,-1.878,-17,-141,19,53,H1
"Decatur County, IA",2011-2012,8257,8250,-7,-0.085,-1,-6,19,53,H1
"Decatur County, IA",2012-2013,8250,8245,-5,-0.061,0,-5,19,53,H1
"Decatur County, IA",2013-2014,8245,8263,18,0.218,1,17,19,53,H1
"Decatur County, IA",2014-2015,8257,8220,-37,-0.448,13,-50,19,53,H1
"Decatur County, IA",2015-2016,8220,8045,-175,-2.129,18,-193,19,53,H1
"Decatur County, IA",2016-2017,8045,7950,-95,-1.181,12,-107,19,53,H1
"Delaware County, IA",2000-2001,18416,18294,-122,-0.662,44,-166,19,55,H1
"Delaware County, IA",2001-2002,18294,18271,-23,-0.126,27,-50,19,55,H1
"Delaware County, IA",2002-2003,18271,18190,-81,-0.443,56,-137,19,55,H1
"Delaware County, IA",2003-2004,18190,18066,-124,-0.682,66,-190,19,55,H1
"Delaware County, IA",2004-2005,18066,17955,-111,-0.614,27,-138,19,55,H1
"Delaware County, IA",2005-2006,17955,17957,2,0.011,77,-75,19,55,H1
"Delaware County, IA",2006-2007,17957,17981,24,0.134,36,-12,19,55,H1
"Delaware County, IA",2007-2008,17981,17840,-141,-0.784,53,-194,19,55,H1
"Delaware County, IA",2008-2009,17840,17755,-85,-0.476,40,-125,19,55,H1
"Delaware County, IA",2009-2010,17755,17772,17,0.096,42,-25,19,55,H1
"Delaware County, IA",2010-2011,17772,17650,-122,-0.686,29,-151,19,55,H1
"Delaware County, IA",2011-2012,17650,17572,-78,-0.442,29,-107,19,55,H1
"Delaware County, IA",2012-2013,17572,17499,-73,-0.415,36,-109,19,55,H1
"Delaware County, IA",2013-2014,17499,17398,-101,-0.577,28,-129,19,55,H1
"Delaware County, IA",2014-2015,17419,17403,-16,-0.092,40,-56,19,55,H1
"Delaware County, IA",2015-2016,17403,17269,-134,-0.77,41,-175,19,55,H1
"Delaware County, IA",2016-2017,17269,17153,-116,-0.672,32,-148,19,55,H1
"Des Moines County, IA",2000-2001,42253,41820,-433,-1.025,117,-550,19,57,H1
"Des Moines County, IA",2001-2002,41820,41138,-682,-1.631,67,-749,19,57,H1
"Des Moines County, IA",2002-2003,41138,41047,-91,-0.221,80,-171,19,57,H1
"Des Moines County, IA",2003-2004,41047,40562,-485,-1.182,81,-566,19,57,H1
"Des Moines County, IA",2004-2005,40562,40332,-230,-0.567,26,-256,19,57,H1
"Des Moines County, IA",2005-2006,40332,40192,-140,-0.347,90,-230,19,57,H1
"Des Moines County, IA",2006-2007,40192,40206,14,0.035,127,-113,19,57,H1
"Des Moines County, IA",2007-2008,40206,40235,29,0.072,138,-109,19,57,H1
"Des Moines County, IA",2008-2009,40235,40379,144,0.358,110,34,19,57,H1
"Des Moines County, IA",2009-2010,40379,40250,-129,-0.319,122,-251,19,57,H1
"Des Moines County, IA",2010-2011,40250,40099,-151,-0.375,24,-175,19,57,H1
"Des Moines County, IA",2011-2012,40099,40271,172,0.429,9,163,19,57,H1
"Des Moines County, IA",2012-2013,40271,40452,181,0.449,21,160,19,57,H1
"Des Moines County, IA",2013-2014,40452,40255,-197,-0.487,23,-220,19,57,H1
"Des Moines County, IA",2014-2015,40211,40055,-156,-0.388,28,-184,19,57,H1
"Des Moines County, IA",2015-2016,40055,39625,-430,-1.074,15,-445,19,57,H1
"Des Moines County, IA",2016-2017,39625,39417,-208,-0.525,20,-228,19,57,H1
"Dickinson County, IA",2000-2001,16460,16477,17,0.103,-23,40,19,59,H1
"Dickinson County, IA",2001-2002,16477,16351,-126,-0.765,-29,-97,19,59,H1
"Dickinson County, IA",2002-2003,16351,16339,-12,-0.073,-31,19,19,59,H1
"Dickinson County, IA",2003-2004,16339,16506,167,1.022,0,167,19,59,H1
"Dickinson County, IA",2004-2005,16506,16644,138,0.836,30,108,19,59,H1
"Dickinson County, IA",2005-2006,16644,16667,23,0.138,-4,27,19,59,H1
"Dickinson County, IA",2006-2007,16667,16634,-33,-0.198,-10,-23,19,59,H1
"Dickinson County, IA",2007-2008,16634,16690,56,0.337,-10,66,19,59,H1
"Dickinson County, IA",2008-2009,16690,16666,-24,-0.144,-7,-17,19,59,H1
"Dickinson County, IA",2009-2010,16666,16658,-8,-0.048,-12,4,19,59,H1
"Dickinson County, IA",2010-2011,16658,16879,221,1.327,-59,280,19,59,H1
"Dickinson County, IA",2011-2012,16879,16965,86,0.51,-6,92,19,59,H1
"Dickinson County, IA",2012-2013,16965,16949,-16,-0.094,-43,27,19,59,H1
"Dickinson County, IA",2013-2014,16949,16935,-14,-0.083,-29,15,19,59,H1
"Dickinson County, IA",2014-2015,16928,17111,183,1.081,-9,192,19,59,H1
"Dickinson County, IA",2015-2016,17111,17104,-7,-0.041,-11,4,19,59,H1
"Dickinson County, IA",2016-2017,17104,17199,95,0.555,-4,99,19,59,H1
"Dubuque County, IA",2000-2001,89201,88932,-269,-0.302,349,-618,19,61,H1
"Dubuque County, IA",2001-2002,88932,89132,200,0.225,302,-102,19,61,H1
"Dubuque County, IA",2002-2003,89132,90012,880,0.987,446,434,19,61,H1
"Dubuque County, IA",2003-2004,90012,90462,450,0.5,382,68,19,61,H1
"Dubuque County, IA",2004-2005,90462,90769,307,0.339,353,-46,19,61,H1
"Dubuque County, IA",2005-2006,90769,91258,489,0.539,263,226,19,61,H1
"Dubuque County, IA",2006-2007,91258,92130,872,0.956,366,506,19,61,H1
"Dubuque County, IA",2007-2008,92130,92519,389,0.422,372,17,19,61,H1
"Dubuque County, IA",2008-2009,92519,92948,429,0.464,384,45,19,61,H1
"Dubuque County, IA",2009-2010,92948,93893,945,1.017,404,541,19,61,H1
"Dubuque County, IA",2010-2011,93893,94507,614,0.654,293,321,19,61,H1
"Dubuque County, IA",2011-2012,94507,95147,640,0.677,299,341,19,61,H1
"Dubuque County, IA",2012-2013,95147,95912,765,0.804,309,456,19,61,H1
"Dubuque County, IA",2013-2014,95912,96370,458,0.478,322,136,19,61,H1
"Dubuque County, IA",2014-2015,96587,97125,538,0.557,362,176,19,61,H1
"Dubuque County, IA",2015-2016,97125,96704,-421,-0.433,350,-771,19,61,H1
"Dubuque County, IA",2016-2017,96704,97041,337,0.348,354,-17,19,61,H1
"Emmet County, IA",2000-2001,10995,10890,-105,-0.955,-12,-93,19,63,H1
"Emmet County, IA",2001-2002,10890,10815,-75,-0.689,-1,-74,19,63,H1
"Emmet County, IA",2002-2003,10815,10724,-91,-0.841,4,-95,19,63,H1
"Emmet County, IA",2003-2004,10724,10553,-171,-1.595,-4,-167,19,63,H1
"Emmet County, IA",2004-2005,10553,10527,-26,-0.246,39,-65,19,63,H1
"Emmet County, IA",2005-2006,10527,10437,-90,-0.855,20,-110,19,63,H1
"Emmet County, IA",2006-2007,10437,10417,-20,-0.192,28,-48,19,63,H1
"Emmet County, IA",2007-2008,10417,10448,31,0.298,-9,40,19,63,H1
"Emmet County, IA",2008-2009,10448,10361,-87,-0.833,8,-95,19,63,H1
"Emmet County, IA",2009-2010,10361,10281,-80,-0.772,11,-91,19,63,H1
"Emmet County, IA",2010-2011,10281,10080,-201,-1.955,-13,-188,19,63,H1
"Emmet County, IA",2011-2012,10080,9997,-83,-0.823,-15,-68,19,63,H1
"Emmet County, IA",2012-2013,9997,9994,-3,-0.03,-17,14,19,63,H1
"Emmet County, IA",2013-2014,9994,9990,-4,-0.04,10,-14,19,63,H1
"Emmet County, IA",2014-2015,9866,9769,-97,-0.983,8,-105,19,63,H1
"Emmet County, IA",2015-2016,9769,9558,-211,-2.16,2,-213,19,63,H1
"Emmet County, IA",2016-2017,9558,9432,-126,-1.318,-6,-120,19,63,H1
"Fayette County, IA",2000-2001,22022,21791,-231,-1.049,-69,-162,19,65,H1
"Fayette County, IA",2001-2002,21791,21643,-148,-0.679,-55,-93,19,65,H1
"Fayette County, IA",2002-2003,21643,21604,-39,-0.18,-34,-5,19,65,H1
"Fayette County, IA",2003-2004,21604,21415,-189,-0.875,-22,-167,19,65,H1
"Fayette County, IA",2004-2005,21415,21426,11,0.051,-7,18,19,65,H1
"Fayette County, IA",2005-2006,21426,21265,-161,-0.751,-8,-153,19,65,H1
"Fayette County, IA",2006-2007,21265,21005,-260,-1.223,-15,-245,19,65,H1
"Fayette County, IA",2007-2008,21005,20910,-95,-0.452,-27,-68,19,65,H1
"Fayette County, IA",2008-2009,20910,20939,29,0.139,-15,44,19,65,H1
"Fayette County, IA",2009-2010,20939,20860,-79,-0.377,3,-82,19,65,H1
"Fayette County, IA",2010-2011,20860,20966,106,0.508,-19,125,19,65,H1
"Fayette County, IA",2011-2012,20966,20794,-172,-0.82,-26,-146,19,65,H1
"Fayette County, IA",2012-2013,20794,20501,-293,-1.409,-50,-243,19,65,H1
"Fayette County, IA",2013-2014,20501,20343,-158,-0.771,-21,-137,19,65,H1
"Fayette County, IA",2014-2015,20370,20257,-113,-0.555,-24,-89,19,65,H1
"Fayette County, IA",2015-2016,20257,19986,-271,-1.338,-21,-250,19,65,H1
"Fayette County, IA",2016-2017,19986,19796,-190,-0.951,-14,-176,19,65,H1
"Floyd County, IA",2000-2001,16854,16660,-194,-1.151,5,-199,19,67,H1
"Floyd County, IA",2001-2002,16660,16670,10,0.06,-32,42,19,67,H1
"Floyd County, IA",2002-2003,16670,16641,-29,-0.174,0,-29,19,67,H1
"Floyd County, IA",2003-2004,16641,16586,-55,-0.331,-25,-30,19,67,H1
"Floyd County, IA",2004-2005,16586,16520,-66,-0.398,-6,-60,19,67,H1
"Floyd County, IA",2005-2006,16520,16586,66,0.4,17,49,19,67,H1
"Floyd County, IA",2006-2007,16586,16497,-89,-0.537,31,-120,19,67,H1
"Floyd County, IA",2007-2008,16497,16331,-166,-1.006,11,-177,19,67,H1
"Floyd County, IA",2008-2009,16331,16248,-83,-0.508,19,-102,19,67,H1
"Floyd County, IA",2009-2010,16248,16318,70,0.431,12,58,19,67,H1
"Floyd County, IA",2010-2011,16318,16124,-194,-1.189,9,-203,19,67,H1
"Floyd County, IA",2011-2012,16124,16136,12,0.074,1,11,19,67,H1
"Floyd County, IA",2012-2013,16136,16110,-26,-0.161,-28,2,19,67,H1
"Floyd County, IA",2013-2014,16110,16077,-33,-0.205,-21,-12,19,67,H1
"Floyd County, IA",2014-2015,16027,15960,-67,-0.418,3,-70,19,67,H1
"Floyd County, IA",2015-2016,15960,15835,-125,-0.783,22,-147,19,67,H1
"Floyd County, IA",2016-2017,15835,15744,-91,-0.575,12,-103,19,67,H1
"Franklin County, IA",2000-2001,10679,10618,-61,-0.571,-3,-58,19,69,H1
"Franklin County, IA",2001-2002,10618,10674,56,0.527,-16,72,19,69,H1
"Franklin County, IA",2002-2003,10674,10655,-19,-0.178,-31,12,19,69,H1
"Franklin County, IA",2003-2004,10655,10716,61,0.573,0,61,19,69,H1
"Franklin County, IA",2004-2005,10716,10766,50,0.467,22,28,19,69,H1
"Franklin County, IA",2005-2006,10766,10699,-67,-0.622,9,-76,19,69,H1
"Franklin County, IA",2006-2007,10699,10759,60,0.561,36,24,19,69,H1
"Franklin County, IA",2007-2008,10759,10690,-69,-0.641,23,-92,19,69,H1
"Franklin County, IA",2008-2009,10690,10656,-34,-0.318,-4,-30,19,69,H1
"Franklin County, IA",2009-2010,10656,10685,29,0.272,2,27,19,69,H1
"Franklin County, IA",2010-2011,10685,10683,-2,-0.019,2,-4,19,69,H1
"Franklin County, IA",2011-2012,10683,10526,-157,-1.47,-12,-145,19,69,H1
"Franklin County, IA",2012-2013,10526,10531,5,0.048,-17,22,19,69,H1
"Franklin County, IA",2013-2014,10531,10436,-95,-0.902,0,-95,19,69,H1
"Franklin County, IA",2014-2015,10423,10295,-128,-1.228,22,-150,19,69,H1
"Franklin County, IA",2015-2016,10295,10200,-95,-0.923,1,-96,19,69,H1
"Franklin County, IA",2016-2017,10200,10164,-36,-0.353,7,-43,19,69,H1
"Fremont County, IA",2000-2001,7995,7874,-121,-1.513,-3,-118,19,71,H1
"Fremont County, IA",2001-2002,7874,7787,-87,-1.105,-18,-69,19,71,H1
"Fremont County, IA",2002-2003,7787,7743,-44,-0.565,-21,-23,19,71,H1
"Fremont County, IA",2003-2004,7743,7655,-88,-1.137,-18,-70,19,71,H1
"Fremont County, IA",2004-2005,7655,7616,-39,-0.509,-21,-18,19,71,H1
"Fremont County, IA",2005-2006,7616,7622,6,0.079,7,-1,19,71,H1
"Fremont County, IA",2006-2007,7622,7642,20,0.262,25,-5,19,71,H1
"Fremont County, IA",2007-2008,7642,7489,-153,-2.002,20,-173,19,71,H1
"Fremont County, IA",2008-2009,7489,7453,-36,-0.481,-11,-25,19,71,H1
"Fremont County, IA",2009-2010,7453,7421,-32,-0.429,-2,-30,19,71,H1
"Fremont County, IA",2010-2011,7421,7360,-61,-0.822,-6,-55,19,71,H1
"Fremont County, IA",2011-2012,7360,7134,-226,-3.071,-28,-198,19,71,H1
"Fremont County, IA",2012-2013,7134,7063,-71,-0.995,-17,-54,19,71,H1
"Fremont County, IA",2013-2014,7063,7022,-41,-0.58,-11,-30,19,71,H1
"Fremont County, IA",2014-2015,7039,6906,-133,-1.889,-11,-122,19,71,H1
"Fremont County, IA",2015-2016,6906,6960,54,0.782,0,54,19,71,H1
"Fremont County, IA",2016-2017,6960,6948,-12,-0.172,6,-18,19,71,H1
"Greene County, IA",2000-2001,10341,10150,-191,-1.847,-39,-152,19,73,H1
"Greene County, IA",2001-2002,10150,10105,-45,-0.443,-45,0,19,73,H1
"Greene County, IA",2002-2003,10105,9996,-109,-1.079,-23,-86,19,73,H1
"Greene County, IA",2003-2004,9996,9932,-64,-0.64,-37,-27,19,73,H1
"Greene County, IA",2004-2005,9932,9800,-132,-1.329,-27,-105,19,73,H1
"Greene County, IA",2005-2006,9800,9611,-189,-1.929,0,-189,19,73,H1
"Greene County, IA",2006-2007,9611,9548,-63,-0.655,11,-74,19,73,H1
"Greene County, IA",2007-2008,9548,9415,-133,-1.393,-2,-131,19,73,H1
"Greene County, IA",2008-2009,9415,9329,-86,-0.913,-14,-72,19,73,H1
"Greene County, IA",2009-2010,9329,9332,3,0.032,-15,18,19,73,H1
"Greene County, IA",2010-2011,9332,9305,-27,-0.289,-19,-8,19,73,H1
"Greene County, IA",2011-2012,9305,9161,-144,-1.548,-42,-102,19,73,H1
"Greene County, IA",2012-2013,9161,9156,-5,-0.055,-1,-4,19,73,H1
"Greene County, IA",2013-2014,9156,9200,44,0.481,-12,56,19,73,H1
"Greene County, IA",2014-2015,9204,9027,-177,-1.923,-8,-169,19,73,H1
"Greene County, IA",2015-2016,9027,9009,-18,-0.199,-19,1,19,73,H1
"Greene County, IA",2016-2017,9009,8981,-28,-0.311,-7,-21,19,73,H1
"Grundy County, IA",2000-2001,12368,12319,-49,-0.396,2,-51,19,75,H1
"Grundy County, IA",2001-2002,12319,12372,53,0.43,-4,57,19,75,H1
"Grundy County, IA",2002-2003,12372,12348,-24,-0.194,-39,15,19,75,H1
"Grundy County, IA",2003-2004,12348,12383,35,0.283,-29,64,19,75,H1
"Grundy County, IA",2004-2005,12383,12406,23,0.186,-4,27,19,75,H1
"Grundy County, IA",2005-2006,12406,12436,30,0.242,-22,52,19,75,H1
"Grundy County, IA",2006-2007,12436,12317,-119,-0.957,-19,-100,19,75,H1
"Grundy County, IA",2007-2008,12317,12359,42,0.341,13,29,19,75,H1
"Grundy County, IA",2008-2009,12359,12447,88,0.712,2,86,19,75,H1
"Grundy County, IA",2009-2010,12447,12447,0,0,10,-10,19,75,H1
"Grundy County, IA",2010-2011,12447,12458,11,0.088,8,3,19,75,H1
"Grundy County, IA",2011-2012,12458,12423,-35,-0.281,13,-48,19,75,H1
"Grundy County, IA",2012-2013,12423,12311,-112,-0.902,14,-126,19,75,H1
"Grundy County, IA",2013-2014,12311,12375,64,0.52,15,49,19,75,H1
"Grundy County, IA",2014-2015,12377,12435,58,0.469,17,41,19,75,H1
"Grundy County, IA",2015-2016,12435,12297,-138,-1.11,-3,-135,19,75,H1
"Grundy County, IA",2016-2017,12297,12333,36,0.293,-11,47,19,75,H1
"Guthrie County, IA",2000-2001,11334,11225,-109,-0.962,-19,-90,19,77,H1
"Guthrie County, IA",2001-2002,11225,11227,2,0.018,0,2,19,77,H1
"Guthrie County, IA",2002-2003,11227,11343,116,1.033,-1,117,19,77,H1
"Guthrie County, IA",2003-2004,11343,11389,46,0.406,-34,80,19,77,H1
"Guthrie County, IA",2004-2005,11389,11249,-140,-1.229,-29,-111,19,77,H1
"Guthrie County, IA",2005-2006,11249,11150,-99,-0.88,1,-100,19,77,H1
"Guthrie County, IA",2006-2007,11150,11116,-34,-0.305,-19,-15,19,77,H1
"Guthrie County, IA",2007-2008,11116,11038,-78,-0.702,-1,-77,19,77,H1
"Guthrie County, IA",2008-2009,11038,10939,-99,-0.897,-15,-84,19,77,H1
"Guthrie County, IA",2009-2010,10939,10943,4,0.037,-29,33,19,77,H1
"Guthrie County, IA",2010-2011,10943,10861,-82,-0.749,-29,-53,19,77,H1
"Guthrie County, IA",2011-2012,10861,10771,-90,-0.829,-1,-89,19,77,H1
"Guthrie County, IA",2012-2013,10771,10675,-96,-0.891,3,-99,19,77,H1
"Guthrie County, IA",2013-2014,10675,10722,47,0.44,-7,54,19,77,H1
"Guthrie County, IA",2014-2015,10709,10676,-33,-0.308,-14,-19,19,77,H1
"Guthrie County, IA",2015-2016,10676,10650,-26,-0.244,7,-33,19,77,H1
"Guthrie County, IA",2016-2017,10650,10670,20,0.188,-3,23,19,77,H1
"Hamilton County, IA",2000-2001,16423,16236,-187,-1.139,-9,-178,19,79,H1
"Hamilton County, IA",2001-2002,16236,16337,101,0.622,8,93,19,79,H1
"Hamilton County, IA",2002-2003,16337,16366,29,0.178,23,6,19,79,H1
"Hamilton County, IA",2003-2004,16366,16285,-81,-0.495,13,-94,19,79,H1
"Hamilton County, IA",2004-2005,16285,16261,-24,-0.147,-15,-9,19,79,H1
"Hamilton County, IA",2005-2006,16261,16144,-117,-0.72,19,-136,19,79,H1
"Hamilton County, IA",2006-2007,16144,15987,-157,-0.972,31,-188,19,79,H1
"Hamilton County, IA",2007-2008,15987,15863,-124,-0.776,16,-140,19,79,H1
"Hamilton County, IA",2008-2009,15863,15739,-124,-0.782,9,-133,19,79,H1
"Hamilton County, IA",2009-2010,15739,15630,-109,-0.693,27,-136,19,79,H1
"Hamilton County, IA",2010-2011,15630,15447,-183,-1.171,1,-184,19,79,H1
"Hamilton County, IA",2011-2012,15447,15308,-139,-0.9,2,-141,19,79,H1
"Hamilton County, IA",2012-2013,15308,15312,4,0.026,-12,16,19,79,H1
"Hamilton County, IA",2013-2014,15312,15117,-195,-1.274,-12,-183,19,79,H1
"Hamilton County, IA",2014-2015,15179,15190,11,0.072,27,-16,19,79,H1
"Hamilton County, IA",2015-2016,15190,15100,-90,-0.592,22,-112,19,79,H1
"Hamilton County, IA",2016-2017,15100,15115,15,0.099,22,-7,19,79,H1
"Hancock County, IA",2000-2001,12109,11954,-155,-1.28,-10,-145,19,81,H1
"Hancock County, IA",2001-2002,11954,11846,-108,-0.903,5,-113,19,81,H1
"Hancock County, IA",2002-2003,11846,11905,59,0.498,-14,73,19,81,H1
"Hancock County, IA",2003-2004,11905,11838,-67,-0.563,0,-67,19,81,H1
"Hancock County, IA",2004-2005,11838,11834,-4,-0.034,14,-18,19,81,H1
"Hancock County, IA",2005-2006,11834,11729,-105,-0.887,-21,-84,19,81,H1
"Hancock County, IA",2006-2007,11729,11580,-149,-1.27,28,-177,19,81,H1
"Hancock County, IA",2007-2008,11580,11525,-55,-0.475,-8,-47,19,81,H1
"Hancock County, IA",2008-2009,11525,11371,-154,-1.336,17,-171,19,81,H1
"Hancock County, IA",2009-2010,11371,11305,-66,-0.58,5,-71,19,81,H1
"Hancock County, IA",2010-2011,11305,11276,-29,-0.257,-6,-23,19,81,H1
"Hancock County, IA",2011-2012,11276,11164,-112,-0.993,-27,-85,19,81,H1
"Hancock County, IA",2012-2013,11164,11102,-62,-0.555,-26,-36,19,81,H1
"Hancock County, IA",2013-2014,11102,11027,-75,-0.676,-16,-59,19,81,H1
"Hancock County, IA",2014-2015,10987,10974,-13,-0.118,-13,0,19,81,H1
"Hancock County, IA",2015-2016,10974,10893,-81,-0.738,11,-92,19,81,H1
"Hancock County, IA",2016-2017,10893,10771,-122,-1.12,-8,-114,19,81,H1
"Hardin County, IA",2000-2001,18807,18669,-138,-0.734,-51,-87,19,83,H1
"Hardin County, IA",2001-2002,18669,18476,-193,-1.034,-27,-166,19,83,H1
"Hardin County, IA",2002-2003,18476,18327,-149,-0.806,-4,-145,19,83,H1
"Hardin County, IA",2003-2004,18327,18164,-163,-0.889,-82,-81,19,83,H1
"Hardin County, IA",2004-2005,18164,17974,-190,-1.046,-60,-130,19,83,H1
"Hardin County, IA",2005-2006,17974,17893,-81,-0.451,-15,-66,19,83,H1
"Hardin County, IA",2006-2007,17893,17789,-104,-0.581,-77,-27,19,83,H1
"Hardin County, IA",2007-2008,17789,17690,-99,-0.557,-45,-54,19,83,H1
"Hardin County, IA",2008-2009,17690,17535,-155,-0.876,-14,-141,19,83,H1
"Hardin County, IA",2009-2010,17535,17531,-4,-0.023,-31,27,19,83,H1
"Hardin County, IA",2010-2011,17531,17384,-147,-0.839,-43,-104,19,83,H1
"Hardin County, IA",2011-2012,17384,17378,-6,-0.035,-41,35,19,83,H1
"Hardin County, IA",2012-2013,17378,17424,46,0.265,-29,75,19,83,H1
"Hardin County, IA",2013-2014,17424,17311,-113,-0.649,-49,-64,19,83,H1
"Hardin County, IA",2014-2015,17371,17367,-4,-0.023,-33,29,19,83,H1
"Hardin County, IA",2015-2016,17367,17193,-174,-1.002,-18,-156,19,83,H1
"Hardin County, IA",2016-2017,17193,17048,-145,-0.843,-24,-121,19,83,H1
"Harrison County, IA",2000-2001,15685,15592,-93,-0.593,14,-107,19,85,H1
"Harrison County, IA",2001-2002,15592,15421,-171,-1.097,-78,-93,19,85,H1
"Harrison County, IA",2002-2003,15421,15444,23,0.149,-3,26,19,85,H1
"Harrison County, IA",2003-2004,15444,15412,-32,-0.207,-23,-9,19,85,H1
"Harrison County, IA",2004-2005,15412,15362,-50,-0.324,-30,-20,19,85,H1
"Harrison County, IA",2005-2006,15362,15346,-16,-0.104,-15,-1,19,85,H1
"Harrison County, IA",2006-2007,15346,15177,-169,-1.101,-4,-165,19,85,H1
"Harrison County, IA",2007-2008,15177,14946,-231,-1.522,22,-253,19,85,H1
"Harrison County, IA",2008-2009,14946,14972,26,0.174,-2,28,19,85,H1
"Harrison County, IA",2009-2010,14972,14925,-47,-0.314,-24,-23,19,85,H1
"Harrison County, IA",2010-2011,14925,14796,-129,-0.864,-58,-71,19,85,H1
"Harrison County, IA",2011-2012,14796,14520,-276,-1.865,-30,-246,19,85,H1
"Harrison County, IA",2012-2013,14520,14437,-83,-0.572,-8,-75,19,85,H1
"Harrison County, IA",2013-2014,14437,14324,-113,-0.783,-21,-92,19,85,H1
"Harrison County, IA",2014-2015,14337,14265,-72,-0.502,1,-73,19,85,H1
"Harrison County, IA",2015-2016,14265,14072,-193,-1.353,-3,-190,19,85,H1
"Harrison County, IA",2016-2017,14072,14136,64,0.455,-10,74,19,85,H1
"Henry County, IA",2000-2001,20341,20408,67,0.329,49,18,19,87,H1
"Henry County, IA",2001-2002,20408,20086,-322,-1.578,-7,-315,19,87,H1
"Henry County, IA",2002-2003,20086,20225,139,0.692,22,117,19,87,H1
"Henry County, IA",2003-2004,20225,20225,0,0,30,-30,19,87,H1
"Henry County, IA",2004-2005,20225,20354,129,0.638,48,81,19,87,H1
"Henry County, IA",2005-2006,20354,20326,-28,-0.138,25,-53,19,87,H1
"Henry County, IA",2006-2007,20326,20359,33,0.162,28,5,19,87,H1
"Henry County, IA",2007-2008,20359,20307,-52,-0.255,30,-82,19,87,H1
"Henry County, IA",2008-2009,20307,20202,-105,-0.517,41,-146,19,87,H1
"Henry County, IA",2009-2010,20202,20121,-81,-0.401,19,-100,19,87,H1
"Henry County, IA",2010-2011,20121,20318,197,0.979,-4,201,19,87,H1
"Henry County, IA",2011-2012,20318,20112,-206,-1.014,14,-220,19,87,H1
"Henry County, IA",2012-2013,20112,20219,107,0.532,33,74,19,87,H1
"Henry County, IA",2013-2014,20219,20217,-2,-0.01,33,-35,19,87,H1
"Henry County, IA",2014-2015,19962,19950,-12,-0.06,38,-50,19,87,H1
"Henry County, IA",2015-2016,19950,19801,-149,-0.747,19,-168,19,87,H1
"Henry County, IA",2016-2017,19801,19863,62,0.313,32,30,19,87,H1
"Howard County, IA",2000-2001,9934,9908,-26,-0.262,-11,-15,19,89,H1
"Howard County, IA",2001-2002,9908,9860,-48,-0.484,-9,-39,19,89,H1
"Howard County, IA",2002-2003,9860,9808,-52,-0.527,-8,-44,19,89,H1
"Howard County, IA",2003-2004,9808,9792,-16,-0.163,-15,-1,19,89,H1
"Howard County, IA",2004-2005,9792,9760,-32,-0.327,9,-41,19,89,H1
"Howard County, IA",2005-2006,9760,9664,-96,-0.984,12,-108,19,89,H1
"Howard County, IA",2006-2007,9664,9636,-28,-0.29,27,-55,19,89,H1
"Howard County, IA",2007-2008,9636,9625,-11,-0.114,16,-27,19,89,H1
"Howard County, IA",2008-2009,9625,9568,-57,-0.592,18,-75,19,89,H1
"Howard County, IA",2009-2010,9568,9558,-10,-0.105,26,-36,19,89,H1
"Howard County, IA",2010-2011,9558,9545,-13,-0.136,-4,-9,19,89,H1
"Howard County, IA",2011-2012,9545,9582,37,0.388,13,24,19,89,H1
"Howard County, IA",2012-2013,9582,9511,-71,-0.741,16,-87,19,89,H1
"Howard County, IA",2013-2014,9511,9449,-62,-0.652,0,-62,19,89,H1
"Howard County, IA",2014-2015,9441,9410,-31,-0.328,4,-35,19,89,H1
"Howard County, IA",2015-2016,9410,9272,-138,-1.467,12,-150,19,89,H1
"Howard County, IA",2016-2017,9272,9228,-44,-0.475,6,-50,19,89,H1
"Humboldt County, IA",2000-2001,10377,10335,-42,-0.405,-18,-24,19,91,H1
"Humboldt County, IA",2001-2002,10335,10176,-159,-1.538,-2,-157,19,91,H1
"Humboldt County, IA",2002-2003,10176,10154,-22,-0.216,-29,7,19,91,H1
"Humboldt County, IA",2003-2004,10154,10121,-33,-0.325,-8,-25,19,91,H1
"Humboldt County, IA",2004-2005,10121,10033,-88,-0.869,15,-103,19,91,H1
"Humboldt County, IA",2005-2006,10033,10038,5,0.05,-6,11,19,91,H1
"Humboldt County, IA",2006-2007,10038,9935,-103,-1.026,2,-105,19,91,H1
"Humboldt County, IA",2007-2008,9935,9911,-24,-0.242,-4,-20,19,91,H1
"Humboldt County, IA",2008-2009,9911,9843,-68,-0.686,-3,-65,19,91,H1
"Humboldt County, IA",2009-2010,9843,9801,-42,-0.427,-5,-37,19,91,H1
"Humboldt County, IA",2010-2011,9801,9799,-2,-0.02,-14,12,19,91,H1
"Humboldt County, IA",2011-2012,9799,9733,-66,-0.674,-17,-49,19,91,H1
"Humboldt County, IA",2012-2013,9733,9683,-50,-0.514,4,-54,19,91,H1
"Humboldt County, IA",2013-2014,9683,9640,-43,-0.444,-1,-42,19,91,H1
"Humboldt County, IA",2014-2015,9624,9555,-69,-0.717,-5,-64,19,91,H1
"Humboldt County, IA",2015-2016,9555,9531,-24,-0.251,5,-29,19,91,H1
"Humboldt County, IA",2016-2017,9531,9564,33,0.346,-4,37,19,91,H1
"Ida County, IA",2000-2001,7804,7704,-100,-1.281,-11,-89,19,93,H1
"Ida County, IA",2001-2002,7704,7636,-68,-0.883,-30,-38,19,93,H1
"Ida County, IA",2002-2003,7636,7571,-65,-0.851,-25,-40,19,93,H1
"Ida County, IA",2003-2004,7571,7457,-114,-1.506,-12,-102,19,93,H1
"Ida County, IA",2004-2005,7457,7369,-88,-1.18,-36,-52,19,93,H1
"Ida County, IA",2005-2006,7369,7247,-122,-1.656,-33,-89,19,93,H1
"Ida County, IA",2006-2007,7247,7228,-19,-0.262,-11,-8,19,93,H1
"Ida County, IA",2007-2008,7228,7215,-13,-0.18,19,-32,19,93,H1
"Ida County, IA",2008-2009,7215,7090,-125,-1.733,-7,-118,19,93,H1
"Ida County, IA",2009-2010,7090,7069,-21,-0.296,-6,-15,19,93,H1
"Ida County, IA",2010-2011,7069,7079,10,0.141,-36,46,19,93,H1
"Ida County, IA",2011-2012,7079,7091,12,0.17,-15,27,19,93,H1
"Ida County, IA",2012-2013,7091,7142,51,0.719,14,37,19,93,H1
"Ida County, IA",2013-2014,7142,7042,-100,-1.4,-9,-91,19,93,H1
"Ida County, IA",2014-2015,7025,7028,3,0.043,-20,23,19,93,H1
"Ida County, IA",2015-2016,7028,6957,-71,-1.01,-6,-65,19,93,H1
"Ida County, IA",2016-2017,6957,6865,-92,-1.322,-25,-67,19,93,H1
"Iowa County, IA",2000-2001,15729,15868,139,0.884,14,125,19,95,H1
"Iowa County, IA",2001-2002,15868,15911,43,0.271,25,18,19,95,H1
"Iowa County, IA",2002-2003,15911,16062,151,0.949,40,111,19,95,H1
"Iowa County, IA",2003-2004,16062,16108,46,0.286,-5,51,19,95,H1
"Iowa County, IA",2004-2005,16108,16297,189,1.173,35,154,19,95,H1
"Iowa County, IA",2005-2006,16297,16391,94,0.577,23,71,19,95,H1
"Iowa County, IA",2006-2007,16391,16308,-83,-0.506,47,-130,19,95,H1
"Iowa County, IA",2007-2008,16308,16337,29,0.178,23,6,19,95,H1
"Iowa County, IA",2008-2009,16337,16406,69,0.422,54,15,19,95,H1
"Iowa County, IA",2009-2010,16406,16320,-86,-0.524,36,-122,19,95,H1
"Iowa County, IA",2010-2011,16320,16340,20,0.123,16,4,19,95,H1
"Iowa County, IA",2011-2012,16340,16206,-134,-0.82,20,-154,19,95,H1
"Iowa County, IA",2012-2013,16206,16341,135,0.833,14,121,19,95,H1
"Iowa County, IA",2013-2014,16341,16375,34,0.208,4,30,19,95,H1
"Iowa County, IA",2014-2015,16390,16401,11,0.067,20,-9,19,95,H1
"Iowa County, IA",2015-2016,16401,16184,-217,-1.323,-4,-213,19,95,H1
"Iowa County, IA",2016-2017,16184,16103,-81,-0.5,0,-81,19,95,H1
"Jackson County, IA",2000-2001,20297,20267,-30,-0.148,39,-69,19,97,H1
"Jackson County, IA",2001-2002,20267,20142,-125,-0.617,20,-145,19,97,H1
"Jackson County, IA",2002-2003,20142,20148,6,0.03,12,-6,19,97,H1
"Jackson County, IA",2003-2004,20148,20146,-2,-0.01,5,-7,19,97,H1
"Jackson County, IA",2004-2005,20146,20124,-22,-0.109,-12,-10,19,97,H1
"Jackson County, IA",2005-2006,20124,20092,-32,-0.159,-26,-6,19,97,H1
"Jackson County, IA",2006-2007,20092,20015,-77,-0.383,18,-95,19,97,H1
"Jackson County, IA",2007-2008,20015,19919,-96,-0.48,-3,-93,19,97,H1
"Jackson County, IA",2008-2009,19919,19841,-78,-0.392,-22,-56,19,97,H1
"Jackson County, IA",2009-2010,19841,19829,-12,-0.06,3,-15,19,97,H1
"Jackson County, IA",2010-2011,19829,19720,-109,-0.55,-32,-77,19,97,H1
"Jackson County, IA",2011-2012,19720,19689,-31,-0.157,-33,2,19,97,H1
"Jackson County, IA",2012-2013,19689,19562,-127,-0.645,9,-136,19,97,H1
"Jackson County, IA",2013-2014,19562,19482,-80,-0.409,-22,-58,19,97,H1
"Jackson County, IA",2014-2015,19460,19444,-16,-0.082,-16,0,19,97,H1
"Jackson County, IA",2015-2016,19444,19390,-54,-0.278,30,-84,19,97,H1
"Jackson County, IA",2016-2017,19390,19366,-24,-0.124,18,-42,19,97,H1
"Jasper County, IA",2000-2001,37252,37377,125,0.336,108,17,19,99,H1
"Jasper County, IA",2001-2002,37377,37552,175,0.468,114,61,19,99,H1
"Jasper County, IA",2002-2003,37552,37703,151,0.402,121,30,19,99,H1
"Jasper County, IA",2003-2004,37703,37645,-58,-0.154,79,-137,19,99,H1
"Jasper County, IA",2004-2005,37645,37482,-163,-0.433,86,-249,19,99,H1
"Jasper County, IA",2005-2006,37482,37288,-194,-0.518,73,-267,19,99,H1
"Jasper County, IA",2006-2007,37288,37167,-121,-0.325,39,-160,19,99,H1
"Jasper County, IA",2007-2008,37167,37103,-64,-0.172,60,-124,19,99,H1
"Jasper County, IA",2008-2009,37103,36879,-224,-0.604,63,-287,19,99,H1
"Jasper County, IA",2009-2010,36879,36805,-74,-0.201,67,-141,19,99,H1
"Jasper County, IA",2010-2011,36805,36624,-181,-0.492,35,-216,19,99,H1
"Jasper County, IA",2011-2012,36624,36544,-80,-0.218,77,-157,19,99,H1
"Jasper County, IA",2012-2013,36544,36731,187,0.512,64,123,19,99,H1
"Jasper County, IA",2013-2014,36731,36872,141,0.384,63,78,19,99,H1
"Jasper County, IA",2014-2015,36866,36827,-39,-0.106,60,-99,19,99,H1
"Jasper County, IA",2015-2016,36827,36661,-166,-0.451,40,-206,19,99,H1
"Jasper County, IA",2016-2017,36661,36966,305,0.832,46,259,19,99,H1
"Jefferson County, IA",2000-2001,16189,16207,18,0.111,-4,22,19,101,H1
"Jefferson County, IA",2001-2002,16207,16131,-76,-0.469,27,-103,19,101,H1
"Jefferson County, IA",2002-2003,16131,16194,63,0.391,-25,88,19,101,H1
"Jefferson County, IA",2003-2004,16194,16298,104,0.642,-4,108,19,101,H1
"Jefferson County, IA",2004-2005,16298,16315,17,0.104,13,4,19,101,H1
"Jefferson County, IA",2005-2006,16315,16401,86,0.527,25,61,19,101,H1
"Jefferson County, IA",2006-2007,16401,16600,199,1.213,-22,221,19,101,H1
"Jefferson County, IA",2007-2008,16600,16607,7,0.042,17,-10,19,101,H1
"Jefferson County, IA",2008-2009,16607,16782,175,1.054,7,168,19,101,H1
"Jefferson County, IA",2009-2010,16782,16816,34,0.203,2,32,19,101,H1
"Jefferson County, IA",2010-2011,16816,17011,195,1.16,-34,229,19,101,H1
"Jefferson County, IA",2011-2012,17011,17084,73,0.429,4,69,19,101,H1
"Jefferson County, IA",2012-2013,17084,17276,192,1.124,-6,198,19,101,H1
"Jefferson County, IA",2013-2014,17276,17325,49,0.284,-12,61,19,101,H1
"Jefferson County, IA",2014-2015,17486,17555,69,0.395,-1,70,19,101,H1
"Jefferson County, IA",2015-2016,17555,18172,617,3.515,-18,635,19,101,H1
"Jefferson County, IA",2016-2017,18172,18422,250,1.376,-15,265,19,101,H1
"Johnson County, IA",2000-2001,111455,113546,2091,1.876,875,1216,19,103,H1
"Johnson County, IA",2001-2002,113546,114948,1402,1.235,871,531,19,103,H1
"Johnson County, IA",2002-2003,114948,116673,1725,1.501,948,777,19,103,H1
"Johnson County, IA",2003-2004,116673,118891,2218,1.901,1089,1129,19,103,H1
"Johnson County, IA",2004-2005,118891,120300,1409,1.185,915,494,19,103,H1
"Johnson County, IA",2005-2006,120300,122226,1926,1.601,976,950,19,103,H1
"Johnson County, IA",2006-2007,122226,124541,2315,1.894,1125,1190,19,103,H1
"Johnson County, IA",2007-2008,124541,127113,2572,2.065,1127,1445,19,103,H1
"Johnson County, IA",2008-2009,127113,129864,2751,2.164,1124,1627,19,103,H1
"Johnson County, IA",2009-2010,129864,131267,1403,1.08,1094,309,19,103,H1
"Johnson County, IA",2010-2011,131267,133730,2463,1.876,1185,1278,19,103,H1
"Johnson County, IA",2011-2012,133730,136913,3183,2.38,1162,2021,19,103,H1
"Johnson County, IA",2012-2013,136913,139814,2901,2.119,1117,1784,19,103,H1
"Johnson County, IA",2013-2014,139814,142287,2473,1.769,1154,1319,19,103,H1
"Johnson County, IA",2014-2015,142421,144251,1830,1.285,1136,694,19,103,H1
"Johnson County, IA",2015-2016,144251,146633,2382,1.651,1042,1340,19,103,H1
"Johnson County, IA",2016-2017,146633,149210,2577,1.757,1060,1517,19,103,H1
"Jones County, IA",2000-2001,20259,20254,-5,-0.025,12,-17,19,105,H1
"Jones County, IA",2001-2002,20254,20283,29,0.143,-22,51,19,105,H1
"Jones County, IA",2002-2003,20283,20406,123,0.606,51,72,19,105,H1
"Jones County, IA",2003-2004,20406,20613,207,1.014,9,198,19,105,H1
"Jones County, IA",2004-2005,20613,20605,-8,-0.039,40,-48,19,105,H1
"Jones County, IA",2005-2006,20605,20678,73,0.354,33,40,19,105,H1
"Jones County, IA",2006-2007,20678,20803,125,0.605,51,74,19,105,H1
"Jones County, IA",2007-2008,20803,20848,45,0.216,53,-8,19,105,H1
"Jones County, IA",2008-2009,20848,20562,-286,-1.372,48,-334,19,105,H1
"Jones County, IA",2009-2010,20562,20685,123,0.598,0,123,19,105,H1
"Jones County, IA",2010-2011,20685,20752,67,0.324,19,48,19,105,H1
"Jones County, IA",2011-2012,20752,20619,-133,-0.641,-18,-115,19,105,H1
"Jones County, IA",2012-2013,20619,20524,-95,-0.461,12,-107,19,105,H1
"Jones County, IA",2013-2014,20524,20454,-70,-0.341,3,-73,19,105,H1
"Jones County, IA",2014-2015,20496,20466,-30,-0.146,21,-51,19,105,H1
"Jones County, IA",2015-2016,20466,20384,-82,-0.401,14,-96,19,105,H1
"Jones County, IA",2016-2017,20384,20536,152,0.746,18,134,19,105,H1
"Keokuk County, IA",2000-2001,11418,11369,-49,-0.429,-1,-48,19,107,H1
"Keokuk County, IA",2001-2002,11369,11330,-39,-0.343,13,-52,19,107,H1
"Keokuk County, IA",2002-2003,11330,11186,-144,-1.271,4,-148,19,107,H1
"Keokuk County, IA",2003-2004,11186,11061,-125,-1.117,1,-126,19,107,H1
"Keokuk County, IA",2004-2005,11061,10881,-180,-1.627,-10,-170,19,107,H1
"Keokuk County, IA",2005-2006,10881,10713,-168,-1.544,-7,-161,19,107,H1
"Keokuk County, IA",2006-2007,10713,10688,-25,-0.233,27,-52,19,107,H1
"Keokuk County, IA",2007-2008,10688,10620,-68,-0.636,14,-82,19,107,H1
"Keokuk County, IA",2008-2009,10620,10552,-68,-0.64,-3,-65,19,107,H1
"Keokuk County, IA",2009-2010,10552,10499,-53,-0.502,-1,-52,19,107,H1
"Keokuk County, IA",2010-2011,10499,10366,-133,-1.267,25,-158,19,107,H1
"Keokuk County, IA",2011-2012,10366,10398,32,0.309,39,-7,19,107,H1
"Keokuk County, IA",2012-2013,10398,10313,-85,-0.817,-13,-72,19,107,H1
"Keokuk County, IA",2013-2014,10313,10231,-82,-0.795,20,-102,19,107,H1
"Keokuk County, IA",2014-2015,10225,10163,-62,-0.606,23,-85,19,107,H1
"Keokuk County, IA",2015-2016,10163,10177,14,0.138,17,-3,19,107,H1
"Keokuk County, IA",2016-2017,10177,10153,-24,-0.236,16,-40,19,107,H1
"Kossuth County, IA",2000-2001,17206,16912,-294,-1.709,-34,-260,19,109,H1
"Kossuth County, IA",2001-2002,16912,16670,-242,-1.431,-31,-211,19,109,H1
"Kossuth County, IA",2002-2003,16670,16525,-145,-0.87,-11,-134,19,109,H1
"Kossuth County, IA",2003-2004,16525,16437,-88,-0.533,-31,-57,19,109,H1
"Kossuth County, IA",2004-2005,16437,16287,-150,-0.913,24,-174,19,109,H1
"Kossuth County, IA",2005-2006,16287,16045,-242,-1.486,13,-255,19,109,H1
"Kossuth County, IA",2006-2007,16045,15878,-167,-1.041,-19,-148,19,109,H1
"Kossuth County, IA",2007-2008,15878,15685,-193,-1.216,-17,-176,19,109,H1
"Kossuth County, IA",2008-2009,15685,15630,-55,-0.351,-13,-42,19,109,H1
"Kossuth County, IA",2009-2010,15630,15517,-113,-0.723,1,-114,19,109,H1
"Kossuth County, IA",2010-2011,15517,15369,-148,-0.954,-24,-124,19,109,H1
"Kossuth County, IA",2011-2012,15369,15351,-18,-0.117,-9,-9,19,109,H1
"Kossuth County, IA",2012-2013,15351,15277,-74,-0.482,-32,-42,19,109,H1
"Kossuth County, IA",2013-2014,15277,15222,-55,-0.36,-9,-46,19,109,H1
"Kossuth County, IA",2014-2015,15224,15165,-59,-0.388,9,-68,19,109,H1
"Kossuth County, IA",2015-2016,15165,15133,-32,-0.211,20,-52,19,109,H1
"Kossuth County, IA",2016-2017,15133,14999,-134,-0.885,17,-151,19,109,H1
"Lee County, IA",2000-2001,37931,37435,-496,-1.308,-33,-463,19,111,H1
"Lee County, IA",2001-2002,37435,36960,-475,-1.269,-18,-457,19,111,H1
"Lee County, IA",2002-2003,36960,36627,-333,-0.901,14,-347,19,111,H1
"Lee County, IA",2003-2004,36627,36587,-40,-0.109,-66,26,19,111,H1
"Lee County, IA",2004-2005,36587,36364,-223,-0.61,-43,-180,19,111,H1
"Lee County, IA",2005-2006,36364,36291,-73,-0.201,7,-80,19,111,H1
"Lee County, IA",2006-2007,36291,36130,-161,-0.444,-26,-135,19,111,H1
"Lee County, IA",2007-2008,36130,35819,-311,-0.861,2,-313,19,111,H1
"Lee County, IA",2008-2009,35819,35856,37,0.103,-16,53,19,111,H1
"Lee County, IA",2009-2010,35856,35860,4,0.011,29,-25,19,111,H1
"Lee County, IA",2010-2011,35860,35605,-255,-0.711,-40,-215,19,111,H1
"Lee County, IA",2011-2012,35605,35622,17,0.048,-22,39,19,111,H1
"Lee County, IA",2012-2013,35622,35386,-236,-0.663,5,-241,19,111,H1
"Lee County, IA",2013-2014,35386,35286,-100,-0.283,16,-116,19,111,H1
"Lee County, IA",2014-2015,35210,35089,-121,-0.344,15,-136,19,111,H1
"Lee County, IA",2015-2016,35089,34456,-633,-1.804,-32,-601,19,111,H1
"Lee County, IA",2016-2017,34456,34295,-161,-0.467,-3,-158,19,111,H1
"Linn County, IA",2000-2001,192365,194359,1994,1.037,1266,728,19,113,H1
"Linn County, IA",2001-2002,194359,195987,1628,0.838,1420,208,19,113,H1
"Linn County, IA",2002-2003,195987,196920,933,0.476,1233,-300,19,113,H1
"Linn County, IA",2003-2004,196920,198314,1394,0.708,1283,111,19,113,H1
"Linn County, IA",2004-2005,198314,200395,2081,1.049,1191,890,19,113,H1
"Linn County, IA",2005-2006,200395,202709,2314,1.155,1292,1022,19,113,H1
"Linn County, IA",2006-2007,202709,205840,3131,1.545,1242,1889,19,113,H1
"Linn County, IA",2007-2008,205840,208558,2718,1.32,1330,1388,19,113,H1
"Linn County, IA",2008-2009,208558,210217,1659,0.795,1416,243,19,113,H1
"Linn County, IA",2009-2010,210217,211616,1399,0.666,1358,41,19,113,H1
"Linn County, IA",2010-2011,211616,213973,2357,1.114,1017,1340,19,113,H1
"Linn County, IA",2011-2012,213973,215206,1233,0.576,1121,112,19,113,H1
"Linn County, IA",2012-2013,215206,216087,881,0.409,1097,-216,19,113,H1
"Linn County, IA",2013-2014,216087,217751,1664,0.77,1051,613,19,113,H1
"Linn County, IA",2014-2015,217819,219916,2097,0.963,1080,1017,19,113,H1
"Linn County, IA",2015-2016,219916,221900,1984,0.902,1063,921,19,113,H1
"Linn County, IA",2016-2017,221900,224115,2215,0.998,1074,1141,19,113,H1
"Louisa County, IA",2000-2001,12174,12184,10,0.082,57,-47,19,115,H1
"Louisa County, IA",2001-2002,12184,12225,41,0.337,62,-21,19,115,H1
"Louisa County, IA",2002-2003,12225,12230,5,0.041,65,-60,19,115,H1
"Louisa County, IA",2003-2004,12230,12115,-115,-0.94,22,-137,19,115,H1
"Louisa County, IA",2004-2005,12115,11862,-253,-2.088,35,-288,19,115,H1
"Louisa County, IA",2005-2006,11862,11904,42,0.354,37,5,19,115,H1
"Louisa County, IA",2006-2007,11904,11892,-12,-0.101,10,-22,19,115,H1
"Louisa County, IA",2007-2008,11892,11830,-62,-0.521,39,-101,19,115,H1
"Louisa County, IA",2008-2009,11830,11416,-414,-3.5,28,-442,19,115,H1
"Louisa County, IA",2009-2010,11416,11372,-44,-0.385,20,-64,19,115,H1
"Louisa County, IA",2010-2011,11372,11370,-2,-0.018,26,-28,19,115,H1
"Louisa County, IA",2011-2012,11370,11327,-43,-0.378,37,-80,19,115,H1
"Louisa County, IA",2012-2013,11327,11294,-33,-0.291,27,-60,19,115,H1
"Louisa County, IA",2013-2014,11294,11161,-133,-1.178,18,-151,19,115,H1
"Louisa County, IA",2014-2015,11179,11185,6,0.054,30,-24,19,115,H1
"Louisa County, IA",2015-2016,11185,11188,3,0.027,40,-37,19,115,H1
"Louisa County, IA",2016-2017,11188,11184,-4,-0.036,30,-34,19,115,H1
"Lucas County, IA",2000-2001,9369,9386,17,0.181,-7,24,19,117,H1
"Lucas County, IA",2001-2002,9386,9360,-26,-0.277,8,-34,19,117,H1
"Lucas County, IA",2002-2003,9360,9384,24,0.256,-11,35,19,117,H1
"Lucas County, IA",2003-2004,9384,9508,124,1.321,11,113,19,117,H1
"Lucas County, IA",2004-2005,9508,9462,-46,-0.484,-33,-13,19,117,H1
"Lucas County, IA",2005-2006,9462,9331,-131,-1.384,15,-146,19,117,H1
"Lucas County, IA",2006-2007,9331,9280,-51,-0.547,18,-69,19,117,H1
"Lucas County, IA",2007-2008,9280,9137,-143,-1.541,25,-168,19,117,H1
"Lucas County, IA",2008-2009,9137,8948,-189,-2.069,-12,-177,19,117,H1
"Lucas County, IA",2009-2010,8948,8889,-59,-0.659,-14,-45,19,117,H1
"Lucas County, IA",2010-2011,8889,8836,-53,-0.596,14,-67,19,117,H1
"Lucas County, IA",2011-2012,8836,8764,-72,-0.815,-27,-45,19,117,H1
"Lucas County, IA",2012-2013,8764,8735,-29,-0.331,-8,-21,19,117,H1
"Lucas County, IA",2013-2014,8735,8701,-34,-0.389,-6,-28,19,117,H1
"Lucas County, IA",2014-2015,8673,8682,9,0.104,5,4,19,117,H1
"Lucas County, IA",2015-2016,8682,8556,-126,-1.451,-17,-109,19,117,H1
"Lucas County, IA",2016-2017,8556,8534,-22,-0.257,3,-25,19,117,H1
"Lyon County, IA",2000-2001,11748,11684,-64,-0.545,5,-69,19,119,H1
"Lyon County, IA",2001-2002,11684,11670,-14,-0.12,54,-68,19,119,H1
"Lyon County, IA",2002-2003,11670,11702,32,0.274,24,8,19,119,H1
"Lyon County, IA",2003-2004,11702,11692,-10,-0.085,33,-43,19,119,H1
"Lyon County, IA",2004-2005,11692,11677,-15,-0.128,52,-67,19,119,H1
"Lyon County, IA",2005-2006,11677,11604,-73,-0.625,30,-103,19,119,H1
"Lyon County, IA",2006-2007,11604,11536,-68,-0.586,54,-122,19,119,H1
"Lyon County, IA",2007-2008,11536,11545,9,0.078,46,-37,19,119,H1
"Lyon County, IA",2008-2009,11545,11557,12,0.104,47,-35,19,119,H1
"Lyon County, IA",2009-2010,11557,11558,1,0.009,56,-55,19,119,H1
"Lyon County, IA",2010-2011,11558,11706,148,1.28,78,70,19,119,H1
"Lyon County, IA",2011-2012,11706,11760,54,0.461,29,25,19,119,H1
"Lyon County, IA",2012-2013,11760,11692,-68,-0.578,66,-134,19,119,H1
"Lyon County, IA",2013-2014,11692,11683,-9,-0.077,54,-63,19,119,H1
"Lyon County, IA",2014-2015,11695,11745,50,0.428,63,-13,19,119,H1
"Lyon County, IA",2015-2016,11745,11788,43,0.366,86,-43,19,119,H1
"Lyon County, IA",2016-2017,11788,11792,4,0.034,65,-61,19,119,H1
"Madison County, IA",2000-2001,14049,14144,95,0.676,39,56,19,121,H1
"Madison County, IA",2001-2002,14144,14312,168,1.188,43,125,19,121,H1
"Madison County, IA",2002-2003,14312,14481,169,1.181,58,111,19,121,H1
"Madison County, IA",2003-2004,14481,14733,252,1.74,76,176,19,121,H1
"Madison County, IA",2004-2005,14733,14918,185,1.256,54,131,19,121,H1
"Madison County, IA",2005-2006,14918,15262,344,2.306,55,289,19,121,H1
"Madison County, IA",2006-2007,15262,15418,156,1.022,53,103,19,121,H1
"Madison County, IA",2007-2008,15418,15517,99,0.642,85,14,19,121,H1
"Madison County, IA",2008-2009,15517,15510,-7,-0.045,92,-99,19,121,H1
"Madison County, IA",2009-2010,15510,15722,212,1.367,45,167,19,121,H1
"Madison County, IA",2010-2011,15722,15724,2,0.013,6,-4,19,121,H1
"Madison County, IA",2011-2012,15724,15627,-97,-0.617,45,-142,19,121,H1
"Madison County, IA",2012-2013,15627,15463,-164,-1.049,15,-179,19,121,H1
"Madison County, IA",2013-2014,15463,15609,146,0.944,9,137,19,121,H1
"Madison County, IA",2014-2015,15611,15753,142,0.91,12,130,19,121,H1
"Madison County, IA",2015-2016,15753,15794,41,0.26,9,32,19,121,H1
"Madison County, IA",2016-2017,15794,16013,219,1.387,24,195,19,121,H1
"Mahaska County, IA",2000-2001,22299,22407,108,0.484,74,34,19,123,H1
"Mahaska County, IA",2001-2002,22407,22394,-13,-0.058,75,-88,19,123,H1
"Mahaska County, IA",2002-2003,22394,22156,-238,-1.063,30,-268,19,123,H1
"Mahaska County, IA",2003-2004,22156,22240,84,0.379,83,1,19,123,H1
"Mahaska County, IA",2004-2005,22240,22454,214,0.962,90,124,19,123,H1
"Mahaska County, IA",2005-2006,22454,22298,-156,-0.695,89,-245,19,123,H1
"Mahaska County, IA",2006-2007,22298,22388,90,0.404,93,-3,19,123,H1
"Mahaska County, IA",2007-2008,22388,22483,95,0.424,73,22,19,123,H1
"Mahaska County, IA",2008-2009,22483,22364,-119,-0.529,78,-197,19,123,H1
"Mahaska County, IA",2009-2010,22364,22397,33,0.148,93,-60,19,123,H1
"Mahaska County, IA",2010-2011,22397,22505,108,0.482,84,24,19,123,H1
"Mahaska County, IA",2011-2012,22505,22417,-88,-0.391,14,-102,19,123,H1
"Mahaska County, IA",2012-2013,22417,22412,-5,-0.022,57,-62,19,123,H1
"Mahaska County, IA",2013-2014,22412,22370,-42,-0.187,42,-84,19,123,H1
"Mahaska County, IA",2014-2015,22342,22324,-18,-0.081,55,-73,19,123,H1
"Mahaska County, IA",2015-2016,22324,22206,-118,-0.529,65,-183,19,123,H1
"Mahaska County, IA",2016-2017,22206,22235,29,0.131,41,-12,19,123,H1
"Marion County, IA",2000-2001,32104,32583,479,1.492,42,437,19,125,H1
"Marion County, IA",2001-2002,32583,32572,-11,-0.034,41,-52,19,125,H1
"Marion County, IA",2002-2003,32572,32547,-25,-0.077,113,-138,19,125,H1
"Marion County, IA",2003-2004,32547,32618,71,0.218,28,43,19,125,H1
"Marion County, IA",2004-2005,32618,32774,156,0.478,35,121,19,125,H1
"Marion County, IA",2005-2006,32774,33396,622,1.898,126,496,19,125,H1
"Marion County, IA",2006-2007,33396,33279,-117,-0.35,141,-258,19,125,H1
"Marion County, IA",2007-2008,33279,33515,236,0.709,85,151,19,125,H1
"Marion County, IA",2008-2009,33515,33468,-47,-0.14,75,-122,19,125,H1
"Marion County, IA",2009-2010,33468,33248,-220,-0.657,77,-297,19,125,H1
"Marion County, IA",2010-2011,33248,33352,104,0.313,73,31,19,125,H1
"Marion County, IA",2011-2012,33352,33378,26,0.078,11,15,19,125,H1
"Marion County, IA",2012-2013,33378,33196,-182,-0.545,56,-238,19,125,H1
"Marion County, IA",2013-2014,33196,33365,169,0.509,55,114,19,125,H1
"Marion County, IA",2014-2015,33257,33294,37,0.111,59,-22,19,125,H1
"Marion County, IA",2015-2016,33294,33149,-145,-0.436,49,-194,19,125,H1
"Marion County, IA",2016-2017,33149,33105,-44,-0.133,53,-97,19,125,H1
"Marshall County, IA",2000-2001,39356,39414,58,0.147,39,19,19,127,H1
"Marshall County, IA",2001-2002,39414,39297,-117,-0.297,9,-126,19,127,H1
"Marshall County, IA",2002-2003,39297,39397,100,0.254,68,32,19,127,H1
"Marshall County, IA",2003-2004,39397,39711,314,0.797,168,146,19,127,H1
"Marshall County, IA",2004-2005,39711,39646,-65,-0.164,147,-212,19,127,H1
"Marshall County, IA",2005-2006,39646,39601,-45,-0.114,139,-184,19,127,H1
"Marshall County, IA",2006-2007,39601,39875,274,0.692,175,99,19,127,H1
"Marshall County, IA",2007-2008,39875,40151,276,0.692,168,108,19,127,H1
"Marshall County, IA",2008-2009,40151,40280,129,0.321,145,-16,19,127,H1
"Marshall County, IA",2009-2010,40280,40682,402,0.998,165,237,19,127,H1
"Marshall County, IA",2010-2011,40682,40982,300,0.737,79,221,19,127,H1
"Marshall County, IA",2011-2012,40982,41058,76,0.185,92,-16,19,127,H1
"Marshall County, IA",2012-2013,41058,41022,-36,-0.088,101,-137,19,127,H1
"Marshall County, IA",2013-2014,41022,40866,-156,-0.38,97,-253,19,127,H1
"Marshall County, IA",2014-2015,40896,40746,-150,-0.367,67,-217,19,127,H1
"Marshall County, IA",2015-2016,40746,40160,-586,-1.438,39,-625,19,127,H1
"Marshall County, IA",2016-2017,40160,40288,128,0.319,54,74,19,127,H1
"Mills County, IA",2000-2001,14554,14497,-57,-0.392,24,-81,19,129,H1
"Mills County, IA",2001-2002,14497,14546,49,0.338,46,3,19,129,H1
"Mills County, IA",2002-2003,14546,14621,75,0.516,45,30,19,129,H1
"Mills County, IA",2003-2004,14621,14715,94,0.643,22,72,19,129,H1
"Mills County, IA",2004-2005,14715,14905,190,1.291,64,126,19,129,H1
"Mills County, IA",2005-2006,14905,15214,309,2.073,58,251,19,129,H1
"Mills County, IA",2006-2007,15214,15239,25,0.164,36,-11,19,129,H1
"Mills County, IA",2007-2008,15239,15214,-25,-0.164,54,-79,19,129,H1
"Mills County, IA",2008-2009,15214,15056,-158,-1.039,56,-214,19,129,H1
"Mills County, IA",2009-2010,15056,15074,18,0.12,27,-9,19,129,H1
"Mills County, IA",2010-2011,15074,15036,-38,-0.252,14,-52,19,129,H1
"Mills County, IA",2011-2012,15036,14881,-155,-1.031,-5,-150,19,129,H1
"Mills County, IA",2012-2013,14881,14910,29,0.195,12,17,19,129,H1
"Mills County, IA",2013-2014,14910,14831,-79,-0.53,34,-113,19,129,H1
"Mills County, IA",2014-2015,14754,14844,90,0.61,13,77,19,129,H1
"Mills County, IA",2015-2016,14844,15044,200,1.347,35,165,19,129,H1
"Mills County, IA",2016-2017,15044,15068,24,0.16,28,-4,19,129,H1
"Mitchell County, IA",2000-2001,10868,10736,-132,-1.215,17,-149,19,131,H1
"Mitchell County, IA",2001-2002,10736,10822,86,0.801,-2,88,19,131,H1
"Mitchell County, IA",2002-2003,10822,10830,8,0.074,-9,17,19,131,H1
"Mitchell County, IA",2003-2004,10830,10898,68,0.628,-11,79,19,131,H1
"Mitchell County, IA",2004-2005,10898,10800,-98,-0.899,-15,-83,19,131,H1
"Mitchell County, IA",2005-2006,10800,10836,36,0.333,-13,49,19,131,H1
"Mitchell County, IA",2006-2007,10836,10812,-24,-0.221,-5,-19,19,131,H1
"Mitchell County, IA",2007-2008,10812,10815,3,0.028,12,-9,19,131,H1
"Mitchell County, IA",2008-2009,10815,10763,-52,-0.481,-14,-38,19,131,H1
"Mitchell County, IA",2009-2010,10763,10789,26,0.242,-21,47,19,131,H1
"Mitchell County, IA",2010-2011,10789,10702,-87,-0.806,-14,-73,19,131,H1
"Mitchell County, IA",2011-2012,10702,10727,25,0.234,-18,43,19,131,H1
"Mitchell County, IA",2012-2013,10727,10724,-3,-0.028,5,-8,19,131,H1
"Mitchell County, IA",2013-2014,10724,10779,55,0.513,-1,56,19,131,H1
"Mitchell County, IA",2014-2015,10788,10832,44,0.408,18,26,19,131,H1
"Mitchell County, IA",2015-2016,10832,10657,-175,-1.616,4,-179,19,131,H1
"Mitchell County, IA",2016-2017,10657,10631,-26,-0.244,-10,-16,19,131,H1
"Monona County, IA",2000-2001,10009,9860,-149,-1.489,-77,-72,19,133,H1
"Monona County, IA",2001-2002,9860,9791,-69,-0.7,-77,8,19,133,H1
"Monona County, IA",2002-2003,9791,9819,28,0.286,-47,75,19,133,H1
"Monona County, IA",2003-2004,9819,9681,-138,-1.405,-74,-64,19,133,H1
"Monona County, IA",2004-2005,9681,9566,-115,-1.188,-98,-17,19,133,H1
"Monona County, IA",2005-2006,9566,9479,-87,-0.909,-25,-62,19,133,H1
"Monona County, IA",2006-2007,9479,9423,-56,-0.591,-38,-18,19,133,H1
"Monona County, IA",2007-2008,9423,9350,-73,-0.775,-60,-13,19,133,H1
"Monona County, IA",2008-2009,9350,9247,-103,-1.102,-64,-39,19,133,H1
"Monona County, IA",2009-2010,9247,9240,-7,-0.076,-61,54,19,133,H1
"Monona County, IA",2010-2011,9240,9262,22,0.238,-67,89,19,133,H1
"Monona County, IA",2011-2012,9262,9142,-120,-1.296,-61,-59,19,133,H1
"Monona County, IA",2012-2013,9142,9104,-38,-0.416,-62,24,19,133,H1
"Monona County, IA",2013-2014,9104,8996,-108,-1.186,-70,-38,19,133,H1
"Monona County, IA",2014-2015,8979,8979,0,0,-69,69,19,133,H1
"Monona County, IA",2015-2016,8979,8799,-180,-2.005,-50,-130,19,133,H1
"Monona County, IA",2016-2017,8799,8740,-59,-0.671,-48,-11,19,133,H1
"Monroe County, IA",2000-2001,8005,7986,-19,-0.237,-8,-11,19,135,H1
"Monroe County, IA",2001-2002,7986,7887,-99,-1.24,-44,-55,19,135,H1
"Monroe County, IA",2002-2003,7887,7954,67,0.849,-8,75,19,135,H1
"Monroe County, IA",2003-2004,7954,7969,15,0.189,-16,31,19,135,H1
"Monroe County, IA",2004-2005,7969,7955,-14,-0.176,-17,3,19,135,H1
"Monroe County, IA",2005-2006,7955,7911,-44,-0.553,2,-46,19,135,H1
"Monroe County, IA",2006-2007,7911,7877,-34,-0.43,-19,-15,19,135,H1
"Monroe County, IA",2007-2008,7877,7904,27,0.343,19,8,19,135,H1
"Monroe County, IA",2008-2009,7904,7924,20,0.253,-9,29,19,135,H1
"Monroe County, IA",2009-2010,7924,7984,60,0.757,-23,83,19,135,H1
"Monroe County, IA",2010-2011,7984,8046,62,0.777,-18,80,19,135,H1
"Monroe County, IA",2011-2012,8046,8071,25,0.311,-5,30,19,135,H1
"Monroe County, IA",2012-2013,8071,7992,-79,-0.979,-13,-66,19,135,H1
"Monroe County, IA",2013-2014,7992,8001,9,0.113,-6,15,19,135,H1
"Monroe County, IA",2014-2015,7965,7973,8,0.1,-1,9,19,135,H1
"Monroe County, IA",2015-2016,7973,7853,-120,-1.505,0,-120,19,135,H1
"Monroe County, IA",2016-2017,7853,7845,-8,-0.102,-5,-3,19,135,H1
"Montgomery County, IA",2000-2001,11793,11509,-284,-2.408,-28,-256,19,137,H1
"Montgomery County, IA",2001-2002,11509,11313,-196,-1.703,-22,-174,19,137,H1
"Montgomery County, IA",2002-2003,11313,11211,-102,-0.902,-42,-60,19,137,H1
"Montgomery County, IA",2003-2004,11211,11191,-20,-0.178,-36,16,19,137,H1
"Montgomery County, IA",2004-2005,11191,11214,23,0.206,0,23,19,137,H1
"Montgomery County, IA",2005-2006,11214,11179,-35,-0.312,-20,-15,19,137,H1
"Montgomery County, IA",2006-2007,11179,10981,-198,-1.771,-18,-180,19,137,H1
"Montgomery County, IA",2007-2008,10981,10823,-158,-1.439,-17,-141,19,137,H1
"Montgomery County, IA",2008-2009,10823,10803,-20,-0.185,-26,6,19,137,H1
"Montgomery County, IA",2009-2010,10803,10694,-109,-1.009,-16,-93,19,137,H1
"Montgomery County, IA",2010-2011,10694,10651,-43,-0.402,-42,-1,19,137,H1
"Montgomery County, IA",2011-2012,10651,10558,-93,-0.873,-23,-70,19,137,H1
"Montgomery County, IA",2012-2013,10558,10421,-137,-1.298,-41,-96,19,137,H1
"Montgomery County, IA",2013-2014,10421,10421,0,0,-20,20,19,137,H1
"Montgomery County, IA",2014-2015,10438,10234,-204,-1.954,-12,-192,19,137,H1
"Montgomery County, IA",2015-2016,10234,10134,-100,-0.977,-6,-94,19,137,H1
"Montgomery County, IA",2016-2017,10134,10137,3,0.03,2,1,19,137,H1
"Muscatine County, IA",2000-2001,41791,41760,-31,-0.074,291,-322,19,139,H1
"Muscatine County, IA",2001-2002,41760,41757,-3,-0.007,197,-200,19,139,H1
"Muscatine County, IA",2002-2003,41757,41654,-103,-0.247,244,-347,19,139,H1
"Muscatine County, IA",2003-2004,41654,41758,104,0.25,202,-98,19,139,H1
"Muscatine County, IA",2004-2005,41758,41894,136,0.326,187,-51,19,139,H1
"Muscatine County, IA",2005-2006,41894,42145,251,0.599,247,4,19,139,H1
"Muscatine County, IA",2006-2007,42145,42325,180,0.427,293,-113,19,139,H1
"Muscatine County, IA",2007-2008,42325,42515,190,0.449,256,-66,19,139,H1
"Muscatine County, IA",2008-2009,42515,42783,268,0.63,234,34,19,139,H1
"Muscatine County, IA",2009-2010,42783,42758,-25,-0.058,214,-239,19,139,H1
"Muscatine County, IA",2010-2011,42758,42799,41,0.096,174,-133,19,139,H1
"Muscatine County, IA",2011-2012,42799,42905,106,0.248,125,-19,19,139,H1
"Muscatine County, IA",2012-2013,42905,42918,13,0.03,173,-160,19,139,H1
"Muscatine County, IA",2013-2014,42918,42903,-15,-0.035,216,-231,19,139,H1
"Muscatine County, IA",2014-2015,42939,43011,72,0.168,217,-145,19,139,H1
"Muscatine County, IA",2015-2016,43011,42904,-107,-0.249,156,-263,19,139,H1
"Muscatine County, IA",2016-2017,42904,42880,-24,-0.056,164,-188,19,139,H1
"O'Brien County, IA",2000-2001,15067,14950,-117,-0.777,-17,-100,19,141,H1
"O'Brien County, IA",2001-2002,14950,14808,-142,-0.95,-33,-109,19,141,H1
"O'Brien County, IA",2002-2003,14808,14762,-46,-0.311,-26,-20,19,141,H1
"O'Brien County, IA",2003-2004,14762,14564,-198,-1.341,-29,-169,19,141,H1
"O'Brien County, IA",2004-2005,14564,14552,-12,-0.082,7,-19,19,141,H1
"O'Brien County, IA",2005-2006,14552,14558,6,0.041,-26,32,19,141,H1
"O'Brien County, IA",2006-2007,14558,14421,-137,-0.941,-25,-112,19,141,H1
"O'Brien County, IA",2007-2008,14421,14332,-89,-0.617,-23,-66,19,141,H1
"O'Brien County, IA",2008-2009,14332,14412,80,0.558,-10,90,19,141,H1
"O'Brien County, IA",2009-2010,14412,14400,-12,-0.083,-6,-6,19,141,H1
"O'Brien County, IA",2010-2011,14400,14201,-199,-1.382,-51,-148,19,141,H1
"O'Brien County, IA",2011-2012,14201,14163,-38,-0.268,-35,-3,19,141,H1
"O'Brien County, IA",2012-2013,14163,14047,-116,-0.819,5,-121,19,141,H1
"O'Brien County, IA",2013-2014,14047,14056,9,0.064,-18,27,19,141,H1
"O'Brien County, IA",2014-2015,14066,13984,-82,-0.583,-12,-70,19,141,H1
"O'Brien County, IA",2015-2016,13984,13921,-63,-0.451,-18,-45,19,141,H1
"O'Brien County, IA",2016-2017,13921,13801,-120,-0.862,1,-121,19,141,H1
"Osceola County, IA",2000-2001,6985,6963,-22,-0.315,-15,-7,19,143,H1
"Osceola County, IA",2001-2002,6963,6899,-64,-0.919,-13,-51,19,143,H1
"Osceola County, IA",2002-2003,6899,6888,-11,-0.159,11,-22,19,143,H1
"Osceola County, IA",2003-2004,6888,6863,-25,-0.363,-14,-11,19,143,H1
"Osceola County, IA",2004-2005,6863,6743,-120,-1.749,-8,-112,19,143,H1
"Osceola County, IA",2005-2006,6743,6713,-30,-0.445,-13,-17,19,143,H1
"Osceola County, IA",2006-2007,6713,6600,-113,-1.683,-17,-96,19,143,H1
"Osceola County, IA",2007-2008,6600,6617,17,0.258,10,7,19,143,H1
"Osceola County, IA",2008-2009,6617,6509,-108,-1.632,6,-114,19,143,H1
"Osceola County, IA",2009-2010,6509,6451,-58,-0.891,0,-58,19,143,H1
"Osceola County, IA",2010-2011,6451,6312,-139,-2.155,-26,-113,19,143,H1
"Osceola County, IA",2011-2012,6312,6190,-122,-1.933,5,-127,19,143,H1
"Osceola County, IA",2012-2013,6190,6222,32,0.517,17,15,19,143,H1
"Osceola County, IA",2013-2014,6222,6218,-4,-0.064,16,-20,19,143,H1
"Osceola County, IA",2014-2015,6203,6154,-49,-0.79,10,-59,19,143,H1
"Osceola County, IA",2015-2016,6154,6084,-70,-1.137,-9,-61,19,143,H1
"Osceola County, IA",2016-2017,6084,6045,-39,-0.641,-6,-33,19,143,H1
"Page County, IA",2000-2001,16939,16822,-117,-0.691,-56,-61,19,145,H1
"Page County, IA",2001-2002,16822,16506,-316,-1.878,-76,-240,19,145,H1
"Page County, IA",2002-2003,16506,16356,-150,-0.909,-43,-107,19,145,H1
"Page County, IA",2003-2004,16356,16227,-129,-0.789,-46,-83,19,145,H1
"Page County, IA",2004-2005,16227,16274,47,0.29,-54,101,19,145,H1
"Page County, IA",2005-2006,16274,16331,57,0.35,-12,69,19,145,H1
"Page County, IA",2006-2007,16331,16256,-75,-0.459,-11,-64,19,145,H1
"Page County, IA",2007-2008,16256,16083,-173,-1.064,-55,-118,19,145,H1
"Page County, IA",2008-2009,16083,15885,-198,-1.231,-56,-142,19,145,H1
"Page County, IA",2009-2010,15885,15934,49,0.308,-32,81,19,145,H1
"Page County, IA",2010-2011,15934,15926,-8,-0.05,-34,26,19,145,H1
"Page County, IA",2011-2012,15926,15751,-175,-1.099,-38,-137,19,145,H1
"Page County, IA",2012-2013,15751,15577,-174,-1.105,-19,-155,19,145,H1
"Page County, IA",2013-2014,15577,15496,-81,-0.52,-16,-65,19,145,H1
"Page County, IA",2014-2015,15543,15527,-16,-0.103,-23,7,19,145,H1
"Page County, IA",2015-2016,15527,15335,-192,-1.237,-27,-165,19,145,H1
"Page County, IA",2016-2017,15335,15224,-111,-0.724,-40,-71,19,145,H1
"Palo Alto County, IA",2000-2001,10135,10051,-84,-0.829,-7,-77,19,147,H1
"Palo Alto County, IA",2001-2002,10051,9896,-155,-1.542,-46,-109,19,147,H1
"Palo Alto County, IA",2002-2003,9896,9748,-148,-1.496,-14,-134,19,147,H1
"Palo Alto County, IA",2003-2004,9748,9753,5,0.051,-14,19,19,147,H1
"Palo Alto County, IA",2004-2005,9753,9702,-51,-0.523,-1,-50,19,147,H1
"Palo Alto County, IA",2005-2006,9702,9586,-116,-1.196,-33,-83,19,147,H1
"Palo Alto County, IA",2006-2007,9586,9577,-9,-0.094,12,-21,19,147,H1
"Palo Alto County, IA",2007-2008,9577,9486,-91,-0.95,-9,-82,19,147,H1
"Palo Alto County, IA",2008-2009,9486,9510,24,0.253,-6,30,19,147,H1
"Palo Alto County, IA",2009-2010,9510,9399,-111,-1.167,-7,-104,19,147,H1
"Palo Alto County, IA",2010-2011,9399,9365,-34,-0.362,-35,1,19,147,H1
"Palo Alto County, IA",2011-2012,9365,9281,-84,-0.897,-36,-48,19,147,H1
"Palo Alto County, IA",2012-2013,9281,9170,-111,-1.196,-31,-80,19,147,H1
"Palo Alto County, IA",2013-2014,9170,9099,-71,-0.774,-21,-50,19,147,H1
"Palo Alto County, IA",2014-2015,9105,9133,28,0.308,-4,32,19,147,H1
"Palo Alto County, IA",2015-2016,9133,9042,-91,-0.996,-2,-89,19,147,H1
"Palo Alto County, IA",2016-2017,9042,9092,50,0.553,2,48,19,147,H1
"Plymouth County, IA",2000-2001,24870,24847,-23,-0.092,61,-84,19,149,H1
"Plymouth County, IA",2001-2002,24847,24729,-118,-0.475,56,-174,19,149,H1
"Plymouth County, IA",2002-2003,24729,24858,129,0.522,93,36,19,149,H1
"Plymouth County, IA",2003-2004,24858,25042,184,0.74,65,119,19,149,H1
"Plymouth County, IA",2004-2005,25042,24980,-62,-0.248,56,-118,19,149,H1
"Plymouth County, IA",2005-2006,24980,24982,2,0.008,76,-74,19,149,H1
"Plymouth County, IA",2006-2007,24982,24886,-96,-0.384,37,-133,19,149,H1
"Plymouth County, IA",2007-2008,24886,24898,12,0.048,107,-95,19,149,H1
"Plymouth County, IA",2008-2009,24898,24904,6,0.024,93,-87,19,149,H1
"Plymouth County, IA",2009-2010,24904,24977,73,0.293,75,-2,19,149,H1
"Plymouth County, IA",2010-2011,24977,24839,-138,-0.553,59,-197,19,149,H1
"Plymouth County, IA",2011-2012,24839,24881,42,0.169,24,18,19,149,H1
"Plymouth County, IA",2012-2013,24881,24924,43,0.173,53,-10,19,149,H1
"Plymouth County, IA",2013-2014,24924,24874,-50,-0.201,51,-101,19,149,H1
"Plymouth County, IA",2014-2015,24851,24800,-51,-0.205,34,-85,19,149,H1
"Plymouth County, IA",2015-2016,24800,25205,405,1.633,76,329,19,149,H1
"Plymouth County, IA",2016-2017,25205,25220,15,0.06,67,-52,19,149,H1
"Pocahontas County, IA",2000-2001,8602,8465,-137,-1.593,-43,-94,19,151,H1
"Pocahontas County, IA",2001-2002,8465,8355,-110,-1.299,-31,-79,19,151,H1
"Pocahontas County, IA",2002-2003,8355,8170,-185,-2.214,-41,-144,19,151,H1
"Pocahontas County, IA",2003-2004,8170,8003,-167,-2.044,-45,-122,19,151,H1
"Pocahontas County, IA",2004-2005,8003,7835,-168,-2.099,-49,-119,19,151,H1
"Pocahontas County, IA",2005-2006,7835,7694,-141,-1.8,-29,-112,19,151,H1
"Pocahontas County, IA",2006-2007,7694,7667,-27,-0.351,-45,18,19,151,H1
"Pocahontas County, IA",2007-2008,7667,7510,-157,-2.048,-18,-139,19,151,H1
"Pocahontas County, IA",2008-2009,7510,7395,-115,-1.531,-18,-97,19,151,H1
"Pocahontas County, IA",2009-2010,7395,7284,-111,-1.501,-19,-92,19,151,H1
"Pocahontas County, IA",2010-2011,7284,7216,-68,-0.934,-36,-32,19,151,H1
"Pocahontas County, IA",2011-2012,7216,7161,-55,-0.762,-2,-53,19,151,H1
"Pocahontas County, IA",2012-2013,7161,7154,-7,-0.098,-11,4,19,151,H1
"Pocahontas County, IA",2013-2014,7154,7138,-16,-0.224,-7,-9,19,151,H1
"Pocahontas County, IA",2014-2015,7125,7008,-117,-1.642,7,-124,19,151,H1
"Pocahontas County, IA",2015-2016,7008,6848,-160,-2.283,-14,-146,19,151,H1
"Pocahontas County, IA",2016-2017,6848,6846,-2,-0.029,-6,4,19,151,H1
"Polk County, IA",2000-2001,375627,380108,4481,1.193,3486,995,19,153,H1
"Polk County, IA",2001-2002,380108,384355,4247,1.117,3234,1013,19,153,H1
"Polk County, IA",2002-2003,384355,388277,3922,1.02,3470,452,19,153,H1
"Polk County, IA",2003-2004,388277,392164,3887,1.001,3442,445,19,153,H1
"Polk County, IA",2004-2005,392164,399030,6866,1.751,3748,3118,19,153,H1
"Polk County, IA",2005-2006,399030,405990,6960,1.744,3857,3103,19,153,H1
"Polk County, IA",2006-2007,405990,413024,7034,1.733,4034,3.00E+03,19,153,H1
"Polk County, IA",2007-2008,413024,419495,6471,1.567,3948,2523,19,153,H1
"Polk County, IA",2008-2009,419495,425737,6242,1.488,3739,2503,19,153,H1
"Polk County, IA",2009-2010,425737,432243,6506,1.528,3762,2744,19,153,H1
"Polk County, IA",2010-2011,432243,437770,5527,1.279,3371,2156,19,153,H1
"Polk County, IA",2011-2012,437770,443984,6214,1.419,3565,2649,19,153,H1
"Polk County, IA",2012-2013,443984,451822,7838,1.765,3552,4286,19,153,H1
"Polk County, IA",2013-2014,451822,459862,8040,1.779,3563,4477,19,153,H1
"Polk County, IA",2014-2015,460341,467711,7370,1.601,3687,3683,19,153,H1
"Polk County, IA",2015-2016,467711,474768,7057,1.509,3591,3466,19,153,H1
"Polk County, IA",2016-2017,474768,481830,7062,1.487,3542,3520,19,153,H1
"Pottawattamie County, IA",2000-2001,88022,87953,-69,-0.078,345,-414,19,155,H1
"Pottawattamie County, IA",2001-2002,87953,88447,494,0.562,346,148,19,155,H1
"Pottawattamie County, IA",2002-2003,88447,88821,374,0.423,355,19,19,155,H1
"Pottawattamie County, IA",2003-2004,88821,89762,941,1.059,373,568,19,155,H1
"Pottawattamie County, IA",2004-2005,89762,90198,436,0.486,354,82,19,155,H1
"Pottawattamie County, IA",2005-2006,90198,90867,669,0.742,424,245,19,155,H1
"Pottawattamie County, IA",2006-2007,90867,91239,372,0.409,402,-30,19,155,H1
"Pottawattamie County, IA",2007-2008,91239,91781,542,0.594,385,157,19,155,H1
"Pottawattamie County, IA",2008-2009,91781,92395,614,0.669,369,245,19,155,H1
"Pottawattamie County, IA",2009-2010,92395,93384,989,1.07,395,594,19,155,H1
"Pottawattamie County, IA",2010-2011,93384,93490,106,0.114,414,-308,19,155,H1
"Pottawattamie County, IA",2011-2012,93490,92918,-572,-0.612,337,-909,19,155,H1
"Pottawattamie County, IA",2012-2013,92918,92846,-72,-0.077,279,-351,19,155,H1
"Pottawattamie County, IA",2013-2014,92846,93128,282,0.304,257,25,19,155,H1
"Pottawattamie County, IA",2014-2015,93207,93671,464,0.498,291,173,19,155,H1
"Pottawattamie County, IA",2015-2016,93671,93508,-163,-0.174,274,-437,19,155,H1
"Pottawattamie County, IA",2016-2017,93508,93386,-122,-0.13,201,-323,19,155,H1
"Poweshiek County, IA",2000-2001,18903,18972,69,0.365,21,48,19,157,H1
"Poweshiek County, IA",2001-2002,18972,18941,-31,-0.163,-47,16,19,157,H1
"Poweshiek County, IA",2002-2003,18941,19060,119,0.628,-36,155,19,157,H1
"Poweshiek County, IA",2003-2004,19060,19106,46,0.241,-28,74,19,157,H1
"Poweshiek County, IA",2004-2005,19106,19002,-104,-0.544,-29,-75,19,157,H1
"Poweshiek County, IA",2005-2006,19002,19053,51,0.268,-37,88,19,157,H1
"Poweshiek County, IA",2006-2007,19053,19140,87,0.457,-7,94,19,157,H1
"Poweshiek County, IA",2007-2008,19140,19025,-115,-0.601,-23,-92,19,157,H1
"Poweshiek County, IA",2008-2009,19025,18958,-67,-0.352,-27,-40,19,157,H1
"Poweshiek County, IA",2009-2010,18958,18902,-56,-0.295,-27,-29,19,157,H1
"Poweshiek County, IA",2010-2011,18902,18861,-41,-0.217,-37,-4,19,157,H1
"Poweshiek County, IA",2011-2012,18861,18759,-102,-0.541,-53,-49,19,157,H1
"Poweshiek County, IA",2012-2013,18759,18634,-125,-0.666,-55,-70,19,157,H1
"Poweshiek County, IA",2013-2014,18634,18668,34,0.182,-37,71,19,157,H1
"Poweshiek County, IA",2014-2015,18701,18550,-151,-0.807,-20,-131,19,157,H1
"Poweshiek County, IA",2015-2016,18550,18292,-258,-1.391,-44,-214,19,157,H1
"Poweshiek County, IA",2016-2017,18292,18314,22,0.12,-38,60,19,157,H1
"Ringgold County, IA",2000-2001,5465,5415,-50,-0.915,-25,-25,19,159,H1
"Ringgold County, IA",2001-2002,5415,5339,-76,-1.404,-23,-53,19,159,H1
"Ringgold County, IA",2002-2003,5339,5332,-7,-0.131,-26,19,19,159,H1
"Ringgold County, IA",2003-2004,5332,5335,3,0.056,-29,32,19,159,H1
"Ringgold County, IA",2004-2005,5335,5304,-31,-0.581,12,-43,19,159,H1
"Ringgold County, IA",2005-2006,5304,5230,-74,-1.395,-23,-51,19,159,H1
"Ringgold County, IA",2006-2007,5230,5201,-29,-0.554,-16,-13,19,159,H1
"Ringgold County, IA",2007-2008,5201,5164,-37,-0.711,-24,-13,19,159,H1
"Ringgold County, IA",2008-2009,5164,5119,-45,-0.871,-9,-36,19,159,H1
"Ringgold County, IA",2009-2010,5119,5129,10,0.195,-6,16,19,159,H1
"Ringgold County, IA",2010-2011,5129,5101,-28,-0.546,-38,10,19,159,H1
"Ringgold County, IA",2011-2012,5101,5085,-16,-0.314,-22,6,19,159,H1
"Ringgold County, IA",2012-2013,5085,5046,-39,-0.767,-13,-26,19,159,H1
"Ringgold County, IA",2013-2014,5046,5051,5,0.099,-4,9,19,159,H1
"Ringgold County, IA",2014-2015,5033,5068,35,0.695,1,34,19,159,H1
"Ringgold County, IA",2015-2016,5068,4989,-79,-1.559,-9,-70,19,159,H1
"Ringgold County, IA",2016-2017,4989,5034,45,0.902,-4,49,19,159,H1
"Sac County, IA",2000-2001,11481,11403,-78,-0.679,-22,-56,19,161,H1
"Sac County, IA",2001-2002,11403,11119,-284,-2.491,-67,-217,19,161,H1
"Sac County, IA",2002-2003,11119,10967,-152,-1.367,-52,-100,19,161,H1
"Sac County, IA",2003-2004,10967,10871,-96,-0.875,-41,-55,19,161,H1
"Sac County, IA",2004-2005,10871,10716,-155,-1.426,-16,-139,19,161,H1
"Sac County, IA",2005-2006,10716,10707,-9,-0.084,-27,18,19,161,H1
"Sac County, IA",2006-2007,10707,10532,-175,-1.634,-23,-152,19,161,H1
"Sac County, IA",2007-2008,10532,10475,-57,-0.541,-51,-6,19,161,H1
"Sac County, IA",2008-2009,10475,10342,-133,-1.27,-39,-94,19,161,H1
"Sac County, IA",2009-2010,10342,10343,1,0.01,-32,33,19,161,H1
"Sac County, IA",2010-2011,10343,10220,-123,-1.189,-52,-71,19,161,H1
"Sac County, IA",2011-2012,10220,10162,-58,-0.568,-25,-33,19,161,H1
"Sac County, IA",2012-2013,10162,10049,-113,-1.112,-20,-93,19,161,H1
"Sac County, IA",2013-2014,10049,10035,-14,-0.139,-26,12,19,161,H1
"Sac County, IA",2014-2015,10043,10021,-22,-0.219,3,-25,19,161,H1
"Sac County, IA",2015-2016,10021,9818,-203,-2.026,-18,-185,19,161,H1
"Sac County, IA",2016-2017,9818,9817,-1,-0.01,-4,3,19,161,H1
"Scott County, IA",2000-2001,158614,158203,-411,-0.259,963,-1374,19,163,H1
"Scott County, IA",2001-2002,158203,158086,-117,-0.074,998,-1115,19,163,H1
"Scott County, IA",2002-2003,158086,158048,-38,-0.024,910,-948,19,163,H1
"Scott County, IA",2003-2004,158048,158145,97,0.061,912,-815,19,163,H1
"Scott County, IA",2004-2005,158145,158543,398,0.252,1002,-604,19,163,H1
"Scott County, IA",2005-2006,158543,159597,1054,0.665,978,76,19,163,H1
"Scott County, IA",2006-2007,159597,160077,480,0.301,1042,-562,19,163,H1
"Scott County, IA",2007-2008,160077,161824,1747,1.091,1077,670,19,163,H1
"Scott County, IA",2008-2009,161824,163582,1758,1.086,1033,725,19,163,H1
"Scott County, IA",2009-2010,163582,165752,2170,1.327,1038,1132,19,163,H1
"Scott County, IA",2010-2011,165752,167053,1301,0.785,756,545,19,163,H1
"Scott County, IA",2011-2012,167053,168827,1774,1.062,812,962,19,163,H1
"Scott County, IA",2012-2013,168827,170553,1726,1.022,840,886,19,163,H1
"Scott County, IA",2013-2014,170553,171387,834,0.489,831,3,19,163,H1
"Scott County, IA",2014-2015,171437,172126,689,0.402,871,-182,19,163,H1
"Scott County, IA",2015-2016,172126,172045,-81,-0.047,768,-849,19,163,H1
"Scott County, IA",2016-2017,172045,172509,464,0.27,722,-258,19,163,H1
"Shelby County, IA",2000-2001,13031,12990,-41,-0.315,-19,-22,19,165,H1
"Shelby County, IA",2001-2002,12990,12869,-121,-0.931,-30,-91,19,165,H1
"Shelby County, IA",2002-2003,12869,12819,-50,-0.389,-13,-37,19,165,H1
"Shelby County, IA",2003-2004,12819,12750,-69,-0.538,-40,-29,19,165,H1
"Shelby County, IA",2004-2005,12750,12547,-203,-1.592,-26,-177,19,165,H1
"Shelby County, IA",2005-2006,12547,12480,-67,-0.534,-32,-35,19,165,H1
"Shelby County, IA",2006-2007,12480,12496,16,0.128,-29,45,19,165,H1
"Shelby County, IA",2007-2008,12496,12338,-158,-1.264,-6,-152,19,165,H1
"Shelby County, IA",2008-2009,12338,12165,-173,-1.402,-33,-140,19,165,H1
"Shelby County, IA",2009-2010,12165,12168,3,0.025,-26,29,19,165,H1
"Shelby County, IA",2010-2011,12168,12038,-130,-1.068,-41,-89,19,165,H1
"Shelby County, IA",2011-2012,12038,12071,33,0.274,-6,39,19,165,H1
"Shelby County, IA",2012-2013,12071,11944,-127,-1.052,20,-147,19,165,H1
"Shelby County, IA",2013-2014,11944,11948,4,0.033,-3,7,19,165,H1
"Shelby County, IA",2014-2015,11962,11927,-35,-0.293,-18,-17,19,165,H1
"Shelby County, IA",2015-2016,11927,11672,-255,-2.138,-41,-214,19,165,H1
"Shelby County, IA",2016-2017,11672,11628,-44,-0.377,-21,-23,19,165,H1
"Sioux County, IA",2000-2001,31609,31952,343,1.085,244,99,19,167,H1
"Sioux County, IA",2001-2002,31952,32164,212,0.663,192,20,19,167,H1
"Sioux County, IA",2002-2003,32164,32318,154,0.479,163,-9,19,167,H1
"Sioux County, IA",2003-2004,32318,32547,229,0.709,204,25,19,167,H1
"Sioux County, IA",2004-2005,32547,32726,179,0.55,244,-65,19,167,H1
"Sioux County, IA",2005-2006,32726,33077,351,1.073,283,68,19,167,H1
"Sioux County, IA",2006-2007,33077,33150,73,0.221,271,-198,19,167,H1
"Sioux County, IA",2007-2008,33150,33364,214,0.646,258,-44,19,167,H1
"Sioux County, IA",2008-2009,33364,33587,223,0.668,248,-25,19,167,H1
"Sioux County, IA",2009-2010,33587,33716,129,0.384,225,-96,19,167,H1
"Sioux County, IA",2010-2011,33716,34034,318,0.943,274,44,19,167,H1
"Sioux County, IA",2011-2012,34034,34348,314,0.923,247,67,19,167,H1
"Sioux County, IA",2012-2013,34348,34524,176,0.512,254,-78,19,167,H1
"Sioux County, IA",2013-2014,34524,34681,157,0.455,255,-98,19,167,H1
"Sioux County, IA",2014-2015,34699,34937,238,0.686,263,-25,19,167,H1
"Sioux County, IA",2015-2016,34937,34891,-46,-0.132,238,-284,19,167,H1
"Sioux County, IA",2016-2017,34891,34860,-31,-0.089,218,-249,19,167,H1
"Story County, IA",2000-2001,80152,80260,108,0.135,511,-403,19,169,H1
"Story County, IA",2001-2002,80260,81885,1625,2.025,460,1165,19,169,H1
"Story County, IA",2002-2003,81885,82068,183,0.223,469,-286,19,169,H1
"Story County, IA",2003-2004,82068,82754,686,0.836,450,236,19,169,H1
"Story County, IA",2004-2005,82754,82884,130,0.157,388,-258,19,169,H1
"Story County, IA",2005-2006,82884,84739,1855,2.238,560,1295,19,169,H1
"Story County, IA",2006-2007,84739,86540,1801,2.125,539,1262,19,169,H1
"Story County, IA",2007-2008,86540,87831,1291,1.492,499,792,19,169,H1
"Story County, IA",2008-2009,87831,89285,1454,1.655,540,914,19,169,H1
"Story County, IA",2009-2010,89285,89596,311,0.348,499,-188,19,169,H1
"Story County, IA",2010-2011,89596,90896,1300,1.451,497,803,19,169,H1
"Story County, IA",2011-2012,90896,91721,825,0.908,469,356,19,169,H1
"Story County, IA",2012-2013,91721,93410,1689,1.841,511,1178,19,169,H1
"Story County, IA",2013-2014,93410,94073,663,0.71,446,217,19,169,H1
"Story County, IA",2014-2015,95456,96021,565,0.592,477,88,19,169,H1
"Story County, IA",2015-2016,96021,96816,795,0.828,372,423,19,169,H1
"Story County, IA",2016-2017,96816,97502,686,0.709,376,310,19,169,H1
"Tama County, IA",2000-2001,18084,18080,-4,-0.022,16,-20,19,171,H1
"Tama County, IA",2001-2002,18080,18017,-63,-0.348,17,-80,19,171,H1
"Tama County, IA",2002-2003,18017,18030,13,0.072,30,-17,19,171,H1
"Tama County, IA",2003-2004,18030,18167,137,0.76,77,60,19,171,H1
"Tama County, IA",2004-2005,18167,18197,30,0.165,29,1,19,171,H1
"Tama County, IA",2005-2006,18197,18149,-48,-0.264,40,-88,19,171,H1
"Tama County, IA",2006-2007,18149,18064,-85,-0.468,10,-95,19,171,H1
"Tama County, IA",2007-2008,18064,17986,-78,-0.432,43,-121,19,171,H1
"Tama County, IA",2008-2009,17986,17833,-153,-0.851,65,-218,19,171,H1
"Tama County, IA",2009-2010,17833,17723,-110,-0.617,41,-151,19,171,H1
"Tama County, IA",2010-2011,17723,17619,-104,-0.587,-6,-98,19,171,H1
"Tama County, IA",2011-2012,17619,17526,-93,-0.528,23,-116,19,171,H1
"Tama County, IA",2012-2013,17526,17523,-3,-0.017,22,-25,19,171,H1
"Tama County, IA",2013-2014,17523,17451,-72,-0.411,35,-107,19,171,H1
"Tama County, IA",2014-2015,17400,17337,-63,-0.362,34,-97,19,171,H1
"Tama County, IA",2015-2016,17337,17179,-158,-0.911,16,-174,19,171,H1
"Tama County, IA",2016-2017,17179,17058,-121,-0.704,38,-159,19,171,H1
"Taylor County, IA",2000-2001,6976,6894,-82,-1.175,-17,-65,19,173,H1
"Taylor County, IA",2001-2002,6894,6813,-81,-1.175,-26,-55,19,173,H1
"Taylor County, IA",2002-2003,6813,6747,-66,-0.969,-22,-44,19,173,H1
"Taylor County, IA",2003-2004,6747,6689,-58,-0.86,-3,-55,19,173,H1
"Taylor County, IA",2004-2005,6689,6534,-155,-2.317,-37,-118,19,173,H1
"Taylor County, IA",2005-2006,6534,6557,23,0.352,21,2,19,173,H1
"Taylor County, IA",2006-2007,6557,6448,-109,-1.662,-33,-76,19,173,H1
"Taylor County, IA",2007-2008,6448,6348,-100,-1.551,-10,-90,19,173,H1
"Taylor County, IA",2008-2009,6348,6355,7,0.11,-12,19,19,173,H1
"Taylor County, IA",2009-2010,6355,6308,-47,-0.74,-16,-31,19,173,H1
"Taylor County, IA",2010-2011,6308,6266,-42,-0.666,-17,-25,19,173,H1
"Taylor County, IA",2011-2012,6266,6223,-43,-0.686,11,-54,19,173,H1
"Taylor County, IA",2012-2013,6223,6187,-36,-0.578,-5,-31,19,173,H1
"Taylor County, IA",2013-2014,6187,6143,-44,-0.711,16,-60,19,173,H1
"Taylor County, IA",2014-2015,6150,6205,55,0.894,12,43,19,173,H1
"Taylor County, IA",2015-2016,6205,6237,32,0.516,7,25,19,173,H1
"Taylor County, IA",2016-2017,6237,6178,-59,-0.946,14,-73,19,173,H1
"Union County, IA",2000-2001,12281,12240,-41,-0.334,-19,-22,19,175,H1
"Union County, IA",2001-2002,12240,12163,-77,-0.629,-36,-41,19,175,H1
"Union County, IA",2002-2003,12163,12004,-159,-1.307,-4,-155,19,175,H1
"Union County, IA",2003-2004,12004,12085,81,0.675,-10,91,19,175,H1
"Union County, IA",2004-2005,12085,12143,58,0.48,-8,66,19,175,H1
"Union County, IA",2005-2006,12143,12225,82,0.675,9,73,19,175,H1
"Union County, IA",2006-2007,12225,12319,94,0.769,1,93,19,175,H1
"Union County, IA",2007-2008,12319,12447,128,1.039,14,114,19,175,H1
"Union County, IA",2008-2009,12447,12527,80,0.643,6,74,19,175,H1
"Union County, IA",2009-2010,12527,12506,-21,-0.168,5,-26,19,175,H1
"Union County, IA",2010-2011,12506,12557,51,0.408,8,43,19,175,H1
"Union County, IA",2011-2012,12557,12591,34,0.271,-30,64,19,175,H1
"Union County, IA",2012-2013,12591,12599,8,0.064,17,-9,19,175,H1
"Union County, IA",2013-2014,12599,12516,-83,-0.659,-9,-74,19,175,H1
"Union County, IA",2014-2015,12626,12469,-157,-1.243,-7,-150,19,175,H1
"Union County, IA",2015-2016,12469,12390,-79,-0.634,-2,-77,19,175,H1
"Union County, IA",2016-2017,12390,12450,60,0.484,-14,74,19,175,H1
"Van Buren County, IA",2000-2001,7793,7716,-77,-0.988,-24,-53,19,177,H1
"Van Buren County, IA",2001-2002,7716,7722,6,0.078,0,6,19,177,H1
"Van Buren County, IA",2002-2003,7722,7672,-50,-0.648,-26,-24,19,177,H1
"Van Buren County, IA",2003-2004,7672,7665,-7,-0.091,3,-10,19,177,H1
"Van Buren County, IA",2004-2005,7665,7638,-27,-0.352,-7,-20,19,177,H1
"Van Buren County, IA",2005-2006,7638,7660,22,0.288,-12,34,19,177,H1
"Van Buren County, IA",2006-2007,7660,7690,30,0.392,29,1,19,177,H1
"Van Buren County, IA",2007-2008,7690,7699,9,0.117,10,-1,19,177,H1
"Van Buren County, IA",2008-2009,7699,7628,-71,-0.922,8,-79,19,177,H1
"Van Buren County, IA",2009-2010,7628,7560,-68,-0.891,7,-75,19,177,H1
"Van Buren County, IA",2010-2011,7560,7511,-49,-0.648,-4,-45,19,177,H1
"Van Buren County, IA",2011-2012,7511,7454,-57,-0.759,1,-58,19,177,H1
"Van Buren County, IA",2012-2013,7454,7440,-14,-0.188,16,-30,19,177,H1
"Van Buren County, IA",2013-2014,7440,7468,28,0.376,1,27,19,177,H1
"Van Buren County, IA",2014-2015,7415,7344,-71,-0.958,-15,-56,19,177,H1
"Van Buren County, IA",2015-2016,7344,7255,-89,-1.212,4,-93,19,177,H1
"Van Buren County, IA",2016-2017,7255,7157,-98,-1.351,-12,-86,19,177,H1
"Wapello County, IA",2000-2001,36007,35947,-60,-0.167,25,-85,19,179,H1
"Wapello County, IA",2001-2002,35947,35796,-151,-0.42,57,-208,19,179,H1
"Wapello County, IA",2002-2003,35796,35750,-46,-0.129,55,-101,19,179,H1
"Wapello County, IA",2003-2004,35750,35709,-41,-0.115,90,-131,19,179,H1
"Wapello County, IA",2004-2005,35709,35855,146,0.409,82,64,19,179,H1
"Wapello County, IA",2005-2006,35855,35776,-79,-0.22,71,-150,19,179,H1
"Wapello County, IA",2006-2007,35776,35458,-318,-0.889,99,-417,19,179,H1
"Wapello County, IA",2007-2008,35458,35381,-77,-0.217,81,-158,19,179,H1
"Wapello County, IA",2008-2009,35381,35481,100,0.283,69,31,19,179,H1
"Wapello County, IA",2009-2010,35481,35652,171,0.482,119,52,19,179,H1
"Wapello County, IA",2010-2011,35652,35444,-208,-0.583,46,-254,19,179,H1
"Wapello County, IA",2011-2012,35444,35349,-95,-0.268,6,-101,19,179,H1
"Wapello County, IA",2012-2013,35349,35373,24,0.068,47,-23,19,179,H1
"Wapello County, IA",2013-2014,35373,35212,-161,-0.455,45,-206,19,179,H1
"Wapello County, IA",2014-2015,35240,35173,-67,-0.19,25,-92,19,179,H1
"Wapello County, IA",2015-2016,35173,35270,97,0.276,64,33,19,179,H1
"Wapello County, IA",2016-2017,35270,35044,-226,-0.641,75,-301,19,179,H1
"Warren County, IA",2000-2001,40787,41080,293,0.718,201,92,19,181,H1
"Warren County, IA",2001-2002,41080,41422,342,0.833,126,216,19,181,H1
"Warren County, IA",2002-2003,41422,42187,765,1.847,153,612,19,181,H1
"Warren County, IA",2003-2004,42187,42584,397,0.941,141,256,19,181,H1
"Warren County, IA",2004-2005,42584,43339,755,1.773,199,556,19,181,H1
"Warren County, IA",2005-2006,43339,44178,839,1.936,220,619,19,181,H1
"Warren County, IA",2006-2007,44178,44868,690,1.562,156,534,19,181,H1
"Warren County, IA",2007-2008,44868,45450,582,1.297,177,405,19,181,H1
"Warren County, IA",2008-2009,45450,45926,476,1.047,213,263,19,181,H1
"Warren County, IA",2009-2010,45926,46323,397,0.864,152,245,19,181,H1
"Warren County, IA",2010-2011,46323,46664,341,0.736,128,213,19,181,H1
"Warren County, IA",2011-2012,46664,46950,286,0.613,150,136,19,181,H1
"Warren County, IA",2012-2013,46950,47399,449,0.956,168,281,19,181,H1
"Warren County, IA",2013-2014,47399,47956,557,1.175,144,413,19,181,H1
"Warren County, IA",2014-2015,47979,48626,647,1.349,166,481,19,181,H1
"Warren County, IA",2015-2016,48626,49343,717,1.475,150,567,19,181,H1
"Warren County, IA",2016-2017,49343,50163,820,1.662,140,680,19,181,H1
"Washington County, IA",2000-2001,20718,21064,346,1.67,93,253,19,183,H1
"Washington County, IA",2001-2002,21064,21108,44,0.209,80,-36,19,183,H1
"Washington County, IA",2002-2003,21108,21190,82,0.388,62,20,19,183,H1
"Washington County, IA",2003-2004,21190,21258,68,0.321,81,-13,19,183,H1
"Washington County, IA",2004-2005,21258,21350,92,0.433,37,55,19,183,H1
"Washington County, IA",2005-2006,21350,21472,122,0.571,65,57,19,183,H1
"Washington County, IA",2006-2007,21472,21588,116,0.54,61,55,19,183,H1
"Washington County, IA",2007-2008,21588,21686,98,0.454,44,54,19,183,H1
"Washington County, IA",2008-2009,21686,21692,6,0.028,52,-46,19,183,H1
"Washington County, IA",2009-2010,21692,21696,4,0.018,38,-34,19,183,H1
"Washington County, IA",2010-2011,21696,21830,134,0.618,10,124,19,183,H1
"Washington County, IA",2011-2012,21830,21921,91,0.417,38,53,19,183,H1
"Washington County, IA",2012-2013,21921,22015,94,0.429,81,13,19,183,H1
"Washington County, IA",2013-2014,22015,22070,55,0.25,71,-16,19,183,H1
"Washington County, IA",2014-2015,22087,22247,160,0.724,110,50,19,183,H1
"Washington County, IA",2015-2016,22247,22109,-138,-0.62,72,-210,19,183,H1
"Washington County, IA",2016-2017,22109,22281,172,0.778,74,98,19,183,H1
"Wayne County, IA",2000-2001,6728,6655,-73,-1.085,-29,-44,19,185,H1
"Wayne County, IA",2001-2002,6655,6665,10,0.15,-1,11,19,185,H1
"Wayne County, IA",2002-2003,6665,6614,-51,-0.765,-30,-21,19,185,H1
"Wayne County, IA",2003-2004,6614,6561,-53,-0.801,-17,-36,19,185,H1
"Wayne County, IA",2004-2005,6561,6494,-67,-1.021,-34,-33,19,185,H1
"Wayne County, IA",2005-2006,6494,6478,-16,-0.246,-9,-7,19,185,H1
"Wayne County, IA",2006-2007,6478,6376,-102,-1.575,-4,-98,19,185,H1
"Wayne County, IA",2007-2008,6376,6373,-3,-0.047,-25,22,19,185,H1
"Wayne County, IA",2008-2009,6373,6393,20,0.314,-6,26,19,185,H1
"Wayne County, IA",2009-2010,6393,6398,5,0.078,-6,11,19,185,H1
"Wayne County, IA",2010-2011,6398,6363,-35,-0.547,-1,-34,19,185,H1
"Wayne County, IA",2011-2012,6363,6355,-8,-0.126,-22,14,19,185,H1
"Wayne County, IA",2012-2013,6355,6416,61,0.96,26,35,19,185,H1
"Wayne County, IA",2013-2014,6416,6395,-21,-0.327,10,-31,19,185,H1
"Wayne County, IA",2014-2015,6387,6385,-2,-0.031,2,-4,19,185,H1
"Wayne County, IA",2015-2016,6385,6437,52,0.814,4,48,19,185,H1
"Wayne County, IA",2016-2017,6437,6476,39,0.606,6,33,19,185,H1
"Webster County, IA",2000-2001,40234,40045,-189,-0.47,58,-247,19,187,H1
"Webster County, IA",2001-2002,40045,39654,-391,-0.976,33,-424,19,187,H1
"Webster County, IA",2002-2003,39654,39377,-277,-0.699,-15,-262,19,187,H1
"Webster County, IA",2003-2004,39377,38922,-455,-1.155,66,-521,19,187,H1
"Webster County, IA",2004-2005,38922,38562,-360,-0.925,14,-374,19,187,H1
"Webster County, IA",2005-2006,38562,38534,-28,-0.073,-38,10,19,187,H1
"Webster County, IA",2006-2007,38534,38393,-141,-0.366,36,-177,19,187,H1
"Webster County, IA",2007-2008,38393,38273,-120,-0.313,32,-152,19,187,H1
"Webster County, IA",2008-2009,38273,38316,43,0.112,49,-6,19,187,H1
"Webster County, IA",2009-2010,38316,37865,-451,-1.177,53,-504,19,187,H1
"Webster County, IA",2010-2011,37865,37704,-161,-0.425,-3,-158,19,187,H1
"Webster County, IA",2011-2012,37704,37253,-451,-1.196,-35,-416,19,187,H1
"Webster County, IA",2012-2013,37253,37216,-37,-0.099,-32,-5,19,187,H1
"Webster County, IA",2013-2014,37216,36955,-261,-0.701,17,-278,19,187,H1
"Webster County, IA",2014-2015,37053,37071,18,0.049,17,1,19,187,H1
"Webster County, IA",2015-2016,37071,36752,-319,-0.861,29,-348,19,187,H1
"Webster County, IA",2016-2017,36752,36605,-147,-0.4,24,-171,19,187,H1
"Winnebago County, IA",2000-2001,11778,11586,-192,-1.63,-16,-176,19,189,H1
"Winnebago County, IA",2001-2002,11586,11403,-183,-1.579,-3,-180,19,189,H1
"Winnebago County, IA",2002-2003,11403,11412,9,0.079,-20,29,19,189,H1
"Winnebago County, IA",2003-2004,11412,11321,-91,-0.797,-36,-55,19,189,H1
"Winnebago County, IA",2004-2005,11321,11340,19,0.168,0,19,19,189,H1
"Winnebago County, IA",2005-2006,11340,11138,-202,-1.781,-13,-189,19,189,H1
"Winnebago County, IA",2006-2007,11138,10986,-152,-1.365,-3,-149,19,189,H1
"Winnebago County, IA",2007-2008,10986,10927,-59,-0.537,-6,-53,19,189,H1
"Winnebago County, IA",2008-2009,10927,10917,-10,-0.092,-4,-6,19,189,H1
"Winnebago County, IA",2009-2010,10917,10828,-89,-0.815,-5,-84,19,189,H1
"Winnebago County, IA",2010-2011,10828,10718,-110,-1.016,-26,-84,19,189,H1
"Winnebago County, IA",2011-2012,10718,10626,-92,-0.858,-4,-88,19,189,H1
"Winnebago County, IA",2012-2013,10626,10494,-132,-1.242,-14,-118,19,189,H1
"Winnebago County, IA",2013-2014,10494,10559,65,0.619,-8,73,19,189,H1
"Winnebago County, IA",2014-2015,10606,10609,3,0.028,9,-6,19,189,H1
"Winnebago County, IA",2015-2016,10609,10601,-8,-0.075,-5,-3,19,189,H1
"Winnebago County, IA",2016-2017,10601,10587,-14,-0.132,-8,-6,19,189,H1
"Winneshiek County, IA",2000-2001,21265,21258,-7,-0.033,-18,11,19,191,H1
"Winneshiek County, IA",2001-2002,21258,21183,-75,-0.353,31,-106,19,191,H1
"Winneshiek County, IA",2002-2003,21183,21006,-177,-0.836,-12,-165,19,191,H1
"Winneshiek County, IA",2003-2004,21006,21040,34,0.162,23,11,19,191,H1
"Winneshiek County, IA",2004-2005,21040,21060,20,0.095,23,-3,19,191,H1
"Winneshiek County, IA",2005-2006,21060,21012,-48,-0.228,38,-86,19,191,H1
"Winneshiek County, IA",2006-2007,21012,21078,66,0.314,44,22,19,191,H1
"Winneshiek County, IA",2007-2008,21078,20980,-98,-0.465,27,-125,19,191,H1
"Winneshiek County, IA",2008-2009,20980,21025,45,0.214,9,36,19,191,H1
"Winneshiek County, IA",2009-2010,21025,21066,41,0.195,9,32,19,191,H1
"Winneshiek County, IA",2010-2011,21066,21038,-28,-0.133,-17,-11,19,191,H1
"Winneshiek County, IA",2011-2012,21038,21036,-2,-0.01,1,-3,19,191,H1
"Winneshiek County, IA",2012-2013,21036,20879,-157,-0.746,-2,-155,19,191,H1
"Winneshiek County, IA",2013-2014,20879,20768,-111,-0.532,-21,-90,19,191,H1
"Winneshiek County, IA",2014-2015,20750,20709,-41,-0.198,-16,-25,19,191,H1
"Winneshiek County, IA",2015-2016,20709,20409,-300,-1.449,21,-321,19,191,H1
"Winneshiek County, IA",2016-2017,20409,20201,-208,-1.019,-18,-190,19,191,H1
"Woodbury County, IA",2000-2001,103786,103129,-657,-0.633,813,-1470,19,193,H1
"Woodbury County, IA",2001-2002,103129,102666,-463,-0.449,657,-1120,19,193,H1
"Woodbury County, IA",2002-2003,102666,102039,-627,-0.611,602,-1229,19,193,H1
"Woodbury County, IA",2003-2004,102039,101816,-223,-0.219,786,-1009,19,193,H1
"Woodbury County, IA",2004-2005,101816,100589,-1227,-1.205,661,-1888,19,193,H1
"Woodbury County, IA",2005-2006,100589,100693,104,0.103,773,-669,19,193,H1
"Woodbury County, IA",2006-2007,100693,100492,-201,-0.2,707,-908,19,193,H1
"Woodbury County, IA",2007-2008,100492,100910,418,0.416,766,-348,19,193,H1
"Woodbury County, IA",2008-2009,100910,101581,671,0.665,744,-73,19,193,H1
"Woodbury County, IA",2009-2010,101581,102337,756,0.744,804,-48,19,193,H1
"Woodbury County, IA",2010-2011,102337,102642,305,0.298,591,-286,19,193,H1
"Woodbury County, IA",2011-2012,102642,102330,-312,-0.304,618,-930,19,193,H1
"Woodbury County, IA",2012-2013,102330,102278,-52,-0.051,661,-713,19,193,H1
"Woodbury County, IA",2013-2014,102278,102271,-7,-0.007,594,-601,19,193,H1
"Woodbury County, IA",2014-2015,102486,102782,296,0.289,665,-369,19,193,H1
"Woodbury County, IA",2015-2016,102782,102707,-75,-0.073,606,-681,19,193,H1
"Woodbury County, IA",2016-2017,102707,102429,-278,-0.271,622,-900,19,193,H1
"Worth County, IA",2000-2001,7894,7797,-97,-1.229,-32,-65,19,195,H1
"Worth County, IA",2001-2002,7797,7795,-2,-0.026,-17,15,19,195,H1
"Worth County, IA",2002-2003,7795,7734,-61,-0.783,-24,-37,19,195,H1
"Worth County, IA",2003-2004,7734,7731,-3,-0.039,-31,28,19,195,H1
"Worth County, IA",2004-2005,7731,7742,11,0.142,-16,27,19,195,H1
"Worth County, IA",2005-2006,7742,7649,-93,-1.201,-11,-82,19,195,H1
"Worth County, IA",2006-2007,7649,7655,6,0.078,21,-15,19,195,H1
"Worth County, IA",2007-2008,7655,7632,-23,-0.3,-14,-9,19,195,H1
"Worth County, IA",2008-2009,7632,7610,-22,-0.288,4,-26,19,195,H1
"Worth County, IA",2009-2010,7610,7577,-33,-0.434,-12,-21,19,195,H1
"Worth County, IA",2010-2011,7577,7574,-3,-0.04,-10,7,19,195,H1
"Worth County, IA",2011-2012,7574,7519,-55,-0.726,-11,-44,19,195,H1
"Worth County, IA",2012-2013,7519,7541,22,0.293,-14,36,19,195,H1
"Worth County, IA",2013-2014,7541,7624,83,1.101,18,65,19,195,H1
"Worth County, IA",2014-2015,7608,7569,-39,-0.513,7,-46,19,195,H1
"Worth County, IA",2015-2016,7569,7475,-94,-1.242,-9,-85,19,195,H1
"Worth County, IA",2016-2017,7475,7469,-6,-0.08,7,-13,19,195,H1
"Wright County, IA",2000-2001,14327,14133,-194,-1.354,-51,-143,19,197,H1
"Wright County, IA",2001-2002,14133,13957,-176,-1.245,-29,-147,19,197,H1
"Wright County, IA",2002-2003,13957,13831,-126,-0.903,-33,-93,19,197,H1
"Wright County, IA",2003-2004,13831,13808,-23,-0.166,13,-36,19,197,H1
"Wright County, IA",2004-2005,13808,13717,-91,-0.659,-20,-71,19,197,H1
"Wright County, IA",2005-2006,13717,13588,-129,-0.94,22,-151,19,197,H1
"Wright County, IA",2006-2007,13588,13492,-96,-0.707,-6,-90,19,197,H1
"Wright County, IA",2007-2008,13492,13375,-117,-0.867,8,-125,19,197,H1
"Wright County, IA",2008-2009,13375,13262,-113,-0.845,7,-120,19,197,H1
"Wright County, IA",2009-2010,13262,13186,-76,-0.573,16,-92,19,197,H1
"Wright County, IA",2010-2011,13186,13038,-148,-1.122,-27,-121,19,197,H1
"Wright County, IA",2011-2012,13038,13008,-30,-0.23,9,-39,19,197,H1
"Wright County, IA",2012-2013,13008,12963,-45,-0.346,-20,-25,19,197,H1
"Wright County, IA",2013-2014,12963,12840,-123,-0.949,-20,-103,19,197,H1
"Wright County, IA",2014-2015,12872,12773,-99,-0.769,-2,-97,19,197,H1
"Wright County, IA",2015-2016,12773,12816,43,0.337,-5,48,19,197,H1
"Wright County, IA",2016-2017,12816,12784,-32,-0.25,16,-48,19,197,H1
Kansas,2000-2001,2693681,2702162,8481,0.315,14283,-5802,20,0,STATE
Kansas,2001-2002,2702162,2713535,11373,0.421,14110,-2737,20,0,STATE
Kansas,2002-2003,2713535,2723004,9469,0.349,15180,-5711,20,0,STATE
Kansas,2003-2004,2723004,2734373,11369,0.418,14895,-3526,20,0,STATE
Kansas,2004-2005,2734373,2745299,10926,0.4,14833,-3907,20,0,STATE
Kansas,2005-2006,2745299,2762931,17632,0.642,15266,2366,20,0,STATE
Kansas,2006-2007,2762931,2783785,20854,0.755,17211,3643,20,0,STATE
Kansas,2007-2008,2783785,2808076,24291,0.873,17473,6818,20,0,STATE
Kansas,2008-2009,2808076,2832704,24628,0.877,17467,7161,20,0,STATE
Kansas,2009-2010,2832704,2858824,26120,0.922,16662,9458,20,0,STATE
Kansas,2010-2011,2858824,2869917,11093,0.388,14941,-3848,20,0,STATE
Kansas,2011-2012,2869917,2886281,16364,0.57,14624,1740,20,0,STATE
Kansas,2012-2013,2886281,2894630,8349,0.289,14122,-5773,20,0,STATE
Kansas,2013-2014,2894630,2902507,7877,0.272,14588,-6711,20,0,STATE
Kansas,2014-2015,2902507,2911641,9134,0.315,14813,-5679,20,0,STATE
Kansas,2015-2016,2911641,2907731,-3910,-0.134,13438,-17348,20,0,STATE
Kansas,2016-2017,2907731,2913123,5392,0.185,13384,-7992,20,0,STATE
"Allen County, KS",2000-2001,14393,14171,-222,-1.542,-12,-210,20,1,H1
"Allen County, KS",2001-2002,14171,14110,-61,-0.43,-6,-55,20,1,H1
"Allen County, KS",2002-2003,14110,13940,-170,-1.205,-26,-144,20,1,H1
"Allen County, KS",2003-2004,13940,13923,-17,-0.122,-39,22,20,1,H1
"Allen County, KS",2004-2005,13923,13733,-190,-1.365,-5,-185,20,1,H1
"Allen County, KS",2005-2006,13733,13639,-94,-0.684,6,-100,20,1,H1
"Allen County, KS",2006-2007,13639,13545,-94,-0.689,15,-109,20,1,H1
"Allen County, KS",2007-2008,13545,13422,-123,-0.908,-13,-110,20,1,H1
"Allen County, KS",2008-2009,13422,13407,-15,-0.112,-5,-10,20,1,H1
"Allen County, KS",2009-2010,13407,13360,-47,-0.351,-20,-27,20,1,H1
"Allen County, KS",2010-2011,13360,13351,-9,-0.067,-31,22,20,1,H1
"Allen County, KS",2011-2012,13351,13341,-10,-0.075,-36,26,20,1,H1
"Allen County, KS",2012-2013,13341,13098,-243,-1.821,-27,-216,20,1,H1
"Allen County, KS",2013-2014,13098,12909,-189,-1.443,-24,-165,20,1,H1
"Allen County, KS",2014-2015,12912,12717,-195,-1.51,-35,-160,20,1,H1
"Allen County, KS",2015-2016,12717,12647,-70,-0.55,-10,-60,20,1,H1
"Allen County, KS",2016-2017,12647,12519,-128,-1.012,-26,-102,20,1,H1
"Anderson County, KS",2000-2001,8091,8195,104,1.285,-4,108,20,3,H1
"Anderson County, KS",2001-2002,8195,8143,-52,-0.635,5,-57,20,3,H1
"Anderson County, KS",2002-2003,8143,8190,47,0.577,7,40,20,3,H1
"Anderson County, KS",2003-2004,8190,8101,-89,-1.087,-14,-75,20,3,H1
"Anderson County, KS",2004-2005,8101,8087,-14,-0.173,-16,2,20,3,H1
"Anderson County, KS",2005-2006,8087,8023,-64,-0.791,13,-77,20,3,H1
"Anderson County, KS",2006-2007,8023,8040,17,0.212,11,6,20,3,H1
"Anderson County, KS",2007-2008,8040,8158,118,1.468,29,89,20,3,H1
"Anderson County, KS",2008-2009,8158,8101,-57,-0.699,23,-80,20,3,H1
"Anderson County, KS",2009-2010,8101,8098,-3,-0.037,1,-4,20,3,H1
"Anderson County, KS",2010-2011,8098,8051,-47,-0.58,2,-49,20,3,H1
"Anderson County, KS",2011-2012,8051,7918,-133,-1.652,-18,-115,20,3,H1
"Anderson County, KS",2012-2013,7918,7858,-60,-0.758,3,-63,20,3,H1
"Anderson County, KS",2013-2014,7858,7883,25,0.318,-9,34,20,3,H1
"Anderson County, KS",2014-2015,7877,7808,-69,-0.876,2,-71,20,3,H1
"Anderson County, KS",2015-2016,7808,7814,6,0.077,-5,11,20,3,H1
"Anderson County, KS",2016-2017,7814,7833,19,0.243,-17,36,20,3,H1
"Atchison County, KS",2000-2001,16796,16868,72,0.429,45,27,20,5,H1
"Atchison County, KS",2001-2002,16868,16823,-45,-0.267,6,-51,20,5,H1
"Atchison County, KS",2002-2003,16823,16875,52,0.309,17,35,20,5,H1
"Atchison County, KS",2003-2004,16875,16937,62,0.367,66,-4,20,5,H1
"Atchison County, KS",2004-2005,16937,16865,-72,-0.425,30,-102,20,5,H1
"Atchison County, KS",2005-2006,16865,16902,37,0.219,26,11,20,5,H1
"Atchison County, KS",2006-2007,16902,16864,-38,-0.225,20,-58,20,5,H1
"Atchison County, KS",2007-2008,16864,16820,-44,-0.261,42,-86,20,5,H1
"Atchison County, KS",2008-2009,16820,16965,145,0.862,68,77,20,5,H1
"Atchison County, KS",2009-2010,16965,16870,-95,-0.56,50,-145,20,5,H1
"Atchison County, KS",2010-2011,16870,16785,-85,-0.504,31,-116,20,5,H1
"Atchison County, KS",2011-2012,16785,16800,15,0.089,30,-15,20,5,H1
"Atchison County, KS",2012-2013,16800,16717,-83,-0.494,47,-130,20,5,H1
"Atchison County, KS",2013-2014,16717,16513,-204,-1.22,35,-239,20,5,H1
"Atchison County, KS",2014-2015,16491,16398,-93,-0.564,22,-115,20,5,H1
"Atchison County, KS",2015-2016,16398,16373,-25,-0.152,9,-34,20,5,H1
"Atchison County, KS",2016-2017,16373,16332,-41,-0.25,38,-79,20,5,H1
"Barber County, KS",2000-2001,5292,5158,-134,-2.532,-28,-106,20,7,H1
"Barber County, KS",2001-2002,5158,5088,-70,-1.357,-30,-40,20,7,H1
"Barber County, KS",2002-2003,5088,5049,-39,-0.767,-29,-10,20,7,H1
"Barber County, KS",2003-2004,5049,5004,-45,-0.891,-14,-31,20,7,H1
"Barber County, KS",2004-2005,5004,4984,-20,-0.4,-36,16,20,7,H1
"Barber County, KS",2005-2006,4984,5003,19,0.381,13,6,20,7,H1
"Barber County, KS",2006-2007,5003,4927,-76,-1.519,-34,-42,20,7,H1
"Barber County, KS",2007-2008,4927,4844,-83,-1.685,3,-86,20,7,H1
"Barber County, KS",2008-2009,4844,4882,38,0.784,3,35,20,7,H1
"Barber County, KS",2009-2010,4882,4848,-34,-0.696,-3,-31,20,7,H1
"Barber County, KS",2010-2011,4848,4926,78,1.609,24,54,20,7,H1
"Barber County, KS",2011-2012,4926,4880,-46,-0.934,4,-50,20,7,H1
"Barber County, KS",2012-2013,4880,4938,58,1.189,8,50,20,7,H1
"Barber County, KS",2013-2014,4938,4897,-41,-0.83,14,-55,20,7,H1
"Barber County, KS",2014-2015,4870,4823,-47,-0.965,7,-54,20,7,H1
"Barber County, KS",2015-2016,4823,4682,-141,-2.923,2,-143,20,7,H1
"Barber County, KS",2016-2017,4682,4586,-96,-2.05,4,-100,20,7,H1
"Barton County, KS",2000-2001,28163,27771,-392,-1.392,-25,-367,20,9,H1
"Barton County, KS",2001-2002,27771,27684,-87,-0.313,56,-143,20,9,H1
"Barton County, KS",2002-2003,27684,27581,-103,-0.372,77,-180,20,9,H1
"Barton County, KS",2003-2004,27581,27390,-191,-0.693,6,-197,20,9,H1
"Barton County, KS",2004-2005,27390,27536,146,0.533,67,79,20,9,H1
"Barton County, KS",2005-2006,27536,27460,-76,-0.276,77,-153,20,9,H1
"Barton County, KS",2006-2007,27460,27492,32,0.117,77,-45,20,9,H1
"Barton County, KS",2007-2008,27492,27314,-178,-0.647,108,-286,20,9,H1
"Barton County, KS",2008-2009,27314,27526,212,0.776,97,115,20,9,H1
"Barton County, KS",2009-2010,27526,27684,158,0.574,112,46,20,9,H1
"Barton County, KS",2010-2011,27684,27697,13,0.047,57,-44,20,9,H1
"Barton County, KS",2011-2012,27697,27553,-144,-0.52,60,-204,20,9,H1
"Barton County, KS",2012-2013,27553,27510,-43,-0.156,104,-147,20,9,H1
"Barton County, KS",2013-2014,27510,27385,-125,-0.454,96,-221,20,9,H1
"Barton County, KS",2014-2015,27258,27103,-155,-0.569,53,-208,20,9,H1
"Barton County, KS",2015-2016,27103,26911,-192,-0.708,78,-270,20,9,H1
"Barton County, KS",2016-2017,26911,26476,-435,-1.616,42,-477,20,9,H1
"Bourbon County, KS",2000-2001,15366,15368,2,0.013,-15,17,20,11,H1
"Bourbon County, KS",2001-2002,15368,15200,-168,-1.093,-4,-164,20,11,H1
"Bourbon County, KS",2002-2003,15200,15187,-13,-0.086,17,-30,20,11,H1
"Bourbon County, KS",2003-2004,15187,15110,-77,-0.507,28,-105,20,11,H1
"Bourbon County, KS",2004-2005,15110,15002,-108,-0.715,18,-126,20,11,H1
"Bourbon County, KS",2005-2006,15002,14990,-12,-0.08,5,-17,20,11,H1
"Bourbon County, KS",2006-2007,14990,15038,48,0.32,57,-9,20,11,H1
"Bourbon County, KS",2007-2008,15038,15127,89,0.592,48,41,20,11,H1
"Bourbon County, KS",2008-2009,15127,15157,30,0.198,50,-20,20,11,H1
"Bourbon County, KS",2009-2010,15157,15169,12,0.079,40,-28,20,11,H1
"Bourbon County, KS",2010-2011,15169,14941,-228,-1.503,34,-262,20,11,H1
"Bourbon County, KS",2011-2012,14941,14859,-82,-0.549,17,-99,20,11,H1
"Bourbon County, KS",2012-2013,14859,14826,-33,-0.222,53,-86,20,11,H1
"Bourbon County, KS",2013-2014,14826,14772,-54,-0.364,45,-99,20,11,H1
"Bourbon County, KS",2014-2015,14776,14712,-64,-0.433,58,-122,20,11,H1
"Bourbon County, KS",2015-2016,14712,14672,-40,-0.272,47,-87,20,11,H1
"Bourbon County, KS",2016-2017,14672,14754,82,0.559,59,23,20,11,H1
"Brown County, KS",2000-2001,10709,10555,-154,-1.438,4,-158,20,13,H1
"Brown County, KS",2001-2002,10555,10373,-182,-1.724,21,-203,20,13,H1
"Brown County, KS",2002-2003,10373,10271,-102,-0.983,-14,-88,20,13,H1
"Brown County, KS",2003-2004,10271,10253,-18,-0.175,2,-20,20,13,H1
"Brown County, KS",2004-2005,10253,10087,-166,-1.619,-35,-131,20,13,H1
"Brown County, KS",2005-2006,10087,10111,24,0.238,-8,32,20,13,H1
"Brown County, KS",2006-2007,10111,10036,-75,-0.742,-32,-43,20,13,H1
"Brown County, KS",2007-2008,10036,9988,-48,-0.478,29,-77,20,13,H1
"Brown County, KS",2008-2009,9988,9972,-16,-0.16,7,-23,20,13,H1
"Brown County, KS",2009-2010,9972,9982,10,0.1,5,5,20,13,H1
"Brown County, KS",2010-2011,9982,9998,16,0.16,16,0,20,13,H1
"Brown County, KS",2011-2012,9998,9888,-110,-1.1,19,-129,20,13,H1
"Brown County, KS",2012-2013,9888,9949,61,0.617,13,48,20,13,H1
"Brown County, KS",2013-2014,9949,9815,-134,-1.347,18,-152,20,13,H1
"Brown County, KS",2014-2015,9804,9776,-28,-0.286,19,-47,20,13,H1
"Brown County, KS",2015-2016,9776,9642,-134,-1.371,32,-166,20,13,H1
"Brown County, KS",2016-2017,9642,9641,-1,-0.01,7,-8,20,13,H1
"Butler County, KS",2000-2001,59681,59894,213,0.357,196,17,20,15,H1
"Butler County, KS",2001-2002,59894,60473,579,0.967,232,347,20,15,H1
"Butler County, KS",2002-2003,60473,61056,583,0.964,200,383,20,15,H1
"Butler County, KS",2003-2004,61056,61849,793,1.299,205,588,20,15,H1
"Butler County, KS",2004-2005,61849,62547,698,1.129,201,497,20,15,H1
"Butler County, KS",2005-2006,62547,63571,1024,1.637,267,757,20,15,H1
"Butler County, KS",2006-2007,63571,64213,642,1.01,246,396,20,15,H1
"Butler County, KS",2007-2008,64213,64941,728,1.134,270,458,20,15,H1
"Butler County, KS",2008-2009,64941,65617,676,1.041,308,368,20,15,H1
"Butler County, KS",2009-2010,65617,65918,301,0.459,184,117,20,15,H1
"Butler County, KS",2010-2011,65918,65851,-67,-0.102,178,-245,20,15,H1
"Butler County, KS",2011-2012,65851,65756,-95,-0.144,141,-236,20,15,H1
"Butler County, KS",2012-2013,65756,65884,128,0.195,215,-87,20,15,H1
"Butler County, KS",2013-2014,65884,66227,343,0.521,223,120,20,15,H1
"Butler County, KS",2014-2015,66183,66741,558,0.843,174,384,20,15,H1
"Butler County, KS",2015-2016,66741,66648,-93,-0.139,117,-210,20,15,H1
"Butler County, KS",2016-2017,66648,66878,230,0.345,116,114,20,15,H1
"Chase County, KS",2000-2001,3019,2966,-53,-1.756,15,-68,20,17,H1
"Chase County, KS",2001-2002,2966,3008,42,1.416,56,-14,20,17,H1
"Chase County, KS",2002-2003,3008,2942,-66,-2.194,-12,-54,20,17,H1
"Chase County, KS",2003-2004,2942,2996,54,1.835,1,53,20,17,H1
"Chase County, KS",2004-2005,2996,2962,-34,-1.135,14,-48,20,17,H1
"Chase County, KS",2005-2006,2962,2949,-13,-0.439,-3,-10,20,17,H1
"Chase County, KS",2006-2007,2949,2840,-109,-3.696,-19,-90,20,17,H1
"Chase County, KS",2007-2008,2840,2810,-30,-1.056,6,-36,20,17,H1
"Chase County, KS",2008-2009,2810,2779,-31,-1.103,2,-33,20,17,H1
"Chase County, KS",2009-2010,2779,2788,9,0.324,1,8,20,17,H1
"Chase County, KS",2010-2011,2788,2791,3,0.108,-23,26,20,17,H1
"Chase County, KS",2011-2012,2791,2750,-41,-1.469,-9,-32,20,17,H1
"Chase County, KS",2012-2013,2750,2708,-42,-1.527,15,-57,20,17,H1
"Chase County, KS",2013-2014,2708,2692,-16,-0.591,14,-30,20,17,H1
"Chase County, KS",2014-2015,2683,2679,-4,-0.149,15,-19,20,17,H1
"Chase County, KS",2015-2016,2679,2644,-35,-1.306,3,-38,20,17,H1
"Chase County, KS",2016-2017,2644,2683,39,1.475,13,26,20,17,H1
"Chautauqua County, KS",2000-2001,4344,4240,-104,-2.394,-51,-53,20,19,H1
"Chautauqua County, KS",2001-2002,4240,4183,-57,-1.344,-37,-20,20,19,H1
"Chautauqua County, KS",2002-2003,4183,4143,-40,-0.956,-42,2,20,19,H1
"Chautauqua County, KS",2003-2004,4143,4139,-4,-0.097,-28,24,20,19,H1
"Chautauqua County, KS",2004-2005,4139,3989,-150,-3.624,-25,-125,20,19,H1
"Chautauqua County, KS",2005-2006,3989,3836,-153,-3.836,-30,-123,20,19,H1
"Chautauqua County, KS",2006-2007,3836,3757,-79,-2.059,-24,-55,20,19,H1
"Chautauqua County, KS",2007-2008,3757,3735,-22,-0.586,-27,5,20,19,H1
"Chautauqua County, KS",2008-2009,3735,3691,-44,-1.178,-21,-23,20,19,H1
"Chautauqua County, KS",2009-2010,3691,3646,-45,-1.219,-27,-18,20,19,H1
"Chautauqua County, KS",2010-2011,3646,3614,-32,-0.878,-23,-9,20,19,H1
"Chautauqua County, KS",2011-2012,3614,3566,-48,-1.328,-29,-19,20,19,H1
"Chautauqua County, KS",2012-2013,3566,3553,-13,-0.365,9,-22,20,19,H1
"Chautauqua County, KS",2013-2014,3553,3481,-72,-2.026,-6,-66,20,19,H1
"Chautauqua County, KS",2014-2015,3474,3402,-72,-2.073,-6,-66,20,19,H1
"Chautauqua County, KS",2015-2016,3402,3385,-17,-0.5,-5,-12,20,19,H1
"Chautauqua County, KS",2016-2017,3385,3363,-22,-0.65,-2,-20,20,19,H1
"Cherokee County, KS",2000-2001,22554,22338,-216,-0.958,-19,-197,20,21,H1
"Cherokee County, KS",2001-2002,22338,22185,-153,-0.685,44,-197,20,21,H1
"Cherokee County, KS",2002-2003,22185,22138,-47,-0.212,34,-81,20,21,H1
"Cherokee County, KS",2003-2004,22138,22124,-14,-0.063,1,-15,20,21,H1
"Cherokee County, KS",2004-2005,22124,21750,-374,-1.69,-91,-283,20,21,H1
"Cherokee County, KS",2005-2006,21750,21855,105,0.483,-49,154,20,21,H1
"Cherokee County, KS",2006-2007,21855,21896,41,0.188,-12,53,20,21,H1
"Cherokee County, KS",2007-2008,21896,21720,-176,-0.804,-10,-166,20,21,H1
"Cherokee County, KS",2008-2009,21720,21658,-62,-0.285,8,-70,20,21,H1
"Cherokee County, KS",2009-2010,21658,21563,-95,-0.439,-26,-69,20,21,H1
"Cherokee County, KS",2010-2011,21563,21387,-176,-0.816,-31,-145,20,21,H1
"Cherokee County, KS",2011-2012,21387,21224,-163,-0.762,-11,-152,20,21,H1
"Cherokee County, KS",2012-2013,21224,20933,-291,-1.371,-56,-235,20,21,H1
"Cherokee County, KS",2013-2014,20933,20787,-146,-0.697,-34,-112,20,21,H1
"Cherokee County, KS",2014-2015,20748,20533,-215,-1.036,-34,-181,20,21,H1
"Cherokee County, KS",2015-2016,20533,20220,-313,-1.524,3,-316,20,21,H1
"Cherokee County, KS",2016-2017,20220,20115,-105,-0.519,-26,-79,20,21,H1
"Cheyenne County, KS",2000-2001,3157,3083,-74,-2.344,-18,-56,20,23,H1
"Cheyenne County, KS",2001-2002,3083,3033,-50,-1.622,-17,-33,20,23,H1
"Cheyenne County, KS",2002-2003,3033,2957,-76,-2.506,-18,-58,20,23,H1
"Cheyenne County, KS",2003-2004,2957,2922,-35,-1.184,-13,-22,20,23,H1
"Cheyenne County, KS",2004-2005,2922,2880,-42,-1.437,-24,-18,20,23,H1
"Cheyenne County, KS",2005-2006,2880,2866,-14,-0.486,-15,1,20,23,H1
"Cheyenne County, KS",2006-2007,2866,2810,-56,-1.954,-37,-19,20,23,H1
"Cheyenne County, KS",2007-2008,2810,2778,-32,-1.139,-17,-15,20,23,H1
"Cheyenne County, KS",2008-2009,2778,2743,-35,-1.26,-14,-21,20,23,H1
"Cheyenne County, KS",2009-2010,2743,2721,-22,-0.802,-14,-8,20,23,H1
"Cheyenne County, KS",2010-2011,2721,2704,-17,-0.625,-10,-7,20,23,H1
"Cheyenne County, KS",2011-2012,2704,2675,-29,-1.072,-14,-15,20,23,H1
"Cheyenne County, KS",2012-2013,2675,2682,7,0.262,-8,15,20,23,H1
"Cheyenne County, KS",2013-2014,2682,2693,11,0.41,-15,26,20,23,H1
"Cheyenne County, KS",2014-2015,2687,2679,-8,-0.298,-9,1,20,23,H1
"Cheyenne County, KS",2015-2016,2679,2671,-8,-0.299,0,-8,20,23,H1
"Cheyenne County, KS",2016-2017,2671,2683,12,0.449,-1,13,20,23,H1
"Clark County, KS",2000-2001,2402,2393,-9,-0.375,-1,-8,20,25,H1
"Clark County, KS",2001-2002,2393,2372,-21,-0.878,-12,-9,20,25,H1
"Clark County, KS",2002-2003,2372,2364,-8,-0.337,1,-9,20,25,H1
"Clark County, KS",2003-2004,2364,2358,-6,-0.254,-11,5,20,25,H1
"Clark County, KS",2004-2005,2358,2298,-60,-2.545,-1,-59,20,25,H1
"Clark County, KS",2005-2006,2298,2252,-46,-2.002,-9,-37,20,25,H1
"Clark County, KS",2006-2007,2252,2200,-52,-2.309,-6,-46,20,25,H1
"Clark County, KS",2007-2008,2200,2225,25,1.136,-1,26,20,25,H1
"Clark County, KS",2008-2009,2225,2242,17,0.764,4,13,20,25,H1
"Clark County, KS",2009-2010,2242,2198,-44,-1.963,1,-45,20,25,H1
"Clark County, KS",2010-2011,2198,2131,-67,-3.048,-12,-55,20,25,H1
"Clark County, KS",2011-2012,2131,2174,43,2.018,-13,56,20,25,H1
"Clark County, KS",2012-2013,2174,2201,27,1.242,18,9,20,25,H1
"Clark County, KS",2013-2014,2201,2144,-57,-2.59,15,-72,20,25,H1
"Clark County, KS",2014-2015,2120,2096,-24,-1.132,0,-24,20,25,H1
"Clark County, KS",2015-2016,2096,2065,-31,-1.479,-4,-27,20,25,H1
"Clark County, KS",2016-2017,2065,2004,-61,-2.954,-1,-60,20,25,H1
"Clay County, KS",2000-2001,8827,8730,-97,-1.099,1,-98,20,27,H1
"Clay County, KS",2001-2002,8730,8607,-123,-1.409,-27,-96,20,27,H1
"Clay County, KS",2002-2003,8607,8493,-114,-1.325,-23,-91,20,27,H1
"Clay County, KS",2003-2004,8493,8447,-46,-0.542,-9,-37,20,27,H1
"Clay County, KS",2004-2005,8447,8444,-3,-0.036,-25,22,20,27,H1
"Clay County, KS",2005-2006,8444,8458,14,0.166,-3,17,20,27,H1
"Clay County, KS",2006-2007,8458,8527,69,0.816,28,41,20,27,H1
"Clay County, KS",2007-2008,8527,8618,91,1.067,-10,101,20,27,H1
"Clay County, KS",2008-2009,8618,8500,-118,-1.369,25,-143,20,27,H1
"Clay County, KS",2009-2010,8500,8550,50,0.588,-2,52,20,27,H1
"Clay County, KS",2010-2011,8550,8525,-25,-0.292,-13,-12,20,27,H1
"Clay County, KS",2011-2012,8525,8517,-8,-0.094,2,-10,20,27,H1
"Clay County, KS",2012-2013,8517,8390,-127,-1.491,12,-139,20,27,H1
"Clay County, KS",2013-2014,8390,8317,-73,-0.87,-14,-59,20,27,H1
"Clay County, KS",2014-2015,8337,8347,10,0.12,3,7,20,27,H1
"Clay County, KS",2015-2016,8347,8079,-268,-3.211,-33,-235,20,27,H1
"Clay County, KS",2016-2017,8079,7958,-121,-1.498,-31,-90,20,27,H1
"Cloud County, KS",2000-2001,10238,10090,-148,-1.446,-62,-86,20,29,H1
"Cloud County, KS",2001-2002,10090,9948,-142,-1.407,-52,-90,20,29,H1
"Cloud County, KS",2002-2003,9948,9886,-62,-0.623,-44,-18,20,29,H1
"Cloud County, KS",2003-2004,9886,9739,-147,-1.487,-56,-91,20,29,H1
"Cloud County, KS",2004-2005,9739,9741,2,0.021,-46,48,20,29,H1
"Cloud County, KS",2005-2006,9741,9560,-181,-1.858,-27,-154,20,29,H1
"Cloud County, KS",2006-2007,9560,9525,-35,-0.366,-34,-1,20,29,H1
"Cloud County, KS",2007-2008,9525,9541,16,0.168,-40,56,20,29,H1
"Cloud County, KS",2008-2009,9541,9545,4,0.042,-32,36,20,29,H1
"Cloud County, KS",2009-2010,9545,9531,-14,-0.147,-36,22,20,29,H1
"Cloud County, KS",2010-2011,9531,9395,-136,-1.427,-2,-134,20,29,H1
"Cloud County, KS",2011-2012,9395,9392,-3,-0.032,-13,10,20,29,H1
"Cloud County, KS",2012-2013,9392,9365,-27,-0.287,4,-31,20,29,H1
"Cloud County, KS",2013-2014,9365,9385,20,0.214,6,14,20,29,H1
"Cloud County, KS",2014-2015,9331,9219,-112,-1.2,-37,-75,20,29,H1
"Cloud County, KS",2015-2016,9219,9100,-119,-1.291,1,-120,20,29,H1
"Cloud County, KS",2016-2017,9100,8991,-109,-1.198,-12,-97,20,29,H1
"Coffey County, KS",2000-2001,8932,8828,-104,-1.164,-22,-82,20,31,H1
"Coffey County, KS",2001-2002,8828,8784,-44,-0.498,-12,-32,20,31,H1
"Coffey County, KS",2002-2003,8784,8795,11,0.125,6,5,20,31,H1
"Coffey County, KS",2003-2004,8795,8694,-101,-1.148,-20,-81,20,31,H1
"Coffey County, KS",2004-2005,8694,8622,-72,-0.828,-4,-68,20,31,H1
"Coffey County, KS",2005-2006,8622,8652,30,0.348,-19,49,20,31,H1
"Coffey County, KS",2006-2007,8652,8542,-110,-1.271,-22,-88,20,31,H1
"Coffey County, KS",2007-2008,8542,8563,21,0.246,-3,24,20,31,H1
"Coffey County, KS",2008-2009,8563,8566,3,0.035,0,3,20,31,H1
"Coffey County, KS",2009-2010,8566,8591,25,0.292,-13,38,20,31,H1
"Coffey County, KS",2010-2011,8591,8519,-72,-0.838,-15,-57,20,31,H1
"Coffey County, KS",2011-2012,8519,8506,-13,-0.153,-9,-4,20,31,H1
"Coffey County, KS",2012-2013,8506,8415,-91,-1.07,-13,-78,20,31,H1
"Coffey County, KS",2013-2014,8415,8433,18,0.214,4,14,20,31,H1
"Coffey County, KS",2014-2015,8444,8384,-60,-0.711,25,-85,20,31,H1
"Coffey County, KS",2015-2016,8384,8348,-36,-0.429,-12,-24,20,31,H1
"Coffey County, KS",2016-2017,8348,8224,-124,-1.485,-3,-121,20,31,H1
"Comanche County, KS",2000-2001,1955,1984,29,1.483,-6,35,20,33,H1
"Comanche County, KS",2001-2002,1984,1956,-28,-1.411,-25,-3,20,33,H1
"Comanche County, KS",2002-2003,1956,1910,-46,-2.352,-21,-25,20,33,H1
"Comanche County, KS",2003-2004,1910,1905,-5,-0.262,-11,6,20,33,H1
"Comanche County, KS",2004-2005,1905,1931,26,1.365,-15,41,20,33,H1
"Comanche County, KS",2005-2006,1931,1842,-89,-4.609,-28,-61,20,33,H1
"Comanche County, KS",2006-2007,1842,1841,-1,-0.054,-19,18,20,33,H1
"Comanche County, KS",2007-2008,1841,1902,61,3.313,-24,85,20,33,H1
"Comanche County, KS",2008-2009,1902,1878,-24,-1.262,-5,-19,20,33,H1
"Comanche County, KS",2009-2010,1878,1886,8,0.426,-5,13,20,33,H1
"Comanche County, KS",2010-2011,1886,1883,-3,-0.159,-7,4,20,33,H1
"Comanche County, KS",2011-2012,1883,1908,25,1.328,-4,29,20,33,H1
"Comanche County, KS",2012-2013,1908,1924,16,0.839,9,7,20,33,H1
"Comanche County, KS",2013-2014,1924,1954,30,1.559,5,25,20,33,H1
"Comanche County, KS",2014-2015,1949,1843,-106,-5.439,5,-111,20,33,H1
"Comanche County, KS",2015-2016,1843,1851,8,0.434,-2,10,20,33,H1
"Comanche County, KS",2016-2017,1851,1790,-61,-3.296,6,-67,20,33,H1
"Cowley County, KS",2000-2001,36342,36103,-239,-0.658,36,-275,20,35,H1
"Cowley County, KS",2001-2002,36103,36680,577,1.598,62,515,20,35,H1
"Cowley County, KS",2002-2003,36680,36300,-380,-1.036,-1,-379,20,35,H1
"Cowley County, KS",2003-2004,36300,36317,17,0.047,28,-11,20,35,H1
"Cowley County, KS",2004-2005,36317,35928,-389,-1.071,24,-413,20,35,H1
"Cowley County, KS",2005-2006,35928,35787,-141,-0.392,11,-152,20,35,H1
"Cowley County, KS",2006-2007,35787,36148,361,1.009,72,289,20,35,H1
"Cowley County, KS",2007-2008,36148,36284,136,0.376,67,69,20,35,H1
"Cowley County, KS",2008-2009,36284,36195,-89,-0.245,98,-187,20,35,H1
"Cowley County, KS",2009-2010,36195,36308,113,0.312,61,52,20,35,H1
"Cowley County, KS",2010-2011,36308,36242,-66,-0.182,27,-93,20,35,H1
"Cowley County, KS",2011-2012,36242,36264,22,0.061,17,5,20,35,H1
"Cowley County, KS",2012-2013,36264,36230,-34,-0.094,77,-111,20,35,H1
"Cowley County, KS",2013-2014,36230,35963,-267,-0.737,64,-331,20,35,H1
"Cowley County, KS",2014-2015,35920,35788,-132,-0.367,39,-171,20,35,H1
"Cowley County, KS",2015-2016,35788,35621,-167,-0.467,-19,-148,20,35,H1
"Cowley County, KS",2016-2017,35621,35361,-260,-0.73,22,-282,20,35,H1
"Crawford County, KS",2000-2001,38262,38434,172,0.45,95,77,20,37,H1
"Crawford County, KS",2001-2002,38434,38330,-104,-0.271,56,-160,20,37,H1
"Crawford County, KS",2002-2003,38330,38631,301,0.785,70,231,20,37,H1
"Crawford County, KS",2003-2004,38631,38656,25,0.065,78,-53,20,37,H1
"Crawford County, KS",2004-2005,38656,38638,-18,-0.047,-4,-14,20,37,H1
"Crawford County, KS",2005-2006,38638,38855,217,0.562,94,123,20,37,H1
"Crawford County, KS",2006-2007,38855,38922,67,0.172,63,4,20,37,H1
"Crawford County, KS",2007-2008,38922,38997,75,0.193,136,-61,20,37,H1
"Crawford County, KS",2008-2009,38997,38966,-31,-0.079,137,-168,20,37,H1
"Crawford County, KS",2009-2010,38966,39200,234,0.601,124,110,20,37,H1
"Crawford County, KS",2010-2011,39200,39204,4,0.01,38,-34,20,37,H1
"Crawford County, KS",2011-2012,39204,39361,157,0.4,67,90,20,37,H1
"Crawford County, KS",2012-2013,39361,39330,-31,-0.079,130,-161,20,37,H1
"Crawford County, KS",2013-2014,39330,39290,-40,-0.102,119,-159,20,37,H1
"Crawford County, KS",2014-2015,39374,39217,-157,-0.399,129,-286,20,37,H1
"Crawford County, KS",2015-2016,39217,38992,-225,-0.574,114,-339,20,37,H1
"Crawford County, KS",2016-2017,38992,39034,42,0.108,123,-81,20,37,H1
"Decatur County, KS",2000-2001,3460,3450,-10,-0.289,-19,9,20,39,H1
"Decatur County, KS",2001-2002,3450,3381,-69,-2,-35,-34,20,39,H1
"Decatur County, KS",2002-2003,3381,3302,-79,-2.337,-24,-55,20,39,H1
"Decatur County, KS",2003-2004,3302,3239,-63,-1.908,-19,-44,20,39,H1
"Decatur County, KS",2004-2005,3239,3128,-111,-3.427,-37,-74,20,39,H1
"Decatur County, KS",2005-2006,3128,3107,-21,-0.671,-36,15,20,39,H1
"Decatur County, KS",2006-2007,3107,3043,-64,-2.06,-25,-39,20,39,H1
"Decatur County, KS",2007-2008,3043,2992,-51,-1.676,-24,-27,20,39,H1
"Decatur County, KS",2008-2009,2992,2980,-12,-0.401,-31,19,20,39,H1
"Decatur County, KS",2009-2010,2980,2949,-31,-1.04,-29,-2,20,39,H1
"Decatur County, KS",2010-2011,2949,2922,-27,-0.916,-33,6,20,39,H1
"Decatur County, KS",2011-2012,2922,2881,-41,-1.403,-31,-10,20,39,H1
"Decatur County, KS",2012-2013,2881,2915,34,1.18,0,34,20,39,H1
"Decatur County, KS",2013-2014,2915,2908,-7,-0.24,5,-12,20,39,H1
"Decatur County, KS",2014-2015,2890,2932,42,1.453,0,42,20,39,H1
"Decatur County, KS",2015-2016,2932,2837,-95,-3.24,-8,-87,20,39,H1
"Decatur County, KS",2016-2017,2837,2885,48,1.692,-8,56,20,39,H1
"Dickinson County, KS",2000-2001,19349,19138,-211,-1.09,-5,-206,20,41,H1
"Dickinson County, KS",2001-2002,19138,19121,-17,-0.089,-74,57,20,41,H1
"Dickinson County, KS",2002-2003,19121,19238,117,0.612,-28,145,20,41,H1
"Dickinson County, KS",2003-2004,19238,19189,-49,-0.255,-26,-23,20,41,H1
"Dickinson County, KS",2004-2005,19189,19285,96,0.5,-28,124,20,41,H1
"Dickinson County, KS",2005-2006,19285,19429,144,0.747,7,137,20,41,H1
"Dickinson County, KS",2006-2007,19429,19454,25,0.129,13,12,20,41,H1
"Dickinson County, KS",2007-2008,19454,19862,408,2.097,23,385,20,41,H1
"Dickinson County, KS",2008-2009,19862,19730,-132,-0.665,4,-136,20,41,H1
"Dickinson County, KS",2009-2010,19730,19801,71,0.36,-18,89,20,41,H1
"Dickinson County, KS",2010-2011,19801,19731,-70,-0.354,23,-93,20,41,H1
"Dickinson County, KS",2011-2012,19731,19758,27,0.137,-54,81,20,41,H1
"Dickinson County, KS",2012-2013,19758,19521,-237,-1.2,-6,-231,20,41,H1
"Dickinson County, KS",2013-2014,19521,19394,-127,-0.651,3,-130,20,41,H1
"Dickinson County, KS",2014-2015,19360,19303,-57,-0.294,26,-83,20,41,H1
"Dickinson County, KS",2015-2016,19303,18981,-322,-1.668,-3,-319,20,41,H1
"Dickinson County, KS",2016-2017,18981,18902,-79,-0.416,23,-102,20,41,H1
"Doniphan County, KS",2000-2001,8240,8219,-21,-0.255,-9,-12,20,43,H1
"Doniphan County, KS",2001-2002,8219,8186,-33,-0.402,-4,-29,20,43,H1
"Doniphan County, KS",2002-2003,8186,8144,-42,-0.513,-5,-37,20,43,H1
"Doniphan County, KS",2003-2004,8144,8013,-131,-1.609,1,-132,20,43,H1
"Doniphan County, KS",2004-2005,8013,7868,-145,-1.81,-16,-129,20,43,H1
"Doniphan County, KS",2005-2006,7868,7936,68,0.864,0,68,20,43,H1
"Doniphan County, KS",2006-2007,7936,7988,52,0.655,5,47,20,43,H1
"Doniphan County, KS",2007-2008,7988,8003,15,0.188,22,-7,20,43,H1
"Doniphan County, KS",2008-2009,8003,7907,-96,-1.2,-3,-93,20,43,H1
"Doniphan County, KS",2009-2010,7907,7956,49,0.62,-8,57,20,43,H1
"Doniphan County, KS",2010-2011,7956,7955,-1,-0.013,25,-26,20,43,H1
"Doniphan County, KS",2011-2012,7955,7877,-78,-0.981,2,-80,20,43,H1
"Doniphan County, KS",2012-2013,7877,7859,-18,-0.229,13,-31,20,43,H1
"Doniphan County, KS",2013-2014,7859,7874,15,0.191,18,-3,20,43,H1
"Doniphan County, KS",2014-2015,7846,7797,-49,-0.625,6,-55,20,43,H1
"Doniphan County, KS",2015-2016,7797,7729,-68,-0.872,17,-85,20,43,H1
"Doniphan County, KS",2016-2017,7729,7727,-2,-0.026,31,-33,20,43,H1
"Douglas County, KS",2000-2001,100247,101269,1022,1.019,635,387,20,45,H1
"Douglas County, KS",2001-2002,101269,102552,1283,1.267,651,632,20,45,H1
"Douglas County, KS",2002-2003,102552,103570,1018,0.993,721,297,20,45,H1
"Douglas County, KS",2003-2004,103570,104826,1256,1.213,694,562,20,45,H1
"Douglas County, KS",2004-2005,104826,105681,855,0.816,656,199,20,45,H1
"Douglas County, KS",2005-2006,105681,107187,1506,1.425,665,841,20,45,H1
"Douglas County, KS",2006-2007,107187,107892,705,0.658,677,28,20,45,H1
"Douglas County, KS",2007-2008,107892,109010,1118,1.036,728,390,20,45,H1
"Douglas County, KS",2008-2009,109010,110039,1029,0.944,729,300,20,45,H1
"Douglas County, KS",2009-2010,110039,111296,1257,1.142,589,668,20,45,H1
"Douglas County, KS",2010-2011,111296,112491,1195,1.074,625,570,20,45,H1
"Douglas County, KS",2011-2012,112491,113339,848,0.754,672,176,20,45,H1
"Douglas County, KS",2012-2013,113339,114803,1464,1.292,588,876,20,45,H1
"Douglas County, KS",2013-2014,114803,116585,1782,1.552,664,1118,20,45,H1
"Douglas County, KS",2014-2015,116463,118053,1590,1.365,630,960,20,45,H1
"Douglas County, KS",2015-2016,118053,119492,1439,1.219,622,817,20,45,H1
"Douglas County, KS",2016-2017,119492,120793,1301,1.089,667,634,20,45,H1
"Edwards County, KS",2000-2001,3434,3376,-58,-1.689,3,-61,20,47,H1
"Edwards County, KS",2001-2002,3376,3309,-67,-1.985,-7,-60,20,47,H1
"Edwards County, KS",2002-2003,3309,3223,-86,-2.599,-13,-73,20,47,H1
"Edwards County, KS",2003-2004,3223,3231,8,0.248,-10,18,20,47,H1
"Edwards County, KS",2004-2005,3231,3194,-37,-1.145,-1,-36,20,47,H1
"Edwards County, KS",2005-2006,3194,3078,-116,-3.632,9,-125,20,47,H1
"Edwards County, KS",2006-2007,3078,3068,-10,-0.325,20,-30,20,47,H1
"Edwards County, KS",2007-2008,3068,3058,-10,-0.326,-1,-9,20,47,H1
"Edwards County, KS",2008-2009,3058,3008,-50,-1.635,2,-52,20,47,H1
"Edwards County, KS",2009-2010,3008,3049,41,1.363,-3,44,20,47,H1
"Edwards County, KS",2010-2011,3049,3021,-28,-0.918,8,-36,20,47,H1
"Edwards County, KS",2011-2012,3021,2974,-47,-1.556,-22,-25,20,47,H1
"Edwards County, KS",2012-2013,2974,2957,-17,-0.572,12,-29,20,47,H1
"Edwards County, KS",2013-2014,2957,3030,73,2.469,19,54,20,47,H1
"Edwards County, KS",2014-2015,3022,2968,-54,-1.787,16,-70,20,47,H1
"Edwards County, KS",2015-2016,2968,2900,-68,-2.291,-2,-66,20,47,H1
"Edwards County, KS",2016-2017,2900,2893,-7,-0.241,1,-8,20,47,H1
"Elk County, KS",2000-2001,3217,3147,-70,-2.176,-38,-32,20,49,H1
"Elk County, KS",2001-2002,3147,3148,1,0.032,-9,10,20,49,H1
"Elk County, KS",2002-2003,3148,3087,-61,-1.938,-34,-27,20,49,H1
"Elk County, KS",2003-2004,3087,3073,-14,-0.454,-14,0,20,49,H1
"Elk County, KS",2004-2005,3073,3041,-32,-1.041,-12,-20,20,49,H1
"Elk County, KS",2005-2006,3041,2971,-70,-2.302,-12,-58,20,49,H1
"Elk County, KS",2006-2007,2971,2939,-32,-1.077,-14,-18,20,49,H1
"Elk County, KS",2007-2008,2939,2954,15,0.51,-2,17,20,49,H1
"Elk County, KS",2008-2009,2954,2914,-40,-1.354,1,-41,20,49,H1
"Elk County, KS",2009-2010,2914,2868,-46,-1.579,-14,-32,20,49,H1
"Elk County, KS",2010-2011,2868,2790,-78,-2.72,-16,-62,20,49,H1
"Elk County, KS",2011-2012,2790,2669,-121,-4.337,-20,-101,20,49,H1
"Elk County, KS",2012-2013,2669,2650,-19,-0.712,-7,-12,20,49,H1
"Elk County, KS",2013-2014,2650,2694,44,1.66,-5,49,20,49,H1
"Elk County, KS",2014-2015,2693,2605,-88,-3.268,-4,-84,20,49,H1
"Elk County, KS",2015-2016,2605,2511,-94,-3.608,-8,-86,20,49,H1
"Elk County, KS",2016-2017,2511,2498,-13,-0.518,-19,6,20,49,H1
"Ellis County, KS",2000-2001,27454,27591,137,0.499,113,24,20,51,H1
"Ellis County, KS",2001-2002,27591,27532,-59,-0.214,82,-141,20,51,H1
"Ellis County, KS",2002-2003,27532,27507,-25,-0.091,134,-159,20,51,H1
"Ellis County, KS",2003-2004,27507,27457,-50,-0.182,95,-145,20,51,H1
"Ellis County, KS",2004-2005,27457,27429,-28,-0.102,83,-111,20,51,H1
"Ellis County, KS",2005-2006,27429,27653,224,0.817,121,103,20,51,H1
"Ellis County, KS",2006-2007,27653,27710,57,0.206,131,-74,20,51,H1
"Ellis County, KS",2007-2008,27710,28010,300,1.083,144,156,20,51,H1
"Ellis County, KS",2008-2009,28010,28353,343,1.225,137,206,20,51,H1
"Ellis County, KS",2009-2010,28353,28451,98,0.346,128,-30,20,51,H1
"Ellis County, KS",2010-2011,28451,28774,323,1.135,168,155,20,51,H1
"Ellis County, KS",2011-2012,28774,29090,316,1.098,168,148,20,51,H1
"Ellis County, KS",2012-2013,29090,29060,-30,-0.103,152,-182,20,51,H1
"Ellis County, KS",2013-2014,29060,29013,-47,-0.162,148,-195,20,51,H1
"Ellis County, KS",2014-2015,29006,29029,23,0.079,111,-88,20,51,H1
"Ellis County, KS",2015-2016,29029,28823,-206,-0.71,95,-301,20,51,H1
"Ellis County, KS",2016-2017,28823,28689,-134,-0.465,106,-240,20,51,H1
"Ellsworth County, KS",2000-2001,6536,6477,-59,-0.903,-51,-8,20,53,H1
"Ellsworth County, KS",2001-2002,6477,6419,-58,-0.895,-55,-3,20,53,H1
"Ellsworth County, KS",2002-2003,6419,6440,21,0.327,-31,52,20,53,H1
"Ellsworth County, KS",2003-2004,6440,6437,-3,-0.047,-23,20,20,53,H1
"Ellsworth County, KS",2004-2005,6437,6404,-33,-0.513,-54,21,20,53,H1
"Ellsworth County, KS",2005-2006,6404,6465,61,0.953,-25,86,20,53,H1
"Ellsworth County, KS",2006-2007,6465,6503,38,0.588,-19,57,20,53,H1
"Ellsworth County, KS",2007-2008,6503,6471,-32,-0.492,-8,-24,20,53,H1
"Ellsworth County, KS",2008-2009,6471,6432,-39,-0.603,-28,-11,20,53,H1
"Ellsworth County, KS",2009-2010,6432,6508,76,1.182,-36,112,20,53,H1
"Ellsworth County, KS",2010-2011,6508,6458,-50,-0.768,-32,-18,20,53,H1
"Ellsworth County, KS",2011-2012,6458,6465,7,0.108,-4,11,20,53,H1
"Ellsworth County, KS",2012-2013,6465,6390,-75,-1.16,3,-78,20,53,H1
"Ellsworth County, KS",2013-2014,6390,6392,2,0.031,-7,9,20,53,H1
"Ellsworth County, KS",2014-2015,6375,6343,-32,-0.502,-21,-11,20,53,H1
"Ellsworth County, KS",2015-2016,6343,6311,-32,-0.504,-9,-23,20,53,H1
"Ellsworth County, KS",2016-2017,6311,6330,19,0.301,-2,21,20,53,H1
"Finney County, KS",2000-2001,40508,39730,-778,-1.921,664,-1442,20,55,H1
"Finney County, KS",2001-2002,39730,38499,-1231,-3.098,584,-1815,20,55,H1
"Finney County, KS",2002-2003,38499,37701,-798,-2.073,590,-1388,20,55,H1
"Finney County, KS",2003-2004,37701,37462,-239,-0.634,600,-839,20,55,H1
"Finney County, KS",2004-2005,37462,36754,-708,-1.89,614,-1322,20,55,H1
"Finney County, KS",2005-2006,36754,36259,-495,-1.347,569,-1064,20,55,H1
"Finney County, KS",2006-2007,36259,35663,-596,-1.644,569,-1165,20,55,H1
"Finney County, KS",2007-2008,35663,35461,-202,-0.566,577,-779,20,55,H1
"Finney County, KS",2008-2009,35461,36300,839,2.366,623,216,20,55,H1
"Finney County, KS",2009-2010,36300,36939,639,1.76,743,-104,20,55,H1
"Finney County, KS",2010-2011,36939,37112,173,0.468,570,-397,20,55,H1
"Finney County, KS",2011-2012,37112,37130,18,0.049,461,-443,20,55,H1
"Finney County, KS",2012-2013,37130,37131,1,0.003,543,-542,20,55,H1
"Finney County, KS",2013-2014,37131,37184,53,0.143,506,-453,20,55,H1
"Finney County, KS",2014-2015,37147,37118,-29,-0.078,458,-487,20,55,H1
"Finney County, KS",2015-2016,37118,36998,-120,-0.323,476,-596,20,55,H1
"Finney County, KS",2016-2017,36998,37084,86,0.232,477,-391,20,55,H1
"Ford County, KS",2000-2001,32544,32182,-362,-1.112,343,-705,20,57,H1
"Ford County, KS",2001-2002,32182,31981,-201,-0.625,370,-571,20,57,H1
"Ford County, KS",2002-2003,31981,32285,304,0.951,402,-98,20,57,H1
"Ford County, KS",2003-2004,32285,32265,-20,-0.062,409,-429,20,57,H1
"Ford County, KS",2004-2005,32265,32354,89,0.276,403,-314,20,57,H1
"Ford County, KS",2005-2006,32354,32029,-325,-1.005,431,-756,20,57,H1
"Ford County, KS",2006-2007,32029,32168,139,0.434,418,-279,20,57,H1
"Ford County, KS",2007-2008,32168,32187,19,0.059,418,-399,20,57,H1
"Ford County, KS",2008-2009,32187,33158,971,3.017,385,586,20,57,H1
"Ford County, KS",2009-2010,33158,34062,904,2.726,449,455,20,57,H1
"Ford County, KS",2010-2011,34062,34441,379,1.113,414,-35,20,57,H1
"Ford County, KS",2011-2012,34441,34773,332,0.964,492,-160,20,57,H1
"Ford County, KS",2012-2013,34773,34950,177,0.509,459,-282,20,57,H1
"Ford County, KS",2013-2014,34950,34795,-155,-0.443,455,-610,20,57,H1
"Ford County, KS",2014-2015,34865,34536,-329,-0.944,452,-781,20,57,H1
"Ford County, KS",2015-2016,34536,34501,-35,-0.101,412,-447,20,57,H1
"Ford County, KS",2016-2017,34501,34381,-120,-0.348,396,-516,20,57,H1
"Franklin County, KS",2000-2001,24869,2.50E+04,131,0.527,89,42,20,59,H1
"Franklin County, KS",2001-2002,2.50E+04,25218,218,0.872,144,74,20,59,H1
"Franklin County, KS",2002-2003,25218,25312,94,0.373,140,-46,20,59,H1
"Franklin County, KS",2003-2004,25312,25525,213,0.841,122,91,20,59,H1
"Franklin County, KS",2004-2005,25525,25527,2,0.008,138,-136,20,59,H1
"Franklin County, KS",2005-2006,25527,25716,189,0.74,143,46,20,59,H1
"Franklin County, KS",2006-2007,25716,25734,18,0.07,154,-136,20,59,H1
"Franklin County, KS",2007-2008,25734,25851,117,0.455,141,-24,20,59,H1
"Franklin County, KS",2008-2009,25851,25870,19,0.073,185,-166,20,59,H1
"Franklin County, KS",2009-2010,25870,26006,136,0.526,126,10,20,59,H1
"Franklin County, KS",2010-2011,26006,25887,-119,-0.458,104,-223,20,59,H1
"Franklin County, KS",2011-2012,25887,25878,-9,-0.035,73,-82,20,59,H1
"Franklin County, KS",2012-2013,25878,25790,-88,-0.34,68,-156,20,59,H1
"Franklin County, KS",2013-2014,25790,25611,-179,-0.694,71,-250,20,59,H1
"Franklin County, KS",2014-2015,25614,25609,-5,-0.02,85,-90,20,59,H1
"Franklin County, KS",2015-2016,25609,25547,-62,-0.242,62,-124,20,59,H1
"Franklin County, KS",2016-2017,25547,25733,186,0.728,68,118,20,59,H1
"Geary County, KS",2000-2001,27845,27821,-24,-0.086,351,-375,20,61,H1
"Geary County, KS",2001-2002,27821,27679,-142,-0.51,383,-525,20,61,H1
"Geary County, KS",2002-2003,27679,27532,-147,-0.531,388,-535,20,61,H1
"Geary County, KS",2003-2004,27532,27149,-383,-1.391,340,-723,20,61,H1
"Geary County, KS",2004-2005,27149,27099,-50,-0.184,359,-409,20,61,H1
"Geary County, KS",2005-2006,27099,27708,609,2.247,343,266,20,61,H1
"Geary County, KS",2006-2007,27708,27951,243,0.877,538,-295,20,61,H1
"Geary County, KS",2007-2008,27951,30276,2325,8.318,539,1786,20,61,H1
"Geary County, KS",2008-2009,30276,31537,1261,4.165,487,774,20,61,H1
"Geary County, KS",2009-2010,31537,35263,3726,11.815,575,3151,20,61,H1
"Geary County, KS",2010-2011,35263,35324,61,0.173,850,-789,20,61,H1
"Geary County, KS",2011-2012,35324,38003,2679,7.584,760,1919,20,61,H1
"Geary County, KS",2012-2013,38003,36987,-1016,-2.673,843,-1859,20,61,H1
"Geary County, KS",2013-2014,36987,36713,-274,-0.741,770,-1044,20,61,H1
"Geary County, KS",2014-2015,36722,37030,308,0.839,815,-507,20,61,H1
"Geary County, KS",2015-2016,37030,35208,-1822,-4.92,862,-2684,20,61,H1
"Geary County, KS",2016-2017,35208,33855,-1353,-3.843,814,-2167,20,61,H1
"Gove County, KS",2000-2001,3087,3044,-43,-1.393,-7,-36,20,63,H1
"Gove County, KS",2001-2002,3044,3018,-26,-0.854,-7,-19,20,63,H1
"Gove County, KS",2002-2003,3018,2947,-71,-2.353,-14,-57,20,63,H1
"Gove County, KS",2003-2004,2947,2896,-51,-1.731,-18,-33,20,63,H1
"Gove County, KS",2004-2005,2896,2840,-56,-1.934,-5,-51,20,63,H1
"Gove County, KS",2005-2006,2840,2824,-16,-0.563,3,-19,20,63,H1
"Gove County, KS",2006-2007,2824,2757,-67,-2.373,-5,-62,20,63,H1
"Gove County, KS",2007-2008,2757,2646,-111,-4.026,-7,-104,20,63,H1
"Gove County, KS",2008-2009,2646,2689,43,1.625,-8,51,20,63,H1
"Gove County, KS",2009-2010,2689,2683,-6,-0.223,9,-15,20,63,H1
"Gove County, KS",2010-2011,2683,2689,6,0.224,-7,13,20,63,H1
"Gove County, KS",2011-2012,2689,2721,32,1.19,6,26,20,63,H1
"Gove County, KS",2012-2013,2721,2765,44,1.617,-2,46,20,63,H1
"Gove County, KS",2013-2014,2765,2727,-38,-1.374,-2,-36,20,63,H1
"Gove County, KS",2014-2015,2706,2640,-66,-2.439,-10,-56,20,63,H1
"Gove County, KS",2015-2016,2640,2630,-10,-0.379,1,-11,20,63,H1
"Gove County, KS",2016-2017,2630,2631,1,0.038,-3,4,20,63,H1
"Graham County, KS",2000-2001,2925,2896,-29,-0.991,-26,-3,20,65,H1
"Graham County, KS",2001-2002,2896,2886,-10,-0.345,-18,8,20,65,H1
"Graham County, KS",2002-2003,2886,2842,-44,-1.525,-15,-29,20,65,H1
"Graham County, KS",2003-2004,2842,2786,-56,-1.97,-5,-51,20,65,H1
"Graham County, KS",2004-2005,2786,2762,-24,-0.861,-23,-1,20,65,H1
"Graham County, KS",2005-2006,2762,2751,-11,-0.398,-16,5,20,65,H1
"Graham County, KS",2006-2007,2751,2707,-44,-1.599,-9,-35,20,65,H1
"Graham County, KS",2007-2008,2707,2669,-38,-1.404,-3,-35,20,65,H1
"Graham County, KS",2008-2009,2669,2592,-77,-2.885,-14,-63,20,65,H1
"Graham County, KS",2009-2010,2592,2609,17,0.656,-12,29,20,65,H1
"Graham County, KS",2010-2011,2609,2643,34,1.303,-7,41,20,65,H1
"Graham County, KS",2011-2012,2643,2592,-51,-1.93,-5,-46,20,65,H1
"Graham County, KS",2012-2013,2592,2598,6,0.231,-7,13,20,65,H1
"Graham County, KS",2013-2014,2598,2566,-32,-1.232,1,-33,20,65,H1
"Graham County, KS",2014-2015,2555,2591,36,1.409,-8,44,20,65,H1
"Graham County, KS",2015-2016,2591,2568,-23,-0.888,-14,-9,20,65,H1
"Graham County, KS",2016-2017,2568,2495,-73,-2.843,-16,-57,20,65,H1
"Grant County, KS",2000-2001,7880,7789,-91,-1.155,77,-168,20,67,H1
"Grant County, KS",2001-2002,7789,7901,112,1.438,107,5,20,67,H1
"Grant County, KS",2002-2003,7901,7770,-131,-1.658,99,-230,20,67,H1
"Grant County, KS",2003-2004,7770,7722,-48,-0.618,77,-125,20,67,H1
"Grant County, KS",2004-2005,7722,7687,-35,-0.453,80,-115,20,67,H1
"Grant County, KS",2005-2006,7687,7707,20,0.26,70,-50,20,67,H1
"Grant County, KS",2006-2007,7707,7756,49,0.636,78,-29,20,67,H1
"Grant County, KS",2007-2008,7756,7674,-82,-1.057,89,-171,20,67,H1
"Grant County, KS",2008-2009,7674,7731,57,0.743,85,-28,20,67,H1
"Grant County, KS",2009-2010,7731,7846,115,1.488,84,31,20,67,H1
"Grant County, KS",2010-2011,7846,7899,53,0.676,70,-17,20,67,H1
"Grant County, KS",2011-2012,7899,7852,-47,-0.595,70,-117,20,67,H1
"Grant County, KS",2012-2013,7852,7869,17,0.217,68,-51,20,67,H1
"Grant County, KS",2013-2014,7869,7816,-53,-0.674,85,-138,20,67,H1
"Grant County, KS",2014-2015,7792,7733,-59,-0.757,93,-152,20,67,H1
"Grant County, KS",2015-2016,7733,7685,-48,-0.621,85,-133,20,67,H1
"Grant County, KS",2016-2017,7685,7526,-159,-2.069,90,-249,20,67,H1
"Gray County, KS",2000-2001,5913,5921,8,0.135,58,-50,20,69,H1
"Gray County, KS",2001-2002,5921,5973,52,0.878,18,34,20,69,H1
"Gray County, KS",2002-2003,5973,5981,8,0.134,40,-32,20,69,H1
"Gray County, KS",2003-2004,5981,5951,-30,-0.502,50,-80,20,69,H1
"Gray County, KS",2004-2005,5951,5882,-69,-1.159,37,-106,20,69,H1
"Gray County, KS",2005-2006,5882,5838,-44,-0.748,39,-83,20,69,H1
"Gray County, KS",2006-2007,5838,5735,-103,-1.764,22,-125,20,69,H1
"Gray County, KS",2007-2008,5735,5821,86,1.5,62,24,20,69,H1
"Gray County, KS",2008-2009,5821,5920,99,1.701,34,65,20,69,H1
"Gray County, KS",2009-2010,5920,6026,106,1.791,39,67,20,69,H1
"Gray County, KS",2010-2011,6026,6106,80,1.328,36,44,20,69,H1
"Gray County, KS",2011-2012,6106,5994,-112,-1.834,49,-161,20,69,H1
"Gray County, KS",2012-2013,5994,6007,13,0.217,38,-25,20,69,H1
"Gray County, KS",2013-2014,6007,6082,75,1.249,44,31,20,69,H1
"Gray County, KS",2014-2015,6095,6133,38,0.623,67,-29,20,69,H1
"Gray County, KS",2015-2016,6133,5980,-153,-2.495,29,-182,20,69,H1
"Gray County, KS",2016-2017,5980,5958,-22,-0.368,29,-51,20,69,H1
"Greeley County, KS",2000-2001,1530,1524,-6,-0.392,6,-12,20,71,H1
"Greeley County, KS",2001-2002,1524,1422,-102,-6.693,1,-103,20,71,H1
"Greeley County, KS",2002-2003,1422,1377,-45,-3.165,-9,-36,20,71,H1
"Greeley County, KS",2003-2004,1377,1366,-11,-0.799,-14,3,20,71,H1
"Greeley County, KS",2004-2005,1366,1299,-67,-4.905,-3,-64,20,71,H1
"Greeley County, KS",2005-2006,1299,1262,-37,-2.848,0,-37,20,71,H1
"Greeley County, KS",2006-2007,1262,1275,13,1.03,3,10,20,71,H1
"Greeley County, KS",2007-2008,1275,1247,-28,-2.196,3,-31,20,71,H1
"Greeley County, KS",2008-2009,1247,1210,-37,-2.967,2,-39,20,71,H1
"Greeley County, KS",2009-2010,1210,1256,46,3.802,3,43,20,71,H1
"Greeley County, KS",2010-2011,1256,1250,-6,-0.478,5,-11,20,71,H1
"Greeley County, KS",2011-2012,1250,1266,16,1.28,-3,19,20,71,H1
"Greeley County, KS",2012-2013,1266,1286,20,1.58,4,16,20,71,H1
"Greeley County, KS",2013-2014,1286,1301,15,1.166,8,7,20,71,H1
"Greeley County, KS",2014-2015,1305,1330,25,1.916,16,9,20,71,H1
"Greeley County, KS",2015-2016,1330,1280,-50,-3.759,1,-51,20,71,H1
"Greeley County, KS",2016-2017,1280,1249,-31,-2.422,10,-41,20,71,H1
"Greenwood County, KS",2000-2001,7647,7653,6,0.078,-41,47,20,73,H1
"Greenwood County, KS",2001-2002,7653,7567,-86,-1.124,-54,-32,20,73,H1
"Greenwood County, KS",2002-2003,7567,7493,-74,-0.978,-25,-49,20,73,H1
"Greenwood County, KS",2003-2004,7493,7415,-78,-1.041,-53,-25,20,73,H1
"Greenwood County, KS",2004-2005,7415,7222,-193,-2.603,-54,-139,20,73,H1
"Greenwood County, KS",2005-2006,7222,6944,-278,-3.849,-32,-246,20,73,H1
"Greenwood County, KS",2006-2007,6944,6957,13,0.187,-40,53,20,73,H1
"Greenwood County, KS",2007-2008,6957,6817,-140,-2.012,-17,-123,20,73,H1
"Greenwood County, KS",2008-2009,6817,6724,-93,-1.364,-43,-50,20,73,H1
"Greenwood County, KS",2009-2010,6724,6683,-41,-0.61,-47,6,20,73,H1
"Greenwood County, KS",2010-2011,6683,6612,-71,-1.062,-42,-29,20,73,H1
"Greenwood County, KS",2011-2012,6612,6446,-166,-2.511,-37,-129,20,73,H1
"Greenwood County, KS",2012-2013,6446,6404,-42,-0.652,-13,-29,20,73,H1
"Greenwood County, KS",2013-2014,6404,6328,-76,-1.187,-19,-57,20,73,H1
"Greenwood County, KS",2014-2015,6311,6244,-67,-1.062,-16,-51,20,73,H1
"Greenwood County, KS",2015-2016,6244,6132,-112,-1.794,-19,-93,20,73,H1
"Greenwood County, KS",2016-2017,6132,6123,-9,-0.147,-11,2,20,73,H1
"Hamilton County, KS",2000-2001,2651,2675,24,0.905,8,16,20,75,H1
"Hamilton County, KS",2001-2002,2675,2676,1,0.037,20,-19,20,75,H1
"Hamilton County, KS",2002-2003,2676,2694,18,0.673,15,3,20,75,H1
"Hamilton County, KS",2003-2004,2694,2642,-52,-1.93,12,-64,20,75,H1
"Hamilton County, KS",2004-2005,2642,2590,-52,-1.968,10,-62,20,75,H1
"Hamilton County, KS",2005-2006,2590,2583,-7,-0.27,5,-12,20,75,H1
"Hamilton County, KS",2006-2007,2583,2633,50,1.936,16,34,20,75,H1
"Hamilton County, KS",2007-2008,2633,2638,5,0.19,15,-10,20,75,H1
"Hamilton County, KS",2008-2009,2638,2669,31,1.175,26,5,20,75,H1
"Hamilton County, KS",2009-2010,2669,2698,29,1.087,27,2,20,75,H1
"Hamilton County, KS",2010-2011,2698,2623,-75,-2.78,11,-86,20,75,H1
"Hamilton County, KS",2011-2012,2623,2631,8,0.305,19,-11,20,75,H1
"Hamilton County, KS",2012-2013,2631,2606,-25,-0.95,12,-37,20,75,H1
"Hamilton County, KS",2013-2014,2606,2603,-3,-0.115,22,-25,20,75,H1
"Hamilton County, KS",2014-2015,2593,2474,-119,-4.589,22,-141,20,75,H1
"Hamilton County, KS",2015-2016,2474,2629,155,6.265,11,144,20,75,H1
"Hamilton County, KS",2016-2017,2629,2640,11,0.418,21,-10,20,75,H1
"Harper County, KS",2000-2001,6511,6436,-75,-1.152,-39,-36,20,77,H1
"Harper County, KS",2001-2002,6436,6307,-129,-2.004,-41,-88,20,77,H1
"Harper County, KS",2002-2003,6307,6308,1,0.016,-36,37,20,77,H1
"Harper County, KS",2003-2004,6308,6261,-47,-0.745,-35,-12,20,77,H1
"Harper County, KS",2004-2005,6261,6166,-95,-1.517,-47,-48,20,77,H1
"Harper County, KS",2005-2006,6166,6049,-117,-1.898,-44,-73,20,77,H1
"Harper County, KS",2006-2007,6049,5998,-51,-0.843,-19,-32,20,77,H1
"Harper County, KS",2007-2008,5998,6063,65,1.084,-14,79,20,77,H1
"Harper County, KS",2008-2009,6063,6025,-38,-0.627,-16,-22,20,77,H1
"Harper County, KS",2009-2010,6025,6030,5,0.083,-22,27,20,77,H1
"Harper County, KS",2010-2011,6030,5948,-82,-1.36,-31,-51,20,77,H1
"Harper County, KS",2011-2012,5948,5874,-74,-1.244,-24,-50,20,77,H1
"Harper County, KS",2012-2013,5874,5859,-15,-0.255,-12,-3,20,77,H1
"Harper County, KS",2013-2014,5859,5818,-41,-0.7,-33,-8,20,77,H1
"Harper County, KS",2014-2015,5832,5817,-15,-0.257,3,-18,20,77,H1
"Harper County, KS",2015-2016,5817,5680,-137,-2.355,-15,-122,20,77,H1
"Harper County, KS",2016-2017,5680,5590,-90,-1.585,-21,-69,20,77,H1
"Harvey County, KS",2000-2001,32894,32961,67,0.204,103,-36,20,79,H1
"Harvey County, KS",2001-2002,32961,33254,293,0.889,93,200,20,79,H1
"Harvey County, KS",2002-2003,33254,33422,168,0.505,86,82,20,79,H1
"Harvey County, KS",2003-2004,33422,33549,127,0.38,26,101,20,79,H1
"Harvey County, KS",2004-2005,33549,33566,17,0.051,62,-45,20,79,H1
"Harvey County, KS",2005-2006,33566,33659,93,0.277,89,4,20,79,H1
"Harvey County, KS",2006-2007,33659,33823,164,0.487,89,75,20,79,H1
"Harvey County, KS",2007-2008,33823,33994,171,0.506,66,105,20,79,H1
"Harvey County, KS",2008-2009,33994,34547,553,1.627,81,472,20,79,H1
"Harvey County, KS",2009-2010,34547,34784,237,0.686,73,164,20,79,H1
"Harvey County, KS",2010-2011,34784,34748,-36,-0.103,62,-98,20,79,H1
"Harvey County, KS",2011-2012,34748,34831,83,0.239,42,41,20,79,H1
"Harvey County, KS",2012-2013,34831,34803,-28,-0.08,122,-150,20,79,H1
"Harvey County, KS",2013-2014,34803,34820,17,0.049,133,-116,20,79,H1
"Harvey County, KS",2014-2015,34797,35073,276,0.793,117,159,20,79,H1
"Harvey County, KS",2015-2016,35073,34774,-299,-0.853,61,-360,20,79,H1
"Harvey County, KS",2016-2017,34774,34544,-230,-0.661,63,-293,20,79,H1
"Haskell County, KS",2000-2001,4302,4246,-56,-1.302,27,-83,20,81,H1
"Haskell County, KS",2001-2002,4246,4194,-52,-1.225,39,-91,20,81,H1
"Haskell County, KS",2002-2003,4194,4214,20,0.477,45,-25,20,81,H1
"Haskell County, KS",2003-2004,4214,4238,24,0.57,41,-17,20,81,H1
"Haskell County, KS",2004-2005,4238,4250,12,0.283,56,-44,20,81,H1
"Haskell County, KS",2005-2006,4250,4182,-68,-1.6,26,-94,20,81,H1
"Haskell County, KS",2006-2007,4182,4184,2,0.048,37,-35,20,81,H1
"Haskell County, KS",2007-2008,4184,4153,-31,-0.741,39,-70,20,81,H1
"Haskell County, KS",2008-2009,4153,4188,35,0.843,52,-17,20,81,H1
"Haskell County, KS",2009-2010,4188,4290,102,2.436,47,55,20,81,H1
"Haskell County, KS",2010-2011,4290,4237,-53,-1.235,25,-78,20,81,H1
"Haskell County, KS",2011-2012,4237,4221,-16,-0.378,33,-49,20,81,H1
"Haskell County, KS",2012-2013,4221,4136,-85,-2.014,40,-125,20,81,H1
"Haskell County, KS",2013-2014,4136,4106,-30,-0.725,33,-63,20,81,H1
"Haskell County, KS",2014-2015,4073,4064,-9,-0.221,29,-38,20,81,H1
"Haskell County, KS",2015-2016,4064,4038,-26,-0.64,30,-56,20,81,H1
"Haskell County, KS",2016-2017,4038,4053,15,0.371,33,-18,20,81,H1
"Hodgeman County, KS",2000-2001,2072,2118,46,2.22,-12,58,20,83,H1
"Hodgeman County, KS",2001-2002,2118,2139,21,0.992,0,21,20,83,H1
"Hodgeman County, KS",2002-2003,2139,2122,-17,-0.795,-3,-14,20,83,H1
"Hodgeman County, KS",2003-2004,2122,2089,-33,-1.555,-1,-32,20,83,H1
"Hodgeman County, KS",2004-2005,2089,2038,-51,-2.441,-3,-48,20,83,H1
"Hodgeman County, KS",2005-2006,2038,2027,-11,-0.54,2,-13,20,83,H1
"Hodgeman County, KS",2006-2007,2027,1959,-68,-3.355,-14,-54,20,83,H1
"Hodgeman County, KS",2007-2008,1959,1949,-10,-0.51,5,-15,20,83,H1
"Hodgeman County, KS",2008-2009,1949,1929,-20,-1.026,11,-31,20,83,H1
"Hodgeman County, KS",2009-2010,1929,1908,-21,-1.089,8,-29,20,83,H1
"Hodgeman County, KS",2010-2011,1908,1979,71,3.721,-1,72,20,83,H1
"Hodgeman County, KS",2011-2012,1979,1953,-26,-1.314,4,-30,20,83,H1
"Hodgeman County, KS",2012-2013,1953,1951,-2,-0.102,19,-21,20,83,H1
"Hodgeman County, KS",2013-2014,1951,1916,-35,-1.794,6,-41,20,83,H1
"Hodgeman County, KS",2014-2015,1914,1893,-21,-1.097,-9,-12,20,83,H1
"Hodgeman County, KS",2015-2016,1893,1833,-60,-3.17,-9,-51,20,83,H1
"Hodgeman County, KS",2016-2017,1833,1842,9,0.491,-11,20,20,83,H1
"Jackson County, KS",2000-2001,12655,12672,17,0.134,34,-17,20,85,H1
"Jackson County, KS",2001-2002,12672,12826,154,1.215,15,139,20,85,H1
"Jackson County, KS",2002-2003,12826,12983,157,1.224,65,92,20,85,H1
"Jackson County, KS",2003-2004,12983,13069,86,0.662,80,6,20,85,H1
"Jackson County, KS",2004-2005,13069,13362,293,2.242,79,214,20,85,H1
"Jackson County, KS",2005-2006,13362,13356,-6,-0.045,19,-25,20,85,H1
"Jackson County, KS",2006-2007,13356,13348,-8,-0.06,52,-60,20,85,H1
"Jackson County, KS",2007-2008,13348,13235,-113,-0.847,61,-174,20,85,H1
"Jackson County, KS",2008-2009,13235,13369,134,1.012,76,58,20,85,H1
"Jackson County, KS",2009-2010,13369,13490,121,0.905,45,76,20,85,H1
"Jackson County, KS",2010-2011,13490,13468,-22,-0.163,43,-65,20,85,H1
"Jackson County, KS",2011-2012,13468,13448,-20,-0.149,43,-63,20,85,H1
"Jackson County, KS",2012-2013,13448,13373,-75,-0.558,23,-98,20,85,H1
"Jackson County, KS",2013-2014,13373,13539,166,1.241,43,123,20,85,H1
"Jackson County, KS",2014-2015,13464,13338,-126,-0.936,39,-165,20,85,H1
"Jackson County, KS",2015-2016,13338,13259,-79,-0.592,24,-103,20,85,H1
"Jackson County, KS",2016-2017,13259,13318,59,0.445,36,23,20,85,H1
"Jefferson County, KS",2000-2001,18553,18640,87,0.469,37,50,20,87,H1
"Jefferson County, KS",2001-2002,18640,18741,101,0.542,40,61,20,87,H1
"Jefferson County, KS",2002-2003,18741,18835,94,0.502,69,25,20,87,H1
"Jefferson County, KS",2003-2004,18835,19042,207,1.099,62,145,20,87,H1
"Jefferson County, KS",2004-2005,19042,19159,117,0.614,34,83,20,87,H1
"Jefferson County, KS",2005-2006,19159,19005,-154,-0.804,22,-176,20,87,H1
"Jefferson County, KS",2006-2007,19005,19049,44,0.232,41,3,20,87,H1
"Jefferson County, KS",2007-2008,19049,19072,23,0.121,36,-13,20,87,H1
"Jefferson County, KS",2008-2009,19072,19037,-35,-0.184,48,-83,20,87,H1
"Jefferson County, KS",2009-2010,19037,19121,84,0.441,13,71,20,87,H1
"Jefferson County, KS",2010-2011,19121,18960,-161,-0.842,4,-165,20,87,H1
"Jefferson County, KS",2011-2012,18960,18901,-59,-0.311,-10,-49,20,87,H1
"Jefferson County, KS",2012-2013,18901,18824,-77,-0.407,40,-117,20,87,H1
"Jefferson County, KS",2013-2014,18824,18855,31,0.165,66,-35,20,87,H1
"Jefferson County, KS",2014-2015,18854,18930,76,0.403,67,9,20,87,H1
"Jefferson County, KS",2015-2016,18930,18856,-74,-0.391,21,-95,20,87,H1
"Jefferson County, KS",2016-2017,18856,18998,142,0.753,38,104,20,87,H1
"Jewell County, KS",2000-2001,3747,3603,-144,-3.843,-52,-92,20,89,H1
"Jewell County, KS",2001-2002,3603,3491,-112,-3.109,-34,-78,20,89,H1
"Jewell County, KS",2002-2003,3491,3421,-70,-2.005,-26,-44,20,89,H1
"Jewell County, KS",2003-2004,3421,3349,-72,-2.105,-33,-39,20,89,H1
"Jewell County, KS",2004-2005,3349,3271,-78,-2.329,-24,-54,20,89,H1
"Jewell County, KS",2005-2006,3271,3264,-7,-0.214,-25,18,20,89,H1
"Jewell County, KS",2006-2007,3264,3200,-64,-1.961,-20,-44,20,89,H1
"Jewell County, KS",2007-2008,3200,3137,-63,-1.969,-8,-55,20,89,H1
"Jewell County, KS",2008-2009,3137,3077,-60,-1.913,-20,-40,20,89,H1
"Jewell County, KS",2009-2010,3077,3065,-12,-0.39,-25,13,20,89,H1
"Jewell County, KS",2010-2011,3065,3087,22,0.718,-19,41,20,89,H1
"Jewell County, KS",2011-2012,3087,3037,-50,-1.62,-20,-30,20,89,H1
"Jewell County, KS",2012-2013,3037,3067,30,0.988,-1,31,20,89,H1
"Jewell County, KS",2013-2014,3067,3043,-24,-0.783,-3,-21,20,89,H1
"Jewell County, KS",2014-2015,3030,2970,-60,-1.98,-7,-53,20,89,H1
"Jewell County, KS",2015-2016,2970,2888,-82,-2.761,6,-88,20,89,H1
"Jewell County, KS",2016-2017,2888,2850,-38,-1.316,-7,-31,20,89,H1
"Johnson County, KS",2000-2001,454539,463554,9015,1.983,4210,4805,20,91,H1
"Johnson County, KS",2001-2002,463554,475239,11685,2.521,4221,7464,20,91,H1
"Johnson County, KS",2002-2003,475239,485689,10450,2.199,4615,5835,20,91,H1
"Johnson County, KS",2003-2004,485689,495396,9707,1.999,4661,5046,20,91,H1
"Johnson County, KS",2004-2005,495396,504441,9045,1.826,4395,4650,20,91,H1
"Johnson County, KS",2005-2006,504441,514813,10372,2.056,4391,5981,20,91,H1
"Johnson County, KS",2006-2007,514813,523879,9066,1.761,4705,4361,20,91,H1
"Johnson County, KS",2007-2008,523879,532175,8296,1.584,4767,3529,20,91,H1
"Johnson County, KS",2008-2009,532175,539396,7221,1.357,4770,2451,20,91,H1
"Johnson County, KS",2009-2010,539396,545666,6270,1.162,4656,1614,20,91,H1
"Johnson County, KS",2010-2011,545666,552906,7240,1.327,3995,3245,20,91,H1
"Johnson County, KS",2011-2012,552906,559954,7048,1.275,3791,3257,20,91,H1
"Johnson County, KS",2012-2013,559954,567326,7372,1.317,3962,3410,20,91,H1
"Johnson County, KS",2013-2014,567326,574272,6946,1.224,3831,3115,20,91,H1
"Johnson County, KS",2014-2015,573964,580159,6195,1.079,3694,2501,20,91,H1
"Johnson County, KS",2015-2016,580159,584716,4557,0.785,3604,953,20,91,H1
"Johnson County, KS",2016-2017,584716,591178,6462,1.105,3565,2897,20,91,H1
"Kearny County, KS",2000-2001,4497,4489,-8,-0.178,45,-53,20,93,H1
"Kearny County, KS",2001-2002,4489,4371,-118,-2.629,37,-155,20,93,H1
"Kearny County, KS",2002-2003,4371,4249,-122,-2.791,19,-141,20,93,H1
"Kearny County, KS",2003-2004,4249,4231,-18,-0.424,32,-50,20,93,H1
"Kearny County, KS",2004-2005,4231,4147,-84,-1.985,47,-131,20,93,H1
"Kearny County, KS",2005-2006,4147,4052,-95,-2.291,24,-119,20,93,H1
"Kearny County, KS",2006-2007,4052,3928,-124,-3.06,27,-151,20,93,H1
"Kearny County, KS",2007-2008,3928,3909,-19,-0.484,19,-38,20,93,H1
"Kearny County, KS",2008-2009,3909,3941,32,0.819,19,13,20,93,H1
"Kearny County, KS",2009-2010,3941,3992,51,1.294,26,25,20,93,H1
"Kearny County, KS",2010-2011,3992,3963,-29,-0.726,10,-39,20,93,H1
"Kearny County, KS",2011-2012,3963,3976,13,0.328,39,-26,20,93,H1
"Kearny County, KS",2012-2013,3976,3904,-72,-1.811,6,-78,20,93,H1
"Kearny County, KS",2013-2014,3904,3915,11,0.282,27,-16,20,93,H1
"Kearny County, KS",2014-2015,3941,3956,15,0.381,41,-26,20,93,H1
"Kearny County, KS",2015-2016,3956,3900,-56,-1.416,35,-91,20,93,H1
"Kearny County, KS",2016-2017,3900,3960,60,1.538,41,19,20,93,H1
"Kingman County, KS",2000-2001,8685,8597,-88,-1.013,-3,-85,20,95,H1
"Kingman County, KS",2001-2002,8597,8472,-125,-1.454,-40,-85,20,95,H1
"Kingman County, KS",2002-2003,8472,8544,72,0.85,-25,97,20,95,H1
"Kingman County, KS",2003-2004,8544,8439,-105,-1.229,-33,-72,20,95,H1
"Kingman County, KS",2004-2005,8439,8249,-190,-2.251,-44,-146,20,95,H1
"Kingman County, KS",2005-2006,8249,8119,-130,-1.576,-21,-109,20,95,H1
"Kingman County, KS",2006-2007,8119,8011,-108,-1.33,-17,-91,20,95,H1
"Kingman County, KS",2007-2008,8011,7892,-119,-1.485,-24,-95,20,95,H1
"Kingman County, KS",2008-2009,7892,7885,-7,-0.089,-23,16,20,95,H1
"Kingman County, KS",2009-2010,7885,7842,-43,-0.545,-27,-16,20,95,H1
"Kingman County, KS",2010-2011,7842,7895,53,0.676,-1,54,20,95,H1
"Kingman County, KS",2011-2012,7895,7828,-67,-0.849,-28,-39,20,95,H1
"Kingman County, KS",2012-2013,7828,7837,9,0.115,-26,35,20,95,H1
"Kingman County, KS",2013-2014,7837,7698,-139,-1.774,-18,-121,20,95,H1
"Kingman County, KS",2014-2015,7708,7687,-21,-0.272,-12,-9,20,95,H1
"Kingman County, KS",2015-2016,7687,7414,-273,-3.551,-32,-241,20,95,H1
"Kingman County, KS",2016-2017,7414,7360,-54,-0.728,-16,-38,20,95,H1
"Kiowa County, KS",2000-2001,3264,3160,-104,-3.186,-9,-95,20,97,H1
"Kiowa County, KS",2001-2002,3160,3150,-10,-0.316,1,-11,20,97,H1
"Kiowa County, KS",2002-2003,3150,3175,25,0.794,7,18,20,97,H1
"Kiowa County, KS",2003-2004,3175,3130,-45,-1.417,4,-49,20,97,H1
"Kiowa County, KS",2004-2005,3130,3088,-42,-1.342,4,-46,20,97,H1
"Kiowa County, KS",2005-2006,3088,3039,-49,-1.587,0,-49,20,97,H1
"Kiowa County, KS",2006-2007,3039,2837,-202,-6.647,0,-202,20,97,H1
"Kiowa County, KS",2007-2008,2837,2418,-419,-14.769,2,-421,20,97,H1
"Kiowa County, KS",2008-2009,2418,2490,72,2.978,15,57,20,97,H1
"Kiowa County, KS",2009-2010,2490,2560,70,2.811,12,58,20,97,H1
"Kiowa County, KS",2010-2011,2560,2553,-7,-0.273,12,-19,20,97,H1
"Kiowa County, KS",2011-2012,2553,2499,-54,-2.115,1,-55,20,97,H1
"Kiowa County, KS",2012-2013,2499,2518,19,0.76,13,6,20,97,H1
"Kiowa County, KS",2013-2014,2518,2513,-5,-0.199,9,-14,20,97,H1
"Kiowa County, KS",2014-2015,2530,2564,34,1.344,11,23,20,97,H1
"Kiowa County, KS",2015-2016,2564,2504,-60,-2.34,16,-76,20,97,H1
"Kiowa County, KS",2016-2017,2504,2485,-19,-0.759,6,-25,20,97,H1
"Labette County, KS",2000-2001,22733,22436,-297,-1.306,-16,-281,20,99,H1
"Labette County, KS",2001-2002,22436,22214,-222,-0.989,-41,-181,20,99,H1
"Labette County, KS",2002-2003,22214,22100,-114,-0.513,-19,-95,20,99,H1
"Labette County, KS",2003-2004,22100,21911,-189,-0.855,-58,-131,20,99,H1
"Labette County, KS",2004-2005,21911,21913,2,0.009,-27,29,20,99,H1
"Labette County, KS",2005-2006,21913,21929,16,0.073,2,14,20,99,H1
"Labette County, KS",2006-2007,21929,21928,-1,-0.005,33,-34,20,99,H1
"Labette County, KS",2007-2008,21928,21786,-142,-0.648,40,-182,20,99,H1
"Labette County, KS",2008-2009,21786,21759,-27,-0.124,20,-47,20,99,H1
"Labette County, KS",2009-2010,21759,21546,-213,-0.979,16,-229,20,99,H1
"Labette County, KS",2010-2011,21546,21432,-114,-0.529,-28,-86,20,99,H1
"Labette County, KS",2011-2012,21432,21219,-213,-0.994,2,-215,20,99,H1
"Labette County, KS",2012-2013,21219,20969,-250,-1.178,57,-307,20,99,H1
"Labette County, KS",2013-2014,20969,20960,-9,-0.043,59,-68,20,99,H1
"Labette County, KS",2014-2015,20876,20803,-73,-0.35,49,-122,20,99,H1
"Labette County, KS",2015-2016,20803,20330,-473,-2.274,4,-477,20,99,H1
"Labette County, KS",2016-2017,20330,20145,-185,-0.91,18,-203,20,99,H1
"Lane County, KS",2000-2001,2145,2104,-41,-1.911,-4,-37,20,101,H1
"Lane County, KS",2001-2002,2104,1981,-123,-5.846,-20,-103,20,101,H1
"Lane County, KS",2002-2003,1981,1956,-25,-1.262,-10,-15,20,101,H1
"Lane County, KS",2003-2004,1956,1916,-40,-2.045,-15,-25,20,101,H1
"Lane County, KS",2004-2005,1916,1848,-68,-3.549,-17,-51,20,101,H1
"Lane County, KS",2005-2006,1848,1780,-68,-3.68,3,-71,20,101,H1
"Lane County, KS",2006-2007,1780,1763,-17,-0.955,-7,-10,20,101,H1
"Lane County, KS",2007-2008,1763,1756,-7,-0.397,-7,0,20,101,H1
"Lane County, KS",2008-2009,1756,1779,23,1.31,-2,25,20,101,H1
"Lane County, KS",2009-2010,1779,1736,-43,-2.417,-3,-40,20,101,H1
"Lane County, KS",2010-2011,1736,1762,26,1.498,-6,32,20,101,H1
"Lane County, KS",2011-2012,1762,1700,-62,-3.519,-5,-57,20,101,H1
"Lane County, KS",2012-2013,1700,1720,20,1.176,3,17,20,101,H1
"Lane County, KS",2013-2014,1720,1687,-33,-1.919,8,-41,20,101,H1
"Lane County, KS",2014-2015,1687,1670,-17,-1.008,6,-23,20,101,H1
"Lane County, KS",2015-2016,1670,1600,-70,-4.192,-11,-59,20,101,H1
"Lane County, KS",2016-2017,1600,1559,-41,-2.562,-4,-37,20,101,H1
"Leavenworth County, KS",2000-2001,68957,69906,949,1.376,411,538,20,103,H1
"Leavenworth County, KS",2001-2002,69906,70793,887,1.269,393,494,20,103,H1
"Leavenworth County, KS",2002-2003,70793,70939,146,0.206,435,-289,20,103,H1
"Leavenworth County, KS",2003-2004,70939,71373,434,0.612,376,58,20,103,H1
"Leavenworth County, KS",2004-2005,71373,71788,415,0.581,328,87,20,103,H1
"Leavenworth County, KS",2005-2006,71788,72741,953,1.328,386,567,20,103,H1
"Leavenworth County, KS",2006-2007,72741,73791,1050,1.443,463,587,20,103,H1
"Leavenworth County, KS",2007-2008,73791,74560,769,1.042,435,334,20,103,H1
"Leavenworth County, KS",2008-2009,74560,75461,901,1.208,433,468,20,103,H1
"Leavenworth County, KS",2009-2010,75461,76555,1094,1.45,354,740,20,103,H1
"Leavenworth County, KS",2010-2011,76555,77118,563,0.735,359,204,20,103,H1
"Leavenworth County, KS",2011-2012,77118,77729,611,0.792,438,173,20,103,H1
"Leavenworth County, KS",2012-2013,77729,78234,505,0.65,432,73,20,103,H1
"Leavenworth County, KS",2013-2014,78234,78797,563,0.72,423,140,20,103,H1
"Leavenworth County, KS",2014-2015,78784,79315,531,0.674,411,120,20,103,H1
"Leavenworth County, KS",2015-2016,79315,80115,800,1.009,434,366,20,103,H1
"Leavenworth County, KS",2016-2017,80115,81095,980,1.223,424,556,20,103,H1
"Lincoln County, KS",2000-2001,3576,3560,-16,-0.447,-27,11,20,105,H1
"Lincoln County, KS",2001-2002,3560,3513,-47,-1.32,-27,-20,20,105,H1
"Lincoln County, KS",2002-2003,3513,3536,23,0.655,-19,42,20,105,H1
"Lincoln County, KS",2003-2004,3536,3414,-122,-3.45,-27,-95,20,105,H1
"Lincoln County, KS",2004-2005,3414,3443,29,0.849,-7,36,20,105,H1
"Lincoln County, KS",2005-2006,3443,3360,-83,-2.411,-14,-69,20,105,H1
"Lincoln County, KS",2006-2007,3360,3365,5,0.149,-5,10,20,105,H1
"Lincoln County, KS",2007-2008,3365,3333,-32,-0.951,-10,-22,20,105,H1
"Lincoln County, KS",2008-2009,3333,3249,-84,-2.52,-15,-69,20,105,H1
"Lincoln County, KS",2009-2010,3249,3232,-17,-0.523,-19,2,20,105,H1
"Lincoln County, KS",2010-2011,3232,3206,-26,-0.804,-11,-15,20,105,H1
"Lincoln County, KS",2011-2012,3206,3159,-47,-1.466,-5,-42,20,105,H1
"Lincoln County, KS",2012-2013,3159,3138,-21,-0.665,-3,-18,20,105,H1
"Lincoln County, KS",2013-2014,3138,3167,29,0.924,0,29,20,105,H1
"Lincoln County, KS",2014-2015,3153,3105,-48,-1.522,-6,-42,20,105,H1
"Lincoln County, KS",2015-2016,3105,3077,-28,-0.902,-13,-15,20,105,H1
"Lincoln County, KS",2016-2017,3077,3043,-34,-1.105,-9,-25,20,105,H1
"Linn County, KS",2000-2001,9580,9734,154,1.608,-2,156,20,107,H1
"Linn County, KS",2001-2002,9734,9724,-10,-0.103,5,-15,20,107,H1
"Linn County, KS",2002-2003,9724,9775,51,0.524,-1,52,20,107,H1
"Linn County, KS",2003-2004,9775,9830,55,0.563,21,34,20,107,H1
"Linn County, KS",2004-2005,9830,10032,202,2.055,20,182,20,107,H1
"Linn County, KS",2005-2006,10032,10013,-19,-0.189,-6,-13,20,107,H1
"Linn County, KS",2006-2007,10013,9858,-155,-1.548,15,-170,20,107,H1
"Linn County, KS",2007-2008,9858,9731,-127,-1.288,25,-152,20,107,H1
"Linn County, KS",2008-2009,9731,9669,-62,-0.637,24,-86,20,107,H1
"Linn County, KS",2009-2010,9669,9637,-32,-0.331,2,-34,20,107,H1
"Linn County, KS",2010-2011,9637,9605,-32,-0.332,-13,-19,20,107,H1
"Linn County, KS",2011-2012,9605,9481,-124,-1.291,-14,-110,20,107,H1
"Linn County, KS",2012-2013,9481,9531,50,0.527,-20,70,20,107,H1
"Linn County, KS",2013-2014,9531,9502,-29,-0.304,-19,-10,20,107,H1
"Linn County, KS",2014-2015,9496,9536,40,0.421,-23,63,20,107,H1
"Linn County, KS",2015-2016,9536,9626,90,0.944,16,74,20,107,H1
"Linn County, KS",2016-2017,9626,9726,100,1.039,-10,110,20,107,H1
"Logan County, KS",2000-2001,3059,2992,-67,-2.19,-14,-53,20,109,H1
"Logan County, KS",2001-2002,2992,2984,-8,-0.267,-6,-2,20,109,H1
"Logan County, KS",2002-2003,2984,2925,-59,-1.977,-4,-55,20,109,H1
"Logan County, KS",2003-2004,2925,2905,-20,-0.684,0,-20,20,109,H1
"Logan County, KS",2004-2005,2905,2881,-24,-0.826,-4,-20,20,109,H1
"Logan County, KS",2005-2006,2881,2808,-73,-2.534,-7,-66,20,109,H1
"Logan County, KS",2006-2007,2808,2798,-10,-0.356,-9,-1,20,109,H1
"Logan County, KS",2007-2008,2798,2779,-19,-0.679,-2,-17,20,109,H1
"Logan County, KS",2008-2009,2779,2729,-50,-1.799,2,-52,20,109,H1
"Logan County, KS",2009-2010,2729,2771,42,1.539,2,40,20,109,H1
"Logan County, KS",2010-2011,2771,2764,-7,-0.253,-8,1,20,109,H1
"Logan County, KS",2011-2012,2764,2795,31,1.122,-1,32,20,109,H1
"Logan County, KS",2012-2013,2795,2789,-6,-0.215,10,-16,20,109,H1
"Logan County, KS",2013-2014,2789,2794,5,0.179,14,-9,20,109,H1
"Logan County, KS",2014-2015,2793,2825,32,1.146,16,16,20,109,H1
"Logan County, KS",2015-2016,2825,2812,-13,-0.46,24,-37,20,109,H1
"Logan County, KS",2016-2017,2812,2821,9,0.32,25,-16,20,109,H1
"Lyon County, KS",2000-2001,35967,36049,82,0.228,251,-169,20,111,H1
"Lyon County, KS",2001-2002,36049,35826,-223,-0.619,221,-444,20,111,H1
"Lyon County, KS",2002-2003,35826,35868,42,0.117,258,-216,20,111,H1
"Lyon County, KS",2003-2004,35868,36034,166,0.463,240,-74,20,111,H1
"Lyon County, KS",2004-2005,36034,35936,-98,-0.272,247,-345,20,111,H1
"Lyon County, KS",2005-2006,35936,35832,-104,-0.289,258,-362,20,111,H1
"Lyon County, KS",2006-2007,35832,36018,186,0.519,207,-21,20,111,H1
"Lyon County, KS",2007-2008,36018,35591,-427,-1.186,260,-687,20,111,H1
"Lyon County, KS",2008-2009,35591,33777,-1814,-5.097,244,-2058,20,111,H1
"Lyon County, KS",2009-2010,33777,33632,-145,-0.429,230,-375,20,111,H1
"Lyon County, KS",2010-2011,33632,33653,21,0.062,107,-86,20,111,H1
"Lyon County, KS",2011-2012,33653,33529,-124,-0.368,147,-271,20,111,H1
"Lyon County, KS",2012-2013,33529,33522,-7,-0.021,169,-176,20,111,H1
"Lyon County, KS",2013-2014,33522,33212,-310,-0.925,153,-463,20,111,H1
"Lyon County, KS",2014-2015,33243,33339,96,0.289,157,-61,20,111,H1
"Lyon County, KS",2015-2016,33339,33400,61,0.183,145,-84,20,111,H1
"Lyon County, KS",2016-2017,33400,33392,-8,-0.024,165,-173,20,111,H1
"McPherson County, KS",2000-2001,29572,29489,-83,-0.281,2,-85,20,113,H1
"McPherson County, KS",2001-2002,29489,29237,-252,-0.855,-30,-222,20,113,H1
"McPherson County, KS",2002-2003,29237,29239,2,0.007,-3,5,20,113,H1
"McPherson County, KS",2003-2004,29239,29276,37,0.127,2,35,20,113,H1
"McPherson County, KS",2004-2005,29276,29375,99,0.338,33,66,20,113,H1
"McPherson County, KS",2005-2006,29375,29174,-201,-0.684,-19,-182,20,113,H1
"McPherson County, KS",2006-2007,29174,29250,76,0.261,-29,105,20,113,H1
"McPherson County, KS",2007-2008,29250,29095,-155,-0.53,-12,-143,20,113,H1
"McPherson County, KS",2008-2009,29095,29222,127,0.437,11,116,20,113,H1
"McPherson County, KS",2009-2010,29222,29141,-81,-0.277,-10,-71,20,113,H1
"McPherson County, KS",2010-2011,29141,29213,72,0.247,-26,98,20,113,H1
"McPherson County, KS",2011-2012,29213,29341,128,0.438,-24,152,20,113,H1
"McPherson County, KS",2012-2013,29341,29606,265,0.903,18,247,20,113,H1
"McPherson County, KS",2013-2014,29606,29241,-365,-1.233,13,-378,20,113,H1
"McPherson County, KS",2014-2015,29161,28941,-220,-0.754,-54,-166,20,113,H1
"McPherson County, KS",2015-2016,28941,28402,-539,-1.862,-50,-489,20,113,H1
"McPherson County, KS",2016-2017,28402,28708,306,1.077,-20,326,20,113,H1
"Marion County, KS",2000-2001,13394,13377,-17,-0.127,-50,33,20,115,H1
"Marion County, KS",2001-2002,13377,13289,-88,-0.658,-50,-38,20,115,H1
"Marion County, KS",2002-2003,13289,13240,-49,-0.369,-49,0,20,115,H1
"Marion County, KS",2003-2004,13240,13066,-174,-1.314,-40,-134,20,115,H1
"Marion County, KS",2004-2005,13066,13012,-54,-0.413,-61,7,20,115,H1
"Marion County, KS",2005-2006,13012,12804,-208,-1.599,-44,-164,20,115,H1
"Marion County, KS",2006-2007,12804,12707,-97,-0.758,-60,-37,20,115,H1
"Marion County, KS",2007-2008,12707,12639,-68,-0.535,-66,-2,20,115,H1
"Marion County, KS",2008-2009,12639,12654,15,0.119,-54,69,20,115,H1
"Marion County, KS",2009-2010,12654,12663,9,0.071,-53,62,20,115,H1
"Marion County, KS",2010-2011,12663,12540,-123,-0.971,-53,-70,20,115,H1
"Marion County, KS",2011-2012,12540,12372,-168,-1.34,-66,-102,20,115,H1
"Marion County, KS",2012-2013,12372,12224,-148,-1.196,-28,-120,20,115,H1
"Marion County, KS",2013-2014,12224,12208,-16,-0.131,-27,11,20,115,H1
"Marion County, KS",2014-2015,12208,12103,-105,-0.86,-28,-77,20,115,H1
"Marion County, KS",2015-2016,12103,12022,-81,-0.669,-43,-38,20,115,H1
"Marion County, KS",2016-2017,12022,11986,-36,-0.299,-36,0,20,115,H1
"Marshall County, KS",2000-2001,10933,10791,-142,-1.299,-49,-93,20,117,H1
"Marshall County, KS",2001-2002,10791,10585,-206,-1.909,-11,-195,20,117,H1
"Marshall County, KS",2002-2003,10585,10451,-134,-1.266,-40,-94,20,117,H1
"Marshall County, KS",2003-2004,10451,10312,-139,-1.33,-5,-134,20,117,H1
"Marshall County, KS",2004-2005,10312,10270,-42,-0.407,-37,-5,20,117,H1
"Marshall County, KS",2005-2006,10270,10171,-99,-0.964,-26,-73,20,117,H1
"Marshall County, KS",2006-2007,10171,10150,-21,-0.206,-8,-13,20,117,H1
"Marshall County, KS",2007-2008,10150,10174,24,0.236,-2,26,20,117,H1
"Marshall County, KS",2008-2009,10174,10121,-53,-0.521,-2,-51,20,117,H1
"Marshall County, KS",2009-2010,10121,10105,-16,-0.158,-3,-13,20,117,H1
"Marshall County, KS",2010-2011,10105,10003,-102,-1.009,-29,-73,20,117,H1
"Marshall County, KS",2011-2012,10003,10066,63,0.63,5,58,20,117,H1
"Marshall County, KS",2012-2013,10066,10028,-38,-0.378,-4,-34,20,117,H1
"Marshall County, KS",2013-2014,10028,10006,-22,-0.219,12,-34,20,117,H1
"Marshall County, KS",2014-2015,9998,9936,-62,-0.62,16,-78,20,117,H1
"Marshall County, KS",2015-2016,9936,9801,-135,-1.359,35,-170,20,117,H1
"Marshall County, KS",2016-2017,9801,9745,-56,-0.571,17,-73,20,117,H1
"Meade County, KS",2000-2001,4621,4669,48,1.039,45,3,20,119,H1
"Meade County, KS",2001-2002,4669,4663,-6,-0.129,14,-20,20,119,H1
"Meade County, KS",2002-2003,4663,4595,-68,-1.458,4,-72,20,119,H1
"Meade County, KS",2003-2004,4595,4570,-25,-0.544,9,-34,20,119,H1
"Meade County, KS",2004-2005,4570,4586,16,0.35,17,-1,20,119,H1
"Meade County, KS",2005-2006,4586,4531,-55,-1.199,1,-56,20,119,H1
"Meade County, KS",2006-2007,4531,4490,-41,-0.905,9,-50,20,119,H1
"Meade County, KS",2007-2008,4490,4497,7,0.156,15,-8,20,119,H1
"Meade County, KS",2008-2009,4497,4502,5,0.111,19,-14,20,119,H1
"Meade County, KS",2009-2010,4502,4604,102,2.266,14,88,20,119,H1
"Meade County, KS",2010-2011,4604,4539,-65,-1.412,4,-69,20,119,H1
"Meade County, KS",2011-2012,4539,4415,-124,-2.732,7,-131,20,119,H1
"Meade County, KS",2012-2013,4415,4304,-111,-2.514,15,-126,20,119,H1
"Meade County, KS",2013-2014,4304,4357,53,1.231,7,46,20,119,H1
"Meade County, KS",2014-2015,4367,4330,-37,-0.847,41,-78,20,119,H1
"Meade County, KS",2015-2016,4330,4251,-79,-1.824,30,-109,20,119,H1
"Meade County, KS",2016-2017,4251,4303,52,1.223,34,18,20,119,H1
"Miami County, KS",2000-2001,28536,28770,234,0.82,133,101,20,121,H1
"Miami County, KS",2001-2002,28770,29072,302,1.05,85,217,20,121,H1
"Miami County, KS",2002-2003,29072,29437,365,1.256,161,204,20,121,H1
"Miami County, KS",2003-2004,29437,30158,721,2.449,200,521,20,121,H1
"Miami County, KS",2004-2005,30158,30758,600,1.99,150,450,20,121,H1
"Miami County, KS",2005-2006,30758,31180,422,1.372,144,278,20,121,H1
"Miami County, KS",2006-2007,31180,31962,782,2.508,189,593,20,121,H1
"Miami County, KS",2007-2008,31962,32131,169,0.529,176,-7,20,121,H1
"Miami County, KS",2008-2009,32131,32445,314,0.977,237,77,20,121,H1
"Miami County, KS",2009-2010,32445,32862,417,1.285,146,271,20,121,H1
"Miami County, KS",2010-2011,32862,32696,-166,-0.505,65,-231,20,121,H1
"Miami County, KS",2011-2012,32696,32605,-91,-0.278,148,-239,20,121,H1
"Miami County, KS",2012-2013,32605,32839,234,0.718,119,115,20,121,H1
"Miami County, KS",2013-2014,32839,32822,-17,-0.052,96,-113,20,121,H1
"Miami County, KS",2014-2015,32740,32553,-187,-0.571,22,-209,20,121,H1
"Miami County, KS",2015-2016,32553,32963,410,1.259,95,315,20,121,H1
"Miami County, KS",2016-2017,32963,33461,498,1.511,71,427,20,121,H1
"Mitchell County, KS",2000-2001,6911,6772,-139,-2.011,-41,-98,20,123,H1
"Mitchell County, KS",2001-2002,6772,6706,-66,-0.975,-13,-53,20,123,H1
"Mitchell County, KS",2002-2003,6706,6688,-18,-0.268,-34,16,20,123,H1
"Mitchell County, KS",2003-2004,6688,6539,-149,-2.228,-45,-104,20,123,H1
"Mitchell County, KS",2004-2005,6539,6443,-96,-1.468,-25,-71,20,123,H1
"Mitchell County, KS",2005-2006,6443,6382,-61,-0.947,-59,-2,20,123,H1
"Mitchell County, KS",2006-2007,6382,6389,7,0.11,-10,17,20,123,H1
"Mitchell County, KS",2007-2008,6389,6370,-19,-0.297,-29,10,20,123,H1
"Mitchell County, KS",2008-2009,6370,6420,50,0.785,-12,62,20,123,H1
"Mitchell County, KS",2009-2010,6420,6355,-65,-1.012,-5,-60,20,123,H1
"Mitchell County, KS",2010-2011,6355,6304,-51,-0.803,-10,-41,20,123,H1
"Mitchell County, KS",2011-2012,6304,6342,38,0.603,-23,61,20,123,H1
"Mitchell County, KS",2012-2013,6342,6336,-6,-0.095,-14,8,20,123,H1
"Mitchell County, KS",2013-2014,6336,6284,-52,-0.821,-26,-26,20,123,H1
"Mitchell County, KS",2014-2015,6255,6282,27,0.432,-27,54,20,123,H1
"Mitchell County, KS",2015-2016,6282,6186,-96,-1.528,-25,-71,20,123,H1
"Mitchell County, KS",2016-2017,6186,6128,-58,-0.938,-23,-35,20,123,H1
"Montgomery County, KS",2000-2001,36242,35935,-307,-0.847,-8,-299,20,125,H1
"Montgomery County, KS",2001-2002,35935,35490,-445,-1.238,-14,-431,20,125,H1
"Montgomery County, KS",2002-2003,35490,35152,-338,-0.952,-23,-315,20,125,H1
"Montgomery County, KS",2003-2004,35152,35150,-2,-0.006,-46,44,20,125,H1
"Montgomery County, KS",2004-2005,35150,35034,-116,-0.33,-3,-113,20,125,H1
"Montgomery County, KS",2005-2006,35034,35246,212,0.605,-2,214,20,125,H1
"Montgomery County, KS",2006-2007,35246,35504,258,0.732,32,226,20,125,H1
"Montgomery County, KS",2007-2008,35504,35538,34,0.096,71,-37,20,125,H1
"Montgomery County, KS",2008-2009,35538,35589,51,0.144,67,-16,20,125,H1
"Montgomery County, KS",2009-2010,35589,35370,-219,-0.615,55,-274,20,125,H1
"Montgomery County, KS",2010-2011,35370,34744,-626,-1.77,-26,-600,20,125,H1
"Montgomery County, KS",2011-2012,34744,34433,-311,-0.895,71,-382,20,125,H1
"Montgomery County, KS",2012-2013,34433,34396,-37,-0.107,78,-115,20,125,H1
"Montgomery County, KS",2013-2014,34396,34065,-331,-0.962,131,-462,20,125,H1
"Montgomery County, KS",2014-2015,33977,33314,-663,-1.951,47,-710,20,125,H1
"Montgomery County, KS",2015-2016,33314,32867,-447,-1.342,40,-487,20,125,H1
"Montgomery County, KS",2016-2017,32867,32556,-311,-0.946,67,-378,20,125,H1
"Morris County, KS",2000-2001,6120,6061,-59,-0.964,-29,-30,20,127,H1
"Morris County, KS",2001-2002,6061,5981,-80,-1.32,-15,-65,20,127,H1
"Morris County, KS",2002-2003,5981,5922,-59,-0.986,-31,-28,20,127,H1
"Morris County, KS",2003-2004,5922,5904,-18,-0.304,-22,4,20,127,H1
"Morris County, KS",2004-2005,5904,5947,43,0.728,-11,54,20,127,H1
"Morris County, KS",2005-2006,5947,5929,-18,-0.303,-13,-5,20,127,H1
"Morris County, KS",2006-2007,5929,5931,2,0.034,-21,23,20,127,H1
"Morris County, KS",2007-2008,5931,5999,68,1.147,-7,75,20,127,H1
"Morris County, KS",2008-2009,5999,5958,-41,-0.683,-20,-21,20,127,H1
"Morris County, KS",2009-2010,5958,5913,-45,-0.755,-32,-13,20,127,H1
"Morris County, KS",2010-2011,5913,5861,-52,-0.879,-32,-20,20,127,H1
"Morris County, KS",2011-2012,5861,5851,-10,-0.171,-16,6,20,127,H1
"Morris County, KS",2012-2013,5851,5717,-134,-2.29,14,-148,20,127,H1
"Morris County, KS",2013-2014,5717,5698,-19,-0.332,-3,-16,20,127,H1
"Morris County, KS",2014-2015,5678,5645,-33,-0.581,-16,-17,20,127,H1
"Morris County, KS",2015-2016,5645,5556,-89,-1.577,-13,-76,20,127,H1
"Morris County, KS",2016-2017,5556,5455,-101,-1.818,-22,-79,20,127,H1
"Morton County, KS",2000-2001,3482,3393,-89,-2.556,33,-122,20,129,H1
"Morton County, KS",2001-2002,3393,3387,-6,-0.177,41,-47,20,129,H1
"Morton County, KS",2002-2003,3387,3403,16,0.472,5,11,20,129,H1
"Morton County, KS",2003-2004,3403,3326,-77,-2.263,7,-84,20,129,H1
"Morton County, KS",2004-2005,3326,3300,-26,-0.782,13,-39,20,129,H1
"Morton County, KS",2005-2006,3300,3285,-15,-0.455,11,-26,20,129,H1
"Morton County, KS",2006-2007,3285,3256,-29,-0.883,15,-44,20,129,H1
"Morton County, KS",2007-2008,3256,3227,-29,-0.891,28,-57,20,129,H1
"Morton County, KS",2008-2009,3227,3226,-1,-0.031,22,-23,20,129,H1
"Morton County, KS",2009-2010,3226,3229,3,0.093,24,-21,20,129,H1
"Morton County, KS",2010-2011,3229,3169,-60,-1.858,-13,-47,20,129,H1
"Morton County, KS",2011-2012,3169,3139,-30,-0.947,8,-38,20,129,H1
"Morton County, KS",2012-2013,3139,3150,11,0.35,31,-20,20,129,H1
"Morton County, KS",2013-2014,3150,3110,-40,-1.27,18,-58,20,129,H1
"Morton County, KS",2014-2015,3075,3007,-68,-2.211,4,-72,20,129,H1
"Morton County, KS",2015-2016,3007,2800,-207,-6.884,0,-207,20,129,H1
"Morton County, KS",2016-2017,2800,2740,-60,-2.143,-6,-54,20,129,H1
"Nemaha County, KS",2000-2001,10694,10494,-200,-1.87,-55,-145,20,131,H1
"Nemaha County, KS",2001-2002,10494,10501,7,0.067,1,6,20,131,H1
"Nemaha County, KS",2002-2003,10501,10490,-11,-0.105,-14,3,20,131,H1
"Nemaha County, KS",2003-2004,10490,10397,-93,-0.887,-32,-61,20,131,H1
"Nemaha County, KS",2004-2005,10397,10367,-30,-0.289,-31,1,20,131,H1
"Nemaha County, KS",2005-2006,10367,10345,-22,-0.212,-15,-7,20,131,H1
"Nemaha County, KS",2006-2007,10345,10325,-20,-0.193,-15,-5,20,131,H1
"Nemaha County, KS",2007-2008,10325,10259,-66,-0.639,-3,-63,20,131,H1
"Nemaha County, KS",2008-2009,10259,10165,-94,-0.916,18,-112,20,131,H1
"Nemaha County, KS",2009-2010,10165,10164,-1,-0.01,22,-23,20,131,H1
"Nemaha County, KS",2010-2011,10164,10123,-41,-0.403,-11,-30,20,131,H1
"Nemaha County, KS",2011-2012,10123,10104,-19,-0.188,-26,7,20,131,H1
"Nemaha County, KS",2012-2013,10104,10140,36,0.356,36,0,20,131,H1
"Nemaha County, KS",2013-2014,10140,10148,8,0.079,49,-41,20,131,H1
"Nemaha County, KS",2014-2015,10175,10227,52,0.511,74,-22,20,131,H1
"Nemaha County, KS",2015-2016,10227,10100,-127,-1.242,70,-197,20,131,H1
"Nemaha County, KS",2016-2017,10100,10118,18,0.178,58,-40,20,131,H1
"Neosho County, KS",2000-2001,16934,16884,-50,-0.295,16,-66,20,133,H1
"Neosho County, KS",2001-2002,16884,16719,-165,-0.977,3,-168,20,133,H1
"Neosho County, KS",2002-2003,16719,16615,-104,-0.622,-9,-95,20,133,H1
"Neosho County, KS",2003-2004,16615,16664,49,0.295,17,32,20,133,H1
"Neosho County, KS",2004-2005,16664,16591,-73,-0.438,6,-79,20,133,H1
"Neosho County, KS",2005-2006,16591,16479,-112,-0.675,5,-117,20,133,H1
"Neosho County, KS",2006-2007,16479,16578,99,0.601,22,77,20,133,H1
"Neosho County, KS",2007-2008,16578,16587,9,0.054,43,-34,20,133,H1
"Neosho County, KS",2008-2009,16587,16568,-19,-0.115,29,-48,20,133,H1
"Neosho County, KS",2009-2010,16568,16485,-83,-0.501,10,-93,20,133,H1
"Neosho County, KS",2010-2011,16485,16455,-30,-0.182,1,-31,20,133,H1
"Neosho County, KS",2011-2012,16455,16452,-3,-0.018,27,-30,20,133,H1
"Neosho County, KS",2012-2013,16452,16458,6,0.036,62,-56,20,133,H1
"Neosho County, KS",2013-2014,16458,16416,-42,-0.255,61,-103,20,133,H1
"Neosho County, KS",2014-2015,16390,16346,-44,-0.268,42,-86,20,133,H1
"Neosho County, KS",2015-2016,16346,16058,-288,-1.762,-1,-287,20,133,H1
"Neosho County, KS",2016-2017,16058,16015,-43,-0.268,9,-52,20,133,H1
"Ness County, KS",2000-2001,3448,3391,-57,-1.653,-17,-40,20,135,H1
"Ness County, KS",2001-2002,3391,3352,-39,-1.15,-22,-17,20,135,H1
"Ness County, KS",2002-2003,3352,3274,-78,-2.327,-18,-60,20,135,H1
"Ness County, KS",2003-2004,3274,3219,-55,-1.68,-11,-44,20,135,H1
"Ness County, KS",2004-2005,3219,3177,-42,-1.305,-24,-18,20,135,H1
"Ness County, KS",2005-2006,3177,3135,-42,-1.322,-24,-18,20,135,H1
"Ness County, KS",2006-2007,3135,3150,15,0.478,-35,50,20,135,H1
"Ness County, KS",2007-2008,3150,3127,-23,-0.73,-12,-11,20,135,H1
"Ness County, KS",2008-2009,3127,3085,-42,-1.343,-15,-27,20,135,H1
"Ness County, KS",2009-2010,3085,3108,23,0.746,-15,38,20,135,H1
"Ness County, KS",2010-2011,3108,3127,19,0.611,-10,29,20,135,H1
"Ness County, KS",2011-2012,3127,3085,-42,-1.343,-12,-30,20,135,H1
"Ness County, KS",2012-2013,3085,3094,9,0.292,7,2,20,135,H1
"Ness County, KS",2013-2014,3094,3105,11,0.356,-1,12,20,135,H1
"Ness County, KS",2014-2015,3083,3005,-78,-2.53,-9,-69,20,135,H1
"Ness County, KS",2015-2016,3005,2956,-49,-1.631,-12,-37,20,135,H1
"Ness County, KS",2016-2017,2956,2869,-87,-2.943,-12,-75,20,135,H1
"Norton County, KS",2000-2001,5962,5863,-99,-1.661,-13,-86,20,137,H1
"Norton County, KS",2001-2002,5863,5845,-18,-0.307,-22,4,20,137,H1
"Norton County, KS",2002-2003,5845,5852,7,0.12,-1,8,20,137,H1
"Norton County, KS",2003-2004,5852,5789,-63,-1.077,-43,-20,20,137,H1
"Norton County, KS",2004-2005,5789,5765,-24,-0.415,-9,-15,20,137,H1
"Norton County, KS",2005-2006,5765,5748,-17,-0.295,-13,-4,20,137,H1
"Norton County, KS",2006-2007,5748,5698,-50,-0.87,-22,-28,20,137,H1
"Norton County, KS",2007-2008,5698,5702,4,0.07,-8,12,20,137,H1
"Norton County, KS",2008-2009,5702,5640,-62,-1.087,-10,-52,20,137,H1
"Norton County, KS",2009-2010,5640,5661,21,0.372,-12,33,20,137,H1
"Norton County, KS",2010-2011,5661,5672,11,0.194,-13,24,20,137,H1
"Norton County, KS",2011-2012,5672,5605,-67,-1.181,-4,-63,20,137,H1
"Norton County, KS",2012-2013,5605,5642,37,0.66,7,30,20,137,H1
"Norton County, KS",2013-2014,5642,5560,-82,-1.453,2,-84,20,137,H1
"Norton County, KS",2014-2015,5525,5550,25,0.452,-9,34,20,137,H1
"Norton County, KS",2015-2016,5550,5506,-44,-0.793,8,-52,20,137,H1
"Norton County, KS",2016-2017,5506,5441,-65,-1.181,-9,-56,20,137,H1
"Osage County, KS",2000-2001,16756,16657,-99,-0.591,-19,-80,20,139,H1
"Osage County, KS",2001-2002,16657,16689,32,0.192,-23,55,20,139,H1
"Osage County, KS",2002-2003,16689,16722,33,0.198,48,-15,20,139,H1
"Osage County, KS",2003-2004,16722,16843,121,0.724,-17,138,20,139,H1
"Osage County, KS",2004-2005,16843,16869,26,0.154,-4,30,20,139,H1
"Osage County, KS",2005-2006,16869,16633,-236,-1.399,21,-257,20,139,H1
"Osage County, KS",2006-2007,16633,16468,-165,-0.992,3,-168,20,139,H1
"Osage County, KS",2007-2008,16468,16439,-29,-0.176,12,-41,20,139,H1
"Osage County, KS",2008-2009,16439,16297,-142,-0.864,21,-163,20,139,H1
"Osage County, KS",2009-2010,16297,16294,-3,-0.018,-6,3,20,139,H1
"Osage County, KS",2010-2011,16294,16340,46,0.282,16,30,20,139,H1
"Osage County, KS",2011-2012,16340,16173,-167,-1.022,-15,-152,20,139,H1
"Osage County, KS",2012-2013,16173,16082,-91,-0.563,-29,-62,20,139,H1
"Osage County, KS",2013-2014,16082,15936,-146,-0.908,-47,-99,20,139,H1
"Osage County, KS",2014-2015,15955,15847,-108,-0.677,-53,-55,20,139,H1
"Osage County, KS",2015-2016,15847,15789,-58,-0.366,-45,-13,20,139,H1
"Osage County, KS",2016-2017,15789,15772,-17,-0.108,-49,32,20,139,H1
"Osborne County, KS",2000-2001,4436,4342,-94,-2.119,-40,-54,20,141,H1
"Osborne County, KS",2001-2002,4342,4283,-59,-1.359,-30,-29,20,141,H1
"Osborne County, KS",2002-2003,4283,4149,-134,-3.129,-32,-102,20,141,H1
"Osborne County, KS",2003-2004,4149,4094,-55,-1.326,-44,-11,20,141,H1
"Osborne County, KS",2004-2005,4094,4035,-59,-1.441,-36,-23,20,141,H1
"Osborne County, KS",2005-2006,4035,3998,-37,-0.917,-20,-17,20,141,H1
"Osborne County, KS",2006-2007,3998,3916,-82,-2.051,-26,-56,20,141,H1
"Osborne County, KS",2007-2008,3916,3867,-49,-1.251,-23,-26,20,141,H1
"Osborne County, KS",2008-2009,3867,3913,46,1.19,-24,70,20,141,H1
"Osborne County, KS",2009-2010,3913,3837,-76,-1.942,-26,-50,20,141,H1
"Osborne County, KS",2010-2011,3837,3842,5,0.13,-15,20,20,141,H1
"Osborne County, KS",2011-2012,3842,3815,-27,-0.703,-16,-11,20,141,H1
"Osborne County, KS",2012-2013,3815,3806,-9,-0.236,-14,5,20,141,H1
"Osborne County, KS",2013-2014,3806,3756,-50,-1.314,-3,-47,20,141,H1
"Osborne County, KS",2014-2015,3763,3683,-80,-2.126,10,-90,20,141,H1
"Osborne County, KS",2015-2016,3683,3624,-59,-1.602,6,-65,20,141,H1
"Osborne County, KS",2016-2017,3624,3610,-14,-0.386,17,-31,20,141,H1
"Ottawa County, KS",2000-2001,6192,6142,-50,-0.807,-21,-29,20,143,H1
"Ottawa County, KS",2001-2002,6142,6188,46,0.749,-14,60,20,143,H1
"Ottawa County, KS",2002-2003,6188,6153,-35,-0.566,-3,-32,20,143,H1
"Ottawa County, KS",2003-2004,6153,6112,-41,-0.666,-5,-36,20,143,H1
"Ottawa County, KS",2004-2005,6112,6097,-15,-0.245,-7,-8,20,143,H1
"Ottawa County, KS",2005-2006,6097,6108,11,0.18,-14,25,20,143,H1
"Ottawa County, KS",2006-2007,6108,6101,-7,-0.115,-15,8,20,143,H1
"Ottawa County, KS",2007-2008,6101,6137,36,0.59,14,22,20,143,H1
"Ottawa County, KS",2008-2009,6137,6114,-23,-0.375,4,-27,20,143,H1
"Ottawa County, KS",2009-2010,6114,6093,-21,-0.343,-22,1,20,143,H1
"Ottawa County, KS",2010-2011,6093,6085,-8,-0.131,-7,-1,20,143,H1
"Ottawa County, KS",2011-2012,6085,6061,-24,-0.394,-33,9,20,143,H1
"Ottawa County, KS",2012-2013,6061,6071,10,0.165,26,-16,20,143,H1
"Ottawa County, KS",2013-2014,6071,6065,-6,-0.099,10,-16,20,143,H1
"Ottawa County, KS",2014-2015,6054,5975,-79,-1.305,6,-85,20,143,H1
"Ottawa County, KS",2015-2016,5975,5919,-56,-0.937,-11,-45,20,143,H1
"Ottawa County, KS",2016-2017,5919,5863,-56,-0.946,4,-60,20,143,H1
"Pawnee County, KS",2000-2001,7225,7068,-157,-2.173,-29,-128,20,145,H1
"Pawnee County, KS",2001-2002,7068,6996,-72,-1.019,-44,-28,20,145,H1
"Pawnee County, KS",2002-2003,6996,6964,-32,-0.457,-12,-20,20,145,H1
"Pawnee County, KS",2003-2004,6964,6975,11,0.158,-24,35,20,145,H1
"Pawnee County, KS",2004-2005,6975,7027,52,0.746,-7,59,20,145,H1
"Pawnee County, KS",2005-2006,7027,6889,-138,-1.964,-31,-107,20,145,H1
"Pawnee County, KS",2006-2007,6889,6930,41,0.595,1,40,20,145,H1
"Pawnee County, KS",2007-2008,6930,6859,-71,-1.025,-1,-70,20,145,H1
"Pawnee County, KS",2008-2009,6859,6927,68,0.991,10,58,20,145,H1
"Pawnee County, KS",2009-2010,6927,6987,60,0.866,22,38,20,145,H1
"Pawnee County, KS",2010-2011,6987,7035,48,0.687,-17,65,20,145,H1
"Pawnee County, KS",2011-2012,7035,6913,-122,-1.734,-4,-118,20,145,H1
"Pawnee County, KS",2012-2013,6913,6946,33,0.477,16,17,20,145,H1
"Pawnee County, KS",2013-2014,6946,6916,-30,-0.432,-1,-29,20,145,H1
"Pawnee County, KS",2014-2015,6884,6838,-46,-0.668,-4,-42,20,145,H1
"Pawnee County, KS",2015-2016,6838,6742,-96,-1.404,4,-100,20,145,H1
"Pawnee County, KS",2016-2017,6742,6680,-62,-0.92,-15,-47,20,145,H1
"Phillips County, KS",2000-2001,5995,5903,-92,-1.535,-23,-69,20,147,H1
"Phillips County, KS",2001-2002,5903,5833,-70,-1.186,-50,-20,20,147,H1
"Phillips County, KS",2002-2003,5833,5748,-85,-1.457,-38,-47,20,147,H1
"Phillips County, KS",2003-2004,5748,5749,1,0.017,-23,24,20,147,H1
"Phillips County, KS",2004-2005,5749,5642,-107,-1.861,-13,-94,20,147,H1
"Phillips County, KS",2005-2006,5642,5573,-69,-1.223,-24,-45,20,147,H1
"Phillips County, KS",2006-2007,5573,5588,15,0.269,-17,32,20,147,H1
"Phillips County, KS",2007-2008,5588,5586,-2,-0.036,-27,25,20,147,H1
"Phillips County, KS",2008-2009,5586,5620,34,0.609,-26,60,20,147,H1
"Phillips County, KS",2009-2010,5620,5632,12,0.214,-17,29,20,147,H1
"Phillips County, KS",2010-2011,5632,5543,-89,-1.58,-30,-59,20,147,H1
"Phillips County, KS",2011-2012,5543,5521,-22,-0.397,-10,-12,20,147,H1
"Phillips County, KS",2012-2013,5521,5571,50,0.906,15,35,20,147,H1
"Phillips County, KS",2013-2014,5571,5533,-38,-0.682,18,-56,20,147,H1
"Phillips County, KS",2014-2015,5483,5428,-55,-1.003,7,-62,20,147,H1
"Phillips County, KS",2015-2016,5428,5393,-35,-0.645,-22,-13,20,147,H1
"Phillips County, KS",2016-2017,5393,5370,-23,-0.426,-18,-5,20,147,H1
"Pottawatomie County, KS",2000-2001,18302,18412,110,0.601,91,19,20,149,H1
"Pottawatomie County, KS",2001-2002,18412,18580,168,0.912,113,55,20,149,H1
"Pottawatomie County, KS",2002-2003,18580,18925,345,1.857,115,230,20,149,H1
"Pottawatomie County, KS",2003-2004,18925,19193,268,1.416,134,134,20,149,H1
"Pottawatomie County, KS",2004-2005,19193,19444,251,1.308,99,152,20,149,H1
"Pottawatomie County, KS",2005-2006,19444,19720,276,1.419,110,166,20,149,H1
"Pottawatomie County, KS",2006-2007,19720,20395,675,3.423,193,482,20,149,H1
"Pottawatomie County, KS",2007-2008,20395,20884,489,2.398,153,336,20,149,H1
"Pottawatomie County, KS",2008-2009,20884,21206,322,1.542,170,152,20,149,H1
"Pottawatomie County, KS",2009-2010,21206,21732,526,2.48,166,360,20,149,H1
"Pottawatomie County, KS",2010-2011,21732,22040,308,1.417,240,68,20,149,H1
"Pottawatomie County, KS",2011-2012,22040,22351,311,1.411,192,119,20,149,H1
"Pottawatomie County, KS",2012-2013,22351,22670,319,1.427,208,111,20,149,H1
"Pottawatomie County, KS",2013-2014,22670,22897,227,1.001,195,32,20,149,H1
"Pottawatomie County, KS",2014-2015,22849,23298,449,1.965,190,259,20,149,H1
"Pottawatomie County, KS",2015-2016,23298,23593,295,1.266,184,111,20,149,H1
"Pottawatomie County, KS",2016-2017,23593,23908,315,1.335,180,135,20,149,H1
"Pratt County, KS",2000-2001,9649,9579,-70,-0.725,-8,-62,20,151,H1
"Pratt County, KS",2001-2002,9579,9669,90,0.94,-17,107,20,151,H1
"Pratt County, KS",2002-2003,9669,9575,-94,-0.972,-16,-78,20,151,H1
"Pratt County, KS",2003-2004,9575,9492,-83,-0.867,16,-99,20,151,H1
"Pratt County, KS",2004-2005,9492,9618,126,1.327,-14,140,20,151,H1
"Pratt County, KS",2005-2006,9618,9658,40,0.416,40,0,20,151,H1
"Pratt County, KS",2006-2007,9658,9698,40,0.414,-5,45,20,151,H1
"Pratt County, KS",2007-2008,9698,9684,-14,-0.144,-12,-2,20,151,H1
"Pratt County, KS",2008-2009,9684,9669,-15,-0.155,17,-32,20,151,H1
"Pratt County, KS",2009-2010,9669,9647,-22,-0.228,2,-24,20,151,H1
"Pratt County, KS",2010-2011,9647,9662,15,0.155,8,7,20,151,H1
"Pratt County, KS",2011-2012,9662,9787,125,1.294,32,93,20,151,H1
"Pratt County, KS",2012-2013,9787,9844,57,0.582,51,6,20,151,H1
"Pratt County, KS",2013-2014,9844,9850,6,0.061,55,-49,20,151,H1
"Pratt County, KS",2014-2015,9770,9691,-79,-0.809,35,-114,20,151,H1
"Pratt County, KS",2015-2016,9691,9572,-119,-1.228,42,-161,20,151,H1
"Pratt County, KS",2016-2017,9572,9547,-25,-0.261,38,-63,20,151,H1
"Rawlins County, KS",2000-2001,2988,2917,-71,-2.376,-21,-50,20,153,H1
"Rawlins County, KS",2001-2002,2917,2903,-14,-0.48,-10,-4,20,153,H1
"Rawlins County, KS",2002-2003,2903,2836,-67,-2.308,-21,-46,20,153,H1
"Rawlins County, KS",2003-2004,2836,2776,-60,-2.116,-32,-28,20,153,H1
"Rawlins County, KS",2004-2005,2776,2697,-79,-2.846,-22,-57,20,153,H1
"Rawlins County, KS",2005-2006,2697,2663,-34,-1.261,-24,-10,20,153,H1
"Rawlins County, KS",2006-2007,2663,2655,-8,-0.3,-26,18,20,153,H1
"Rawlins County, KS",2007-2008,2655,2592,-63,-2.373,-6,-57,20,153,H1
"Rawlins County, KS",2008-2009,2592,2558,-34,-1.312,-16,-18,20,153,H1
"Rawlins County, KS",2009-2010,2558,2502,-56,-2.189,-16,-40,20,153,H1
"Rawlins County, KS",2010-2011,2502,2539,37,1.479,-12,49,20,153,H1
"Rawlins County, KS",2011-2012,2539,2538,-1,-0.039,-6,5,20,153,H1
"Rawlins County, KS",2012-2013,2538,2603,65,2.561,5,60,20,153,H1
"Rawlins County, KS",2013-2014,2603,2584,-19,-0.73,11,-30,20,153,H1
"Rawlins County, KS",2014-2015,2555,2506,-49,-1.918,-4,-45,20,153,H1
"Rawlins County, KS",2015-2016,2506,2501,-5,-0.2,-9,4,20,153,H1
"Rawlins County, KS",2016-2017,2501,2497,-4,-0.16,5,-9,20,153,H1
"Reno County, KS",2000-2001,64731,64584,-147,-0.227,201,-348,20,155,H1
"Reno County, KS",2001-2002,64584,64163,-421,-0.652,121,-542,20,155,H1
"Reno County, KS",2002-2003,64163,63990,-173,-0.27,167,-340,20,155,H1
"Reno County, KS",2003-2004,63990,63779,-211,-0.33,207,-418,20,155,H1
"Reno County, KS",2004-2005,63779,63778,-1,-0.002,176,-177,20,155,H1
"Reno County, KS",2005-2006,63778,63822,44,0.069,87,-43,20,155,H1
"Reno County, KS",2006-2007,63822,63683,-139,-0.218,171,-310,20,155,H1
"Reno County, KS",2007-2008,63683,63974,291,0.457,139,152,20,155,H1
"Reno County, KS",2008-2009,63974,64196,222,0.347,169,53,20,155,H1
"Reno County, KS",2009-2010,64196,64558,362,0.564,124,238,20,155,H1
"Reno County, KS",2010-2011,64558,64393,-165,-0.256,11,-176,20,155,H1
"Reno County, KS",2011-2012,64393,64217,-176,-0.273,18,-194,20,155,H1
"Reno County, KS",2012-2013,64217,64155,-62,-0.097,32,-94,20,155,H1
"Reno County, KS",2013-2014,64155,63794,-361,-0.563,45,-406,20,155,H1
"Reno County, KS",2014-2015,63781,63718,-63,-0.099,51,-114,20,155,H1
"Reno County, KS",2015-2016,63718,63040,-678,-1.064,-37,-641,20,155,H1
"Reno County, KS",2016-2017,63040,62510,-530,-0.841,-26,-504,20,155,H1
"Republic County, KS",2000-2001,5804,5685,-119,-2.05,-74,-45,20,157,H1
"Republic County, KS",2001-2002,5685,5485,-200,-3.518,-56,-144,20,157,H1
"Republic County, KS",2002-2003,5485,5395,-90,-1.641,-43,-47,20,157,H1
"Republic County, KS",2003-2004,5395,5285,-110,-2.039,-41,-69,20,157,H1
"Republic County, KS",2004-2005,5285,5238,-47,-0.889,-46,-1,20,157,H1
"Republic County, KS",2005-2006,5238,5159,-79,-1.508,-23,-56,20,157,H1
"Republic County, KS",2006-2007,5159,5124,-35,-0.678,-32,-3,20,157,H1
"Republic County, KS",2007-2008,5124,5067,-57,-1.112,-23,-34,20,157,H1
"Republic County, KS",2008-2009,5067,5045,-22,-0.434,-29,7,20,157,H1
"Republic County, KS",2009-2010,5045,4957,-88,-1.744,-22,-66,20,157,H1
"Republic County, KS",2010-2011,4957,4913,-44,-0.888,-46,2,20,157,H1
"Republic County, KS",2011-2012,4913,4858,-55,-1.119,-53,-2,20,157,H1
"Republic County, KS",2012-2013,4858,4810,-48,-0.988,-22,-26,20,157,H1
"Republic County, KS",2013-2014,4810,4803,-7,-0.146,-23,16,20,157,H1
"Republic County, KS",2014-2015,4773,4725,-48,-1.006,-17,-31,20,157,H1
"Republic County, KS",2015-2016,4725,4651,-74,-1.566,-20,-54,20,157,H1
"Republic County, KS",2016-2017,4651,4691,40,0.86,-17,57,20,157,H1
"Rice County, KS",2000-2001,10728,10609,-119,-1.109,7,-126,20,159,H1
"Rice County, KS",2001-2002,10609,10526,-83,-0.782,-10,-73,20,159,H1
"Rice County, KS",2002-2003,10526,10465,-61,-0.58,3,-64,20,159,H1
"Rice County, KS",2003-2004,10465,10498,33,0.315,-16,49,20,159,H1
"Rice County, KS",2004-2005,10498,10396,-102,-0.972,0,-102,20,159,H1
"Rice County, KS",2005-2006,10396,10224,-172,-1.654,-32,-140,20,159,H1
"Rice County, KS",2006-2007,10224,10103,-121,-1.183,-1,-120,20,159,H1
"Rice County, KS",2007-2008,10103,10175,72,0.713,32,40,20,159,H1
"Rice County, KS",2008-2009,10175,10047,-128,-1.258,22,-150,20,159,H1
"Rice County, KS",2009-2010,10047,10113,66,0.657,5,61,20,159,H1
"Rice County, KS",2010-2011,10113,10101,-12,-0.119,0,-12,20,159,H1
"Rice County, KS",2011-2012,10101,10009,-92,-0.911,-21,-71,20,159,H1
"Rice County, KS",2012-2013,10009,10010,1,0.01,3,-2,20,159,H1
"Rice County, KS",2013-2014,10010,10015,5,0.05,15,-10,20,159,H1
"Rice County, KS",2014-2015,10008,9977,-31,-0.31,38,-69,20,159,H1
"Rice County, KS",2015-2016,9977,9809,-168,-1.684,22,-190,20,159,H1
"Rice County, KS",2016-2017,9809,9660,-149,-1.519,35,-184,20,159,H1
"Riley County, KS",2000-2001,63237,62962,-275,-0.435,639,-914,20,161,H1
"Riley County, KS",2001-2002,62962,62625,-337,-0.535,560,-897,20,161,H1
"Riley County, KS",2002-2003,62625,62922,297,0.474,638,-341,20,161,H1
"Riley County, KS",2003-2004,62922,64218,1296,2.06,544,752,20,161,H1
"Riley County, KS",2004-2005,64218,64751,533,0.83,573,-40,20,161,H1
"Riley County, KS",2005-2006,64751,66928,2177,3.362,724,1453,20,161,H1
"Riley County, KS",2006-2007,66928,67329,401,0.599,837,-436,20,161,H1
"Riley County, KS",2007-2008,67329,69444,2115,3.141,710,1405,20,161,H1
"Riley County, KS",2008-2009,69444,69995,551,0.793,708,-157,20,161,H1
"Riley County, KS",2009-2010,69995,71612,1617,2.31,727,890,20,161,H1
"Riley County, KS",2010-2011,71612,73384,1772,2.474,768,1004,20,161,H1
"Riley County, KS",2011-2012,73384,76297,2913,3.97,821,2092,20,161,H1
"Riley County, KS",2012-2013,76297,75905,-392,-0.514,858,-1250,20,161,H1
"Riley County, KS",2013-2014,75905,75194,-711,-0.937,827,-1538,20,161,H1
"Riley County, KS",2014-2015,74675,75247,572,0.766,635,-63,20,161,H1
"Riley County, KS",2015-2016,75247,74548,-699,-0.929,647,-1346,20,161,H1
"Riley County, KS",2016-2017,74548,74172,-376,-0.504,580,-956,20,161,H1
"Rooks County, KS",2000-2001,5665,5560,-105,-1.853,-17,-88,20,163,H1
"Rooks County, KS",2001-2002,5560,5482,-78,-1.403,-16,-62,20,163,H1
"Rooks County, KS",2002-2003,5482,5430,-52,-0.949,-13,-39,20,163,H1
"Rooks County, KS",2003-2004,5430,5400,-30,-0.552,-17,-13,20,163,H1
"Rooks County, KS",2004-2005,5400,5352,-48,-0.889,-13,-35,20,163,H1
"Rooks County, KS",2005-2006,5352,5322,-30,-0.561,-20,-10,20,163,H1
"Rooks County, KS",2006-2007,5322,5275,-47,-0.883,2,-49,20,163,H1
"Rooks County, KS",2007-2008,5275,5254,-21,-0.398,10,-31,20,163,H1
"Rooks County, KS",2008-2009,5254,5179,-75,-1.427,-2,-73,20,163,H1
"Rooks County, KS",2009-2010,5179,5173,-6,-0.116,-5,-1,20,163,H1
"Rooks County, KS",2010-2011,5173,5182,9,0.174,-9,18,20,163,H1
"Rooks County, KS",2011-2012,5182,5197,15,0.289,7,8,20,163,H1
"Rooks County, KS",2012-2013,5197,5164,-33,-0.635,-6,-27,20,163,H1
"Rooks County, KS",2013-2014,5164,5155,-9,-0.174,-6,-3,20,163,H1
"Rooks County, KS",2014-2015,5171,5174,3,0.058,-11,14,20,163,H1
"Rooks County, KS",2015-2016,5174,5120,-54,-1.044,-5,-49,20,163,H1
"Rooks County, KS",2016-2017,5120,5043,-77,-1.504,-15,-62,20,163,H1
"Rush County, KS",2000-2001,3536,3511,-25,-0.707,-23,-2,20,165,H1
"Rush County, KS",2001-2002,3511,3454,-57,-1.623,-25,-32,20,165,H1
"Rush County, KS",2002-2003,3454,3439,-15,-0.434,-19,4,20,165,H1
"Rush County, KS",2003-2004,3439,3442,3,0.087,-11,14,20,165,H1
"Rush County, KS",2004-2005,3442,3384,-58,-1.685,-13,-45,20,165,H1
"Rush County, KS",2005-2006,3384,3294,-90,-2.66,-27,-63,20,165,H1
"Rush County, KS",2006-2007,3294,3273,-21,-0.638,-12,-9,20,165,H1
"Rush County, KS",2007-2008,3273,3310,37,1.13,-9,46,20,165,H1
"Rush County, KS",2008-2009,3310,3253,-57,-1.722,-14,-43,20,165,H1
"Rush County, KS",2009-2010,3253,3318,65,1.998,-22,87,20,165,H1
"Rush County, KS",2010-2011,3318,3200,-118,-3.556,-22,-96,20,165,H1
"Rush County, KS",2011-2012,3200,3207,7,0.219,-24,31,20,165,H1
"Rush County, KS",2012-2013,3207,3186,-21,-0.655,-12,-9,20,165,H1
"Rush County, KS",2013-2014,3186,3197,11,0.345,0,11,20,165,H1
"Rush County, KS",2014-2015,3187,3130,-57,-1.789,1,-58,20,165,H1
"Rush County, KS",2015-2016,3130,3074,-56,-1.789,-9,-47,20,165,H1
"Rush County, KS",2016-2017,3074,3103,29,0.943,11,18,20,165,H1
"Russell County, KS",2000-2001,7349,7179,-170,-2.313,-34,-136,20,167,H1
"Russell County, KS",2001-2002,7179,7066,-113,-1.574,-45,-68,20,167,H1
"Russell County, KS",2002-2003,7066,7032,-34,-0.481,-21,-13,20,167,H1
"Russell County, KS",2003-2004,7032,7085,53,0.754,-26,79,20,167,H1
"Russell County, KS",2004-2005,7085,6930,-155,-2.188,-54,-101,20,167,H1
"Russell County, KS",2005-2006,6930,6894,-36,-0.519,-49,13,20,167,H1
"Russell County, KS",2006-2007,6894,6943,49,0.711,-6,55,20,167,H1
"Russell County, KS",2007-2008,6943,6869,-74,-1.066,-21,-53,20,167,H1
"Russell County, KS",2008-2009,6869,6880,11,0.16,-17,28,20,167,H1
"Russell County, KS",2009-2010,6880,6983,103,1.497,-14,117,20,167,H1
"Russell County, KS",2010-2011,6983,6962,-21,-0.301,-22,1,20,167,H1
"Russell County, KS",2011-2012,6962,6963,1,0.014,-5,6,20,167,H1
"Russell County, KS",2012-2013,6963,6929,-34,-0.488,-6,-28,20,167,H1
"Russell County, KS",2013-2014,6929,6956,27,0.39,-4,31,20,167,H1
"Russell County, KS",2014-2015,7001,7039,38,0.543,4,34,20,167,H1
"Russell County, KS",2015-2016,7039,6990,-49,-0.696,-11,-38,20,167,H1
"Russell County, KS",2016-2017,6990,6915,-75,-1.073,-20,-55,20,167,H1
"Saline County, KS",2000-2001,53659,53952,293,0.546,258,35,20,169,H1
"Saline County, KS",2001-2002,53952,54157,205,0.38,262,-57,20,169,H1
"Saline County, KS",2002-2003,54157,54018,-139,-0.257,269,-408,20,169,H1
"Saline County, KS",2003-2004,54018,54178,160,0.296,228,-68,20,169,H1
"Saline County, KS",2004-2005,54178,54361,183,0.338,355,-172,20,169,H1
"Saline County, KS",2005-2006,54361,54478,117,0.215,282,-165,20,169,H1
"Saline County, KS",2006-2007,54478,54723,245,0.45,262,-17,20,169,H1
"Saline County, KS",2007-2008,54723,54811,88,0.161,261,-173,20,169,H1
"Saline County, KS",2008-2009,54811,55164,353,0.644,319,34,20,169,H1
"Saline County, KS",2009-2010,55164,55758,594,1.077,293,301,20,169,H1
"Saline County, KS",2010-2011,55758,55733,-25,-0.045,236,-261,20,169,H1
"Saline County, KS",2011-2012,55733,55890,157,0.282,242,-85,20,169,H1
"Saline County, KS",2012-2013,55890,55830,-60,-0.107,278,-338,20,169,H1
"Saline County, KS",2013-2014,55830,55755,-75,-0.134,297,-372,20,169,H1
"Saline County, KS",2014-2015,55650,55691,41,0.074,300,-259,20,169,H1
"Saline County, KS",2015-2016,55691,55070,-621,-1.115,205,-826,20,169,H1
"Saline County, KS",2016-2017,55070,54734,-336,-0.61,214,-550,20,169,H1
"Scott County, KS",2000-2001,5100,5110,10,0.196,2,8,20,171,H1
"Scott County, KS",2001-2002,5110,4960,-150,-2.935,8,-158,20,171,H1
"Scott County, KS",2002-2003,4960,4865,-95,-1.915,6,-101,20,171,H1
"Scott County, KS",2003-2004,4865,4713,-152,-3.124,26,-178,20,171,H1
"Scott County, KS",2004-2005,4713,4771,58,1.231,16,42,20,171,H1
"Scott County, KS",2005-2006,4771,4738,-33,-0.692,17,-50,20,171,H1
"Scott County, KS",2006-2007,4738,4707,-31,-0.654,14,-45,20,171,H1
"Scott County, KS",2007-2008,4707,4729,22,0.467,11,11,20,171,H1
"Scott County, KS",2008-2009,4729,4823,94,1.988,21,73,20,171,H1
"Scott County, KS",2009-2010,4823,4946,123,2.55,22,101,20,171,H1
"Scott County, KS",2010-2011,4946,4906,-40,-0.809,-6,-34,20,171,H1
"Scott County, KS",2011-2012,4906,4900,-6,-0.122,6,-12,20,171,H1
"Scott County, KS",2012-2013,4900,4992,92,1.878,12,80,20,171,H1
"Scott County, KS",2013-2014,4992,5080,88,1.763,12,76,20,171,H1
"Scott County, KS",2014-2015,4976,4964,-12,-0.241,2,-14,20,171,H1
"Scott County, KS",2015-2016,4964,5011,47,0.947,-2,49,20,171,H1
"Scott County, KS",2016-2017,5011,4961,-50,-0.998,-11,-39,20,171,H1
"Sedgwick County, KS",2000-2001,453705,456887,3182,0.701,3994,-812,20,173,H1
"Sedgwick County, KS",2001-2002,456887,461020,4133,0.905,3772,361,20,173,H1
"Sedgwick County, KS",2002-2003,461020,462442,1422,0.308,3744,-2322,20,173,H1
"Sedgwick County, KS",2003-2004,462442,464021,1579,0.341,3833,-2254,20,173,H1
"Sedgwick County, KS",2004-2005,464021,467113,3092,0.666,3904,-812,20,173,H1
"Sedgwick County, KS",2005-2006,467113,471659,4546,0.973,3944,602,20,173,H1
"Sedgwick County, KS",2006-2007,471659,478479,6820,1.446,4400,2420,20,173,H1
"Sedgwick County, KS",2007-2008,478479,486077,7598,1.588,4190,3408,20,173,H1
"Sedgwick County, KS",2008-2009,486077,495006,8929,1.837,4080,4849,20,173,H1
"Sedgwick County, KS",2009-2010,495006,499282,4276,0.864,4128,148,20,173,H1
"Sedgwick County, KS",2010-2011,499282,500914,1632,0.327,3912,-2280,20,173,H1
"Sedgwick County, KS",2011-2012,500914,503821,2907,0.58,3744,-837,20,173,H1
"Sedgwick County, KS",2012-2013,503821,506121,2300,0.457,3773,-1473,20,173,H1
"Sedgwick County, KS",2013-2014,506121,508803,2682,0.53,3615,-933,20,173,H1
"Sedgwick County, KS",2014-2015,509294,511574,2280,0.448,3331,-1051,20,173,H1
"Sedgwick County, KS",2015-2016,511574,512641,1067,0.209,2785,-1718,20,173,H1
"Sedgwick County, KS",2016-2017,512641,513687,1046,0.204,2812,-1766,20,173,H1
"Seward County, KS",2000-2001,22616,22544,-72,-0.318,394,-466,20,175,H1
"Seward County, KS",2001-2002,22544,22687,143,0.634,343,-200,20,175,H1
"Seward County, KS",2002-2003,22687,22647,-40,-0.176,422,-462,20,175,H1
"Seward County, KS",2003-2004,22647,22538,-109,-0.481,374,-483,20,175,H1
"Seward County, KS",2004-2005,22538,22334,-204,-0.905,393,-597,20,175,H1
"Seward County, KS",2005-2006,22334,22246,-88,-0.394,356,-444,20,175,H1
"Seward County, KS",2006-2007,22246,22409,163,0.733,413,-250,20,175,H1
"Seward County, KS",2007-2008,22409,22522,113,0.504,399,-286,20,175,H1
"Seward County, KS",2008-2009,22522,22729,207,0.919,364,-157,20,175,H1
"Seward County, KS",2009-2010,22729,22985,256,1.126,429,-173,20,175,H1
"Seward County, KS",2010-2011,22985,23223,238,1.035,319,-81,20,175,H1
"Seward County, KS",2011-2012,23223,23453,230,0.99,346,-116,20,175,H1
"Seward County, KS",2012-2013,23453,23470,17,0.072,331,-314,20,175,H1
"Seward County, KS",2013-2014,23470,23465,-5,-0.021,339,-344,20,175,H1
"Seward County, KS",2014-2015,23296,23152,-144,-0.618,331,-475,20,175,H1
"Seward County, KS",2015-2016,23152,22756,-396,-1.71,304,-700,20,175,H1
"Seward County, KS",2016-2017,22756,22159,-597,-2.623,291,-888,20,175,H1
"Shawnee County, KS",2000-2001,170027,170320,293,0.172,651,-358,20,177,H1
"Shawnee County, KS",2001-2002,170320,170349,29,0.017,759,-730,20,177,H1
"Shawnee County, KS",2002-2003,170349,170854,505,0.296,703,-198,20,177,H1
"Shawnee County, KS",2003-2004,170854,171378,524,0.307,876,-352,20,177,H1
"Shawnee County, KS",2004-2005,171378,171893,515,0.301,928,-413,20,177,H1
"Shawnee County, KS",2005-2006,171893,172986,1093,0.636,837,256,20,177,H1
"Shawnee County, KS",2006-2007,172986,174162,1176,0.68,1036,140,20,177,H1
"Shawnee County, KS",2007-2008,174162,175449,1287,0.739,885,402,20,177,H1
"Shawnee County, KS",2008-2009,175449,176786,1337,0.762,930,407,20,177,H1
"Shawnee County, KS",2009-2010,176786,178257,1471,0.832,828,643,20,177,H1
"Shawnee County, KS",2010-2011,178257,178861,604,0.339,821,-217,20,177,H1
"Shawnee County, KS",2011-2012,178861,178904,43,0.024,664,-621,20,177,H1
"Shawnee County, KS",2012-2013,178904,178574,-330,-0.184,678,-1008,20,177,H1
"Shawnee County, KS",2013-2014,178574,178406,-168,-0.094,645,-813,20,177,H1
"Shawnee County, KS",2014-2015,178537,178725,188,0.105,616,-428,20,177,H1
"Shawnee County, KS",2015-2016,178725,178154,-571,-0.319,435,-1006,20,177,H1
"Shawnee County, KS",2016-2017,178154,178187,33,0.019,422,-389,20,177,H1
"Sheridan County, KS",2000-2001,2795,2728,-67,-2.397,-15,-52,20,179,H1
"Sheridan County, KS",2001-2002,2728,2675,-53,-1.943,-7,-46,20,179,H1
"Sheridan County, KS",2002-2003,2675,2659,-16,-0.598,-7,-9,20,179,H1
"Sheridan County, KS",2003-2004,2659,2594,-65,-2.445,2,-67,20,179,H1
"Sheridan County, KS",2004-2005,2594,2618,24,0.925,-3,27,20,179,H1
"Sheridan County, KS",2005-2006,2618,2585,-33,-1.261,0,-33,20,179,H1
"Sheridan County, KS",2006-2007,2585,2578,-7,-0.271,-5,-2,20,179,H1
"Sheridan County, KS",2007-2008,2578,2605,27,1.047,7,20,20,179,H1
"Sheridan County, KS",2008-2009,2605,2575,-30,-1.152,-1,-29,20,179,H1
"Sheridan County, KS",2009-2010,2575,2551,-24,-0.932,-5,-19,20,179,H1
"Sheridan County, KS",2010-2011,2551,2544,-7,-0.274,-15,8,20,179,H1
"Sheridan County, KS",2011-2012,2544,2533,-11,-0.432,6,-17,20,179,H1
"Sheridan County, KS",2012-2013,2533,2531,-2,-0.079,0,-2,20,179,H1
"Sheridan County, KS",2013-2014,2531,2539,8,0.316,6,2,20,179,H1
"Sheridan County, KS",2014-2015,2541,2512,-29,-1.141,11,-40,20,179,H1
"Sheridan County, KS",2015-2016,2512,2482,-30,-1.194,-2,-28,20,179,H1
"Sheridan County, KS",2016-2017,2482,2527,45,1.813,6,39,20,179,H1
"Sherman County, KS",2000-2001,6746,6606,-140,-2.075,14,-154,20,181,H1
"Sherman County, KS",2001-2002,6606,6396,-210,-3.179,-2,-208,20,181,H1
"Sherman County, KS",2002-2003,6396,6293,-103,-1.61,-10,-93,20,181,H1
"Sherman County, KS",2003-2004,6293,6186,-107,-1.7,9,-116,20,181,H1
"Sherman County, KS",2004-2005,6186,6155,-31,-0.501,-1,-30,20,181,H1
"Sherman County, KS",2005-2006,6155,5979,-176,-2.859,-18,-158,20,181,H1
"Sherman County, KS",2006-2007,5979,6004,25,0.418,11,14,20,181,H1
"Sherman County, KS",2007-2008,6004,6017,13,0.217,18,-5,20,181,H1
"Sherman County, KS",2008-2009,6017,6004,-13,-0.216,15,-28,20,181,H1
"Sherman County, KS",2009-2010,6004,6008,4,0.067,11,-7,20,181,H1
"Sherman County, KS",2010-2011,6008,6039,31,0.516,7,24,20,181,H1
"Sherman County, KS",2011-2012,6039,6125,86,1.424,1,85,20,181,H1
"Sherman County, KS",2012-2013,6125,6107,-18,-0.294,21,-39,20,181,H1
"Sherman County, KS",2013-2014,6107,6110,3,0.049,2,1,20,181,H1
"Sherman County, KS",2014-2015,6063,5983,-80,-1.319,-2,-78,20,181,H1
"Sherman County, KS",2015-2016,5983,5945,-38,-0.635,8,-46,20,181,H1
"Sherman County, KS",2016-2017,5945,5930,-15,-0.252,-4,-11,20,181,H1
"Smith County, KS",2000-2001,4519,4416,-103,-2.279,-43,-60,20,183,H1
"Smith County, KS",2001-2002,4416,4311,-105,-2.378,-46,-59,20,183,H1
"Smith County, KS",2002-2003,4311,4246,-65,-1.508,-41,-24,20,183,H1
"Smith County, KS",2003-2004,4246,4190,-56,-1.319,-30,-26,20,183,H1
"Smith County, KS",2004-2005,4190,4128,-62,-1.48,-42,-20,20,183,H1
"Smith County, KS",2005-2006,4128,4052,-76,-1.841,-17,-59,20,183,H1
"Smith County, KS",2006-2007,4052,4008,-44,-1.086,-15,-29,20,183,H1
"Smith County, KS",2007-2008,4008,3909,-99,-2.47,-33,-66,20,183,H1
"Smith County, KS",2008-2009,3909,3849,-60,-1.535,-28,-32,20,183,H1
"Smith County, KS",2009-2010,3849,3859,10,0.26,-29,39,20,183,H1
"Smith County, KS",2010-2011,3859,3791,-68,-1.762,-23,-45,20,183,H1
"Smith County, KS",2011-2012,3791,3754,-37,-0.976,-29,-8,20,183,H1
"Smith County, KS",2012-2013,3754,3720,-34,-0.906,-13,-21,20,183,H1
"Smith County, KS",2013-2014,3720,3769,49,1.317,-7,56,20,183,H1
"Smith County, KS",2014-2015,3739,3704,-35,-0.936,-15,-20,20,183,H1
"Smith County, KS",2015-2016,3704,3678,-26,-0.702,11,-37,20,183,H1
"Smith County, KS",2016-2017,3678,3668,-10,-0.272,1,-11,20,183,H1
"Stafford County, KS",2000-2001,4752,4723,-29,-0.61,-23,-6,20,185,H1
"Stafford County, KS",2001-2002,4723,4646,-77,-1.63,-19,-58,20,185,H1
"Stafford County, KS",2002-2003,4646,4559,-87,-1.873,-13,-74,20,185,H1
"Stafford County, KS",2003-2004,4559,4468,-91,-1.996,-22,-69,20,185,H1
"Stafford County, KS",2004-2005,4468,4473,5,0.112,-12,17,20,185,H1
"Stafford County, KS",2005-2006,4473,4440,-33,-0.738,-12,-21,20,185,H1
"Stafford County, KS",2006-2007,4440,4460,20,0.45,-18,38,20,185,H1
"Stafford County, KS",2007-2008,4460,4404,-56,-1.256,-3,-53,20,185,H1
"Stafford County, KS",2008-2009,4404,4422,18,0.409,-12,30,20,185,H1
"Stafford County, KS",2009-2010,4422,4423,1,0.023,-5,6,20,185,H1
"Stafford County, KS",2010-2011,4423,4390,-33,-0.746,-15,-18,20,185,H1
"Stafford County, KS",2011-2012,4390,4354,-36,-0.82,-11,-25,20,185,H1
"Stafford County, KS",2012-2013,4354,4350,-4,-0.092,-15,11,20,185,H1
"Stafford County, KS",2013-2014,4350,4297,-53,-1.218,-7,-46,20,185,H1
"Stafford County, KS",2014-2015,4296,4236,-60,-1.397,0,-60,20,185,H1
"Stafford County, KS",2015-2016,4236,4200,-36,-0.85,12,-48,20,185,H1
"Stafford County, KS",2016-2017,4200,4207,7,0.167,5,2,20,185,H1
"Stanton County, KS",2000-2001,2394,2410,16,0.668,31,-15,20,187,H1
"Stanton County, KS",2001-2002,2410,2421,11,0.456,18,-7,20,187,H1
"Stanton County, KS",2002-2003,2421,2366,-55,-2.272,14,-69,20,187,H1
"Stanton County, KS",2003-2004,2366,2354,-12,-0.507,16,-28,20,187,H1
"Stanton County, KS",2004-2005,2354,2252,-102,-4.333,24,-126,20,187,H1
"Stanton County, KS",2005-2006,2252,2212,-40,-1.776,12,-52,20,187,H1
"Stanton County, KS",2006-2007,2212,2176,-36,-1.627,22,-58,20,187,H1
"Stanton County, KS",2007-2008,2176,2169,-7,-0.322,24,-31,20,187,H1
"Stanton County, KS",2008-2009,2169,2174,5,0.231,26,-21,20,187,H1
"Stanton County, KS",2009-2010,2174,2258,84,3.864,28,56,20,187,H1
"Stanton County, KS",2010-2011,2258,2228,-30,-1.329,8,-38,20,187,H1
"Stanton County, KS",2011-2012,2228,2170,-58,-2.603,9,-67,20,187,H1
"Stanton County, KS",2012-2013,2170,2167,-3,-0.138,15,-18,20,187,H1
"Stanton County, KS",2013-2014,2167,2111,-56,-2.584,14,-70,20,187,H1
"Stanton County, KS",2014-2015,2127,2072,-55,-2.586,19,-74,20,187,H1
"Stanton County, KS",2015-2016,2072,2100,28,1.351,26,2,20,187,H1
"Stanton County, KS",2016-2017,2100,2060,-40,-1.905,22,-62,20,187,H1
"Stevens County, KS",2000-2001,5460,5428,-32,-0.586,47,-79,20,189,H1
"Stevens County, KS",2001-2002,5428,5442,14,0.258,33,-19,20,189,H1
"Stevens County, KS",2002-2003,5442,5473,31,0.57,47,-16,20,189,H1
"Stevens County, KS",2003-2004,5473,5626,153,2.796,25,128,20,189,H1
"Stevens County, KS",2004-2005,5626,5592,-34,-0.604,43,-77,20,189,H1
"Stevens County, KS",2005-2006,5592,5481,-111,-1.985,54,-165,20,189,H1
"Stevens County, KS",2006-2007,5481,5397,-84,-1.533,35,-119,20,189,H1
"Stevens County, KS",2007-2008,5397,5440,43,0.797,70,-27,20,189,H1
"Stevens County, KS",2008-2009,5440,5592,152,2.794,47,105,20,189,H1
"Stevens County, KS",2009-2010,5592,5749,157,2.808,57,100,20,189,H1
"Stevens County, KS",2010-2011,5749,5641,-108,-1.879,52,-160,20,189,H1
"Stevens County, KS",2011-2012,5641,5737,96,1.702,35,61,20,189,H1
"Stevens County, KS",2012-2013,5737,5790,53,0.924,56,-3,20,189,H1
"Stevens County, KS",2013-2014,5790,5801,11,0.19,60,-49,20,189,H1
"Stevens County, KS",2014-2015,5845,5806,-39,-0.667,68,-107,20,189,H1
"Stevens County, KS",2015-2016,5806,5655,-151,-2.601,29,-180,20,189,H1
"Stevens County, KS",2016-2017,5655,5612,-43,-0.76,47,-90,20,189,H1
"Sumner County, KS",2000-2001,25946,25704,-242,-0.933,39,-281,20,191,H1
"Sumner County, KS",2001-2002,25704,25500,-204,-0.794,103,-307,20,191,H1
"Sumner County, KS",2002-2003,25500,25248,-252,-0.988,10,-262,20,191,H1
"Sumner County, KS",2003-2004,25248,25146,-102,-0.404,14,-116,20,191,H1
"Sumner County, KS",2004-2005,25146,24795,-351,-1.396,10,-361,20,191,H1
"Sumner County, KS",2005-2006,24795,24493,-302,-1.218,33,-335,20,191,H1
"Sumner County, KS",2006-2007,24493,24290,-203,-0.829,-23,-180,20,191,H1
"Sumner County, KS",2007-2008,24290,24238,-52,-0.214,77,-129,20,191,H1
"Sumner County, KS",2008-2009,24238,24160,-78,-0.322,82,-160,20,191,H1
"Sumner County, KS",2009-2010,24160,24110,-50,-0.207,55,-105,20,191,H1
"Sumner County, KS",2010-2011,24110,23858,-252,-1.045,5,-257,20,191,H1
"Sumner County, KS",2011-2012,23858,23706,-152,-0.637,-14,-138,20,191,H1
"Sumner County, KS",2012-2013,23706,23614,-92,-0.388,18,-110,20,191,H1
"Sumner County, KS",2013-2014,23614,23528,-86,-0.364,32,-118,20,191,H1
"Sumner County, KS",2014-2015,23498,23535,37,0.157,30,7,20,191,H1
"Sumner County, KS",2015-2016,23535,23203,-332,-1.411,28,-360,20,191,H1
"Sumner County, KS",2016-2017,23203,23159,-44,-0.19,33,-77,20,191,H1
"Thomas County, KS",2000-2001,8179,8164,-15,-0.183,11,-26,20,193,H1
"Thomas County, KS",2001-2002,8164,8119,-45,-0.551,45,-90,20,193,H1
"Thomas County, KS",2002-2003,8119,8040,-79,-0.973,18,-97,20,193,H1
"Thomas County, KS",2003-2004,8040,7919,-121,-1.505,17,-138,20,193,H1
"Thomas County, KS",2004-2005,7919,7768,-151,-1.907,1,-152,20,193,H1
"Thomas County, KS",2005-2006,7768,7726,-42,-0.541,36,-78,20,193,H1
"Thomas County, KS",2006-2007,7726,7681,-45,-0.582,26,-71,20,193,H1
"Thomas County, KS",2007-2008,7681,7685,4,0.052,35,-31,20,193,H1
"Thomas County, KS",2008-2009,7685,7753,68,0.885,8,60,20,193,H1
"Thomas County, KS",2009-2010,7753,7947,194,2.502,31,163,20,193,H1
"Thomas County, KS",2010-2011,7947,7950,3,0.038,33,-30,20,193,H1
"Thomas County, KS",2011-2012,7950,7947,-3,-0.038,41,-44,20,193,H1
"Thomas County, KS",2012-2013,7947,8001,54,0.68,63,-9,20,193,H1
"Thomas County, KS",2013-2014,8001,7891,-110,-1.375,56,-166,20,193,H1
"Thomas County, KS",2014-2015,7855,7904,49,0.624,42,7,20,193,H1
"Thomas County, KS",2015-2016,7904,7811,-93,-1.177,27,-120,20,193,H1
"Thomas County, KS",2016-2017,7811,7788,-23,-0.294,48,-71,20,193,H1
"Trego County, KS",2000-2001,3280,3225,-55,-1.677,-20,-35,20,195,H1
"Trego County, KS",2001-2002,3225,3137,-88,-2.729,-23,-65,20,195,H1
"Trego County, KS",2002-2003,3137,3097,-40,-1.275,-4,-36,20,195,H1
"Trego County, KS",2003-2004,3097,3120,23,0.743,-23,46,20,195,H1
"Trego County, KS",2004-2005,3120,3025,-95,-3.045,-15,-80,20,195,H1
"Trego County, KS",2005-2006,3025,2991,-34,-1.124,-18,-16,20,195,H1
"Trego County, KS",2006-2007,2991,2971,-20,-0.669,-16,-4,20,195,H1
"Trego County, KS",2007-2008,2971,2943,-28,-0.942,-3,-25,20,195,H1
"Trego County, KS",2008-2009,2943,2985,42,1.427,0,42,20,195,H1
"Trego County, KS",2009-2010,2985,2990,5,0.168,-4,9,20,195,H1
"Trego County, KS",2010-2011,2990,2977,-13,-0.435,-8,-5,20,195,H1
"Trego County, KS",2011-2012,2977,2969,-8,-0.269,-25,17,20,195,H1
"Trego County, KS",2012-2013,2969,2959,-10,-0.337,-27,17,20,195,H1
"Trego County, KS",2013-2014,2959,2902,-57,-1.926,-24,-33,20,195,H1
"Trego County, KS",2014-2015,2916,2927,11,0.377,-12,23,20,195,H1
"Trego County, KS",2015-2016,2927,2863,-64,-2.187,-2,-62,20,195,H1
"Trego County, KS",2016-2017,2863,2884,21,0.733,2,19,20,195,H1
"Wabaunsee County, KS",2000-2001,6868,6801,-67,-0.976,9,-76,20,197,H1
"Wabaunsee County, KS",2001-2002,6801,6750,-51,-0.75,0,-51,20,197,H1
"Wabaunsee County, KS",2002-2003,6750,6759,9,0.133,20,-11,20,197,H1
"Wabaunsee County, KS",2003-2004,6759,6823,64,0.947,12,52,20,197,H1
"Wabaunsee County, KS",2004-2005,6823,6925,102,1.495,30,72,20,197,H1
"Wabaunsee County, KS",2005-2006,6925,6845,-80,-1.155,13,-93,20,197,H1
"Wabaunsee County, KS",2006-2007,6845,6998,153,2.235,12,141,20,197,H1
"Wabaunsee County, KS",2007-2008,6998,7077,79,1.129,33,46,20,197,H1
"Wabaunsee County, KS",2008-2009,7077,7059,-18,-0.254,31,-49,20,197,H1
"Wabaunsee County, KS",2009-2010,7059,7047,-12,-0.17,19,-31,20,197,H1
"Wabaunsee County, KS",2010-2011,7047,7042,-5,-0.071,7,-12,20,197,H1
"Wabaunsee County, KS",2011-2012,7042,7018,-24,-0.341,7,-31,20,197,H1
"Wabaunsee County, KS",2012-2013,7018,7041,23,0.328,68,-45,20,197,H1
"Wabaunsee County, KS",2013-2014,7041,7022,-19,-0.27,67,-86,20,197,H1
"Wabaunsee County, KS",2014-2015,6988,6951,-37,-0.529,55,-92,20,197,H1
"Wabaunsee County, KS",2015-2016,6951,6890,-61,-0.878,39,-100,20,197,H1
"Wabaunsee County, KS",2016-2017,6890,6874,-16,-0.232,42,-58,20,197,H1
"Wallace County, KS",2000-2001,1733,1695,-38,-2.193,7,-45,20,199,H1
"Wallace County, KS",2001-2002,1695,1671,-24,-1.416,-7,-17,20,199,H1
"Wallace County, KS",2002-2003,1671,1623,-48,-2.873,-4,-44,20,199,H1
"Wallace County, KS",2003-2004,1623,1562,-61,-3.758,-2,-59,20,199,H1
"Wallace County, KS",2004-2005,1562,1531,-31,-1.985,0,-31,20,199,H1
"Wallace County, KS",2005-2006,1531,1527,-4,-0.261,-2,-2,20,199,H1
"Wallace County, KS",2006-2007,1527,1481,-46,-3.012,-11,-35,20,199,H1
"Wallace County, KS",2007-2008,1481,1447,-34,-2.296,-1,-33,20,199,H1
"Wallace County, KS",2008-2009,1447,1469,22,1.52,7,15,20,199,H1
"Wallace County, KS",2009-2010,1469,1482,13,0.885,9,4,20,199,H1
"Wallace County, KS",2010-2011,1482,1524,42,2.834,0,42,20,199,H1
"Wallace County, KS",2011-2012,1524,1524,0,0,3,-3,20,199,H1
"Wallace County, KS",2012-2013,1524,1562,38,2.493,5,33,20,199,H1
"Wallace County, KS",2013-2014,1562,1506,-56,-3.585,5,-61,20,199,H1
"Wallace County, KS",2014-2015,1514,1518,4,0.264,7,-3,20,199,H1
"Wallace County, KS",2015-2016,1518,1505,-13,-0.856,7,-20,20,199,H1
"Wallace County, KS",2016-2017,1505,1524,19,1.262,4,15,20,199,H1
"Washington County, KS",2000-2001,6413,6281,-132,-2.058,-47,-85,20,201,H1
"Washington County, KS",2001-2002,6281,6201,-80,-1.274,-51,-29,20,201,H1
"Washington County, KS",2002-2003,6201,6156,-45,-0.726,-26,-19,20,201,H1
"Washington County, KS",2003-2004,6156,6072,-84,-1.365,-33,-51,20,201,H1
"Washington County, KS",2004-2005,6072,6022,-50,-0.823,-22,-28,20,201,H1
"Washington County, KS",2005-2006,6022,5950,-72,-1.196,-37,-35,20,201,H1
"Washington County, KS",2006-2007,5950,5880,-70,-1.176,-25,-45,20,201,H1
"Washington County, KS",2007-2008,5880,5848,-32,-0.544,-10,-22,20,201,H1
"Washington County, KS",2008-2009,5848,5779,-69,-1.18,-17,-52,20,201,H1
"Washington County, KS",2009-2010,5779,5789,10,0.173,0,10,20,201,H1
"Washington County, KS",2010-2011,5789,5838,49,0.846,-18,67,20,201,H1
"Washington County, KS",2011-2012,5838,5731,-107,-1.833,-5,-102,20,201,H1
"Washington County, KS",2012-2013,5731,5628,-103,-1.797,1,-104,20,201,H1
"Washington County, KS",2013-2014,5628,5598,-30,-0.533,-21,-9,20,201,H1
"Washington County, KS",2014-2015,5628,5598,-30,-0.533,-1,-29,20,201,H1
"Washington County, KS",2015-2016,5598,5568,-30,-0.536,15,-45,20,201,H1
"Washington County, KS",2016-2017,5568,5485,-83,-1.491,1,-84,20,201,H1
"Wichita County, KS",2000-2001,2512,2511,-1,-0.04,14,-15,20,203,H1
"Wichita County, KS",2001-2002,2511,2453,-58,-2.31,-6,-52,20,203,H1
"Wichita County, KS",2002-2003,2453,2431,-22,-0.897,26,-48,20,203,H1
"Wichita County, KS",2003-2004,2431,2347,-84,-3.455,2,-86,20,203,H1
"Wichita County, KS",2004-2005,2347,2361,14,0.597,10,4,20,203,H1
"Wichita County, KS",2005-2006,2361,2287,-74,-3.134,15,-89,20,203,H1
"Wichita County, KS",2006-2007,2287,2264,-23,-1.006,12,-35,20,203,H1
"Wichita County, KS",2007-2008,2264,2222,-42,-1.855,21,-63,20,203,H1
"Wichita County, KS",2008-2009,2222,2211,-11,-0.495,17,-28,20,203,H1
"Wichita County, KS",2009-2010,2211,2238,27,1.221,23,4,20,203,H1
"Wichita County, KS",2010-2011,2238,2257,19,0.849,4,15,20,203,H1
"Wichita County, KS",2011-2012,2257,2226,-31,-1.374,-3,-28,20,203,H1
"Wichita County, KS",2012-2013,2226,2186,-40,-1.797,17,-57,20,203,H1
"Wichita County, KS",2013-2014,2186,2176,-10,-0.457,11,-21,20,203,H1
"Wichita County, KS",2014-2015,2174,2157,-17,-0.782,6,-23,20,203,H1
"Wichita County, KS",2015-2016,2157,2131,-26,-1.205,3,-29,20,203,H1
"Wichita County, KS",2016-2017,2131,2125,-6,-0.282,-3,-3,20,203,H1
"Wilson County, KS",2000-2001,10303,10216,-87,-0.844,-46,-41,20,205,H1
"Wilson County, KS",2001-2002,10216,10104,-112,-1.096,-21,-91,20,205,H1
"Wilson County, KS",2002-2003,10104,10063,-41,-0.406,-31,-10,20,205,H1
"Wilson County, KS",2003-2004,10063,9784,-279,-2.773,-32,-247,20,205,H1
"Wilson County, KS",2004-2005,9784,9772,-12,-0.123,4,-16,20,205,H1
"Wilson County, KS",2005-2006,9772,9747,-25,-0.256,4,-29,20,205,H1
"Wilson County, KS",2006-2007,9747,9783,36,0.369,0,36,20,205,H1
"Wilson County, KS",2007-2008,9783,9592,-191,-1.952,-20,-171,20,205,H1
"Wilson County, KS",2008-2009,9592,9485,-107,-1.116,-14,-93,20,205,H1
"Wilson County, KS",2009-2010,9485,9394,-91,-0.959,-21,-70,20,205,H1
"Wilson County, KS",2010-2011,9394,9239,-155,-1.65,-27,-128,20,205,H1
"Wilson County, KS",2011-2012,9239,9119,-120,-1.299,11,-131,20,205,H1
"Wilson County, KS",2012-2013,9119,9105,-14,-0.154,2,-16,20,205,H1
"Wilson County, KS",2013-2014,9105,9028,-77,-0.846,2,-79,20,205,H1
"Wilson County, KS",2014-2015,8988,8856,-132,-1.469,-17,-115,20,205,H1
"Wilson County, KS",2015-2016,8856,8693,-163,-1.841,-18,-145,20,205,H1
"Wilson County, KS",2016-2017,8693,8675,-18,-0.207,-21,3,20,205,H1
"Woodson County, KS",2000-2001,3754,3742,-12,-0.32,-32,20,20,207,H1
"Woodson County, KS",2001-2002,3742,3602,-140,-3.741,-35,-105,20,207,H1
"Woodson County, KS",2002-2003,3602,3572,-30,-0.833,-25,-5,20,207,H1
"Woodson County, KS",2003-2004,3572,3485,-87,-2.436,-22,-65,20,207,H1
"Woodson County, KS",2004-2005,3485,3523,38,1.09,-35,73,20,207,H1
"Woodson County, KS",2005-2006,3523,3440,-83,-2.356,-8,-75,20,207,H1
"Woodson County, KS",2006-2007,3440,3363,-77,-2.238,-25,-52,20,207,H1
"Woodson County, KS",2007-2008,3363,3347,-16,-0.476,-15,-1,20,207,H1
"Woodson County, KS",2008-2009,3347,3309,-38,-1.135,-27,-11,20,207,H1
"Woodson County, KS",2009-2010,3309,3299,-10,-0.302,-33,23,20,207,H1
"Woodson County, KS",2010-2011,3299,3306,7,0.212,-13,20,20,207,H1
"Woodson County, KS",2011-2012,3306,3260,-46,-1.391,-10,-36,20,207,H1
"Woodson County, KS",2012-2013,3260,3206,-54,-1.656,-28,-26,20,207,H1
"Woodson County, KS",2013-2014,3206,3157,-49,-1.528,-20,-29,20,207,H1
"Woodson County, KS",2014-2015,3157,3115,-42,-1.33,-15,-27,20,207,H1
"Woodson County, KS",2015-2016,3115,3195,80,2.568,-7,87,20,207,H1
"Woodson County, KS",2016-2017,3195,3147,-48,-1.502,-10,-38,20,207,H1
"Wyandotte County, KS",2000-2001,157883,158372,489,0.31,1222,-733,20,209,H6
"Wyandotte County, KS",2001-2002,158372,157498,-874,-0.552,1294,-2168,20,209,H6
"Wyandotte County, KS",2002-2003,157498,156276,-1222,-0.776,1375,-2597,20,209,H6
"Wyandotte County, KS",2003-2004,156276,154874,-1402,-0.897,1230,-2632,20,209,H6
"Wyandotte County, KS",2004-2005,154874,154356,-518,-0.334,1335,-1853,20,209,H6
"Wyandotte County, KS",2005-2006,154356,153689,-667,-0.432,1401,-2068,20,209,H6
"Wyandotte County, KS",2006-2007,153689,154267,578,0.376,1512,-934,20,209,H6
"Wyandotte County, KS",2007-2008,154267,155092,825,0.535,1403,-578,20,209,H6
"Wyandotte County, KS",2008-2009,155092,156416,1324,0.854,1291,33,20,209,H6
"Wyandotte County, KS",2009-2010,156416,157762,1346,0.861,1363,-17,20,209,H6
"Wyandotte County, KS",2010-2011,157762,158030,268,0.17,1433,-1165,20,209,H6
"Wyandotte County, KS",2011-2012,158030,159303,1273,0.806,1391,-118,20,209,H6
"Wyandotte County, KS",2012-2013,159303,160601,1298,0.815,1410,-112,20,209,H6
"Wyandotte County, KS",2013-2014,160601,161636,1035,0.644,1396,-361,20,209,H6
"Wyandotte County, KS",2014-2015,162147,163369,1222,0.754,1315,-93,20,209,H6
"Wyandotte County, KS",2015-2016,163369,164418,1049,0.642,1399,-350,20,209,H6
"Wyandotte County, KS",2016-2017,164418,165288,870,0.529,1324,-454,20,209,H6
Kentucky,2000-2001,4049021,4068132,19111,0.472,15383,3728,21,0,STATE
Kentucky,2001-2002,4068132,4089875,21743,0.534,13631,8112,21,0,STATE
Kentucky,2002-2003,4089875,4117170,27295,0.667,14745,12550,21,0,STATE
Kentucky,2003-2004,4117170,4146101,28931,0.703,15267,13664,21,0,STATE
Kentucky,2004-2005,4146101,4182742,36641,0.884,16573,20068,21,0,STATE
Kentucky,2005-2006,4182742,4219239,36497,0.873,17272,19225,21,0,STATE
Kentucky,2006-2007,4219239,4256672,37433,0.887,19124,18309,21,0,STATE
Kentucky,2007-2008,4256672,4289878,33206,0.78,16660,16546,21,0,STATE
Kentucky,2008-2009,4289878,4317074,27196,0.634,15194,12002,21,0,STATE
Kentucky,2009-2010,4317074,4347937,30863,0.715,13910,16953,21,0,STATE
Kentucky,2010-2011,4347937,4367882,19945,0.459,12780,7165,21,0,STATE
Kentucky,2011-2012,4367882,4382667,14785,0.338,12427,2358,21,0,STATE
Kentucky,2012-2013,4382667,4398500,15833,0.361,11606,4227,21,0,STATE
Kentucky,2013-2014,4398500,4412617,14117,0.321,12340,1777,21,0,STATE
Kentucky,2014-2015,4412617,4425092,12475,0.283,12605,-130,21,0,STATE
Kentucky,2015-2016,4425092,4436113,11021,0.249,10272,749,21,0,STATE
Kentucky,2016-2017,4436113,4454189,18076,0.407,10146,7930,21,0,STATE
"Adair County, KY",2000-2001,17327,17584,257,1.483,58,199,21,1,H1
"Adair County, KY",2001-2002,17584,17762,178,1.012,56,122,21,1,H1
"Adair County, KY",2002-2003,17762,17924,162,0.912,19,143,21,1,H1
"Adair County, KY",2003-2004,17924,17994,70,0.391,27,43,21,1,H1
"Adair County, KY",2004-2005,17994,18128,134,0.745,43,91,21,1,H1
"Adair County, KY",2005-2006,18128,18335,207,1.142,59,148,21,1,H1
"Adair County, KY",2006-2007,18335,18493,158,0.862,31,127,21,1,H1
"Adair County, KY",2007-2008,18493,18541,48,0.26,74,-26,21,1,H1
"Adair County, KY",2008-2009,18541,18729,188,1.014,26,162,21,1,H1
"Adair County, KY",2009-2010,18729,18871,142,0.758,16,126,21,1,H1
"Adair County, KY",2010-2011,18871,18979,108,0.572,7,101,21,1,H1
"Adair County, KY",2011-2012,18979,18971,-8,-0.042,-11,3,21,1,H1
"Adair County, KY",2012-2013,18971,19135,164,0.864,33,131,21,1,H1
"Adair County, KY",2013-2014,19135,19204,69,0.361,17,52,21,1,H1
"Adair County, KY",2014-2015,18967,19027,60,0.316,-4,64,21,1,H1
"Adair County, KY",2015-2016,19027,19379,352,1.85,30,322,21,1,H1
"Adair County, KY",2016-2017,19379,19485,106,0.547,-2,108,21,1,H1
"Allen County, KY",2000-2001,17820,17947,127,0.713,35,92,21,3,H1
"Allen County, KY",2001-2002,17947,18219,272,1.516,27,245,21,3,H1
"Allen County, KY",2002-2003,18219,18434,215,1.18,43,172,21,3,H1
"Allen County, KY",2003-2004,18434,18699,265,1.438,12,253,21,3,H1
"Allen County, KY",2004-2005,18699,18910,211,1.128,29,182,21,3,H1
"Allen County, KY",2005-2006,18910,19272,362,1.914,52,310,21,3,H1
"Allen County, KY",2006-2007,19272,19540,268,1.391,68,200,21,3,H1
"Allen County, KY",2007-2008,19540,19838,298,1.525,56,242,21,3,H1
"Allen County, KY",2008-2009,19838,19811,-27,-0.136,38,-65,21,3,H1
"Allen County, KY",2009-2010,19811,20040,229,1.156,5,224,21,3,H1
"Allen County, KY",2010-2011,20040,20170,130,0.649,30,100,21,3,H1
"Allen County, KY",2011-2012,20170,20231,61,0.302,34,27,21,3,H1
"Allen County, KY",2012-2013,20231,20269,38,0.188,40,-2,21,3,H1
"Allen County, KY",2013-2014,20269,20384,115,0.567,10,105,21,3,H1
"Allen County, KY",2014-2015,20436,20640,204,0.998,38,166,21,3,H1
"Allen County, KY",2015-2016,20640,20729,89,0.431,33,56,21,3,H1
"Allen County, KY",2016-2017,20729,20933,204,0.984,15,189,21,3,H1
"Anderson County, KY",2000-2001,19151,19382,231,1.206,69,162,21,5,H1
"Anderson County, KY",2001-2002,19382,19315,-67,-0.346,62,-129,21,5,H1
"Anderson County, KY",2002-2003,19315,19504,189,0.979,56,133,21,5,H1
"Anderson County, KY",2003-2004,19504,19714,210,1.077,107,103,21,5,H1
"Anderson County, KY",2004-2005,19714,19987,273,1.385,64,209,21,5,H1
"Anderson County, KY",2005-2006,19987,20519,532,2.662,92,440,21,5,H1
"Anderson County, KY",2006-2007,20519,20999,480,2.339,115,365,21,5,H1
"Anderson County, KY",2007-2008,20999,21088,89,0.424,63,26,21,5,H1
"Anderson County, KY",2008-2009,21088,21328,240,1.138,67,173,21,5,H1
"Anderson County, KY",2009-2010,21328,21458,130,0.61,59,71,21,5,H1
"Anderson County, KY",2010-2011,21458,21560,102,0.475,47,55,21,5,H1
"Anderson County, KY",2011-2012,21560,21663,103,0.478,85,18,21,5,H1
"Anderson County, KY",2012-2013,21663,21752,89,0.411,57,32,21,5,H1
"Anderson County, KY",2013-2014,21752,21888,136,0.625,56,80,21,5,H1
"Anderson County, KY",2014-2015,21886,21979,93,0.425,74,19,21,5,H1
"Anderson County, KY",2015-2016,21979,22144,165,0.751,82,83,21,5,H1
"Anderson County, KY",2016-2017,22144,22544,400,1.806,70,330,21,5,H1
"Ballard County, KY",2000-2001,8304,8225,-79,-0.951,-22,-57,21,7,H1
"Ballard County, KY",2001-2002,8225,8164,-61,-0.742,-37,-24,21,7,H1
"Ballard County, KY",2002-2003,8164,8254,90,1.102,13,77,21,7,H1
"Ballard County, KY",2003-2004,8254,8242,-12,-0.145,-10,-2,21,7,H1
"Ballard County, KY",2004-2005,8242,8269,27,0.328,26,1,21,7,H1
"Ballard County, KY",2005-2006,8269,8204,-65,-0.786,-57,-8,21,7,H1
"Ballard County, KY",2006-2007,8204,8190,-14,-0.171,-64,50,21,7,H1
"Ballard County, KY",2007-2008,8190,8265,75,0.916,-25,100,21,7,H1
"Ballard County, KY",2008-2009,8265,8204,-61,-0.738,-7,-54,21,7,H1
"Ballard County, KY",2009-2010,8204,8259,55,0.67,-14,69,21,7,H1
"Ballard County, KY",2010-2011,8259,8285,26,0.315,-6,32,21,7,H1
"Ballard County, KY",2011-2012,8285,8304,19,0.229,-22,41,21,7,H1
"Ballard County, KY",2012-2013,8304,8282,-22,-0.265,-22,0,21,7,H1
"Ballard County, KY",2013-2014,8282,8240,-42,-0.507,-18,-24,21,7,H1
"Ballard County, KY",2014-2015,8213,8212,-1,-0.012,-27,26,21,7,H1
"Ballard County, KY",2015-2016,8212,8057,-155,-1.887,-12,-143,21,7,H1
"Ballard County, KY",2016-2017,8057,8039,-18,-0.223,-26,8,21,7,H1
"Barren County, KY",2000-2001,38128,38517,389,1.02,56,333,21,9,H1
"Barren County, KY",2001-2002,38517,38704,187,0.485,30,157,21,9,H1
"Barren County, KY",2002-2003,38704,39164,460,1.189,55,405,21,9,H1
"Barren County, KY",2003-2004,39164,39601,437,1.116,96,341,21,9,H1
"Barren County, KY",2004-2005,39601,40320,719,1.816,128,591,21,9,H1
"Barren County, KY",2005-2006,40320,40857,537,1.332,146,391,21,9,H1
"Barren County, KY",2006-2007,40857,41435,578,1.415,109,469,21,9,H1
"Barren County, KY",2007-2008,41435,41797,362,0.874,112,250,21,9,H1
"Barren County, KY",2008-2009,41797,42171,374,0.895,117,257,21,9,H1
"Barren County, KY",2009-2010,42171,42178,7,0.017,82,-75,21,9,H1
"Barren County, KY",2010-2011,42178,42415,237,0.562,70,167,21,9,H1
"Barren County, KY",2011-2012,42415,42669,254,0.599,58,196,21,9,H1
"Barren County, KY",2012-2013,42669,43046,377,0.884,103,274,21,9,H1
"Barren County, KY",2013-2014,43046,43148,102,0.237,72,30,21,9,H1
"Barren County, KY",2014-2015,43073,43570,497,1.154,17,480,21,9,H1
"Barren County, KY",2015-2016,43570,43789,219,0.503,86,133,21,9,H1
"Barren County, KY",2016-2017,43789,43801,12,0.027,56,-44,21,9,H1
"Bath County, KY",2000-2001,11128,11280,152,1.366,29,123,21,11,H1
"Bath County, KY",2001-2002,11280,11403,123,1.09,32,91,21,11,H1
"Bath County, KY",2002-2003,11403,11428,25,0.219,18,7,21,11,H1
"Bath County, KY",2003-2004,11428,11447,19,0.166,1,18,21,11,H1
"Bath County, KY",2004-2005,11447,11538,91,0.795,50,41,21,11,H1
"Bath County, KY",2005-2006,11538,11558,20,0.173,29,-9,21,11,H1
"Bath County, KY",2006-2007,11558,11470,-88,-0.761,41,-129,21,11,H1
"Bath County, KY",2007-2008,11470,11647,177,1.543,41,136,21,11,H1
"Bath County, KY",2008-2009,11647,11544,-103,-0.884,29,-132,21,11,H1
"Bath County, KY",2009-2010,11544,11623,79,0.684,16,63,21,11,H1
"Bath County, KY",2010-2011,11623,11715,92,0.792,-11,103,21,11,H1
"Bath County, KY",2011-2012,11715,11799,84,0.717,13,71,21,11,H1
"Bath County, KY",2012-2013,11799,12008,209,1.771,58,151,21,11,H1
"Bath County, KY",2013-2014,12008,12206,198,1.649,36,162,21,11,H1
"Bath County, KY",2014-2015,12164,12228,64,0.526,8,56,21,11,H1
"Bath County, KY",2015-2016,12228,12271,43,0.352,37,6,21,11,H1
"Bath County, KY",2016-2017,12271,12378,107,0.872,16,91,21,11,H1
"Bell County, KY",2000-2001,30015,29561,-454,-1.513,-8,-446,21,13,H1
"Bell County, KY",2001-2002,29561,29691,130,0.44,-14,144,21,13,H1
"Bell County, KY",2002-2003,29691,29478,-213,-0.717,-47,-166,21,13,H1
"Bell County, KY",2003-2004,29478,29275,-203,-0.689,45,-248,21,13,H1
"Bell County, KY",2004-2005,29275,29130,-145,-0.495,11,-156,21,13,H1
"Bell County, KY",2005-2006,29130,28960,-170,-0.584,-7,-163,21,13,H1
"Bell County, KY",2006-2007,28960,28794,-166,-0.573,47,-213,21,13,H1
"Bell County, KY",2007-2008,28794,28836,42,0.146,-15,57,21,13,H1
"Bell County, KY",2008-2009,28836,28667,-169,-0.586,-14,-155,21,13,H1
"Bell County, KY",2009-2010,28667,28705,38,0.133,-37,75,21,13,H1
"Bell County, KY",2010-2011,28705,28631,-74,-0.258,-27,-47,21,13,H1
"Bell County, KY",2011-2012,28631,28152,-479,-1.673,8,-487,21,13,H1
"Bell County, KY",2012-2013,28152,27905,-247,-0.877,-7,-240,21,13,H1
"Bell County, KY",2013-2014,27905,27778,-127,-0.455,19,-146,21,13,H1
"Bell County, KY",2014-2015,27713,27337,-376,-1.357,-14,-362,21,13,H1
"Bell County, KY",2015-2016,27337,27192,-145,-0.53,-82,-63,21,13,H1
"Bell County, KY",2016-2017,27192,26894,-298,-1.096,-34,-264,21,13,H1
"Boone County, KY",2000-2001,87108,90277,3169,3.638,957,2212,21,15,H1
"Boone County, KY",2001-2002,90277,93323,3046,3.374,858,2188,21,15,H1
"Boone County, KY",2002-2003,93323,96680,3357,3.597,904,2453,21,15,H1
"Boone County, KY",2003-2004,96680,100822,4142,4.284,1027,3115,21,15,H1
"Boone County, KY",2004-2005,100822,105456,4634,4.596,1035,3599,21,15,H1
"Boone County, KY",2005-2006,105456,109295,3839,3.64,1119,2720,21,15,H1
"Boone County, KY",2006-2007,109295,112308,3013,2.757,1156,1857,21,15,H1
"Boone County, KY",2007-2008,112308,115262,2954,2.63,1114,1840,21,15,H1
"Boone County, KY",2008-2009,115262,117461,2199,1.908,1129,1070,21,15,H1
"Boone County, KY",2009-2010,117461,119306,1845,1.571,947,898,21,15,H1
"Boone County, KY",2010-2011,119306,121640,2334,1.956,946,1388,21,15,H1
"Boone County, KY",2011-2012,121640,123258,1618,1.33,1027,591,21,15,H1
"Boone County, KY",2012-2013,123258,124535,1277,1.036,935,342,21,15,H1
"Boone County, KY",2013-2014,124535,126413,1878,1.508,927,951,21,15,H1
"Boone County, KY",2014-2015,126190,127712,1522,1.206,870,652,21,15,H1
"Boone County, KY",2015-2016,127712,129154,1442,1.129,704,738,21,15,H1
"Boone County, KY",2016-2017,129154,130728,1574,1.219,720,854,21,15,H1
"Bourbon County, KY",2000-2001,19366,19443,77,0.398,20,57,21,17,H1
"Bourbon County, KY",2001-2002,19443,19452,9,0.046,25,-16,21,17,H1
"Bourbon County, KY",2002-2003,19452,19563,111,0.571,30,81,21,17,H1
"Bourbon County, KY",2003-2004,19563,19733,170,0.869,18,152,21,17,H1
"Bourbon County, KY",2004-2005,19733,19908,175,0.887,37,138,21,17,H1
"Bourbon County, KY",2005-2006,19908,19809,-99,-0.497,38,-137,21,17,H1
"Bourbon County, KY",2006-2007,19809,19891,82,0.414,78,4,21,17,H1
"Bourbon County, KY",2007-2008,19891,20046,155,0.779,62,93,21,17,H1
"Bourbon County, KY",2008-2009,20046,20027,-19,-0.095,50,-69,21,17,H1
"Bourbon County, KY",2009-2010,20027,19964,-63,-0.315,29,-92,21,17,H1
"Bourbon County, KY",2010-2011,19964,19993,29,0.145,17,12,21,17,H1
"Bourbon County, KY",2011-2012,19993,19996,3,0.015,42,-39,21,17,H1
"Bourbon County, KY",2012-2013,19996,19935,-61,-0.305,0,-61,21,17,H1
"Bourbon County, KY",2013-2014,19935,19972,37,0.186,0,37,21,17,H1
"Bourbon County, KY",2014-2015,20019,20116,97,0.485,23,74,21,17,H1
"Bourbon County, KY",2015-2016,20116,20057,-59,-0.293,-15,-44,21,17,H1
"Bourbon County, KY",2016-2017,20057,20029,-28,-0.14,-25,-3,21,17,H1
"Boyd County, KY",2000-2001,49627,49595,-32,-0.064,-21,-11,21,19,H1
"Boyd County, KY",2001-2002,49595,49578,-17,-0.034,-96,79,21,19,H1
"Boyd County, KY",2002-2003,49578,49754,176,0.355,17,159,21,19,H1
"Boyd County, KY",2003-2004,49754,49542,-212,-0.426,-9,-203,21,19,H1
"Boyd County, KY",2004-2005,49542,49403,-139,-0.281,-34,-105,21,19,H1
"Boyd County, KY",2005-2006,49403,49312,-91,-0.184,47,-138,21,19,H1
"Boyd County, KY",2006-2007,49312,49154,-158,-0.32,106,-264,21,19,H1
"Boyd County, KY",2007-2008,49154,49244,90,0.183,47,43,21,19,H1
"Boyd County, KY",2008-2009,49244,49362,118,0.24,2,116,21,19,H1
"Boyd County, KY",2009-2010,49362,49682,320,0.648,6,314,21,19,H1
"Boyd County, KY",2010-2011,49682,49448,-234,-0.471,-44,-190,21,19,H1
"Boyd County, KY",2011-2012,49448,49284,-164,-0.332,11,-175,21,19,H1
"Boyd County, KY",2012-2013,49284,48963,-321,-0.651,29,-350,21,19,H1
"Boyd County, KY",2013-2014,48963,48832,-131,-0.268,15,-146,21,19,H1
"Boyd County, KY",2014-2015,48709,48325,-384,-0.788,-11,-373,21,19,H1
"Boyd County, KY",2015-2016,48325,48196,-129,-0.267,7,-136,21,19,H1
"Boyd County, KY",2016-2017,48196,47979,-217,-0.45,-9,-208,21,19,H1
"Boyle County, KY",2000-2001,27673,27472,-201,-0.726,32,-233,21,21,H1
"Boyle County, KY",2001-2002,27472,27455,-17,-0.062,-22,5,21,21,H1
"Boyle County, KY",2002-2003,27455,27451,-4,-0.015,1,-5,21,21,H1
"Boyle County, KY",2003-2004,27451,27832,381,1.388,22,359,21,21,H1
"Boyle County, KY",2004-2005,27832,27922,90,0.323,-50,140,21,21,H1
"Boyle County, KY",2005-2006,27922,28031,109,0.39,26,83,21,21,H1
"Boyle County, KY",2006-2007,28031,28112,81,0.289,59,22,21,21,H1
"Boyle County, KY",2007-2008,28112,28288,176,0.626,31,145,21,21,H1
"Boyle County, KY",2008-2009,28288,28297,9,0.032,12,-3,21,21,H1
"Boyle County, KY",2009-2010,28297,28651,354,1.251,-18,372,21,21,H1
"Boyle County, KY",2010-2011,28651,28756,105,0.366,-25,130,21,21,H1
"Boyle County, KY",2011-2012,28756,29048,292,1.015,-39,331,21,21,H1
"Boyle County, KY",2012-2013,29048,29588,540,1.859,30,510,21,21,H1
"Boyle County, KY",2013-2014,29588,29706,118,0.399,8,110,21,21,H1
"Boyle County, KY",2014-2015,29788,29809,21,0.07,27,-6,21,21,H1
"Boyle County, KY",2015-2016,29809,29888,79,0.265,-3,82,21,21,H1
"Boyle County, KY",2016-2017,29888,29924,36,0.12,3,33,21,21,H1
"Bracken County, KY",2000-2001,8267,8334,67,0.81,-3,70,21,23,H1
"Bracken County, KY",2001-2002,8334,8408,74,0.888,21,53,21,23,H1
"Bracken County, KY",2002-2003,8408,8387,-21,-0.25,37,-58,21,23,H1
"Bracken County, KY",2003-2004,8387,8592,205,2.444,33,172,21,23,H1
"Bracken County, KY",2004-2005,8592,8533,-59,-0.687,22,-81,21,23,H1
"Bracken County, KY",2005-2006,8533,8484,-49,-0.574,43,-92,21,23,H1
"Bracken County, KY",2006-2007,8484,8468,-16,-0.189,72,-88,21,23,H1
"Bracken County, KY",2007-2008,8468,8471,3,0.035,21,-18,21,23,H1
"Bracken County, KY",2008-2009,8471,8473,2,0.024,33,-31,21,23,H1
"Bracken County, KY",2009-2010,8473,8494,21,0.248,17,4,21,23,H1
"Bracken County, KY",2010-2011,8494,8493,-1,-0.012,13,-14,21,23,H1
"Bracken County, KY",2011-2012,8493,8464,-29,-0.341,16,-45,21,23,H1
"Bracken County, KY",2012-2013,8464,8440,-24,-0.284,34,-58,21,23,H1
"Bracken County, KY",2013-2014,8440,8406,-34,-0.403,4,-38,21,23,H1
"Bracken County, KY",2014-2015,8388,8321,-67,-0.799,1,-68,21,23,H1
"Bracken County, KY",2015-2016,8321,8350,29,0.349,-2,31,21,23,H1
"Bracken County, KY",2016-2017,8350,8267,-83,-0.994,-5,-78,21,23,H1
"Breathitt County, KY",2000-2001,15999,15664,-335,-2.094,-31,-304,21,25,H1
"Breathitt County, KY",2001-2002,15664,15346,-318,-2.03,-35,-283,21,25,H1
"Breathitt County, KY",2002-2003,15346,15098,-248,-1.616,16,-264,21,25,H1
"Breathitt County, KY",2003-2004,15098,14975,-123,-0.815,2,-125,21,25,H1
"Breathitt County, KY",2004-2005,14975,14792,-183,-1.222,-31,-152,21,25,H1
"Breathitt County, KY",2005-2006,14792,14549,-243,-1.643,20,-263,21,25,H1
"Breathitt County, KY",2006-2007,14549,14327,-222,-1.526,24,-246,21,25,H1
"Breathitt County, KY",2007-2008,14327,14249,-78,-0.544,-22,-56,21,25,H1
"Breathitt County, KY",2008-2009,14249,14009,-240,-1.684,-24,-216,21,25,H1
"Breathitt County, KY",2009-2010,14009,13858,-151,-1.078,-35,-116,21,25,H1
"Breathitt County, KY",2010-2011,13858,13834,-24,-0.173,-3,-21,21,25,H1
"Breathitt County, KY",2011-2012,13834,13645,-189,-1.366,-18,-171,21,25,H1
"Breathitt County, KY",2012-2013,13645,13567,-78,-0.572,-21,-57,21,25,H1
"Breathitt County, KY",2013-2014,13567,13409,-158,-1.165,-23,-135,21,25,H1
"Breathitt County, KY",2014-2015,13433,13484,51,0.38,1,50,21,25,H1
"Breathitt County, KY",2015-2016,13484,13189,-295,-2.188,-30,-265,21,25,H1
"Breathitt County, KY",2016-2017,13189,12946,-243,-1.842,-38,-205,21,25,H1
"Breckinridge County, KY",2000-2001,18682,18837,155,0.83,26,129,21,27,H1
"Breckinridge County, KY",2001-2002,18837,19030,193,1.025,14,179,21,27,H1
"Breckinridge County, KY",2002-2003,19030,19209,179,0.941,19,160,21,27,H1
"Breckinridge County, KY",2003-2004,19209,19326,117,0.609,-5,122,21,27,H1
"Breckinridge County, KY",2004-2005,19326,19579,253,1.309,45,208,21,27,H1
"Breckinridge County, KY",2005-2006,19579,19590,11,0.056,53,-42,21,27,H1
"Breckinridge County, KY",2006-2007,19590,19819,229,1.169,-4,233,21,27,H1
"Breckinridge County, KY",2007-2008,19819,20018,199,1.004,21,178,21,27,H1
"Breckinridge County, KY",2008-2009,20018,19979,-39,-0.195,49,-88,21,27,H1
"Breckinridge County, KY",2009-2010,19979,20053,74,0.37,19,55,21,27,H1
"Breckinridge County, KY",2010-2011,20053,20285,232,1.157,-7,239,21,27,H1
"Breckinridge County, KY",2011-2012,20285,20098,-187,-0.922,-26,-161,21,27,H1
"Breckinridge County, KY",2012-2013,20098,20056,-42,-0.209,0,-42,21,27,H1
"Breckinridge County, KY",2013-2014,20056,19888,-168,-0.838,7,-175,21,27,H1
"Breckinridge County, KY",2014-2015,19899,20018,119,0.598,28,91,21,27,H1
"Breckinridge County, KY",2015-2016,20018,19954,-64,-0.32,15,-79,21,27,H1
"Breckinridge County, KY",2016-2017,19954,20111,157,0.787,36,121,21,27,H1
"Bullitt County, KY",2000-2001,61590,62596,1006,1.633,342,664,21,29,H1
"Bullitt County, KY",2001-2002,62596,63775,1179,1.884,367,812,21,29,H1
"Bullitt County, KY",2002-2003,63775,65074,1299,2.037,436,863,21,29,H1
"Bullitt County, KY",2003-2004,65074,66937,1863,2.863,404,1459,21,29,H1
"Bullitt County, KY",2004-2005,66937,68620,1683,2.514,322,1361,21,29,H1
"Bullitt County, KY",2005-2006,68620,70042,1422,2.072,351,1071,21,29,H1
"Bullitt County, KY",2006-2007,70042,71577,1535,2.192,317,1218,21,29,H1
"Bullitt County, KY",2007-2008,71577,72738,1161,1.622,305,856,21,29,H1
"Bullitt County, KY",2008-2009,72738,73743,1005,1.382,353,652,21,29,H1
"Bullitt County, KY",2009-2010,73743,74495,752,1.02,224,528,21,29,H1
"Bullitt County, KY",2010-2011,74495,75282,787,1.056,294,493,21,29,H1
"Bullitt County, KY",2011-2012,75282,75913,631,0.838,285,346,21,29,H1
"Bullitt County, KY",2012-2013,75913,76819,906,1.193,147,759,21,29,H1
"Bullitt County, KY",2013-2014,76819,77955,1136,1.479,188,948,21,29,H1
"Bullitt County, KY",2014-2015,78041,78702,661,0.847,239,422,21,29,H1
"Bullitt County, KY",2015-2016,78702,79209,507,0.644,131,376,21,29,H1
"Bullitt County, KY",2016-2017,79209,80246,1037,1.309,130,907,21,29,H1
"Butler County, KY",2000-2001,12991,13015,24,0.185,36,-12,21,31,H1
"Butler County, KY",2001-2002,13015,12952,-63,-0.484,14,-77,21,31,H1
"Butler County, KY",2002-2003,12952,12957,5,0.039,57,-52,21,31,H1
"Butler County, KY",2003-2004,12957,13044,87,0.671,49,38,21,31,H1
"Butler County, KY",2004-2005,13044,12900,-144,-1.104,24,-168,21,31,H1
"Butler County, KY",2005-2006,12900,12925,25,0.194,45,-20,21,31,H1
"Butler County, KY",2006-2007,12925,12759,-166,-1.284,16,-182,21,31,H1
"Butler County, KY",2007-2008,12759,12745,-14,-0.11,29,-43,21,31,H1
"Butler County, KY",2008-2009,12745,12670,-75,-0.588,29,-104,21,31,H1
"Butler County, KY",2009-2010,12670,12715,45,0.355,30,15,21,31,H1
"Butler County, KY",2010-2011,12715,12763,48,0.378,-11,59,21,31,H1
"Butler County, KY",2011-2012,12763,12806,43,0.337,-9,52,21,31,H1
"Butler County, KY",2012-2013,12806,12826,20,0.156,8,12,21,31,H1
"Butler County, KY",2013-2014,12826,12875,49,0.382,19,30,21,31,H1
"Butler County, KY",2014-2015,12879,12938,59,0.458,68,-9,21,31,H1
"Butler County, KY",2015-2016,12938,12701,-237,-1.832,19,-256,21,31,H1
"Butler County, KY",2016-2017,12701,12831,130,1.024,19,111,21,31,H1
"Caldwell County, KY",2000-2001,13026,12843,-183,-1.405,-84,-99,21,33,H1
"Caldwell County, KY",2001-2002,12843,12798,-45,-0.35,-10,-35,21,33,H1
"Caldwell County, KY",2002-2003,12798,12802,4,0.031,-41,45,21,33,H1
"Caldwell County, KY",2003-2004,12802,12774,-28,-0.219,-36,8,21,33,H1
"Caldwell County, KY",2004-2005,12774,12816,42,0.329,-32,74,21,33,H1
"Caldwell County, KY",2005-2006,12816,12828,12,0.094,-35,47,21,33,H1
"Caldwell County, KY",2006-2007,12828,12882,54,0.421,-9,63,21,33,H1
"Caldwell County, KY",2007-2008,12882,12985,103,0.8,-28,131,21,33,H1
"Caldwell County, KY",2008-2009,12985,12996,11,0.085,-30,41,21,33,H1
"Caldwell County, KY",2009-2010,12996,12986,-10,-0.077,-35,25,21,33,H1
"Caldwell County, KY",2010-2011,12986,12981,-5,-0.039,-32,27,21,33,H1
"Caldwell County, KY",2011-2012,12981,12921,-60,-0.462,-27,-33,21,33,H1
"Caldwell County, KY",2012-2013,12921,12785,-136,-1.053,-28,-108,21,33,H1
"Caldwell County, KY",2013-2014,12785,12725,-60,-0.469,-21,-39,21,33,H1
"Caldwell County, KY",2014-2015,12744,12681,-63,-0.494,0,-63,21,33,H1
"Caldwell County, KY",2015-2016,12681,12619,-62,-0.489,-18,-44,21,33,H1
"Caldwell County, KY",2016-2017,12619,12639,20,0.158,-24,44,21,33,H1
"Calloway County, KY",2000-2001,34160,34439,279,0.817,-22,301,21,35,H1
"Calloway County, KY",2001-2002,34439,34499,60,0.174,-27,87,21,35,H1
"Calloway County, KY",2002-2003,34499,34896,397,1.151,-19,416,21,35,H1
"Calloway County, KY",2003-2004,34896,35327,431,1.235,21,410,21,35,H1
"Calloway County, KY",2004-2005,35327,35788,461,1.305,52,409,21,35,H1
"Calloway County, KY",2005-2006,35788,36375,587,1.64,18,569,21,35,H1
"Calloway County, KY",2006-2007,36375,36585,210,0.577,43,167,21,35,H1
"Calloway County, KY",2007-2008,36585,36686,101,0.276,37,64,21,35,H1
"Calloway County, KY",2008-2009,36686,36886,200,0.545,30,170,21,35,H1
"Calloway County, KY",2009-2010,36886,37425,539,1.461,34,505,21,35,H1
"Calloway County, KY",2010-2011,37425,37831,406,1.085,6,400,21,35,H1
"Calloway County, KY",2011-2012,37831,38228,397,1.049,7,390,21,35,H1
"Calloway County, KY",2012-2013,38228,38141,-87,-0.228,12,-99,21,35,H1
"Calloway County, KY",2013-2014,38141,38282,141,0.37,11,130,21,35,H1
"Calloway County, KY",2014-2015,38221,38343,122,0.319,-19,141,21,35,H1
"Calloway County, KY",2015-2016,38343,38772,429,1.119,-7,436,21,35,H1
"Calloway County, KY",2016-2017,38772,38919,147,0.379,-23,170,21,35,H1
"Campbell County, KY",2000-2001,88687,88843,156,0.176,391,-235,21,37,H1
"Campbell County, KY",2001-2002,88843,88596,-247,-0.278,296,-543,21,37,H1
"Campbell County, KY",2002-2003,88596,88259,-337,-0.38,234,-571,21,37,H1
"Campbell County, KY",2003-2004,88259,87982,-277,-0.314,288,-565,21,37,H1
"Campbell County, KY",2004-2005,87982,88047,65,0.074,294,-229,21,37,H1
"Campbell County, KY",2005-2006,88047,88036,-11,-0.012,379,-390,21,37,H1
"Campbell County, KY",2006-2007,88036,88302,266,0.302,357,-91,21,37,H1
"Campbell County, KY",2007-2008,88302,88548,246,0.279,303,-57,21,37,H1
"Campbell County, KY",2008-2009,88548,89664,1116,1.26,260,856,21,37,H1
"Campbell County, KY",2009-2010,89664,90726,1062,1.184,383,679,21,37,H1
"Campbell County, KY",2010-2011,90726,91220,494,0.544,385,109,21,37,H1
"Campbell County, KY",2011-2012,91220,91175,-45,-0.049,320,-365,21,37,H1
"Campbell County, KY",2012-2013,91175,91385,210,0.23,291,-81,21,37,H1
"Campbell County, KY",2013-2014,91385,91833,448,0.49,293,155,21,37,H1
"Campbell County, KY",2014-2015,91737,92066,329,0.359,223,106,21,37,H1
"Campbell County, KY",2015-2016,92066,92034,-32,-0.035,206,-238,21,37,H1
"Campbell County, KY",2016-2017,92034,92488,454,0.493,178,276,21,37,H1
"Carlisle County, KY",2000-2001,5336,5305,-31,-0.581,-14,-17,21,39,H1
"Carlisle County, KY",2001-2002,5305,5299,-6,-0.113,6,-12,21,39,H1
"Carlisle County, KY",2002-2003,5299,5255,-44,-0.83,-11,-33,21,39,H1
"Carlisle County, KY",2003-2004,5255,5261,6,0.114,-9,15,21,39,H1
"Carlisle County, KY",2004-2005,5261,5215,-46,-0.874,12,-58,21,39,H1
"Carlisle County, KY",2005-2006,5215,5212,-3,-0.058,4,-7,21,39,H1
"Carlisle County, KY",2006-2007,5212,5109,-103,-1.976,-6,-97,21,39,H1
"Carlisle County, KY",2007-2008,5109,5093,-16,-0.313,-1,-15,21,39,H1
"Carlisle County, KY",2008-2009,5093,5113,20,0.393,6,14,21,39,H1
"Carlisle County, KY",2009-2010,5113,5100,-13,-0.254,-4,-9,21,39,H1
"Carlisle County, KY",2010-2011,5100,5049,-51,-1,-15,-36,21,39,H1
"Carlisle County, KY",2011-2012,5049,5042,-7,-0.139,6,-13,21,39,H1
"Carlisle County, KY",2012-2013,5042,4988,-54,-1.071,4,-58,21,39,H1
"Carlisle County, KY",2013-2014,4988,4978,-10,-0.2,0,-10,21,39,H1
"Carlisle County, KY",2014-2015,4974,4874,-100,-2.01,1,-101,21,39,H1
"Carlisle County, KY",2015-2016,4874,4816,-58,-1.19,16,-74,21,39,H1
"Carlisle County, KY",2016-2017,4816,4846,30,0.623,8,22,21,39,H1
"Carroll County, KY",2000-2001,10181,10193,12,0.118,51,-39,21,41,H1
"Carroll County, KY",2001-2002,10193,10312,119,1.167,9,110,21,41,H1
"Carroll County, KY",2002-2003,10312,10372,60,0.582,44,16,21,41,H1
"Carroll County, KY",2003-2004,10372,10379,7,0.067,43,-36,21,41,H1
"Carroll County, KY",2004-2005,10379,10511,132,1.272,26,106,21,41,H1
"Carroll County, KY",2005-2006,10511,10528,17,0.162,45,-28,21,41,H1
"Carroll County, KY",2006-2007,10528,10595,67,0.636,49,18,21,41,H1
"Carroll County, KY",2007-2008,10595,10744,149,1.406,68,81,21,41,H1
"Carroll County, KY",2008-2009,10744,10852,108,1.005,40,68,21,41,H1
"Carroll County, KY",2009-2010,10852,10807,-45,-0.415,35,-80,21,41,H1
"Carroll County, KY",2010-2011,10807,10980,173,1.601,52,121,21,41,H1
"Carroll County, KY",2011-2012,10980,10874,-106,-0.965,32,-138,21,41,H1
"Carroll County, KY",2012-2013,10874,10881,7,0.064,36,-29,21,41,H1
"Carroll County, KY",2013-2014,10881,10815,-66,-0.607,31,-97,21,41,H1
"Carroll County, KY",2014-2015,10751,10699,-52,-0.484,9,-61,21,41,H1
"Carroll County, KY",2015-2016,10699,10599,-100,-0.935,21,-121,21,41,H1
"Carroll County, KY",2016-2017,10599,10713,114,1.076,44,70,21,41,H1
"Carter County, KY",2000-2001,26874,26991,117,0.435,53,64,21,43,H1
"Carter County, KY",2001-2002,26991,27262,271,1.004,64,207,21,43,H1
"Carter County, KY",2002-2003,27262,27504,242,0.888,94,148,21,43,H1
"Carter County, KY",2003-2004,27504,27528,24,0.087,1,23,21,43,H1
"Carter County, KY",2004-2005,27528,27767,239,0.868,109,130,21,43,H1
"Carter County, KY",2005-2006,27767,27921,154,0.555,96,58,21,43,H1
"Carter County, KY",2006-2007,27921,27971,50,0.179,42,8,21,43,H1
"Carter County, KY",2007-2008,27971,27752,-219,-0.783,87,-306,21,43,H1
"Carter County, KY",2008-2009,27752,27785,33,0.119,61,-28,21,43,H1
"Carter County, KY",2009-2010,27785,27754,-31,-0.112,74,-105,21,43,H1
"Carter County, KY",2010-2011,27754,27458,-296,-1.067,30,-326,21,43,H1
"Carter County, KY",2011-2012,27458,27471,13,0.047,37,-24,21,43,H1
"Carter County, KY",2012-2013,27471,27291,-180,-0.655,42,-222,21,43,H1
"Carter County, KY",2013-2014,27291,27223,-68,-0.249,28,-96,21,43,H1
"Carter County, KY",2014-2015,27240,27158,-82,-0.301,27,-109,21,43,H1
"Carter County, KY",2015-2016,27158,27246,88,0.324,-2,90,21,43,H1
"Carter County, KY",2016-2017,27246,27144,-102,-0.374,-9,-93,21,43,H1
"Casey County, KY",2000-2001,15466,15563,97,0.627,35,62,21,45,H1
"Casey County, KY",2001-2002,15563,15679,116,0.745,21,95,21,45,H1
"Casey County, KY",2002-2003,15679,15690,11,0.07,10,1,21,45,H1
"Casey County, KY",2003-2004,15690,15784,94,0.599,-4,98,21,45,H1
"Casey County, KY",2004-2005,15784,15845,61,0.386,-3,64,21,45,H1
"Casey County, KY",2005-2006,15845,15900,55,0.347,-2,57,21,45,H1
"Casey County, KY",2006-2007,15900,15908,8,0.05,8,0,21,45,H1
"Casey County, KY",2007-2008,15908,15970,62,0.39,-9,71,21,45,H1
"Casey County, KY",2008-2009,15970,15946,-24,-0.15,-3,-21,21,45,H1
"Casey County, KY",2009-2010,15946,15965,19,0.119,-14,33,21,45,H1
"Casey County, KY",2010-2011,15965,15963,-2,-0.013,-30,28,21,45,H1
"Casey County, KY",2011-2012,15963,16086,123,0.771,43,80,21,45,H1
"Casey County, KY",2012-2013,16086,16107,21,0.131,-8,29,21,45,H1
"Casey County, KY",2013-2014,16107,15891,-216,-1.341,5,-221,21,45,H1
"Casey County, KY",2014-2015,15844,15808,-36,-0.227,-20,-16,21,45,H1
"Casey County, KY",2015-2016,15808,15761,-47,-0.297,-8,-39,21,45,H1
"Casey County, KY",2016-2017,15761,15750,-11,-0.07,-29,18,21,45,H1
"Christian County, KY",2000-2001,72730,73397,667,0.917,972,-305,21,47,H1
"Christian County, KY",2001-2002,73397,73098,-299,-0.407,992,-1291,21,47,H1
"Christian County, KY",2002-2003,73098,71547,-1551,-2.122,961,-2512,21,47,H1
"Christian County, KY",2003-2004,71547,71700,153,0.214,697,-544,21,47,H1
"Christian County, KY",2004-2005,71700,72892,1192,1.662,1066,126,21,47,H1
"Christian County, KY",2005-2006,72892,70592,-2300,-3.155,987,-3287,21,47,H1
"Christian County, KY",2006-2007,70592,73128,2536,3.592,767,1769,21,47,H1
"Christian County, KY",2007-2008,73128,72034,-1094,-1.496,1060,-2154,21,47,H1
"Christian County, KY",2008-2009,72034,73457,1423,1.975,831,592,21,47,H1
"Christian County, KY",2009-2010,73457,74213,756,1.029,1190,-434,21,47,H1
"Christian County, KY",2010-2011,74213,73640,-573,-0.772,913,-1486,21,47,H1
"Christian County, KY",2011-2012,73640,75770,2130,2.892,887,1243,21,47,H1
"Christian County, KY",2012-2013,75770,74422,-1348,-1.779,997,-2345,21,47,H1
"Christian County, KY",2013-2014,74422,74250,-172,-0.231,938,-1110,21,47,H1
"Christian County, KY",2014-2015,73965,73309,-656,-0.887,871,-1527,21,47,H1
"Christian County, KY",2015-2016,73309,71735,-1574,-2.147,919,-2493,21,47,H1
"Christian County, KY",2016-2017,71735,70416,-1319,-1.839,844,-2163,21,47,H1
"Clark County, KY",2000-2001,33234,33390,156,0.469,112,44,21,49,H1
"Clark County, KY",2001-2002,33390,33407,17,0.051,74,-57,21,49,H1
"Clark County, KY",2002-2003,33407,33672,265,0.793,85,180,21,49,H1
"Clark County, KY",2003-2004,33672,34025,353,1.048,152,201,21,49,H1
"Clark County, KY",2004-2005,34025,34377,352,1.035,109,243,21,49,H1
"Clark County, KY",2005-2006,34377,34823,446,1.297,129,317,21,49,H1
"Clark County, KY",2006-2007,34823,35207,384,1.103,143,241,21,49,H1
"Clark County, KY",2007-2008,35207,35256,49,0.139,116,-67,21,49,H1
"Clark County, KY",2008-2009,35256,35607,351,0.996,88,263,21,49,H1
"Clark County, KY",2009-2010,35607,35607,0,0,85,-85,21,49,H1
"Clark County, KY",2010-2011,35607,35456,-151,-0.424,28,-179,21,49,H1
"Clark County, KY",2011-2012,35456,35739,283,0.798,48,235,21,49,H1
"Clark County, KY",2012-2013,35739,35607,-132,-0.369,60,-192,21,49,H1
"Clark County, KY",2013-2014,35607,35758,151,0.424,80,71,21,49,H1
"Clark County, KY",2014-2015,35710,35757,47,0.132,73,-26,21,49,H1
"Clark County, KY",2015-2016,35757,35889,132,0.369,70,62,21,49,H1
"Clark County, KY",2016-2017,35889,36046,157,0.437,107,50,21,49,H1
"Clay County, KY",2000-2001,24458,24203,-255,-1.043,78,-333,21,51,H1
"Clay County, KY",2001-2002,24203,23995,-208,-0.859,84,-292,21,51,H1
"Clay County, KY",2002-2003,23995,23635,-360,-1.5,43,-403,21,51,H1
"Clay County, KY",2003-2004,23635,23278,-357,-1.51,49,-406,21,51,H1
"Clay County, KY",2004-2005,23278,22946,-332,-1.426,42,-374,21,51,H1
"Clay County, KY",2005-2006,22946,22718,-228,-0.994,58,-286,21,51,H1
"Clay County, KY",2006-2007,22718,22332,-386,-1.699,109,-495,21,51,H1
"Clay County, KY",2007-2008,22332,22289,-43,-0.193,47,-90,21,51,H1
"Clay County, KY",2008-2009,22289,21950,-339,-1.521,23,-362,21,51,H1
"Clay County, KY",2009-2010,21950,21691,-259,-1.18,-13,-246,21,51,H1
"Clay County, KY",2010-2011,21691,21613,-78,-0.36,5,-83,21,51,H1
"Clay County, KY",2011-2012,21613,21541,-72,-0.333,31,-103,21,51,H1
"Clay County, KY",2012-2013,21541,21238,-303,-1.407,28,-331,21,51,H1
"Clay County, KY",2013-2014,21238,21147,-91,-0.428,40,-131,21,51,H1
"Clay County, KY",2014-2015,21123,21013,-110,-0.521,45,-155,21,51,H1
"Clay County, KY",2015-2016,21013,20683,-330,-1.57,-3,-327,21,51,H1
"Clay County, KY",2016-2017,20683,20366,-317,-1.533,26,-343,21,51,H1
"Clinton County, KY",2000-2001,9637,9696,59,0.612,13,46,21,53,H1
"Clinton County, KY",2001-2002,9696,9762,66,0.681,-2,68,21,53,H1
"Clinton County, KY",2002-2003,9762,9825,63,0.645,8,55,21,53,H1
"Clinton County, KY",2003-2004,9825,9886,61,0.621,2,59,21,53,H1
"Clinton County, KY",2004-2005,9886,9932,46,0.465,-17,63,21,53,H1
"Clinton County, KY",2005-2006,9932,9942,10,0.101,-7,17,21,53,H1
"Clinton County, KY",2006-2007,9942,10120,178,1.79,47,131,21,53,H1
"Clinton County, KY",2007-2008,10120,10253,133,1.314,-1,134,21,53,H1
"Clinton County, KY",2008-2009,10253,10227,-26,-0.254,-11,-15,21,53,H1
"Clinton County, KY",2009-2010,10227,10276,49,0.479,-18,67,21,53,H1
"Clinton County, KY",2010-2011,10276,10151,-125,-1.216,-8,-117,21,53,H1
"Clinton County, KY",2011-2012,10151,10233,82,0.808,-2,84,21,53,H1
"Clinton County, KY",2012-2013,10233,10136,-97,-0.948,-1,-96,21,53,H1
"Clinton County, KY",2013-2014,10136,10165,29,0.286,9,20,21,53,H1
"Clinton County, KY",2014-2015,10195,10174,-21,-0.206,16,-37,21,53,H1
"Clinton County, KY",2015-2016,10174,10220,46,0.452,13,33,21,53,H1
"Clinton County, KY",2016-2017,10220,10276,56,0.548,19,37,21,53,H1
"Crittenden County, KY",2000-2001,9408,9310,-98,-1.042,-23,-75,21,55,H1
"Crittenden County, KY",2001-2002,9310,9217,-93,-0.999,-73,-20,21,55,H1
"Crittenden County, KY",2002-2003,9217,9234,17,0.184,-20,37,21,55,H1
"Crittenden County, KY",2003-2004,9234,9126,-108,-1.17,-36,-72,21,55,H1
"Crittenden County, KY",2004-2005,9126,9138,12,0.131,0,12,21,55,H1
"Crittenden County, KY",2005-2006,9138,9264,126,1.379,-6,132,21,55,H1
"Crittenden County, KY",2006-2007,9264,9278,14,0.151,-14,28,21,55,H1
"Crittenden County, KY",2007-2008,9278,9408,130,1.401,-14,144,21,55,H1
"Crittenden County, KY",2008-2009,9408,9301,-107,-1.137,1,-108,21,55,H1
"Crittenden County, KY",2009-2010,9301,9308,7,0.075,-25,32,21,55,H1
"Crittenden County, KY",2010-2011,9308,9270,-38,-0.408,-28,-10,21,55,H1
"Crittenden County, KY",2011-2012,9270,9247,-23,-0.248,-20,-3,21,55,H1
"Crittenden County, KY",2012-2013,9247,9222,-25,-0.27,3,-28,21,55,H1
"Crittenden County, KY",2013-2014,9222,9224,2,0.022,15,-13,21,55,H1
"Crittenden County, KY",2014-2015,9192,9183,-9,-0.098,1,-10,21,55,H1
"Crittenden County, KY",2015-2016,9183,9163,-20,-0.218,0,-20,21,55,H1
"Crittenden County, KY",2016-2017,9163,9084,-79,-0.862,-2,-77,21,55,H1
"Cumberland County, KY",2000-2001,7167,7157,-10,-0.14,-44,34,21,57,H1
"Cumberland County, KY",2001-2002,7157,7164,7,0.098,-6,13,21,57,H1
"Cumberland County, KY",2002-2003,7164,7151,-13,-0.181,-5,-8,21,57,H1
"Cumberland County, KY",2003-2004,7151,7189,38,0.531,-1,39,21,57,H1
"Cumberland County, KY",2004-2005,7189,7066,-123,-1.711,-24,-99,21,57,H1
"Cumberland County, KY",2005-2006,7066,7073,7,0.099,-27,34,21,57,H1
"Cumberland County, KY",2006-2007,7073,6959,-114,-1.612,-18,-96,21,57,H1
"Cumberland County, KY",2007-2008,6959,6917,-42,-0.604,-14,-28,21,57,H1
"Cumberland County, KY",2008-2009,6917,6855,-62,-0.896,-19,-43,21,57,H1
"Cumberland County, KY",2009-2010,6855,6857,2,0.029,-26,28,21,57,H1
"Cumberland County, KY",2010-2011,6857,6867,10,0.146,-16,26,21,57,H1
"Cumberland County, KY",2011-2012,6867,6859,-8,-0.116,-14,6,21,57,H1
"Cumberland County, KY",2012-2013,6859,6815,-44,-0.641,-28,-16,21,57,H1
"Cumberland County, KY",2013-2014,6815,6745,-70,-1.027,-38,-32,21,57,H1
"Cumberland County, KY",2014-2015,6748,6759,11,0.163,-33,44,21,57,H1
"Cumberland County, KY",2015-2016,6759,6736,-23,-0.34,-25,2,21,57,H1
"Cumberland County, KY",2016-2017,6736,6706,-30,-0.445,-34,4,21,57,H1
"Daviess County, KY",2000-2001,91657,91707,50,0.055,414,-364,21,59,H1
"Daviess County, KY",2001-2002,91707,91821,114,0.124,401,-287,21,59,H1
"Daviess County, KY",2002-2003,91821,92457,636,0.693,410,226,21,59,H1
"Daviess County, KY",2003-2004,92457,92769,312,0.337,444,-132,21,59,H1
"Daviess County, KY",2004-2005,92769,93150,381,0.411,417,-36,21,59,H1
"Daviess County, KY",2005-2006,93150,93908,758,0.814,442,316,21,59,H1
"Daviess County, KY",2006-2007,93908,94647,739,0.787,526,213,21,59,H1
"Daviess County, KY",2007-2008,94647,95411,764,0.807,450,314,21,59,H1
"Daviess County, KY",2008-2009,95411,96261,850,0.891,416,434,21,59,H1
"Daviess County, KY",2009-2010,96261,96719,458,0.476,379,79,21,59,H1
"Daviess County, KY",2010-2011,96719,97233,514,0.531,334,180,21,59,H1
"Daviess County, KY",2011-2012,97233,97727,494,0.508,389,105,21,59,H1
"Daviess County, KY",2012-2013,97727,98200,473,0.484,336,137,21,59,H1
"Daviess County, KY",2013-2014,98200,98275,75,0.076,339,-264,21,59,H1
"Daviess County, KY",2014-2015,98336,99259,923,0.939,317,606,21,59,H1
"Daviess County, KY",2015-2016,99259,99844,585,0.589,392,193,21,59,H1
"Daviess County, KY",2016-2017,99844,100374,530,0.531,340,190,21,59,H1
"Edmonson County, KY",2000-2001,11639,11728,89,0.765,41,48,21,61,H1
"Edmonson County, KY",2001-2002,11728,11763,35,0.298,9,26,21,61,H1
"Edmonson County, KY",2002-2003,11763,11809,46,0.391,13,33,21,61,H1
"Edmonson County, KY",2003-2004,11809,11804,-5,-0.042,10,-15,21,61,H1
"Edmonson County, KY",2004-2005,11804,11987,183,1.55,17,166,21,61,H1
"Edmonson County, KY",2005-2006,11987,11957,-30,-0.25,-5,-25,21,61,H1
"Edmonson County, KY",2006-2007,11957,12055,98,0.82,-3,101,21,61,H1
"Edmonson County, KY",2007-2008,12055,12127,72,0.597,-14,86,21,61,H1
"Edmonson County, KY",2008-2009,12127,12122,-5,-0.041,6,-11,21,61,H1
"Edmonson County, KY",2009-2010,12122,12192,70,0.577,-2,72,21,61,H1
"Edmonson County, KY",2010-2011,12192,12267,75,0.615,-14,89,21,61,H1
"Edmonson County, KY",2011-2012,12267,12130,-137,-1.117,-24,-113,21,61,H1
"Edmonson County, KY",2012-2013,12130,12082,-48,-0.396,-46,-2,21,61,H1
"Edmonson County, KY",2013-2014,12082,12013,-69,-0.571,-45,-24,21,61,H1
"Edmonson County, KY",2014-2015,12031,12007,-24,-0.199,-39,15,21,61,H1
"Edmonson County, KY",2015-2016,12007,12068,61,0.508,-32,93,21,61,H1
"Edmonson County, KY",2016-2017,12068,12226,158,1.309,-44,202,21,61,H1
"Elliott County, KY",2000-2001,6767,6694,-73,-1.079,10,-83,21,63,H1
"Elliott County, KY",2001-2002,6694,6700,6,0.09,13,-7,21,63,H1
"Elliott County, KY",2002-2003,6700,6782,82,1.224,17,65,21,63,H1
"Elliott County, KY",2003-2004,6782,6748,-34,-0.501,-8,-26,21,63,H1
"Elliott County, KY",2004-2005,6748,6867,119,1.763,10,109,21,63,H1
"Elliott County, KY",2005-2006,6867,7151,284,4.136,5,279,21,63,H1
"Elliott County, KY",2006-2007,7151,7134,-17,-0.238,21,-38,21,63,H1
"Elliott County, KY",2007-2008,7134,7556,422,5.915,-38,460,21,63,H1
"Elliott County, KY",2008-2009,7556,7727,171,2.263,-24,195,21,63,H1
"Elliott County, KY",2009-2010,7727,7884,157,2.032,-65,222,21,63,H1
"Elliott County, KY",2010-2011,7884,7916,32,0.406,-9,41,21,63,H1
"Elliott County, KY",2011-2012,7916,7748,-168,-2.122,-17,-151,21,63,H1
"Elliott County, KY",2012-2013,7748,7686,-62,-0.8,20,-82,21,63,H1
"Elliott County, KY",2013-2014,7686,7672,-14,-0.182,14,-28,21,63,H1
"Elliott County, KY",2014-2015,7647,7648,1,0.013,-10,11,21,63,H1
"Elliott County, KY",2015-2016,7648,7507,-141,-1.844,20,-161,21,63,H1
"Elliott County, KY",2016-2017,7507,7523,16,0.213,1,15,21,63,H1
"Estill County, KY",2000-2001,15307,15293,-14,-0.091,57,-71,21,65,H1
"Estill County, KY",2001-2002,15293,15193,-100,-0.654,1,-101,21,65,H1
"Estill County, KY",2002-2003,15193,15014,-179,-1.178,8,-187,21,65,H1
"Estill County, KY",2003-2004,15014,14913,-101,-0.673,39,-140,21,65,H1
"Estill County, KY",2004-2005,14913,14780,-133,-0.892,18,-151,21,65,H1
"Estill County, KY",2005-2006,14780,14786,6,0.041,32,-26,21,65,H1
"Estill County, KY",2006-2007,14786,14778,-8,-0.054,15,-23,21,65,H1
"Estill County, KY",2007-2008,14778,14752,-26,-0.176,36,-62,21,65,H1
"Estill County, KY",2008-2009,14752,14672,-80,-0.542,8,-88,21,65,H1
"Estill County, KY",2009-2010,14672,14697,25,0.17,-17,42,21,65,H1
"Estill County, KY",2010-2011,14697,14636,-61,-0.415,-17,-44,21,65,H1
"Estill County, KY",2011-2012,14636,14486,-150,-1.025,-32,-118,21,65,H1
"Estill County, KY",2012-2013,14486,14470,-16,-0.11,-6,-10,21,65,H1
"Estill County, KY",2013-2014,14470,14447,-23,-0.159,-21,-2,21,65,H1
"Estill County, KY",2014-2015,14435,14375,-60,-0.416,-13,-47,21,65,H1
"Estill County, KY",2015-2016,14375,14345,-30,-0.209,-13,-17,21,65,H1
"Estill County, KY",2016-2017,14345,14277,-68,-0.474,-11,-57,21,65,H1
"Fayette County, KY",2000-2001,261408,263990,2582,0.988,1800,782,21,67,H6
"Fayette County, KY",2001-2002,263990,265822,1832,0.694,1515,317,21,67,H6
"Fayette County, KY",2002-2003,265822,269904,4082,1.536,1721,2361,21,67,H6
"Fayette County, KY",2003-2004,269904,272377,2473,0.916,1953,520,21,67,H6
"Fayette County, KY",2004-2005,272377,275540,3163,1.161,1966,1197,21,67,H6
"Fayette County, KY",2005-2006,275540,279971,4431,1.608,1905,2526,21,67,H6
"Fayette County, KY",2006-2007,279971,283291,3320,1.186,2221,1099,21,67,H6
"Fayette County, KY",2007-2008,283291,287683,4392,1.55,1913,2479,21,67,H6
"Fayette County, KY",2008-2009,287683,292514,4831,1.679,1903,2928,21,67,H6
"Fayette County, KY",2009-2010,292514,296695,4181,1.429,2158,2023,21,67,H6
"Fayette County, KY",2010-2011,296695,301213,4518,1.523,1937,2581,21,67,H6
"Fayette County, KY",2011-2012,301213,305251,4038,1.341,1947,2091,21,67,H6
"Fayette County, KY",2012-2013,305251,308411,3160,1.035,1852,1308,21,67,H6
"Fayette County, KY",2013-2014,308411,310797,2386,0.774,1907,479,21,67,H6
"Fayette County, KY",2014-2015,311399,314488,3089,0.992,1963,1126,21,67,H6
"Fayette County, KY",2015-2016,314488,319052,4564,1.451,1812,2752,21,67,H6
"Fayette County, KY",2016-2017,319052,321959,2907,0.911,1791,1116,21,67,H6
"Fleming County, KY",2000-2001,13837,14016,179,1.294,24,155,21,69,H1
"Fleming County, KY",2001-2002,14016,14068,52,0.371,54,-2,21,69,H1
"Fleming County, KY",2002-2003,14068,14230,162,1.152,24,138,21,69,H1
"Fleming County, KY",2003-2004,14230,14271,41,0.288,36,5,21,69,H1
"Fleming County, KY",2004-2005,14271,14270,-1,-0.007,-10,9,21,69,H1
"Fleming County, KY",2005-2006,14270,14235,-35,-0.245,41,-76,21,69,H1
"Fleming County, KY",2006-2007,14235,14349,114,0.801,38,76,21,69,H1
"Fleming County, KY",2007-2008,14349,14345,-4,-0.028,56,-60,21,69,H1
"Fleming County, KY",2008-2009,14345,14280,-65,-0.453,43,-108,21,69,H1
"Fleming County, KY",2009-2010,14280,14394,114,0.798,6,108,21,69,H1
"Fleming County, KY",2010-2011,14394,14486,92,0.639,19,73,21,69,H1
"Fleming County, KY",2011-2012,14486,14532,46,0.318,21,25,21,69,H1
"Fleming County, KY",2012-2013,14532,14567,35,0.241,50,-15,21,69,H1
"Fleming County, KY",2013-2014,14567,14545,-22,-0.151,42,-64,21,69,H1
"Fleming County, KY",2014-2015,14510,14637,127,0.875,42,85,21,69,H1
"Fleming County, KY",2015-2016,14637,14506,-131,-0.895,25,-156,21,69,H1
"Fleming County, KY",2016-2017,14506,14446,-60,-0.414,9,-69,21,69,H1
"Floyd County, KY",2000-2001,42316,41844,-472,-1.115,40,-512,21,71,H1
"Floyd County, KY",2001-2002,41844,41671,-173,-0.413,66,-239,21,71,H1
"Floyd County, KY",2002-2003,41671,41325,-346,-0.83,53,-399,21,71,H1
"Floyd County, KY",2003-2004,41325,41128,-197,-0.477,67,-264,21,71,H1
"Floyd County, KY",2004-2005,41128,40847,-281,-0.683,63,-344,21,71,H1
"Floyd County, KY",2005-2006,40847,40429,-418,-1.023,48,-466,21,71,H1
"Floyd County, KY",2006-2007,40429,40261,-168,-0.416,126,-294,21,71,H1
"Floyd County, KY",2007-2008,40261,39964,-297,-0.738,32,-329,21,71,H1
"Floyd County, KY",2008-2009,39964,39643,-321,-0.803,50,-371,21,71,H1
"Floyd County, KY",2009-2010,39643,39946,303,0.764,23,280,21,71,H1
"Floyd County, KY",2010-2011,39946,39797,-149,-0.373,15,-164,21,71,H1
"Floyd County, KY",2011-2012,39797,39141,-656,-1.648,12,-668,21,71,H1
"Floyd County, KY",2012-2013,39141,38443,-698,-1.783,-14,-684,21,71,H1
"Floyd County, KY",2013-2014,38443,38108,-335,-0.871,-24,-311,21,71,H1
"Floyd County, KY",2014-2015,38095,37756,-339,-0.89,-40,-299,21,71,H1
"Floyd County, KY",2015-2016,37756,36969,-787,-2.084,-102,-685,21,71,H1
"Floyd County, KY",2016-2017,36969,36271,-698,-1.888,-107,-591,21,71,H1
"Franklin County, KY",2000-2001,47888,48185,297,0.62,167,130,21,73,H1
"Franklin County, KY",2001-2002,48185,48293,108,0.224,119,-11,21,73,H1
"Franklin County, KY",2002-2003,48293,48246,-47,-0.097,103,-150,21,73,H1
"Franklin County, KY",2003-2004,48246,48536,290,0.601,153,137,21,73,H1
"Franklin County, KY",2004-2005,48536,48620,84,0.173,136,-52,21,73,H1
"Franklin County, KY",2005-2006,48620,48699,79,0.162,166,-87,21,73,H1
"Franklin County, KY",2006-2007,48699,48795,96,0.197,254,-158,21,73,H1
"Franklin County, KY",2007-2008,48795,49301,506,1.037,154,352,21,73,H1
"Franklin County, KY",2008-2009,49301,49253,-48,-0.097,107,-155,21,73,H1
"Franklin County, KY",2009-2010,49253,49319,66,0.134,78,-12,21,73,H1
"Franklin County, KY",2010-2011,49319,49307,-12,-0.024,65,-77,21,73,H1
"Franklin County, KY",2011-2012,49307,49379,72,0.146,62,10,21,73,H1
"Franklin County, KY",2012-2013,49379,49661,282,0.571,80,202,21,73,H1
"Franklin County, KY",2013-2014,49661,49880,219,0.441,77,142,21,73,H1
"Franklin County, KY",2014-2015,49992,50375,383,0.766,123,260,21,73,H1
"Franklin County, KY",2015-2016,50375,50241,-134,-0.266,43,-177,21,73,H1
"Franklin County, KY",2016-2017,50241,50485,244,0.486,72,172,21,73,H1
"Fulton County, KY",2000-2001,7697,7753,56,0.728,-5,61,21,75,H1
"Fulton County, KY",2001-2002,7753,7563,-190,-2.451,-24,-166,21,75,H1
"Fulton County, KY",2002-2003,7563,7427,-136,-1.798,-32,-104,21,75,H1
"Fulton County, KY",2003-2004,7427,7274,-153,-2.06,-19,-134,21,75,H1
"Fulton County, KY",2004-2005,7274,7090,-184,-2.53,-35,-149,21,75,H1
"Fulton County, KY",2005-2006,7090,6871,-219,-3.089,-18,-201,21,75,H1
"Fulton County, KY",2006-2007,6871,6861,-10,-0.146,-13,3,21,75,H1
"Fulton County, KY",2007-2008,6861,6945,84,1.224,-10,94,21,75,H1
"Fulton County, KY",2008-2009,6945,6793,-152,-2.189,-26,-126,21,75,H1
"Fulton County, KY",2009-2010,6793,6825,32,0.471,-26,58,21,75,H1
"Fulton County, KY",2010-2011,6825,6730,-95,-1.392,-8,-87,21,75,H1
"Fulton County, KY",2011-2012,6730,6547,-183,-2.719,-26,-157,21,75,H1
"Fulton County, KY",2012-2013,6547,6385,-162,-2.474,-39,-123,21,75,H1
"Fulton County, KY",2013-2014,6385,6265,-120,-1.879,-23,-97,21,75,H1
"Fulton County, KY",2014-2015,6250,6238,-12,-0.192,-27,15,21,75,H1
"Fulton County, KY",2015-2016,6238,6180,-58,-0.93,-14,-44,21,75,H1
"Fulton County, KY",2016-2017,6180,6192,12,0.194,-20,32,21,75,H1
"Gallatin County, KY",2000-2001,7866,8004,138,1.754,31,107,21,77,H1
"Gallatin County, KY",2001-2002,8004,7891,-113,-1.412,20,-133,21,77,H1
"Gallatin County, KY",2002-2003,7891,8094,203,2.573,31,172,21,77,H1
"Gallatin County, KY",2003-2004,8094,8119,25,0.309,51,-26,21,77,H1
"Gallatin County, KY",2004-2005,8119,8225,106,1.306,60,46,21,77,H1
"Gallatin County, KY",2005-2006,8225,8253,28,0.34,80,-52,21,77,H1
"Gallatin County, KY",2006-2007,8253,8337,84,1.018,80,4,21,77,H1
"Gallatin County, KY",2007-2008,8337,8420,83,0.996,32,51,21,77,H1
"Gallatin County, KY",2008-2009,8420,8533,113,1.342,32,81,21,77,H1
"Gallatin County, KY",2009-2010,8533,8608,75,0.879,37,38,21,77,H1
"Gallatin County, KY",2010-2011,8608,8576,-32,-0.372,25,-57,21,77,H1
"Gallatin County, KY",2011-2012,8576,8491,-85,-0.991,3,-88,21,77,H1
"Gallatin County, KY",2012-2013,8491,8504,13,0.153,56,-43,21,77,H1
"Gallatin County, KY",2013-2014,8504,8589,85,1,40,45,21,77,H1
"Gallatin County, KY",2014-2015,8606,8636,30,0.349,50,-20,21,77,H1
"Gallatin County, KY",2015-2016,8636,8728,92,1.065,50,42,21,77,H1
"Gallatin County, KY",2016-2017,8728,8776,48,0.55,53,-5,21,77,H1
"Garrard County, KY",2000-2001,14844,15090,246,1.657,52,194,21,79,H1
"Garrard County, KY",2001-2002,15090,15505,415,2.75,25,390,21,79,H1
"Garrard County, KY",2002-2003,15505,15790,285,1.838,74,211,21,79,H1
"Garrard County, KY",2003-2004,15790,15941,151,0.956,15,136,21,79,H1
"Garrard County, KY",2004-2005,15941,16315,374,2.346,36,338,21,79,H1
"Garrard County, KY",2005-2006,16315,16595,280,1.716,26,254,21,79,H1
"Garrard County, KY",2006-2007,16595,16887,292,1.76,73,219,21,79,H1
"Garrard County, KY",2007-2008,16887,16906,19,0.113,47,-28,21,79,H1
"Garrard County, KY",2008-2009,16906,16900,-6,-0.035,39,-45,21,79,H1
"Garrard County, KY",2009-2010,16900,16933,33,0.195,21,12,21,79,H1
"Garrard County, KY",2010-2011,16933,16806,-127,-0.75,16,-143,21,79,H1
"Garrard County, KY",2011-2012,16806,16922,116,0.69,43,73,21,79,H1
"Garrard County, KY",2012-2013,16922,16883,-39,-0.23,-6,-33,21,79,H1
"Garrard County, KY",2013-2014,16883,16858,-25,-0.148,2,-27,21,79,H1
"Garrard County, KY",2014-2015,16934,17237,303,1.789,15,288,21,79,H1
"Garrard County, KY",2015-2016,17237,17398,161,0.934,47,114,21,79,H1
"Garrard County, KY",2016-2017,17398,17523,125,0.718,46,79,21,79,H1
"Grant County, KY",2000-2001,22485,22972,487,2.166,161,326,21,81,H1
"Grant County, KY",2001-2002,22972,23307,335,1.458,193,142,21,81,H1
"Grant County, KY",2002-2003,23307,23619,312,1.339,178,134,21,81,H1
"Grant County, KY",2003-2004,23619,23856,237,1.003,221,16,21,81,H1
"Grant County, KY",2004-2005,23856,23993,137,0.574,203,-66,21,81,H1
"Grant County, KY",2005-2006,23993,24253,260,1.084,230,30,21,81,H1
"Grant County, KY",2006-2007,24253,24544,291,1.2,244,47,21,81,H1
"Grant County, KY",2007-2008,24544,24856,312,1.271,193,119,21,81,H1
"Grant County, KY",2008-2009,24856,24697,-159,-0.64,191,-350,21,81,H1
"Grant County, KY",2009-2010,24697,24682,-15,-0.061,155,-170,21,81,H1
"Grant County, KY",2010-2011,24682,24713,31,0.126,167,-136,21,81,H1
"Grant County, KY",2011-2012,24713,24491,-222,-0.898,156,-378,21,81,H1
"Grant County, KY",2012-2013,24491,24576,85,0.347,110,-25,21,81,H1
"Grant County, KY",2013-2014,24576,24875,299,1.217,125,174,21,81,H1
"Grant County, KY",2014-2015,24846,24757,-89,-0.358,134,-223,21,81,H1
"Grant County, KY",2015-2016,24757,24908,151,0.61,105,46,21,81,H1
"Grant County, KY",2016-2017,24908,24984,76,0.305,124,-48,21,81,H1
"Graves County, KY",2000-2001,37049,36869,-180,-0.486,46,-226,21,83,H1
"Graves County, KY",2001-2002,36869,36770,-99,-0.269,27,-126,21,83,H1
"Graves County, KY",2002-2003,36770,36898,128,0.348,34,94,21,83,H1
"Graves County, KY",2003-2004,36898,36789,-109,-0.295,-10,-99,21,83,H1
"Graves County, KY",2004-2005,36789,36926,137,0.372,60,77,21,83,H1
"Graves County, KY",2005-2006,36926,36859,-67,-0.181,22,-89,21,83,H1
"Graves County, KY",2006-2007,36859,36932,73,0.198,60,13,21,83,H1
"Graves County, KY",2007-2008,36932,36862,-70,-0.19,79,-149,21,83,H1
"Graves County, KY",2008-2009,36862,36932,70,0.19,27,43,21,83,H1
"Graves County, KY",2009-2010,36932,37207,275,0.745,18,257,21,83,H1
"Graves County, KY",2010-2011,37207,37513,306,0.822,86,220,21,83,H1
"Graves County, KY",2011-2012,37513,37535,22,0.059,28,-6,21,83,H1
"Graves County, KY",2012-2013,37535,37380,-155,-0.413,27,-182,21,83,H1
"Graves County, KY",2013-2014,37380,37618,238,0.637,66,172,21,83,H1
"Graves County, KY",2014-2015,37654,37421,-233,-0.619,96,-329,21,83,H1
"Graves County, KY",2015-2016,37421,37148,-273,-0.73,86,-359,21,83,H1
"Graves County, KY",2016-2017,37148,37121,-27,-0.073,76,-103,21,83,H1
"Grayson County, KY",2000-2001,24094,24170,76,0.315,36,40,21,85,H1
"Grayson County, KY",2001-2002,24170,24235,65,0.269,3,62,21,85,H1
"Grayson County, KY",2002-2003,24235,24648,413,1.704,46,367,21,85,H1
"Grayson County, KY",2003-2004,24648,24962,314,1.274,61,253,21,85,H1
"Grayson County, KY",2004-2005,24962,25181,219,0.877,71,148,21,85,H1
"Grayson County, KY",2005-2006,25181,25294,113,0.449,74,39,21,85,H1
"Grayson County, KY",2006-2007,25294,25444,150,0.593,71,79,21,85,H1
"Grayson County, KY",2007-2008,25444,25558,114,0.448,85,29,21,85,H1
"Grayson County, KY",2008-2009,25558,25619,61,0.239,48,13,21,85,H1
"Grayson County, KY",2009-2010,25619,25791,172,0.671,9,163,21,85,H1
"Grayson County, KY",2010-2011,25791,25787,-4,-0.016,-5,1,21,85,H1
"Grayson County, KY",2011-2012,25787,25865,78,0.302,5,73,21,85,H1
"Grayson County, KY",2012-2013,25865,26033,168,0.65,47,121,21,85,H1
"Grayson County, KY",2013-2014,26033,26194,161,0.618,77,84,21,85,H1
"Grayson County, KY",2014-2015,26144,26221,77,0.295,66,11,21,85,H1
"Grayson County, KY",2015-2016,26221,26140,-81,-0.309,43,-124,21,85,H1
"Grayson County, KY",2016-2017,26140,26358,218,0.834,44,174,21,85,H1
"Green County, KY",2000-2001,11526,11566,40,0.347,-1,41,21,87,H1
"Green County, KY",2001-2002,11566,11543,-23,-0.199,10,-33,21,87,H1
"Green County, KY",2002-2003,11543,11557,14,0.121,-42,56,21,87,H1
"Green County, KY",2003-2004,11557,11408,-149,-1.289,-8,-141,21,87,H1
"Green County, KY",2004-2005,11408,11406,-2,-0.018,0,-2,21,87,H1
"Green County, KY",2005-2006,11406,11454,48,0.421,-9,57,21,87,H1
"Green County, KY",2006-2007,11454,11412,-42,-0.367,-13,-29,21,87,H1
"Green County, KY",2007-2008,11412,11432,20,0.175,-26,46,21,87,H1
"Green County, KY",2008-2009,11432,11359,-73,-0.639,-4,-69,21,87,H1
"Green County, KY",2009-2010,11359,11228,-131,-1.153,-16,-115,21,87,H1
"Green County, KY",2010-2011,11228,11204,-24,-0.214,-7,-17,21,87,H1
"Green County, KY",2011-2012,11204,11300,96,0.857,-2,98,21,87,H1
"Green County, KY",2012-2013,11300,11157,-143,-1.265,-32,-111,21,87,H1
"Green County, KY",2013-2014,11157,11043,-114,-1.022,-19,-95,21,87,H1
"Green County, KY",2014-2015,11047,11010,-37,-0.335,-21,-16,21,87,H1
"Green County, KY",2015-2016,11010,11001,-9,-0.082,-23,14,21,87,H1
"Green County, KY",2016-2017,11001,11065,64,0.582,-24,88,21,87,H1
"Greenup County, KY",2000-2001,36836,36804,-32,-0.087,38,-70,21,89,H1
"Greenup County, KY",2001-2002,36804,36600,-204,-0.554,-48,-156,21,89,H1
"Greenup County, KY",2002-2003,36600,36681,81,0.221,28,53,21,89,H1
"Greenup County, KY",2003-2004,36681,36579,-102,-0.278,22,-124,21,89,H1
"Greenup County, KY",2004-2005,36579,36530,-49,-0.134,62,-111,21,89,H1
"Greenup County, KY",2005-2006,36530,36827,297,0.813,22,275,21,89,H1
"Greenup County, KY",2006-2007,36827,36939,112,0.304,-20,132,21,89,H1
"Greenup County, KY",2007-2008,36939,37106,167,0.452,-46,213,21,89,H1
"Greenup County, KY",2008-2009,37106,37053,-53,-0.143,-24,-29,21,89,H1
"Greenup County, KY",2009-2010,37053,36909,-144,-0.389,-87,-57,21,89,H1
"Greenup County, KY",2010-2011,36909,36850,-59,-0.16,-43,-16,21,89,H1
"Greenup County, KY",2011-2012,36850,36718,-132,-0.358,-73,-59,21,89,H1
"Greenup County, KY",2012-2013,36718,36496,-222,-0.605,-34,-188,21,89,H1
"Greenup County, KY",2013-2014,36496,36308,-188,-0.515,-77,-111,21,89,H1
"Greenup County, KY",2014-2015,36299,36068,-231,-0.636,-48,-183,21,89,H1
"Greenup County, KY",2015-2016,36068,35795,-273,-0.757,-106,-167,21,89,H1
"Greenup County, KY",2016-2017,35795,35518,-277,-0.774,-108,-169,21,89,H1
"Hancock County, KY",2000-2001,8424,8431,7,0.083,62,-55,21,91,H1
"Hancock County, KY",2001-2002,8431,8424,-7,-0.083,27,-34,21,91,H1
"Hancock County, KY",2002-2003,8424,8426,2,0.024,32,-30,21,91,H1
"Hancock County, KY",2003-2004,8426,8389,-37,-0.439,46,-83,21,91,H1
"Hancock County, KY",2004-2005,8389,8508,119,1.419,51,68,21,91,H1
"Hancock County, KY",2005-2006,8508,8542,34,0.4,50,-16,21,91,H1
"Hancock County, KY",2006-2007,8542,8536,-6,-0.07,31,-37,21,91,H1
"Hancock County, KY",2007-2008,8536,8567,31,0.363,51,-20,21,91,H1
"Hancock County, KY",2008-2009,8567,8558,-9,-0.105,40,-49,21,91,H1
"Hancock County, KY",2009-2010,8558,8556,-2,-0.023,28,-30,21,91,H1
"Hancock County, KY",2010-2011,8556,8604,48,0.561,19,29,21,91,H1
"Hancock County, KY",2011-2012,8604,8671,67,0.779,48,19,21,91,H1
"Hancock County, KY",2012-2013,8671,8686,15,0.173,16,-1,21,91,H1
"Hancock County, KY",2013-2014,8686,8753,67,0.771,27,40,21,91,H1
"Hancock County, KY",2014-2015,8720,8692,-28,-0.321,29,-57,21,91,H1
"Hancock County, KY",2015-2016,8692,8737,45,0.518,49,-4,21,91,H1
"Hancock County, KY",2016-2017,8737,8801,64,0.733,51,13,21,91,H1
"Hardin County, KY",2000-2001,92919,93715,796,0.857,751,45,21,93,H1
"Hardin County, KY",2001-2002,93715,94136,421,0.449,707,-286,21,93,H1
"Hardin County, KY",2002-2003,94136,93929,-207,-0.22,865,-1072,21,93,H1
"Hardin County, KY",2003-2004,93929,95015,1086,1.156,757,329,21,93,H1
"Hardin County, KY",2004-2005,95015,96652,1637,1.723,896,741,21,93,H1
"Hardin County, KY",2005-2006,96652,97539,887,0.918,823,64,21,93,H1
"Hardin County, KY",2006-2007,97539,98728,1189,1.219,965,224,21,93,H1
"Hardin County, KY",2007-2008,98728,99926,1198,1.213,881,317,21,93,H1
"Hardin County, KY",2008-2009,99926,101254,1328,1.329,791,537,21,93,H1
"Hardin County, KY",2009-2010,101254,106995,5741,5.67,849,4892,21,93,H1
"Hardin County, KY",2010-2011,106995,107440,445,0.416,949,-504,21,93,H1
"Hardin County, KY",2011-2012,107440,107052,-388,-0.361,663,-1051,21,93,H1
"Hardin County, KY",2012-2013,107052,108073,1021,0.954,747,274,21,93,H1
"Hardin County, KY",2013-2014,108073,108266,193,0.179,674,-481,21,93,H1
"Hardin County, KY",2014-2015,108463,106439,-2024,-1.866,696,-2720,21,93,H1
"Hardin County, KY",2015-2016,106439,106893,454,0.427,467,-13,21,93,H1
"Hardin County, KY",2016-2017,106893,108071,1178,1.102,499,679,21,93,H1
"Harlan County, KY",2000-2001,32935,32184,-751,-2.28,-38,-713,21,95,H1
"Harlan County, KY",2001-2002,32184,31938,-246,-0.764,-64,-182,21,95,H1
"Harlan County, KY",2002-2003,31938,31291,-647,-2.026,1,-648,21,95,H1
"Harlan County, KY",2003-2004,31291,30614,-677,-2.164,-76,-601,21,95,H1
"Harlan County, KY",2004-2005,30614,30277,-337,-1.101,-83,-254,21,95,H1
"Harlan County, KY",2005-2006,30277,30113,-164,-0.542,15,-179,21,95,H1
"Harlan County, KY",2006-2007,30113,29969,-144,-0.478,36,-180,21,95,H1
"Harlan County, KY",2007-2008,29969,29591,-378,-1.261,-10,-368,21,95,H1
"Harlan County, KY",2008-2009,29591,29534,-57,-0.193,-39,-18,21,95,H1
"Harlan County, KY",2009-2010,29534,29238,-296,-1.002,-55,-241,21,95,H1
"Harlan County, KY",2010-2011,29238,29177,-61,-0.209,37,-98,21,95,H1
"Harlan County, KY",2011-2012,29177,28616,-561,-1.923,-39,-522,21,95,H1
"Harlan County, KY",2012-2013,28616,28527,-89,-0.311,5,-94,21,95,H1
"Harlan County, KY",2013-2014,28527,28163,-364,-1.276,19,-383,21,95,H1
"Harlan County, KY",2014-2015,28056,27703,-353,-1.258,-31,-322,21,95,H1
"Harlan County, KY",2015-2016,27703,27016,-687,-2.48,-83,-604,21,95,H1
"Harlan County, KY",2016-2017,27016,26713,-303,-1.122,-62,-241,21,95,H1
"Harrison County, KY",2000-2001,17997,18007,10,0.056,29,-19,21,97,H1
"Harrison County, KY",2001-2002,18007,18009,2,0.011,43,-41,21,97,H1
"Harrison County, KY",2002-2003,18009,18171,162,0.9,27,135,21,97,H1
"Harrison County, KY",2003-2004,18171,18233,62,0.341,38,24,21,97,H1
"Harrison County, KY",2004-2005,18233,18314,81,0.444,33,48,21,97,H1
"Harrison County, KY",2005-2006,18314,18483,169,0.923,28,141,21,97,H1
"Harrison County, KY",2006-2007,18483,18725,242,1.309,59,183,21,97,H1
"Harrison County, KY",2007-2008,18725,18876,151,0.806,48,103,21,97,H1
"Harrison County, KY",2008-2009,18876,18894,18,0.095,37,-19,21,97,H1
"Harrison County, KY",2009-2010,18894,18819,-75,-0.397,19,-94,21,97,H1
"Harrison County, KY",2010-2011,18819,18679,-140,-0.744,-21,-119,21,97,H1
"Harrison County, KY",2011-2012,18679,18592,-87,-0.466,-22,-65,21,97,H1
"Harrison County, KY",2012-2013,18592,18532,-60,-0.323,-4,-56,21,97,H1
"Harrison County, KY",2013-2014,18532,18592,60,0.324,-9,69,21,97,H1
"Harrison County, KY",2014-2015,18643,18763,120,0.644,34,86,21,97,H1
"Harrison County, KY",2015-2016,18763,18588,-175,-0.933,13,-188,21,97,H1
"Harrison County, KY",2016-2017,18588,18781,193,1.038,16,177,21,97,H1
"Hart County, KY",2000-2001,17535,17291,-244,-1.392,15,-259,21,99,H1
"Hart County, KY",2001-2002,17291,17573,282,1.631,52,230,21,99,H1
"Hart County, KY",2002-2003,17573,17741,168,0.956,71,97,21,99,H1
"Hart County, KY",2003-2004,17741,17821,80,0.451,36,44,21,99,H1
"Hart County, KY",2004-2005,17821,18040,219,1.229,25,194,21,99,H1
"Hart County, KY",2005-2006,18040,18109,69,0.382,31,38,21,99,H1
"Hart County, KY",2006-2007,18109,18172,63,0.348,36,27,21,99,H1
"Hart County, KY",2007-2008,18172,18320,148,0.814,38,110,21,99,H1
"Hart County, KY",2008-2009,18320,18197,-123,-0.671,56,-179,21,99,H1
"Hart County, KY",2009-2010,18197,18218,21,0.115,27,-6,21,99,H1
"Hart County, KY",2010-2011,18218,18348,130,0.714,85,45,21,99,H1
"Hart County, KY",2011-2012,18348,18433,85,0.463,57,28,21,99,H1
"Hart County, KY",2012-2013,18433,18539,106,0.575,10,96,21,99,H1
"Hart County, KY",2013-2014,18539,18597,58,0.313,54,4,21,99,H1
"Hart County, KY",2014-2015,18533,18454,-79,-0.426,34,-113,21,99,H1
"Hart County, KY",2015-2016,18454,18527,73,0.396,59,14,21,99,H1
"Hart County, KY",2016-2017,18527,18757,230,1.241,61,169,21,99,H1
"Henderson County, KY",2000-2001,44827,44865,38,0.085,139,-101,21,101,H1
"Henderson County, KY",2001-2002,44865,45091,226,0.504,132,94,21,101,H1
"Henderson County, KY",2002-2003,45091,45214,123,0.273,192,-69,21,101,H1
"Henderson County, KY",2003-2004,45214,45362,148,0.327,193,-45,21,101,H1
"Henderson County, KY",2004-2005,45362,45521,159,0.351,158,1,21,101,H1
"Henderson County, KY",2005-2006,45521,45633,112,0.246,193,-81,21,101,H1
"Henderson County, KY",2006-2007,45633,45696,63,0.138,167,-104,21,101,H1
"Henderson County, KY",2007-2008,45696,46046,350,0.766,204,146,21,101,H1
"Henderson County, KY",2008-2009,46046,46037,-9,-0.02,165,-174,21,101,H1
"Henderson County, KY",2009-2010,46037,46270,233,0.506,133,100,21,101,H1
"Henderson County, KY",2010-2011,46270,46384,114,0.246,70,44,21,101,H1
"Henderson County, KY",2011-2012,46384,46462,78,0.168,98,-20,21,101,H1
"Henderson County, KY",2012-2013,46462,46389,-73,-0.157,122,-195,21,101,H1
"Henderson County, KY",2013-2014,46389,46467,78,0.168,44,34,21,101,H1
"Henderson County, KY",2014-2015,46432,46407,-25,-0.054,46,-71,21,101,H1
"Henderson County, KY",2015-2016,46407,46244,-163,-0.351,49,-212,21,101,H1
"Henderson County, KY",2016-2017,46244,45928,-316,-0.683,22,-338,21,101,H1
"Henry County, KY",2000-2001,15032,15113,81,0.539,64,17,21,103,H1
"Henry County, KY",2001-2002,15113,15107,-6,-0.04,34,-40,21,103,H1
"Henry County, KY",2002-2003,15107,15259,152,1.006,69,83,21,103,H1
"Henry County, KY",2003-2004,15259,15327,68,0.446,57,11,21,103,H1
"Henry County, KY",2004-2005,15327,15368,41,0.268,41,0,21,103,H1
"Henry County, KY",2005-2006,15368,15475,107,0.696,60,47,21,103,H1
"Henry County, KY",2006-2007,15475,15465,-10,-0.065,72,-82,21,103,H1
"Henry County, KY",2007-2008,15465,15511,46,0.297,44,2,21,103,H1
"Henry County, KY",2008-2009,15511,15530,19,0.122,40,-21,21,103,H1
"Henry County, KY",2009-2010,15530,15407,-123,-0.792,25,-148,21,103,H1
"Henry County, KY",2010-2011,15407,15382,-25,-0.162,8,-33,21,103,H1
"Henry County, KY",2011-2012,15382,15342,-40,-0.26,14,-54,21,103,H1
"Henry County, KY",2012-2013,15342,15431,89,0.58,22,67,21,103,H1
"Henry County, KY",2013-2014,15431,15572,141,0.914,6,135,21,103,H1
"Henry County, KY",2014-2015,15573,15620,47,0.302,34,13,21,103,H1
"Henry County, KY",2015-2016,15620,15853,233,1.492,4,229,21,103,H1
"Henry County, KY",2016-2017,15853,16006,153,0.965,20,133,21,103,H1
"Hickman County, KY",2000-2001,5240,5234,-6,-0.115,-17,11,21,105,H1
"Hickman County, KY",2001-2002,5234,5225,-9,-0.172,-17,8,21,105,H1
"Hickman County, KY",2002-2003,5225,5186,-39,-0.746,-10,-29,21,105,H1
"Hickman County, KY",2003-2004,5186,5093,-93,-1.793,-19,-74,21,105,H1
"Hickman County, KY",2004-2005,5093,5061,-32,-0.628,-15,-17,21,105,H1
"Hickman County, KY",2005-2006,5061,5002,-59,-1.166,-26,-33,21,105,H1
"Hickman County, KY",2006-2007,5002,4955,-47,-0.94,-8,-39,21,105,H1
"Hickman County, KY",2007-2008,4955,4957,2,0.04,-6,8,21,105,H1
"Hickman County, KY",2008-2009,4957,4945,-12,-0.242,-14,2,21,105,H1
"Hickman County, KY",2009-2010,4945,4883,-62,-1.254,-27,-35,21,105,H1
"Hickman County, KY",2010-2011,4883,4823,-60,-1.229,-23,-37,21,105,H1
"Hickman County, KY",2011-2012,4823,4764,-59,-1.223,-9,-50,21,105,H1
"Hickman County, KY",2012-2013,4764,4748,-16,-0.336,-17,1,21,105,H1
"Hickman County, KY",2013-2014,4748,4734,-14,-0.295,-34,20,21,105,H1
"Hickman County, KY",2014-2015,4707,4612,-95,-2.018,-41,-54,21,105,H1
"Hickman County, KY",2015-2016,4612,4612,0,0,-3,3,21,105,H1
"Hickman County, KY",2016-2017,4612,4520,-92,-1.995,-26,-66,21,105,H1
"Hopkins County, KY",2000-2001,46463,46148,-315,-0.678,40,-355,21,107,H1
"Hopkins County, KY",2001-2002,46148,46374,226,0.49,2,224,21,107,H1
"Hopkins County, KY",2002-2003,46374,46668,294,0.634,-50,344,21,107,H1
"Hopkins County, KY",2003-2004,46668,46759,91,0.195,40,51,21,107,H1
"Hopkins County, KY",2004-2005,46759,46640,-119,-0.254,14,-133,21,107,H1
"Hopkins County, KY",2005-2006,46640,46727,87,0.187,16,71,21,107,H1
"Hopkins County, KY",2006-2007,46727,46834,107,0.229,120,-13,21,107,H1
"Hopkins County, KY",2007-2008,46834,47051,217,0.463,57,160,21,107,H1
"Hopkins County, KY",2008-2009,47051,46921,-130,-0.276,11,-141,21,107,H1
"Hopkins County, KY",2009-2010,46921,46890,-31,-0.066,-9,-22,21,107,H1
"Hopkins County, KY",2010-2011,46890,46896,6,0.013,52,-46,21,107,H1
"Hopkins County, KY",2011-2012,46896,46702,-194,-0.414,-49,-145,21,107,H1
"Hopkins County, KY",2012-2013,46702,46556,-146,-0.313,-69,-77,21,107,H1
"Hopkins County, KY",2013-2014,46556,46376,-180,-0.387,-5,-175,21,107,H1
"Hopkins County, KY",2014-2015,46304,46222,-82,-0.177,5,-87,21,107,H1
"Hopkins County, KY",2015-2016,46222,45708,-514,-1.112,1,-515,21,107,H1
"Hopkins County, KY",2016-2017,45708,45547,-161,-0.352,3,-164,21,107,H1
"Jackson County, KY",2000-2001,13507,13611,104,0.77,32,72,21,109,H1
"Jackson County, KY",2001-2002,13611,13559,-52,-0.382,-14,-38,21,109,H1
"Jackson County, KY",2002-2003,13559,13512,-47,-0.347,20,-67,21,109,H1
"Jackson County, KY",2003-2004,13512,13476,-36,-0.266,29,-65,21,109,H1
"Jackson County, KY",2004-2005,13476,13596,120,0.89,54,66,21,109,H1
"Jackson County, KY",2005-2006,13596,13577,-19,-0.14,41,-60,21,109,H1
"Jackson County, KY",2006-2007,13577,13606,29,0.214,-7,36,21,109,H1
"Jackson County, KY",2007-2008,13606,13650,44,0.323,-50,94,21,109,H1
"Jackson County, KY",2008-2009,13650,13463,-187,-1.37,7,-194,21,109,H1
"Jackson County, KY",2009-2010,13463,13491,28,0.208,-18,46,21,109,H1
"Jackson County, KY",2010-2011,13491,13397,-94,-0.697,-18,-76,21,109,H1
"Jackson County, KY",2011-2012,13397,13298,-99,-0.739,-15,-84,21,109,H1
"Jackson County, KY",2012-2013,13298,13376,78,0.587,-7,85,21,109,H1
"Jackson County, KY",2013-2014,13376,13289,-87,-0.65,0,-87,21,109,H1
"Jackson County, KY",2014-2015,13324,13352,28,0.21,20,8,21,109,H1
"Jackson County, KY",2015-2016,13352,13373,21,0.157,18,3,21,109,H1
"Jackson County, KY",2016-2017,13373,13431,58,0.434,15,43,21,109,H1
"Jefferson County, KY",2000-2001,694399,697159,2760,0.397,2686,74,21,111,H1
"Jefferson County, KY",2001-2002,697159,699810,2651,0.38,2682,-31,21,111,H1
"Jefferson County, KY",2002-2003,699810,703970,4160,0.594,2667,1493,21,111,H1
"Jefferson County, KY",2003-2004,703970,706828,2858,0.406,2885,-27,21,111,H1
"Jefferson County, KY",2004-2005,706828,710018,3190,0.451,3073,117,21,111,H1
"Jefferson County, KY",2005-2006,710018,715149,5131,0.723,3156,1975,21,111,H1
"Jefferson County, KY",2006-2007,715149,723040,7891,1.103,3952,3939,21,111,H1
"Jefferson County, KY",2007-2008,723040,730194,7154,0.989,3324,3830,21,111,H1
"Jefferson County, KY",2008-2009,730194,736705,6511,0.892,2842,3669,21,111,H1
"Jefferson County, KY",2009-2010,736705,742227,5522,0.75,3375,2147,21,111,H1
"Jefferson County, KY",2010-2011,742227,746562,4335,0.584,2843,1492,21,111,H1
"Jefferson County, KY",2011-2012,746562,751327,4765,0.638,2703,2062,21,111,H1
"Jefferson County, KY",2012-2013,751327,757282,5955,0.793,2767,3188,21,111,H1
"Jefferson County, KY",2013-2014,757282,760026,2744,0.362,2817,-73,21,111,H1
"Jefferson County, KY",2014-2015,760621,763623,3002,0.395,2780,222,21,111,H1
"Jefferson County, KY",2015-2016,763623,767335,3712,0.486,2356,1356,21,111,H1
"Jefferson County, KY",2016-2017,767335,771158,3823,0.498,2558,1265,21,111,H1
"Jessamine County, KY",2000-2001,39216,39819,603,1.538,256,347,21,113,H1
"Jessamine County, KY",2001-2002,39819,40760,941,2.363,200,741,21,113,H1
"Jessamine County, KY",2002-2003,40760,41545,785,1.926,228,557,21,113,H1
"Jessamine County, KY",2003-2004,41545,42348,803,1.933,303,500,21,113,H1
"Jessamine County, KY",2004-2005,42348,43503,1155,2.727,263,892,21,113,H1
"Jessamine County, KY",2005-2006,43503,45024,1521,3.496,361,1160,21,113,H1
"Jessamine County, KY",2006-2007,45024,46044,1020,2.265,375,645,21,113,H1
"Jessamine County, KY",2007-2008,46044,47429,1385,3.008,315,1070,21,113,H1
"Jessamine County, KY",2008-2009,47429,48153,724,1.526,312,412,21,113,H1
"Jessamine County, KY",2009-2010,48153,48678,525,1.09,226,299,21,113,H1
"Jessamine County, KY",2010-2011,48678,48865,187,0.384,296,-109,21,113,H1
"Jessamine County, KY",2011-2012,48865,49563,698,1.428,312,386,21,113,H1
"Jessamine County, KY",2012-2013,49563,50084,521,1.051,276,245,21,113,H1
"Jessamine County, KY",2013-2014,50084,50815,731,1.46,275,456,21,113,H1
"Jessamine County, KY",2014-2015,50988,51961,973,1.908,310,663,21,113,H1
"Jessamine County, KY",2015-2016,51961,52255,294,0.566,241,53,21,113,H1
"Jessamine County, KY",2016-2017,52255,53375,1120,2.143,246,874,21,113,H1
"Johnson County, KY",2000-2001,23315,23230,-85,-0.365,44,-129,21,115,H1
"Johnson County, KY",2001-2002,23230,23156,-74,-0.319,36,-110,21,115,H1
"Johnson County, KY",2002-2003,23156,23138,-18,-0.078,51,-69,21,115,H1
"Johnson County, KY",2003-2004,23138,23229,91,0.393,24,67,21,115,H1
"Johnson County, KY",2004-2005,23229,23332,103,0.443,25,78,21,115,H1
"Johnson County, KY",2005-2006,23332,23382,50,0.214,19,31,21,115,H1
"Johnson County, KY",2006-2007,23382,23354,-28,-0.12,30,-58,21,115,H1
"Johnson County, KY",2007-2008,23354,23256,-98,-0.42,-16,-82,21,115,H1
"Johnson County, KY",2008-2009,23256,23220,-36,-0.155,21,-57,21,115,H1
"Johnson County, KY",2009-2010,23220,23385,165,0.711,-8,173,21,115,H1
"Johnson County, KY",2010-2011,23385,23424,39,0.167,21,18,21,115,H1
"Johnson County, KY",2011-2012,23424,23415,-9,-0.038,27,-36,21,115,H1
"Johnson County, KY",2012-2013,23415,23464,49,0.209,24,25,21,115,H1
"Johnson County, KY",2013-2014,23464,23262,-202,-0.861,48,-250,21,115,H1
"Johnson County, KY",2014-2015,23239,23175,-64,-0.275,-3,-61,21,115,H1
"Johnson County, KY",2015-2016,23175,22870,-305,-1.316,-63,-242,21,115,H1
"Johnson County, KY",2016-2017,22870,22594,-276,-1.207,-55,-221,21,115,H1
"Kenton County, KY",2000-2001,151658,151974,316,0.208,1062,-746,21,117,H1
"Kenton County, KY",2001-2002,151974,151777,-197,-0.13,830,-1027,21,117,H1
"Kenton County, KY",2002-2003,151777,152591,814,0.536,1027,-213,21,117,H1
"Kenton County, KY",2003-2004,152591,153138,547,0.358,1072,-525,21,117,H1
"Kenton County, KY",2004-2005,153138,153769,631,0.412,1022,-391,21,117,H1
"Kenton County, KY",2005-2006,153769,155557,1788,1.163,1098,690,21,117,H1
"Kenton County, KY",2006-2007,155557,157240,1683,1.082,1164,519,21,117,H1
"Kenton County, KY",2007-2008,157240,158258,1018,0.647,1108,-90,21,117,H1
"Kenton County, KY",2008-2009,158258,159239,981,0.62,1045,-64,21,117,H1
"Kenton County, KY",2009-2010,159239,160023,784,0.492,1198,-414,21,117,H1
"Kenton County, KY",2010-2011,160023,160583,560,0.35,1043,-483,21,117,H1
"Kenton County, KY",2011-2012,160583,161671,1088,0.678,892,196,21,117,H1
"Kenton County, KY",2012-2013,161671,163367,1696,1.049,1043,653,21,117,H1
"Kenton County, KY",2013-2014,163367,163929,562,0.344,987,-425,21,117,H1
"Kenton County, KY",2014-2015,164045,165012,967,0.589,879,88,21,117,H1
"Kenton County, KY",2015-2016,165012,164596,-416,-0.252,738,-1154,21,117,H1
"Kenton County, KY",2016-2017,164596,165399,803,0.488,798,5,21,117,H1
"Knott County, KY",2000-2001,17593,17411,-182,-1.035,10,-192,21,119,H1
"Knott County, KY",2001-2002,17411,17457,46,0.264,-3,49,21,119,H1
"Knott County, KY",2002-2003,17457,17294,-163,-0.934,7,-170,21,119,H1
"Knott County, KY",2003-2004,17294,17093,-201,-1.162,36,-237,21,119,H1
"Knott County, KY",2004-2005,17093,17089,-4,-0.023,-3,-1,21,119,H1
"Knott County, KY",2005-2006,17089,16837,-252,-1.475,-12,-240,21,119,H1
"Knott County, KY",2006-2007,16837,16640,-197,-1.17,-6,-191,21,119,H1
"Knott County, KY",2007-2008,16640,16616,-24,-0.144,-18,-6,21,119,H1
"Knott County, KY",2008-2009,16616,16543,-73,-0.439,19,-92,21,119,H1
"Knott County, KY",2009-2010,16543,16361,-182,-1.1,-9,-173,21,119,H1
"Knott County, KY",2010-2011,16361,16290,-71,-0.434,-26,-45,21,119,H1
"Knott County, KY",2011-2012,16290,16087,-203,-1.246,-68,-135,21,119,H1
"Knott County, KY",2012-2013,16087,16064,-23,-0.143,5,-28,21,119,H1
"Knott County, KY",2013-2014,16064,15892,-172,-1.071,-6,-166,21,119,H1
"Knott County, KY",2014-2015,15913,15693,-220,-1.383,4,-224,21,119,H1
"Knott County, KY",2015-2016,15693,15510,-183,-1.166,7,-190,21,119,H1
"Knott County, KY",2016-2017,15510,15291,-219,-1.412,-30,-189,21,119,H1
"Knox County, KY",2000-2001,31770,31431,-339,-1.067,95,-434,21,121,H1
"Knox County, KY",2001-2002,31431,31298,-133,-0.423,71,-204,21,121,H1
"Knox County, KY",2002-2003,31298,31376,78,0.249,128,-50,21,121,H1
"Knox County, KY",2003-2004,31376,31371,-5,-0.016,126,-131,21,121,H1
"Knox County, KY",2004-2005,31371,31570,199,0.634,227,-28,21,121,H1
"Knox County, KY",2005-2006,31570,31599,29,0.092,122,-93,21,121,H1
"Knox County, KY",2006-2007,31599,31668,69,0.218,73,-4,21,121,H1
"Knox County, KY",2007-2008,31668,31746,78,0.246,60,18,21,121,H1
"Knox County, KY",2008-2009,31746,31920,174,0.548,126,48,21,121,H1
"Knox County, KY",2009-2010,31920,31867,-53,-0.166,102,-155,21,121,H1
"Knox County, KY",2010-2011,31867,32081,214,0.672,-8,222,21,121,H1
"Knox County, KY",2011-2012,32081,31700,-381,-1.188,63,-444,21,121,H1
"Knox County, KY",2012-2013,31700,31837,137,0.432,60,77,21,121,H1
"Knox County, KY",2013-2014,31837,31798,-39,-0.122,38,-77,21,121,H1
"Knox County, KY",2014-2015,31727,31730,3,0.009,-7,10,21,121,H1
"Knox County, KY",2015-2016,31730,31324,-406,-1.28,-101,-305,21,121,H1
"Knox County, KY",2016-2017,31324,31227,-97,-0.31,-98,1,21,121,H1
"Larue County, KY",2000-2001,13398,13436,38,0.284,29,9,21,123,H1
"Larue County, KY",2001-2002,13436,13536,100,0.744,18,82,21,123,H1
"Larue County, KY",2002-2003,13536,13455,-81,-0.598,2,-83,21,123,H1
"Larue County, KY",2003-2004,13455,13615,160,1.189,1,159,21,123,H1
"Larue County, KY",2004-2005,13615,13793,178,1.307,-19,197,21,123,H1
"Larue County, KY",2005-2006,13793,13934,141,1.022,40,101,21,123,H1
"Larue County, KY",2006-2007,13934,14008,74,0.531,17,57,21,123,H1
"Larue County, KY",2007-2008,14008,14100,92,0.657,-5,97,21,123,H1
"Larue County, KY",2008-2009,14100,14172,72,0.511,2,70,21,123,H1
"Larue County, KY",2009-2010,14172,14199,27,0.191,-13,40,21,123,H1
"Larue County, KY",2010-2011,14199,14206,7,0.049,-44,51,21,123,H1
"Larue County, KY",2011-2012,14206,14085,-121,-0.852,12,-133,21,123,H1
"Larue County, KY",2012-2013,14085,14076,-9,-0.064,-17,8,21,123,H1
"Larue County, KY",2013-2014,14076,14180,104,0.739,-4,108,21,123,H1
"Larue County, KY",2014-2015,14172,14241,69,0.487,23,46,21,123,H1
"Larue County, KY",2015-2016,14241,14033,-208,-1.461,-3,-205,21,123,H1
"Larue County, KY",2016-2017,14033,14205,172,1.226,-10,182,21,123,H1
"Laurel County, KY",2000-2001,52920,53604,684,1.293,298,386,21,125,H1
"Laurel County, KY",2001-2002,53604,54452,848,1.582,268,580,21,125,H1
"Laurel County, KY",2002-2003,54452,55371,919,1.688,284,635,21,125,H1
"Laurel County, KY",2003-2004,55371,55811,440,0.795,220,220,21,125,H1
"Laurel County, KY",2004-2005,55811,56465,654,1.172,232,422,21,125,H1
"Laurel County, KY",2005-2006,56465,57239,774,1.371,280,494,21,125,H1
"Laurel County, KY",2006-2007,57239,57938,699,1.221,203,496,21,125,H1
"Laurel County, KY",2007-2008,57938,58142,204,0.352,206,-2,21,125,H1
"Laurel County, KY",2008-2009,58142,58513,371,0.638,189,182,21,125,H1
"Laurel County, KY",2009-2010,58513,59017,504,0.861,131,373,21,125,H1
"Laurel County, KY",2010-2011,59017,59377,360,0.61,156,204,21,125,H1
"Laurel County, KY",2011-2012,59377,59587,210,0.354,122,88,21,125,H1
"Laurel County, KY",2012-2013,59587,59681,94,0.158,141,-47,21,125,H1
"Laurel County, KY",2013-2014,59681,60015,334,0.56,119,215,21,125,H1
"Laurel County, KY",2014-2015,60036,60094,58,0.097,116,-58,21,125,H1
"Laurel County, KY",2015-2016,60094,59990,-104,-0.173,90,-194,21,125,H1
"Laurel County, KY",2016-2017,59990,60174,184,0.307,48,136,21,125,H1
"Lawrence County, KY",2000-2001,15553,15566,13,0.084,34,-21,21,127,H1
"Lawrence County, KY",2001-2002,15566,15625,59,0.379,2,57,21,127,H1
"Lawrence County, KY",2002-2003,15625,15558,-67,-0.429,5,-72,21,127,H1
"Lawrence County, KY",2003-2004,15558,15664,106,0.681,3,103,21,127,H1
"Lawrence County, KY",2004-2005,15664,15756,92,0.587,44,48,21,127,H1
"Lawrence County, KY",2005-2006,15756,15766,10,0.063,30,-20,21,127,H1
"Lawrence County, KY",2006-2007,15766,15815,49,0.311,72,-23,21,127,H1
"Lawrence County, KY",2007-2008,15815,15867,52,0.329,55,-3,21,127,H1
"Lawrence County, KY",2008-2009,15867,15889,22,0.139,10,12,21,127,H1
"Lawrence County, KY",2009-2010,15889,15879,-10,-0.063,1,-11,21,127,H1
"Lawrence County, KY",2010-2011,15879,15908,29,0.183,5,24,21,127,H1
"Lawrence County, KY",2011-2012,15908,15827,-81,-0.509,8,-89,21,127,H1
"Lawrence County, KY",2012-2013,15827,15832,5,0.032,-25,30,21,127,H1
"Lawrence County, KY",2013-2014,15832,15804,-28,-0.177,-15,-13,21,127,H1
"Lawrence County, KY",2014-2015,15783,15745,-38,-0.241,-25,-13,21,127,H1
"Lawrence County, KY",2015-2016,15745,15846,101,0.641,-9,110,21,127,H1
"Lawrence County, KY",2016-2017,15846,15719,-127,-0.801,-29,-98,21,127,H1
"Lee County, KY",2000-2001,7929,7922,-7,-0.088,-17,10,21,129,H1
"Lee County, KY",2001-2002,7922,7971,49,0.619,-36,85,21,129,H1
"Lee County, KY",2002-2003,7971,8015,44,0.552,-12,56,21,129,H1
"Lee County, KY",2003-2004,8015,7950,-65,-0.811,-26,-39,21,129,H1
"Lee County, KY",2004-2005,7950,7823,-127,-1.597,-14,-113,21,129,H1
"Lee County, KY",2005-2006,7823,7850,27,0.345,-10,37,21,129,H1
"Lee County, KY",2006-2007,7850,7855,5,0.064,-8,13,21,129,H1
"Lee County, KY",2007-2008,7855,7859,4,0.051,-42,46,21,129,H1
"Lee County, KY",2008-2009,7859,7885,26,0.331,-31,57,21,129,H1
"Lee County, KY",2009-2010,7885,7714,-171,-2.169,-42,-129,21,129,H1
"Lee County, KY",2010-2011,7714,7791,77,0.998,-29,106,21,129,H1
"Lee County, KY",2011-2012,7791,7646,-145,-1.861,-41,-104,21,129,H1
"Lee County, KY",2012-2013,7646,7659,13,0.17,-14,27,21,129,H1
"Lee County, KY",2013-2014,7659,7594,-65,-0.849,-22,-43,21,129,H1
"Lee County, KY",2014-2015,6777,6752,-25,-0.369,-38,13,21,129,H1
"Lee County, KY",2015-2016,6752,6598,-154,-2.281,-14,-140,21,129,H1
"Lee County, KY",2016-2017,6598,6570,-28,-0.424,-36,8,21,129,H1
"Leslie County, KY",2000-2001,12371,12183,-188,-1.52,22,-210,21,131,H1
"Leslie County, KY",2001-2002,12183,12156,-27,-0.222,8,-35,21,131,H1
"Leslie County, KY",2002-2003,12156,12010,-146,-1.201,3,-149,21,131,H1
"Leslie County, KY",2003-2004,12010,11820,-190,-1.582,-36,-154,21,131,H1
"Leslie County, KY",2004-2005,11820,11797,-23,-0.195,17,-40,21,131,H1
"Leslie County, KY",2005-2006,11797,11642,-155,-1.314,6,-161,21,131,H1
"Leslie County, KY",2006-2007,11642,11585,-57,-0.49,36,-93,21,131,H1
"Leslie County, KY",2007-2008,11585,11465,-120,-1.036,2,-122,21,131,H1
"Leslie County, KY",2008-2009,11465,11361,-104,-0.907,-5,-99,21,131,H1
"Leslie County, KY",2009-2010,11361,11290,-71,-0.625,-10,-61,21,131,H1
"Leslie County, KY",2010-2011,11290,11281,-9,-0.08,-14,5,21,131,H1
"Leslie County, KY",2011-2012,11281,11144,-137,-1.214,6,-143,21,131,H1
"Leslie County, KY",2012-2013,11144,11005,-139,-1.247,-25,-114,21,131,H1
"Leslie County, KY",2013-2014,11005,10918,-87,-0.791,-21,-66,21,131,H1
"Leslie County, KY",2014-2015,10882,10711,-171,-1.571,-44,-127,21,131,H1
"Leslie County, KY",2015-2016,10711,10439,-272,-2.539,-26,-246,21,131,H1
"Leslie County, KY",2016-2017,10439,10334,-105,-1.006,-35,-70,21,131,H1
"Letcher County, KY",2000-2001,25213,24862,-351,-1.392,-43,-308,21,133,H1
"Letcher County, KY",2001-2002,24862,24914,52,0.209,-5,57,21,133,H1
"Letcher County, KY",2002-2003,24914,24925,11,0.044,-10,21,21,133,H1
"Letcher County, KY",2003-2004,24925,24742,-183,-0.734,10,-193,21,133,H1
"Letcher County, KY",2004-2005,24742,24585,-157,-0.635,28,-185,21,133,H1
"Letcher County, KY",2005-2006,24585,24534,-51,-0.207,40,-91,21,133,H1
"Letcher County, KY",2006-2007,24534,24499,-35,-0.143,19,-54,21,133,H1
"Letcher County, KY",2007-2008,24499,24363,-136,-0.555,-5,-131,21,133,H1
"Letcher County, KY",2008-2009,24363,24364,1,0.004,-25,26,21,133,H1
"Letcher County, KY",2009-2010,24364,24571,207,0.85,-27,234,21,133,H1
"Letcher County, KY",2010-2011,24571,24436,-135,-0.549,-20,-115,21,133,H1
"Letcher County, KY",2011-2012,24436,23946,-490,-2.005,-31,-459,21,133,H1
"Letcher County, KY",2012-2013,23946,23513,-433,-1.808,-27,-406,21,133,H1
"Letcher County, KY",2013-2014,23513,23359,-154,-0.655,-39,-115,21,133,H1
"Letcher County, KY",2014-2015,23365,23123,-242,-1.036,-26,-216,21,133,H1
"Letcher County, KY",2015-2016,23123,22749,-374,-1.617,-72,-302,21,133,H1
"Letcher County, KY",2016-2017,22749,22339,-410,-1.802,-60,-350,21,133,H1
"Lewis County, KY",2000-2001,14111,13990,-121,-0.857,46,-167,21,135,H1
"Lewis County, KY",2001-2002,13990,13728,-262,-1.873,-20,-242,21,135,H1
"Lewis County, KY",2002-2003,13728,13710,-18,-0.131,-6,-12,21,135,H1
"Lewis County, KY",2003-2004,13710,13827,117,0.853,7,110,21,135,H1
"Lewis County, KY",2004-2005,13827,13861,34,0.246,22,12,21,135,H1
"Lewis County, KY",2005-2006,13861,14010,149,1.075,55,94,21,135,H1
"Lewis County, KY",2006-2007,14010,14069,59,0.421,77,-18,21,135,H1
"Lewis County, KY",2007-2008,14069,13997,-72,-0.512,19,-91,21,135,H1
"Lewis County, KY",2008-2009,13997,13915,-82,-0.586,11,-93,21,135,H1
"Lewis County, KY",2009-2010,13915,13854,-61,-0.438,5,-66,21,135,H1
"Lewis County, KY",2010-2011,13854,13864,10,0.072,10,0,21,135,H1
"Lewis County, KY",2011-2012,13864,13842,-22,-0.159,27,-49,21,135,H1
"Lewis County, KY",2012-2013,13842,13799,-43,-0.311,33,-76,21,135,H1
"Lewis County, KY",2013-2014,13799,13880,81,0.587,33,48,21,135,H1
"Lewis County, KY",2014-2015,13835,13682,-153,-1.106,27,-180,21,135,H1
"Lewis County, KY",2015-2016,13682,13475,-207,-1.513,-15,-192,21,135,H1
"Lewis County, KY",2016-2017,13475,13339,-136,-1.009,-2,-134,21,135,H1
"Lincoln County, KY",2000-2001,23410,23704,294,1.256,114,180,21,137,H1
"Lincoln County, KY",2001-2002,23704,23845,141,0.595,81,60,21,137,H1
"Lincoln County, KY",2002-2003,23845,24109,264,1.107,65,199,21,137,H1
"Lincoln County, KY",2003-2004,24109,24309,200,0.83,99,101,21,137,H1
"Lincoln County, KY",2004-2005,24309,24719,410,1.687,131,279,21,137,H1
"Lincoln County, KY",2005-2006,24719,24838,119,0.481,121,-2,21,137,H1
"Lincoln County, KY",2006-2007,24838,24875,37,0.149,96,-59,21,137,H1
"Lincoln County, KY",2007-2008,24875,24664,-211,-0.848,73,-284,21,137,H1
"Lincoln County, KY",2008-2009,24664,24776,112,0.454,63,49,21,137,H1
"Lincoln County, KY",2009-2010,24776,24756,-20,-0.081,35,-55,21,137,H1
"Lincoln County, KY",2010-2011,24756,24709,-47,-0.19,74,-121,21,137,H1
"Lincoln County, KY",2011-2012,24709,24408,-301,-1.218,15,-316,21,137,H1
"Lincoln County, KY",2012-2013,24408,24413,5,0.02,55,-50,21,137,H1
"Lincoln County, KY",2013-2014,24413,24445,32,0.131,52,-20,21,137,H1
"Lincoln County, KY",2014-2015,24484,24463,-21,-0.086,83,-104,21,137,H1
"Lincoln County, KY",2015-2016,24463,24346,-117,-0.478,8,-125,21,137,H1
"Lincoln County, KY",2016-2017,24346,24456,110,0.452,32,78,21,137,H1
"Livingston County, KY",2000-2001,9811,9795,-16,-0.163,6,-22,21,139,H1
"Livingston County, KY",2001-2002,9795,9742,-53,-0.541,-37,-16,21,139,H1
"Livingston County, KY",2002-2003,9742,9656,-86,-0.883,-21,-65,21,139,H1
"Livingston County, KY",2003-2004,9656,9589,-67,-0.694,-38,-29,21,139,H1
"Livingston County, KY",2004-2005,9589,9650,61,0.636,-4,65,21,139,H1
"Livingston County, KY",2005-2006,9650,9594,-56,-0.58,-5,-51,21,139,H1
"Livingston County, KY",2006-2007,9594,9508,-86,-0.896,-14,-72,21,139,H1
"Livingston County, KY",2007-2008,9508,9458,-50,-0.526,5,-55,21,139,H1
"Livingston County, KY",2008-2009,9458,9476,18,0.19,-13,31,21,139,H1
"Livingston County, KY",2009-2010,9476,9538,62,0.654,-24,86,21,139,H1
"Livingston County, KY",2010-2011,9538,9505,-33,-0.346,-41,8,21,139,H1
"Livingston County, KY",2011-2012,9505,9447,-58,-0.61,-18,-40,21,139,H1
"Livingston County, KY",2012-2013,9447,9368,-79,-0.836,-2,-77,21,139,H1
"Livingston County, KY",2013-2014,9368,9359,-9,-0.096,-11,2,21,139,H1
"Livingston County, KY",2014-2015,9355,9316,-39,-0.417,-8,-31,21,139,H1
"Livingston County, KY",2015-2016,9316,9215,-101,-1.084,-38,-63,21,139,H1
"Livingston County, KY",2016-2017,9215,9269,54,0.586,-40,94,21,139,H1
"Logan County, KY",2000-2001,26654,26609,-45,-0.169,131,-176,21,141,H1
"Logan County, KY",2001-2002,26609,26615,6,0.023,55,-49,21,141,H1
"Logan County, KY",2002-2003,26615,26533,-82,-0.308,44,-126,21,141,H1
"Logan County, KY",2003-2004,26533,26632,99,0.373,54,45,21,141,H1
"Logan County, KY",2004-2005,26632,26721,89,0.334,132,-43,21,141,H1
"Logan County, KY",2005-2006,26721,26768,47,0.176,72,-25,21,141,H1
"Logan County, KY",2006-2007,26768,26911,143,0.534,91,52,21,141,H1
"Logan County, KY",2007-2008,26911,26802,-109,-0.405,60,-169,21,141,H1
"Logan County, KY",2008-2009,26802,26872,70,0.261,63,7,21,141,H1
"Logan County, KY",2009-2010,26872,26853,-19,-0.071,63,-82,21,141,H1
"Logan County, KY",2010-2011,26853,26828,-25,-0.093,35,-60,21,141,H1
"Logan County, KY",2011-2012,26828,26703,-125,-0.466,36,-161,21,141,H1
"Logan County, KY",2012-2013,26703,26968,265,0.992,106,159,21,141,H1
"Logan County, KY",2013-2014,26968,26867,-101,-0.375,112,-213,21,141,H1
"Logan County, KY",2014-2015,26882,26910,28,0.104,126,-98,21,141,H1
"Logan County, KY",2015-2016,26910,26657,-253,-0.94,54,-307,21,141,H1
"Logan County, KY",2016-2017,26657,27060,403,1.512,80,323,21,141,H1
"Lyon County, KY",2000-2001,8114,8149,35,0.431,-76,111,21,143,H1
"Lyon County, KY",2001-2002,8149,8144,-5,-0.061,-49,44,21,143,H1
"Lyon County, KY",2002-2003,8144,8180,36,0.442,-25,61,21,143,H1
"Lyon County, KY",2003-2004,8180,8249,69,0.844,-54,123,21,143,H1
"Lyon County, KY",2004-2005,8249,8327,78,0.946,-38,116,21,143,H1
"Lyon County, KY",2005-2006,8327,8434,107,1.285,-38,145,21,143,H1
"Lyon County, KY",2006-2007,8434,8393,-41,-0.486,-56,15,21,143,H1
"Lyon County, KY",2007-2008,8393,8374,-19,-0.226,-34,15,21,143,H1
"Lyon County, KY",2008-2009,8374,8332,-42,-0.502,-56,14,21,143,H1
"Lyon County, KY",2009-2010,8332,8319,-13,-0.156,-54,41,21,143,H1
"Lyon County, KY",2010-2011,8319,8428,109,1.31,-46,155,21,143,H1
"Lyon County, KY",2011-2012,8428,8437,9,0.107,-38,47,21,143,H1
"Lyon County, KY",2012-2013,8437,8463,26,0.308,-39,65,21,143,H1
"Lyon County, KY",2013-2014,8463,8430,-33,-0.39,-59,26,21,143,H1
"Lyon County, KY",2014-2015,8392,8306,-86,-1.025,-72,-14,21,143,H1
"Lyon County, KY",2015-2016,8306,8083,-223,-2.685,-71,-152,21,143,H1
"Lyon County, KY",2016-2017,8083,8082,-1,-0.012,-75,74,21,143,H1
"McCracken County, KY",2000-2001,65423,64825,-598,-0.914,72,-670,21,145,H1
"McCracken County, KY",2001-2002,64825,64588,-237,-0.366,80,-317,21,145,H1
"McCracken County, KY",2002-2003,64588,64430,-158,-0.245,32,-190,21,145,H1
"McCracken County, KY",2003-2004,64430,64270,-160,-0.248,67,-227,21,145,H1
"McCracken County, KY",2004-2005,64270,64430,160,0.249,104,56,21,145,H1
"McCracken County, KY",2005-2006,64430,64678,248,0.385,50,198,21,145,H1
"McCracken County, KY",2006-2007,64678,64925,247,0.382,57,190,21,145,H1
"McCracken County, KY",2007-2008,64925,65287,362,0.558,102,260,21,145,H1
"McCracken County, KY",2008-2009,65287,65654,367,0.562,47,320,21,145,H1
"McCracken County, KY",2009-2010,65654,65566,-88,-0.134,41,-129,21,145,H1
"McCracken County, KY",2010-2011,65566,65818,252,0.384,-20,272,21,145,H1
"McCracken County, KY",2011-2012,65818,65645,-173,-0.263,-30,-143,21,145,H1
"McCracken County, KY",2012-2013,65645,65380,-265,-0.404,-32,-233,21,145,H1
"McCracken County, KY",2013-2014,65380,65316,-64,-0.098,-64,0,21,145,H1
"McCracken County, KY",2014-2015,65300,65018,-282,-0.432,-21,-261,21,145,H1
"McCracken County, KY",2015-2016,65018,65342,324,0.498,41,283,21,145,H1
"McCracken County, KY",2016-2017,65342,65385,43,0.066,-11,54,21,145,H1
"McCreary County, KY",2000-2001,17074,17144,70,0.41,66,4,21,147,H1
"McCreary County, KY",2001-2002,17144,17320,176,1.027,73,103,21,147,H1
"McCreary County, KY",2002-2003,17320,17363,43,0.248,13,30,21,147,H1
"McCreary County, KY",2003-2004,17363,17469,106,0.61,58,48,21,147,H1
"McCreary County, KY",2004-2005,17469,17758,289,1.654,70,219,21,147,H1
"McCreary County, KY",2005-2006,17758,17892,134,0.755,63,71,21,147,H1
"McCreary County, KY",2006-2007,17892,18053,161,0.9,69,92,21,147,H1
"McCreary County, KY",2007-2008,18053,18144,91,0.504,56,35,21,147,H1
"McCreary County, KY",2008-2009,18144,18207,63,0.347,56,7,21,147,H1
"McCreary County, KY",2009-2010,18207,18271,64,0.352,17,47,21,147,H1
"McCreary County, KY",2010-2011,18271,18255,-16,-0.088,64,-80,21,147,H1
"McCreary County, KY",2011-2012,18255,18035,-220,-1.205,42,-262,21,147,H1
"McCreary County, KY",2012-2013,18035,17941,-94,-0.521,70,-164,21,147,H1
"McCreary County, KY",2013-2014,17941,17863,-78,-0.435,81,-159,21,147,H1
"McCreary County, KY",2014-2015,17886,17878,-8,-0.045,52,-60,21,147,H1
"McCreary County, KY",2015-2016,17878,17555,-323,-1.807,56,-379,21,147,H1
"McCreary County, KY",2016-2017,17555,17465,-90,-0.513,51,-141,21,147,H1
"McLean County, KY",2000-2001,9983,9853,-130,-1.302,19,-149,21,149,H1
"McLean County, KY",2001-2002,9853,9945,92,0.934,29,63,21,149,H1
"McLean County, KY",2002-2003,9945,9852,-93,-0.935,18,-111,21,149,H1
"McLean County, KY",2003-2004,9852,9841,-11,-0.112,9,-20,21,149,H1
"McLean County, KY",2004-2005,9841,9811,-30,-0.305,-10,-20,21,149,H1
"McLean County, KY",2005-2006,9811,9702,-109,-1.111,9,-118,21,149,H1
"McLean County, KY",2006-2007,9702,9717,15,0.155,7,8,21,149,H1
"McLean County, KY",2007-2008,9717,9673,-44,-0.453,-9,-35,21,149,H1
"McLean County, KY",2008-2009,9673,9566,-107,-1.106,-2,-105,21,149,H1
"McLean County, KY",2009-2010,9566,9516,-50,-0.523,-12,-38,21,149,H1
"McLean County, KY",2010-2011,9516,9524,8,0.084,14,-6,21,149,H1
"McLean County, KY",2011-2012,9524,9520,-4,-0.042,5,-9,21,149,H1
"McLean County, KY",2012-2013,9520,9513,-7,-0.074,13,-20,21,149,H1
"McLean County, KY",2013-2014,9513,9478,-35,-0.368,14,-49,21,149,H1
"McLean County, KY",2014-2015,9451,9512,61,0.645,2,59,21,149,H1
"McLean County, KY",2015-2016,9512,9342,-170,-1.787,-29,-141,21,149,H1
"McLean County, KY",2016-2017,9342,9201,-141,-1.509,-32,-109,21,149,H1
"Madison County, KY",2000-2001,71309,72571,1262,1.77,474,788,21,151,H1
"Madison County, KY",2001-2002,72571,73634,1063,1.465,368,695,21,151,H1
"Madison County, KY",2002-2003,73634,74998,1364,1.852,419,945,21,151,H1
"Madison County, KY",2003-2004,74998,76673,1675,2.233,394,1281,21,151,H1
"Madison County, KY",2004-2005,76673,78732,2059,2.685,469,1590,21,151,H1
"Madison County, KY",2005-2006,78732,80264,1532,1.946,558,974,21,151,H1
"Madison County, KY",2006-2007,80264,80659,395,0.492,432,-37,21,151,H1
"Madison County, KY",2007-2008,80659,81521,862,1.069,454,408,21,151,H1
"Madison County, KY",2008-2009,81521,82299,778,0.954,464,314,21,151,H1
"Madison County, KY",2009-2010,82299,83868,1569,1.906,410,1159,21,151,H1
"Madison County, KY",2010-2011,83868,84829,961,1.146,285,676,21,151,H1
"Madison County, KY",2011-2012,84829,85206,377,0.444,328,49,21,151,H1
"Madison County, KY",2012-2013,85206,86181,975,1.144,374,601,21,151,H1
"Madison County, KY",2013-2014,86181,87340,1159,1.345,357,802,21,151,H1
"Madison County, KY",2014-2015,86687,87824,1137,1.312,321,816,21,151,H1
"Madison County, KY",2015-2016,87824,89537,1713,1.95,319,1394,21,151,H1
"Madison County, KY",2016-2017,89537,91226,1689,1.886,340,1349,21,151,H1
"Magoffin County, KY",2000-2001,13321,13195,-126,-0.946,38,-164,21,153,H1
"Magoffin County, KY",2001-2002,13195,13285,90,0.682,74,16,21,153,H1
"Magoffin County, KY",2002-2003,13285,13287,2,0.015,61,-59,21,153,H1
"Magoffin County, KY",2003-2004,13287,13297,10,0.075,46,-36,21,153,H1
"Magoffin County, KY",2004-2005,13297,13302,5,0.038,45,-40,21,153,H1
"Magoffin County, KY",2005-2006,13302,13258,-44,-0.331,54,-98,21,153,H1
"Magoffin County, KY",2006-2007,13258,13316,58,0.437,69,-11,21,153,H1
"Magoffin County, KY",2007-2008,13316,13233,-83,-0.623,10,-93,21,153,H1
"Magoffin County, KY",2008-2009,13233,13335,102,0.771,27,75,21,153,H1
"Magoffin County, KY",2009-2010,13335,13313,-22,-0.165,18,-40,21,153,H1
"Magoffin County, KY",2010-2011,13313,13215,-98,-0.736,15,-113,21,153,H1
"Magoffin County, KY",2011-2012,13215,13030,-185,-1.4,13,-198,21,153,H1
"Magoffin County, KY",2012-2013,13030,12907,-123,-0.944,4,-127,21,153,H1
"Magoffin County, KY",2013-2014,12907,12913,6,0.046,0,6,21,153,H1
"Magoffin County, KY",2014-2015,12946,12808,-138,-1.066,17,-155,21,153,H1
"Magoffin County, KY",2015-2016,12808,12674,-134,-1.046,18,-152,21,153,H1
"Magoffin County, KY",2016-2017,12674,12538,-136,-1.073,-3,-133,21,153,H1
"Marion County, KY",2000-2001,18243,18404,161,0.883,55,106,21,155,H1
"Marion County, KY",2001-2002,18404,18540,136,0.739,47,89,21,155,H1
"Marion County, KY",2002-2003,18540,18676,136,0.734,130,6,21,155,H1
"Marion County, KY",2003-2004,18676,19066,390,2.088,65,325,21,155,H1
"Marion County, KY",2004-2005,19066,19251,185,0.97,88,97,21,155,H1
"Marion County, KY",2005-2006,19251,19392,141,0.732,73,68,21,155,H1
"Marion County, KY",2006-2007,19392,19458,66,0.34,78,-12,21,155,H1
"Marion County, KY",2007-2008,19458,19647,189,0.971,103,86,21,155,H1
"Marion County, KY",2008-2009,19647,19769,122,0.621,99,23,21,155,H1
"Marion County, KY",2009-2010,19769,19811,42,0.212,70,-28,21,155,H1
"Marion County, KY",2010-2011,19811,20030,219,1.105,60,159,21,155,H1
"Marion County, KY",2011-2012,20030,19990,-40,-0.2,23,-63,21,155,H1
"Marion County, KY",2012-2013,19990,19985,-5,-0.025,16,-21,21,155,H1
"Marion County, KY",2013-2014,19985,20007,22,0.11,42,-20,21,155,H1
"Marion County, KY",2014-2015,19199,19365,166,0.865,44,122,21,155,H1
"Marion County, KY",2015-2016,19365,19143,-222,-1.146,40,-262,21,155,H1
"Marion County, KY",2016-2017,19143,19395,252,1.316,51,201,21,155,H1
"Marshall County, KY",2000-2001,30113,30145,32,0.106,-83,115,21,157,H1
"Marshall County, KY",2001-2002,30145,30258,113,0.375,-41,154,21,157,H1
"Marshall County, KY",2002-2003,30258,30494,236,0.78,-61,297,21,157,H1
"Marshall County, KY",2003-2004,30494,30674,180,0.59,-69,249,21,157,H1
"Marshall County, KY",2004-2005,30674,30870,196,0.639,-52,248,21,157,H1
"Marshall County, KY",2005-2006,30870,31204,334,1.082,-55,389,21,157,H1
"Marshall County, KY",2006-2007,31204,31443,239,0.766,-63,302,21,157,H1
"Marshall County, KY",2007-2008,31443,31418,-25,-0.08,-23,-2,21,157,H1
"Marshall County, KY",2008-2009,31418,31411,-7,-0.022,-58,51,21,157,H1
"Marshall County, KY",2009-2010,31411,31458,47,0.15,-83,130,21,157,H1
"Marshall County, KY",2010-2011,31458,31264,-194,-0.617,-122,-72,21,157,H1
"Marshall County, KY",2011-2012,31264,31268,4,0.013,-95,99,21,157,H1
"Marshall County, KY",2012-2013,31268,31173,-95,-0.304,-133,38,21,157,H1
"Marshall County, KY",2013-2014,31173,30953,-220,-0.706,-131,-89,21,157,H1
"Marshall County, KY",2014-2015,31047,31101,54,0.174,-85,139,21,157,H1
"Marshall County, KY",2015-2016,31101,31273,172,0.553,-88,260,21,157,H1
"Marshall County, KY",2016-2017,31273,31382,109,0.349,-89,198,21,157,H1
"Martin County, KY",2000-2001,12586,12589,3,0.024,54,-51,21,159,H1
"Martin County, KY",2001-2002,12589,12711,122,0.969,44,78,21,159,H1
"Martin County, KY",2002-2003,12711,12778,67,0.527,58,9,21,159,H1
"Martin County, KY",2003-2004,12778,13138,360,2.817,38,322,21,159,H1
"Martin County, KY",2004-2005,13138,13536,398,3.029,52,346,21,159,H1
"Martin County, KY",2005-2006,13536,13371,-165,-1.219,38,-203,21,159,H1
"Martin County, KY",2006-2007,13371,13224,-147,-1.099,7,-154,21,159,H1
"Martin County, KY",2007-2008,13224,13160,-64,-0.484,34,-98,21,159,H1
"Martin County, KY",2008-2009,13160,13040,-120,-0.912,16,-136,21,159,H1
"Martin County, KY",2009-2010,13040,12890,-150,-1.15,4,-154,21,159,H1
"Martin County, KY",2010-2011,12890,12875,-15,-0.116,25,-40,21,159,H1
"Martin County, KY",2011-2012,12875,12763,-112,-0.87,-15,-97,21,159,H1
"Martin County, KY",2012-2013,12763,12683,-80,-0.627,-12,-68,21,159,H1
"Martin County, KY",2013-2014,12683,12537,-146,-1.151,-22,-124,21,159,H1
"Martin County, KY",2014-2015,12524,12307,-217,-1.733,-30,-187,21,159,H1
"Martin County, KY",2015-2016,12307,11947,-360,-2.925,-46,-314,21,159,H1
"Martin County, KY",2016-2017,11947,11452,-495,-4.143,-58,-437,21,159,H1
"Mason County, KY",2000-2001,16790,16808,18,0.107,22,-4,21,161,H1
"Mason County, KY",2001-2002,16808,16825,17,0.101,11,6,21,161,H1
"Mason County, KY",2002-2003,16825,16729,-96,-0.571,3,-99,21,161,H1
"Mason County, KY",2003-2004,16729,16802,73,0.436,20,53,21,161,H1
"Mason County, KY",2004-2005,16802,16923,121,0.72,5,116,21,161,H1
"Mason County, KY",2005-2006,16923,17138,215,1.27,29,186,21,161,H1
"Mason County, KY",2006-2007,17138,17259,121,0.706,55,66,21,161,H1
"Mason County, KY",2007-2008,17259,17454,195,1.13,15,180,21,161,H1
"Mason County, KY",2008-2009,17454,17464,10,0.057,13,-3,21,161,H1
"Mason County, KY",2009-2010,17464,17508,44,0.252,1,43,21,161,H1
"Mason County, KY",2010-2011,17508,17544,36,0.206,12,24,21,161,H1
"Mason County, KY",2011-2012,17544,17463,-81,-0.462,25,-106,21,161,H1
"Mason County, KY",2012-2013,17463,17309,-154,-0.882,44,-198,21,161,H1
"Mason County, KY",2013-2014,17309,17166,-143,-0.826,40,-183,21,161,H1
"Mason County, KY",2014-2015,17120,17099,-21,-0.123,21,-42,21,161,H1
"Mason County, KY",2015-2016,17099,17158,59,0.345,25,34,21,161,H1
"Mason County, KY",2016-2017,17158,17174,16,0.093,12,4,21,161,H1
"Meade County, KY",2000-2001,28189,28506,317,1.125,145,172,21,163,H1
"Meade County, KY",2001-2002,28506,28919,413,1.449,121,292,21,163,H1
"Meade County, KY",2002-2003,28919,28949,30,0.104,151,-121,21,163,H1
"Meade County, KY",2003-2004,28949,29600,651,2.249,116,535,21,163,H1
"Meade County, KY",2004-2005,29600,29732,132,0.446,59,73,21,163,H1
"Meade County, KY",2005-2006,29732,29397,-335,-1.127,90,-425,21,163,H1
"Meade County, KY",2006-2007,29397,29108,-289,-0.983,34,-323,21,163,H1
"Meade County, KY",2007-2008,29108,28962,-146,-0.502,49,-195,21,163,H1
"Meade County, KY",2008-2009,28962,28403,-559,-1.93,78,-637,21,163,H1
"Meade County, KY",2009-2010,28403,28703,300,1.056,44,256,21,163,H1
"Meade County, KY",2010-2011,28703,29649,946,3.296,37,909,21,163,H1
"Meade County, KY",2011-2012,29649,29276,-373,-1.258,63,-436,21,163,H1
"Meade County, KY",2012-2013,29276,29246,-30,-0.102,39,-69,21,163,H1
"Meade County, KY",2013-2014,29246,29139,-107,-0.366,34,-141,21,163,H1
"Meade County, KY",2014-2015,29260,27924,-1336,-4.566,69,-1405,21,163,H1
"Meade County, KY",2015-2016,27924,28014,90,0.322,29,61,21,163,H1
"Meade County, KY",2016-2017,28014,28154,140,0.5,44,96,21,163,H1
"Menifee County, KY",2000-2001,6565,6631,66,1.005,21,45,21,165,H1
"Menifee County, KY",2001-2002,6631,6651,20,0.302,7,13,21,165,H1
"Menifee County, KY",2002-2003,6651,6581,-70,-1.052,23,-93,21,165,H1
"Menifee County, KY",2003-2004,6581,6597,16,0.243,29,-13,21,165,H1
"Menifee County, KY",2004-2005,6597,6581,-16,-0.243,3,-19,21,165,H1
"Menifee County, KY",2005-2006,6581,6567,-14,-0.213,10,-24,21,165,H1
"Menifee County, KY",2006-2007,6567,6486,-81,-1.233,6,-87,21,165,H1
"Menifee County, KY",2007-2008,6486,6457,-29,-0.447,-9,-20,21,165,H1
"Menifee County, KY",2008-2009,6457,6317,-140,-2.168,-6,-134,21,165,H1
"Menifee County, KY",2009-2010,6317,6355,38,0.602,-16,54,21,165,H1
"Menifee County, KY",2010-2011,6355,6406,51,0.803,6,45,21,165,H1
"Menifee County, KY",2011-2012,6406,6314,-92,-1.436,6,-98,21,165,H1
"Menifee County, KY",2012-2013,6314,6323,9,0.143,3,6,21,165,H1
"Menifee County, KY",2013-2014,6323,6287,-36,-0.569,-11,-25,21,165,H1
"Menifee County, KY",2014-2015,6304,6358,54,0.857,-14,68,21,165,H1
"Menifee County, KY",2015-2016,6358,6446,88,1.384,-7,95,21,165,H1
"Menifee County, KY",2016-2017,6446,6455,9,0.14,-21,30,21,165,H1
"Mercer County, KY",2000-2001,20794,20755,-39,-0.188,43,-82,21,167,H1
"Mercer County, KY",2001-2002,20755,20877,122,0.588,53,69,21,167,H1
"Mercer County, KY",2002-2003,20877,21044,167,0.8,44,123,21,167,H1
"Mercer County, KY",2003-2004,21044,21118,74,0.352,11,63,21,167,H1
"Mercer County, KY",2004-2005,21118,21229,111,0.526,44,67,21,167,H1
"Mercer County, KY",2005-2006,21229,21181,-48,-0.226,-2,-46,21,167,H1
"Mercer County, KY",2006-2007,21181,21255,74,0.349,39,35,21,167,H1
"Mercer County, KY",2007-2008,21255,21273,18,0.085,16,2,21,167,H1
"Mercer County, KY",2008-2009,21273,21286,13,0.061,43,-30,21,167,H1
"Mercer County, KY",2009-2010,21286,21340,54,0.254,26,28,21,167,H1
"Mercer County, KY",2010-2011,21340,21265,-75,-0.351,16,-91,21,167,H1
"Mercer County, KY",2011-2012,21265,21343,78,0.367,45,33,21,167,H1
"Mercer County, KY",2012-2013,21343,21286,-57,-0.267,-67,10,21,167,H1
"Mercer County, KY",2013-2014,21286,21319,33,0.155,-38,71,21,167,H1
"Mercer County, KY",2014-2015,21388,21407,19,0.089,-14,33,21,167,H1
"Mercer County, KY",2015-2016,21407,21393,-14,-0.065,-26,12,21,167,H1
"Mercer County, KY",2016-2017,21393,21521,128,0.598,-30,158,21,167,H1
"Metcalfe County, KY",2000-2001,10005,10075,70,0.7,11,59,21,169,H1
"Metcalfe County, KY",2001-2002,10075,9961,-114,-1.132,-17,-97,21,169,H1
"Metcalfe County, KY",2002-2003,9961,9968,7,0.07,-23,30,21,169,H1
"Metcalfe County, KY",2003-2004,9968,10008,40,0.401,-13,53,21,169,H1
"Metcalfe County, KY",2004-2005,10008,10094,86,0.859,33,53,21,169,H1
"Metcalfe County, KY",2005-2006,10094,10123,29,0.287,15,14,21,169,H1
"Metcalfe County, KY",2006-2007,10123,10187,64,0.632,-15,79,21,169,H1
"Metcalfe County, KY",2007-2008,10187,10166,-21,-0.206,35,-56,21,169,H1
"Metcalfe County, KY",2008-2009,10166,10067,-99,-0.974,-4,-95,21,169,H1
"Metcalfe County, KY",2009-2010,10067,10119,52,0.517,-11,63,21,169,H1
"Metcalfe County, KY",2010-2011,10119,10071,-48,-0.474,-1,-47,21,169,H1
"Metcalfe County, KY",2011-2012,10071,9983,-88,-0.874,20,-108,21,169,H1
"Metcalfe County, KY",2012-2013,9983,9963,-20,-0.2,-1,-19,21,169,H1
"Metcalfe County, KY",2013-2014,9963,9990,27,0.271,-8,35,21,169,H1
"Metcalfe County, KY",2014-2015,9992,9909,-83,-0.831,-8,-75,21,169,H1
"Metcalfe County, KY",2015-2016,9909,10010,101,1.019,0,101,21,169,H1
"Metcalfe County, KY",2016-2017,10010,10107,97,0.969,0,97,21,169,H1
"Monroe County, KY",2000-2001,11700,11684,-16,-0.137,0,-16,21,171,H1
"Monroe County, KY",2001-2002,11684,11557,-127,-1.087,3,-130,21,171,H1
"Monroe County, KY",2002-2003,11557,11481,-76,-0.658,-5,-71,21,171,H1
"Monroe County, KY",2003-2004,11481,11348,-133,-1.158,-1,-132,21,171,H1
"Monroe County, KY",2004-2005,11348,11425,77,0.679,22,55,21,171,H1
"Monroe County, KY",2005-2006,11425,11337,-88,-0.77,3,-91,21,171,H1
"Monroe County, KY",2006-2007,11337,11171,-166,-1.464,3,-169,21,171,H1
"Monroe County, KY",2007-2008,11171,10990,-181,-1.62,-14,-167,21,171,H1
"Monroe County, KY",2008-2009,10990,10969,-21,-0.191,14,-35,21,171,H1
"Monroe County, KY",2009-2010,10969,10977,8,0.073,-7,15,21,171,H1
"Monroe County, KY",2010-2011,10977,10918,-59,-0.537,-46,-13,21,171,H1
"Monroe County, KY",2011-2012,10918,10859,-59,-0.54,-33,-26,21,171,H1
"Monroe County, KY",2012-2013,10859,10725,-134,-1.234,-16,-118,21,171,H1
"Monroe County, KY",2013-2014,10725,10704,-21,-0.196,-26,5,21,171,H1
"Monroe County, KY",2014-2015,10707,10667,-40,-0.374,-9,-31,21,171,H1
"Monroe County, KY",2015-2016,10667,10579,-88,-0.825,-3,-85,21,171,H1
"Monroe County, KY",2016-2017,10579,10659,80,0.756,-9,89,21,171,H1
"Montgomery County, KY",2000-2001,22650,22851,201,0.887,84,117,21,173,H1
"Montgomery County, KY",2001-2002,22851,23251,400,1.75,118,282,21,173,H1
"Montgomery County, KY",2002-2003,23251,23594,343,1.475,84,259,21,173,H1
"Montgomery County, KY",2003-2004,23594,23899,305,1.293,151,154,21,173,H1
"Montgomery County, KY",2004-2005,23899,24491,592,2.477,119,473,21,173,H1
"Montgomery County, KY",2005-2006,24491,25085,594,2.425,106,488,21,173,H1
"Montgomery County, KY",2006-2007,25085,25550,465,1.854,214,251,21,173,H1
"Montgomery County, KY",2007-2008,25550,25981,431,1.687,126,305,21,173,H1
"Montgomery County, KY",2008-2009,25981,26407,426,1.64,128,298,21,173,H1
"Montgomery County, KY",2009-2010,26407,26534,127,0.481,120,7,21,173,H1
"Montgomery County, KY",2010-2011,26534,26746,212,0.799,149,63,21,173,H1
"Montgomery County, KY",2011-2012,26746,26880,134,0.501,109,25,21,173,H1
"Montgomery County, KY",2012-2013,26880,27282,402,1.496,149,253,21,173,H1
"Montgomery County, KY",2013-2014,27282,27474,192,0.704,149,43,21,173,H1
"Montgomery County, KY",2014-2015,27366,27608,242,0.884,92,150,21,173,H1
"Montgomery County, KY",2015-2016,27608,27661,53,0.192,48,5,21,173,H1
"Montgomery County, KY",2016-2017,27661,27928,267,0.965,61,206,21,173,H1
"Morgan County, KY",2000-2001,13964,14046,82,0.587,36,46,21,175,H1
"Morgan County, KY",2001-2002,14046,14165,119,0.847,40,79,21,175,H1
"Morgan County, KY",2002-2003,14165,14201,36,0.254,28,8,21,175,H1
"Morgan County, KY",2003-2004,14201,14319,118,0.831,28,90,21,175,H1
"Morgan County, KY",2004-2005,14319,14219,-100,-0.698,50,-150,21,175,H1
"Morgan County, KY",2005-2006,14219,14174,-45,-0.316,39,-84,21,175,H1
"Morgan County, KY",2006-2007,14174,14191,17,0.12,37,-20,21,175,H1
"Morgan County, KY",2007-2008,14191,14055,-136,-0.958,20,-156,21,175,H1
"Morgan County, KY",2008-2009,14055,13928,-127,-0.904,17,-144,21,175,H1
"Morgan County, KY",2009-2010,13928,13752,-176,-1.264,0,-176,21,175,H1
"Morgan County, KY",2010-2011,13752,13727,-25,-0.182,-3,-22,21,175,H1
"Morgan County, KY",2011-2012,13727,13480,-247,-1.799,-7,-240,21,175,H1
"Morgan County, KY",2012-2013,13480,13349,-131,-0.972,-9,-122,21,175,H1
"Morgan County, KY",2013-2014,13349,13303,-46,-0.345,-31,-15,21,175,H1
"Morgan County, KY",2014-2015,13326,13275,-51,-0.383,-16,-35,21,175,H1
"Morgan County, KY",2015-2016,13275,13235,-40,-0.301,-21,-19,21,175,H1
"Morgan County, KY",2016-2017,13235,13188,-47,-0.355,-35,-12,21,175,H1
"Muhlenberg County, KY",2000-2001,31795,31768,-27,-0.085,31,-58,21,177,H1
"Muhlenberg County, KY",2001-2002,31768,31641,-127,-0.4,-28,-99,21,177,H1
"Muhlenberg County, KY",2002-2003,31641,31588,-53,-0.168,-56,3,21,177,H1
"Muhlenberg County, KY",2003-2004,31588,31615,27,0.085,-13,40,21,177,H1
"Muhlenberg County, KY",2004-2005,31615,31595,-20,-0.063,23,-43,21,177,H1
"Muhlenberg County, KY",2005-2006,31595,31595,0,0,13,-13,21,177,H1
"Muhlenberg County, KY",2006-2007,31595,31627,32,0.101,-45,77,21,177,H1
"Muhlenberg County, KY",2007-2008,31627,31486,-141,-0.446,-25,-116,21,177,H1
"Muhlenberg County, KY",2008-2009,31486,31505,19,0.06,-26,45,21,177,H1
"Muhlenberg County, KY",2009-2010,31505,31642,137,0.435,-38,175,21,177,H1
"Muhlenberg County, KY",2010-2011,31642,31505,-137,-0.433,-45,-92,21,177,H1
"Muhlenberg County, KY",2011-2012,31505,31359,-146,-0.463,-21,-125,21,177,H1
"Muhlenberg County, KY",2012-2013,31359,31244,-115,-0.367,-77,-38,21,177,H1
"Muhlenberg County, KY",2013-2014,31244,31207,-37,-0.118,-76,39,21,177,H1
"Muhlenberg County, KY",2014-2015,31243,31183,-60,-0.192,-68,8,21,177,H1
"Muhlenberg County, KY",2015-2016,31183,31064,-119,-0.382,-96,-23,21,177,H1
"Muhlenberg County, KY",2016-2017,31064,30816,-248,-0.798,-90,-158,21,177,H1
"Nelson County, KY",2000-2001,37662,38128,466,1.237,193,273,21,179,H1
"Nelson County, KY",2001-2002,38128,38681,553,1.45,219,334,21,179,H1
"Nelson County, KY",2002-2003,38681,39307,626,1.618,240,386,21,179,H1
"Nelson County, KY",2003-2004,39307,39947,640,1.628,244,396,21,179,H1
"Nelson County, KY",2004-2005,39947,40582,635,1.59,303,332,21,179,H1
"Nelson County, KY",2005-2006,40582,41424,842,2.075,281,561,21,179,H1
"Nelson County, KY",2006-2007,41424,42020,596,1.439,239,357,21,179,H1
"Nelson County, KY",2007-2008,42020,42588,568,1.352,291,277,21,179,H1
"Nelson County, KY",2008-2009,42588,42974,386,0.906,303,83,21,179,H1
"Nelson County, KY",2009-2010,42974,43604,630,1.466,241,389,21,179,H1
"Nelson County, KY",2010-2011,43604,44013,409,0.938,235,174,21,179,H1
"Nelson County, KY",2011-2012,44013,44351,338,0.768,252,86,21,179,H1
"Nelson County, KY",2012-2013,44351,44492,141,0.318,216,-75,21,179,H1
"Nelson County, KY",2013-2014,44492,44812,320,0.719,225,95,21,179,H1
"Nelson County, KY",2014-2015,44800,45126,326,0.728,214,112,21,179,H1
"Nelson County, KY",2015-2016,45126,45512,386,0.855,153,233,21,179,H1
"Nelson County, KY",2016-2017,45512,45640,128,0.281,154,-26,21,179,H1
"Nicholas County, KY",2000-2001,6789,6878,89,1.311,3,86,21,181,H1
"Nicholas County, KY",2001-2002,6878,7015,137,1.992,11,126,21,181,H1
"Nicholas County, KY",2002-2003,7015,7075,60,0.855,11,49,21,181,H1
"Nicholas County, KY",2003-2004,7075,7139,64,0.905,0,64,21,181,H1
"Nicholas County, KY",2004-2005,7139,7134,-5,-0.07,4,-9,21,181,H1
"Nicholas County, KY",2005-2006,7134,7147,13,0.182,-12,25,21,181,H1
"Nicholas County, KY",2006-2007,7147,7143,-4,-0.056,-22,18,21,181,H1
"Nicholas County, KY",2007-2008,7143,7135,-8,-0.112,-5,-3,21,181,H1
"Nicholas County, KY",2008-2009,7135,7125,-10,-0.14,-5,-5,21,181,H1
"Nicholas County, KY",2009-2010,7125,7127,2,0.028,-7,9,21,181,H1
"Nicholas County, KY",2010-2011,7127,7100,-27,-0.379,-11,-16,21,181,H1
"Nicholas County, KY",2011-2012,7100,7029,-71,-1,-3,-68,21,181,H1
"Nicholas County, KY",2012-2013,7029,7022,-7,-0.1,-41,34,21,181,H1
"Nicholas County, KY",2013-2014,7022,7041,19,0.271,-40,59,21,181,H1
"Nicholas County, KY",2014-2015,7088,7131,43,0.607,-2,45,21,181,H1
"Nicholas County, KY",2015-2016,7131,7063,-68,-0.954,-26,-42,21,181,H1
"Nicholas County, KY",2016-2017,7063,7130,67,0.949,-20,87,21,181,H1
"Ohio County, KY",2000-2001,22933,23040,107,0.467,23,84,21,183,H1
"Ohio County, KY",2001-2002,23040,23161,121,0.525,16,105,21,183,H1
"Ohio County, KY",2002-2003,23161,23158,-3,-0.013,19,-22,21,183,H1
"Ohio County, KY",2003-2004,23158,23452,294,1.27,69,225,21,183,H1
"Ohio County, KY",2004-2005,23452,23611,159,0.678,93,66,21,183,H1
"Ohio County, KY",2005-2006,23611,23658,47,0.199,126,-79,21,183,H1
"Ohio County, KY",2006-2007,23658,23794,136,0.575,99,37,21,183,H1
"Ohio County, KY",2007-2008,23794,24025,231,0.971,45,186,21,183,H1
"Ohio County, KY",2008-2009,24025,23888,-137,-0.57,60,-197,21,183,H1
"Ohio County, KY",2009-2010,23888,23842,-46,-0.193,29,-75,21,183,H1
"Ohio County, KY",2010-2011,23842,23985,143,0.6,57,86,21,183,H1
"Ohio County, KY",2011-2012,23985,24011,26,0.108,24,2,21,183,H1
"Ohio County, KY",2012-2013,24011,23967,-44,-0.183,33,-77,21,183,H1
"Ohio County, KY",2013-2014,23967,23977,10,0.042,49,-39,21,183,H1
"Ohio County, KY",2014-2015,24050,24216,166,0.69,32,134,21,183,H1
"Ohio County, KY",2015-2016,24216,24196,-20,-0.083,15,-35,21,183,H1
"Ohio County, KY",2016-2017,24196,24182,-14,-0.058,13,-27,21,183,H1
"Oldham County, KY",2000-2001,46895,47933,1038,2.213,262,776,21,185,H1
"Oldham County, KY",2001-2002,47933,49250,1317,2.748,265,1052,21,185,H1
"Oldham County, KY",2002-2003,49250,51296,2046,4.154,292,1754,21,185,H1
"Oldham County, KY",2003-2004,51296,52830,1534,2.99,304,1230,21,185,H1
"Oldham County, KY",2004-2005,52830,54266,1436,2.718,228,1208,21,185,H1
"Oldham County, KY",2005-2006,54266,56329,2063,3.802,224,1839,21,185,H1
"Oldham County, KY",2006-2007,56329,57991,1662,2.951,231,1431,21,185,H1
"Oldham County, KY",2007-2008,57991,59375,1384,2.387,235,1149,21,185,H1
"Oldham County, KY",2008-2009,59375,59777,402,0.677,342,60,21,185,H1
"Oldham County, KY",2009-2010,59777,60408,631,1.056,150,481,21,185,H1
"Oldham County, KY",2010-2011,60408,60782,374,0.619,224,150,21,185,H1
"Oldham County, KY",2011-2012,60782,61423,641,1.055,154,487,21,185,H1
"Oldham County, KY",2012-2013,61423,62454,1031,1.679,106,925,21,185,H1
"Oldham County, KY",2013-2014,62454,63490,1036,1.659,161,875,21,185,H1
"Oldham County, KY",2014-2015,64237,64875,638,0.993,182,456,21,185,H1
"Oldham County, KY",2015-2016,64875,65336,461,0.711,129,332,21,185,H1
"Oldham County, KY",2016-2017,65336,66415,1079,1.651,142,937,21,185,H1
"Owen County, KY",2000-2001,10554,10591,37,0.351,29,8,21,187,H1
"Owen County, KY",2001-2002,10591,10749,158,1.492,34,124,21,187,H1
"Owen County, KY",2002-2003,10749,10732,-17,-0.158,10,-27,21,187,H1
"Owen County, KY",2003-2004,10732,10893,161,1.5,39,122,21,187,H1
"Owen County, KY",2004-2005,10893,10900,7,0.064,-5,12,21,187,H1
"Owen County, KY",2005-2006,10900,10886,-14,-0.128,28,-42,21,187,H1
"Owen County, KY",2006-2007,10886,1.10E+04,114,1.047,27,87,21,187,H1
"Owen County, KY",2007-2008,1.10E+04,11010,10,0.091,7,3,21,187,H1
"Owen County, KY",2008-2009,11010,10909,-101,-0.917,24,-125,21,187,H1
"Owen County, KY",2009-2010,10909,10842,-67,-0.614,3,-70,21,187,H1
"Owen County, KY",2010-2011,10842,10818,-24,-0.221,1,-25,21,187,H1
"Owen County, KY",2011-2012,10818,10761,-57,-0.527,5,-62,21,187,H1
"Owen County, KY",2012-2013,10761,10634,-127,-1.18,6,-133,21,187,H1
"Owen County, KY",2013-2014,10634,10645,11,0.103,0,11,21,187,H1
"Owen County, KY",2014-2015,10633,10730,97,0.912,9,88,21,187,H1
"Owen County, KY",2015-2016,10730,10663,-67,-0.624,-28,-39,21,187,H1
"Owen County, KY",2016-2017,10663,10765,102,0.957,-28,130,21,187,H1
"Owsley County, KY",2000-2001,4852,4809,-43,-0.886,-24,-19,21,189,H1
"Owsley County, KY",2001-2002,4809,4768,-41,-0.853,-14,-27,21,189,H1
"Owsley County, KY",2002-2003,4768,4758,-10,-0.21,-13,3,21,189,H1
"Owsley County, KY",2003-2004,4758,4840,82,1.723,0,82,21,189,H1
"Owsley County, KY",2004-2005,4840,4797,-43,-0.888,-15,-28,21,189,H1
"Owsley County, KY",2005-2006,4797,4743,-54,-1.126,-16,-38,21,189,H1
"Owsley County, KY",2006-2007,4743,4729,-14,-0.295,-23,9,21,189,H1
"Owsley County, KY",2007-2008,4729,4761,32,0.677,-2,34,21,189,H1
"Owsley County, KY",2008-2009,4761,4713,-48,-1.008,-10,-38,21,189,H1
"Owsley County, KY",2009-2010,4713,4777,64,1.358,-25,89,21,189,H1
"Owsley County, KY",2010-2011,4777,4832,55,1.151,-17,72,21,189,H1
"Owsley County, KY",2011-2012,4832,4694,-138,-2.856,-39,-99,21,189,H1
"Owsley County, KY",2012-2013,4694,4618,-76,-1.619,-34,-42,21,189,H1
"Owsley County, KY",2013-2014,4618,4508,-110,-2.382,-26,-84,21,189,H1
"Owsley County, KY",2014-2015,4511,4461,-50,-1.108,-7,-43,21,189,H1
"Owsley County, KY",2015-2016,4461,4495,34,0.762,-3,37,21,189,H1
"Owsley County, KY",2016-2017,4495,4435,-60,-1.335,3,-63,21,189,H1
"Pendleton County, KY",2000-2001,14475,14593,118,0.815,69,49,21,191,H1
"Pendleton County, KY",2001-2002,14593,14693,100,0.685,99,1,21,191,H1
"Pendleton County, KY",2002-2003,14693,14819,126,0.858,74,52,21,191,H1
"Pendleton County, KY",2003-2004,14819,14809,-10,-0.067,43,-53,21,191,H1
"Pendleton County, KY",2004-2005,14809,14884,75,0.506,48,27,21,191,H1
"Pendleton County, KY",2005-2006,14884,14972,88,0.591,49,39,21,191,H1
"Pendleton County, KY",2006-2007,14972,14935,-37,-0.247,9,-46,21,191,H1
"Pendleton County, KY",2007-2008,14935,14867,-68,-0.455,35,-103,21,191,H1
"Pendleton County, KY",2008-2009,14867,14786,-81,-0.545,45,-126,21,191,H1
"Pendleton County, KY",2009-2010,14786,14922,136,0.92,27,109,21,191,H1
"Pendleton County, KY",2010-2011,14922,14669,-253,-1.695,7,-260,21,191,H1
"Pendleton County, KY",2011-2012,14669,14547,-122,-0.832,-9,-113,21,191,H1
"Pendleton County, KY",2012-2013,14547,14579,32,0.22,49,-17,21,191,H1
"Pendleton County, KY",2013-2014,14579,14493,-86,-0.59,22,-108,21,191,H1
"Pendleton County, KY",2014-2015,14433,14408,-25,-0.173,4,-29,21,191,H1
"Pendleton County, KY",2015-2016,14408,14576,168,1.166,29,139,21,191,H1
"Pendleton County, KY",2016-2017,14576,14573,-3,-0.021,23,-26,21,191,H1
"Perry County, KY",2000-2001,29259,29112,-147,-0.502,113,-260,21,193,H1
"Perry County, KY",2001-2002,29112,29180,68,0.234,43,25,21,193,H1
"Perry County, KY",2002-2003,29180,29173,-7,-0.024,93,-100,21,193,H1
"Perry County, KY",2003-2004,29173,29043,-130,-0.446,63,-193,21,193,H1
"Perry County, KY",2004-2005,29043,28851,-192,-0.661,60,-252,21,193,H1
"Perry County, KY",2005-2006,28851,28829,-22,-0.076,-4,-18,21,193,H1
"Perry County, KY",2006-2007,28829,28742,-87,-0.302,60,-147,21,193,H1
"Perry County, KY",2007-2008,28742,28686,-56,-0.195,61,-117,21,193,H1
"Perry County, KY",2008-2009,28686,28713,27,0.094,-3,30,21,193,H1
"Perry County, KY",2009-2010,28713,28703,-10,-0.035,5,-15,21,193,H1
"Perry County, KY",2010-2011,28703,28739,36,0.125,-24,60,21,193,H1
"Perry County, KY",2011-2012,28739,28279,-460,-1.601,-23,-437,21,193,H1
"Perry County, KY",2012-2013,28279,27986,-293,-1.036,-35,-258,21,193,H1
"Perry County, KY",2013-2014,27986,27597,-389,-1.39,-55,-334,21,193,H1
"Perry County, KY",2014-2015,27626,27565,-61,-0.221,-40,-21,21,193,H1
"Perry County, KY",2015-2016,27565,27165,-400,-1.451,13,-413,21,193,H1
"Perry County, KY",2016-2017,27165,26553,-612,-2.253,-43,-569,21,193,H1
"Pike County, KY",2000-2001,68506,67607,-899,-1.312,-26,-873,21,195,H1
"Pike County, KY",2001-2002,67607,67438,-169,-0.25,-23,-146,21,195,H1
"Pike County, KY",2002-2003,67438,66850,-588,-0.872,-43,-545,21,195,H1
"Pike County, KY",2003-2004,66850,66070,-780,-1.167,18,-798,21,195,H1
"Pike County, KY",2004-2005,66070,65719,-351,-0.531,-19,-332,21,195,H1
"Pike County, KY",2005-2006,65719,65632,-87,-0.132,-49,-38,21,195,H1
"Pike County, KY",2006-2007,65632,65431,-201,-0.306,18,-219,21,195,H1
"Pike County, KY",2007-2008,65431,65275,-156,-0.238,-64,-92,21,195,H1
"Pike County, KY",2008-2009,65275,65255,-20,-0.031,-78,58,21,195,H1
"Pike County, KY",2009-2010,65255,65239,-16,-0.025,-125,109,21,195,H1
"Pike County, KY",2010-2011,65239,65162,-77,-0.118,-98,21,21,195,H1
"Pike County, KY",2011-2012,65162,64563,-599,-0.919,-64,-535,21,195,H1
"Pike County, KY",2012-2013,64563,63902,-661,-1.024,-92,-569,21,195,H1
"Pike County, KY",2013-2014,63902,63034,-868,-1.358,-87,-781,21,195,H1
"Pike County, KY",2014-2015,62835,61792,-1043,-1.66,-52,-991,21,195,H1
"Pike County, KY",2015-2016,61792,60443,-1349,-2.183,-170,-1179,21,195,H1
"Pike County, KY",2016-2017,60443,58883,-1560,-2.581,-209,-1351,21,195,H1
"Powell County, KY",2000-2001,13251,13213,-38,-0.287,65,-103,21,197,H1
"Powell County, KY",2001-2002,13213,13053,-160,-1.211,64,-224,21,197,H1
"Powell County, KY",2002-2003,13053,12970,-83,-0.636,67,-150,21,197,H1
"Powell County, KY",2003-2004,12970,13051,81,0.625,39,42,21,197,H1
"Powell County, KY",2004-2005,13051,13117,66,0.506,55,11,21,197,H1
"Powell County, KY",2005-2006,13117,12943,-174,-1.327,37,-211,21,197,H1
"Powell County, KY",2006-2007,12943,12926,-17,-0.131,88,-105,21,197,H1
"Powell County, KY",2007-2008,12926,12794,-132,-1.021,18,-150,21,197,H1
"Powell County, KY",2008-2009,12794,12644,-150,-1.172,2,-152,21,197,H1
"Powell County, KY",2009-2010,12644,12665,21,0.166,-13,34,21,197,H1
"Powell County, KY",2010-2011,12665,12643,-22,-0.174,-13,-9,21,197,H1
"Powell County, KY",2011-2012,12643,12495,-148,-1.171,9,-157,21,197,H1
"Powell County, KY",2012-2013,12495,12522,27,0.216,25,2,21,197,H1
"Powell County, KY",2013-2014,12522,12434,-88,-0.703,38,-126,21,197,H1
"Powell County, KY",2014-2015,12385,12269,-116,-0.937,13,-129,21,197,H1
"Powell County, KY",2015-2016,12269,12295,26,0.212,42,-16,21,197,H1
"Powell County, KY",2016-2017,12295,12374,79,0.643,38,41,21,197,H1
"Pulaski County, KY",2000-2001,56428,56911,483,0.856,101,382,21,199,H1
"Pulaski County, KY",2001-2002,56911,57545,634,1.114,189,445,21,199,H1
"Pulaski County, KY",2002-2003,57545,58232,687,1.194,16,671,21,199,H1
"Pulaski County, KY",2003-2004,58232,59175,943,1.619,78,865,21,199,H1
"Pulaski County, KY",2004-2005,59175,59950,775,1.31,137,638,21,199,H1
"Pulaski County, KY",2005-2006,59950,60752,802,1.338,121,681,21,199,H1
"Pulaski County, KY",2006-2007,60752,61440,688,1.132,107,581,21,199,H1
"Pulaski County, KY",2007-2008,61440,62270,830,1.351,136,694,21,199,H1
"Pulaski County, KY",2008-2009,62270,62711,441,0.708,59,382,21,199,H1
"Pulaski County, KY",2009-2010,62711,63177,466,0.743,3,463,21,199,H1
"Pulaski County, KY",2010-2011,63177,63386,209,0.331,7,202,21,199,H1
"Pulaski County, KY",2011-2012,63386,63448,62,0.098,-18,80,21,199,H1
"Pulaski County, KY",2012-2013,63448,63688,240,0.378,-23,263,21,199,H1
"Pulaski County, KY",2013-2014,63688,63825,137,0.215,-21,158,21,199,H1
"Pulaski County, KY",2014-2015,63798,63782,-16,-0.025,-54,38,21,199,H1
"Pulaski County, KY",2015-2016,63782,64014,232,0.364,-40,272,21,199,H1
"Pulaski County, KY",2016-2017,64014,64449,435,0.68,-50,485,21,199,H1
"Robertson County, KY",2000-2001,2271,2256,-15,-0.661,-15,0,21,201,H1
"Robertson County, KY",2001-2002,2256,2292,36,1.596,-11,47,21,201,H1
"Robertson County, KY",2002-2003,2292,2309,17,0.742,-5,22,21,201,H1
"Robertson County, KY",2003-2004,2309,2298,-11,-0.476,-7,-4,21,201,H1
"Robertson County, KY",2004-2005,2298,2251,-47,-2.045,-3,-44,21,201,H1
"Robertson County, KY",2005-2006,2251,2309,58,2.577,-5,63,21,201,H1
"Robertson County, KY",2006-2007,2309,2244,-65,-2.815,-17,-48,21,201,H1
"Robertson County, KY",2007-2008,2244,2272,28,1.248,7,21,21,201,H1
"Robertson County, KY",2008-2009,2272,2288,16,0.704,2,14,21,201,H1
"Robertson County, KY",2009-2010,2288,2274,-14,-0.612,0,-14,21,201,H1
"Robertson County, KY",2010-2011,2274,2288,14,0.616,9,5,21,201,H1
"Robertson County, KY",2011-2012,2288,2215,-73,-3.191,-14,-59,21,201,H1
"Robertson County, KY",2012-2013,2215,2220,5,0.226,-14,19,21,201,H1
"Robertson County, KY",2013-2014,2220,2197,-23,-1.036,-7,-16,21,201,H1
"Robertson County, KY",2014-2015,2188,2138,-50,-2.285,-15,-35,21,201,H1
"Robertson County, KY",2015-2016,2138,2135,-3,-0.14,-1,-2,21,201,H1
"Robertson County, KY",2016-2017,2135,2134,-1,-0.047,-6,5,21,201,H1
"Rockcastle County, KY",2000-2001,16623,16572,-51,-0.307,17,-68,21,203,H1
"Rockcastle County, KY",2001-2002,16572,16684,112,0.676,55,57,21,203,H1
"Rockcastle County, KY",2002-2003,16684,16745,61,0.366,17,44,21,203,H1
"Rockcastle County, KY",2003-2004,16745,16822,77,0.46,34,43,21,203,H1
"Rockcastle County, KY",2004-2005,16822,16911,89,0.529,21,68,21,203,H1
"Rockcastle County, KY",2005-2006,16911,16974,63,0.373,14,49,21,203,H1
"Rockcastle County, KY",2006-2007,16974,17078,104,0.613,15,89,21,203,H1
"Rockcastle County, KY",2007-2008,17078,17216,138,0.808,11,127,21,203,H1
"Rockcastle County, KY",2008-2009,17216,17074,-142,-0.825,15,-157,21,203,H1
"Rockcastle County, KY",2009-2010,17074,17066,-8,-0.047,-6,-2,21,203,H1
"Rockcastle County, KY",2010-2011,17066,17111,45,0.264,-35,80,21,203,H1
"Rockcastle County, KY",2011-2012,17111,17069,-42,-0.245,-7,-35,21,203,H1
"Rockcastle County, KY",2012-2013,17069,16755,-314,-1.84,-24,-290,21,203,H1
"Rockcastle County, KY",2013-2014,16755,16826,71,0.424,-56,127,21,203,H1
"Rockcastle County, KY",2014-2015,16835,16942,107,0.636,-61,168,21,203,H1
"Rockcastle County, KY",2015-2016,16942,16871,-71,-0.419,-21,-50,21,203,H1
"Rockcastle County, KY",2016-2017,16871,16698,-173,-1.025,-71,-102,21,203,H1
"Rowan County, KY",2000-2001,22077,22323,246,1.114,101,145,21,205,H1
"Rowan County, KY",2001-2002,22323,22329,6,0.027,88,-82,21,205,H1
"Rowan County, KY",2002-2003,22329,22348,19,0.085,89,-70,21,205,H1
"Rowan County, KY",2003-2004,22348,22185,-163,-0.729,39,-202,21,205,H1
"Rowan County, KY",2004-2005,22185,22362,177,0.798,40,137,21,205,H1
"Rowan County, KY",2005-2006,22362,22706,344,1.538,74,270,21,205,H1
"Rowan County, KY",2006-2007,22706,22914,208,0.916,125,83,21,205,H1
"Rowan County, KY",2007-2008,22914,23097,183,0.799,57,126,21,205,H1
"Rowan County, KY",2008-2009,23097,23340,243,1.052,61,182,21,205,H1
"Rowan County, KY",2009-2010,23340,23337,-3,-0.013,56,-59,21,205,H1
"Rowan County, KY",2010-2011,23337,23496,159,0.681,43,116,21,205,H1
"Rowan County, KY",2011-2012,23496,23414,-82,-0.349,42,-124,21,205,H1
"Rowan County, KY",2012-2013,23414,23524,110,0.47,89,21,21,205,H1
"Rowan County, KY",2013-2014,23524,23655,131,0.557,83,48,21,205,H1
"Rowan County, KY",2014-2015,23681,23892,211,0.891,102,109,21,205,H1
"Rowan County, KY",2015-2016,23892,24402,510,2.135,46,464,21,205,H1
"Rowan County, KY",2016-2017,24402,24517,115,0.471,62,53,21,205,H1
"Russell County, KY",2000-2001,16296,16367,71,0.436,-5,76,21,207,H1
"Russell County, KY",2001-2002,16367,16445,78,0.477,2,76,21,207,H1
"Russell County, KY",2002-2003,16445,16574,129,0.784,5,124,21,207,H1
"Russell County, KY",2003-2004,16574,16851,277,1.671,10,267,21,207,H1
"Russell County, KY",2004-2005,16851,17018,167,0.991,44,123,21,207,H1
"Russell County, KY",2005-2006,17018,17232,214,1.257,7,207,21,207,H1
"Russell County, KY",2006-2007,17232,17297,65,0.377,-34,99,21,207,H1
"Russell County, KY",2007-2008,17297,17529,232,1.341,62,170,21,207,H1
"Russell County, KY",2008-2009,17529,17632,103,0.588,19,84,21,207,H1
"Russell County, KY",2009-2010,17632,17556,-76,-0.431,8,-84,21,207,H1
"Russell County, KY",2010-2011,17556,17661,105,0.598,-18,123,21,207,H1
"Russell County, KY",2011-2012,17661,17541,-120,-0.679,4,-124,21,207,H1
"Russell County, KY",2012-2013,17541,17698,157,0.895,12,145,21,207,H1
"Russell County, KY",2013-2014,17698,17774,76,0.429,1,75,21,207,H1
"Russell County, KY",2014-2015,17769,17662,-107,-0.602,0,-107,21,207,H1
"Russell County, KY",2015-2016,17662,17770,108,0.611,-32,140,21,207,H1
"Russell County, KY",2016-2017,17770,17775,5,0.028,-12,17,21,207,H1
"Scott County, KY",2000-2001,33422,34547,1125,3.366,289,836,21,209,H1
"Scott County, KY",2001-2002,34547,35601,1054,3.051,326,728,21,209,H1
"Scott County, KY",2002-2003,35601,36714,1113,3.126,297,816,21,209,H1
"Scott County, KY",2003-2004,36714,38051,1337,3.642,385,952,21,209,H1
"Scott County, KY",2004-2005,38051,39637,1586,4.168,394,1192,21,209,H1
"Scott County, KY",2005-2006,39637,41924,2287,5.77,429,1858,21,209,H1
"Scott County, KY",2006-2007,41924,43491,1567,3.738,433,1134,21,209,H1
"Scott County, KY",2007-2008,43491,45157,1666,3.831,417,1249,21,209,H1
"Scott County, KY",2008-2009,45157,46325,1168,2.587,478,690,21,209,H1
"Scott County, KY",2009-2010,46325,47453,1128,2.435,392,736,21,209,H1
"Scott County, KY",2010-2011,47453,48039,586,1.235,291,295,21,209,H1
"Scott County, KY",2011-2012,48039,49028,989,2.059,356,633,21,209,H1
"Scott County, KY",2012-2013,49028,50033,1005,2.05,316,689,21,209,H1
"Scott County, KY",2013-2014,50033,51284,1251,2.5,328,923,21,209,H1
"Scott County, KY",2014-2015,51327,52420,1093,2.129,334,759,21,209,H1
"Scott County, KY",2015-2016,52420,53416,996,1.9,363,633,21,209,H1
"Scott County, KY",2016-2017,53416,54873,1457,2.728,364,1093,21,209,H1
"Shelby County, KY",2000-2001,33574,34047,473,1.409,244,229,21,211,H1
"Shelby County, KY",2001-2002,34047,34754,707,2.077,212,495,21,211,H1
"Shelby County, KY",2002-2003,34754,35706,952,2.739,268,684,21,211,H1
"Shelby County, KY",2003-2004,35706,36682,976,2.733,197,779,21,211,H1
"Shelby County, KY",2004-2005,36682,37800,1118,3.048,287,831,21,211,H1
"Shelby County, KY",2005-2006,37800,39283,1483,3.923,331,1152,21,211,H1
"Shelby County, KY",2006-2007,39283,40335,1052,2.678,311,741,21,211,H1
"Shelby County, KY",2007-2008,40335,41044,709,1.758,227,482,21,211,H1
"Shelby County, KY",2008-2009,41044,41576,532,1.296,270,262,21,211,H1
"Shelby County, KY",2009-2010,41576,42267,691,1.662,194,497,21,211,H1
"Shelby County, KY",2010-2011,42267,42902,635,1.502,273,362,21,211,H1
"Shelby County, KY",2011-2012,42902,43603,701,1.634,268,433,21,211,H1
"Shelby County, KY",2012-2013,43603,44259,656,1.504,383,273,21,211,H1
"Shelby County, KY",2013-2014,44259,44875,616,1.392,365,251,21,211,H1
"Shelby County, KY",2014-2015,44929,45632,703,1.565,336,367,21,211,H1
"Shelby County, KY",2015-2016,45632,46592,960,2.104,253,707,21,211,H1
"Shelby County, KY",2016-2017,46592,47421,829,1.779,280,549,21,211,H1
"Simpson County, KY",2000-2001,16416,16599,183,1.115,68,115,21,213,H1
"Simpson County, KY",2001-2002,16599,16629,30,0.181,44,-14,21,213,H1
"Simpson County, KY",2002-2003,16629,16694,65,0.391,40,25,21,213,H1
"Simpson County, KY",2003-2004,16694,16820,126,0.755,24,102,21,213,H1
"Simpson County, KY",2004-2005,16820,16998,178,1.058,44,134,21,213,H1
"Simpson County, KY",2005-2006,16998,17115,117,0.688,38,79,21,213,H1
"Simpson County, KY",2006-2007,17115,17187,72,0.421,44,28,21,213,H1
"Simpson County, KY",2007-2008,17187,17182,-5,-0.029,62,-67,21,213,H1
"Simpson County, KY",2008-2009,17182,17227,45,0.262,28,17,21,213,H1
"Simpson County, KY",2009-2010,17227,17337,110,0.639,25,85,21,213,H1
"Simpson County, KY",2010-2011,17337,17305,-32,-0.185,60,-92,21,213,H1
"Simpson County, KY",2011-2012,17305,17559,254,1.468,29,225,21,213,H1
"Simpson County, KY",2012-2013,17559,17728,169,0.962,42,127,21,213,H1
"Simpson County, KY",2013-2014,17728,17826,98,0.553,55,43,21,213,H1
"Simpson County, KY",2014-2015,17864,18006,142,0.795,78,64,21,213,H1
"Simpson County, KY",2015-2016,18006,17985,-21,-0.117,81,-102,21,213,H1
"Simpson County, KY",2016-2017,17985,18108,123,0.684,71,52,21,213,H1
"Spencer County, KY",2000-2001,11911,12559,648,5.44,99,549,21,215,H1
"Spencer County, KY",2001-2002,12559,13219,660,5.255,81,579,21,215,H1
"Spencer County, KY",2002-2003,13219,13892,673,5.091,105,568,21,215,H1
"Spencer County, KY",2003-2004,13892,14358,466,3.354,87,379,21,215,H1
"Spencer County, KY",2004-2005,14358,14929,571,3.977,81,490,21,215,H1
"Spencer County, KY",2005-2006,14929,15638,709,4.749,90,619,21,215,H1
"Spencer County, KY",2006-2007,15638,16346,708,4.527,99,609,21,215,H1
"Spencer County, KY",2007-2008,16346,16845,499,3.053,71,428,21,215,H1
"Spencer County, KY",2008-2009,16845,16971,126,0.748,100,26,21,215,H1
"Spencer County, KY",2009-2010,16971,17114,143,0.843,39,104,21,215,H1
"Spencer County, KY",2010-2011,17114,17351,237,1.385,80,157,21,215,H1
"Spencer County, KY",2011-2012,17351,17409,58,0.334,63,-5,21,215,H1
"Spencer County, KY",2012-2013,17409,17554,145,0.833,24,121,21,215,H1
"Spencer County, KY",2013-2014,17554,17668,114,0.649,26,88,21,215,H1
"Spencer County, KY",2014-2015,17688,17894,206,1.165,31,175,21,215,H1
"Spencer County, KY",2015-2016,17894,18239,345,1.928,33,312,21,215,H1
"Spencer County, KY",2016-2017,18239,18507,268,1.469,35,233,21,215,H1
"Taylor County, KY",2000-2001,22874,22918,44,0.192,6,38,21,217,H1
"Taylor County, KY",2001-2002,22918,23338,420,1.833,38,382,21,217,H1
"Taylor County, KY",2002-2003,23338,23388,50,0.214,27,23,21,217,H1
"Taylor County, KY",2003-2004,23388,23536,148,0.633,37,111,21,217,H1
"Taylor County, KY",2004-2005,23536,23755,219,0.93,15,204,21,217,H1
"Taylor County, KY",2005-2006,23755,23971,216,0.909,73,143,21,217,H1
"Taylor County, KY",2006-2007,23971,24078,107,0.446,52,55,21,217,H1
"Taylor County, KY",2007-2008,24078,24256,178,0.739,28,150,21,217,H1
"Taylor County, KY",2008-2009,24256,24367,111,0.458,33,78,21,217,H1
"Taylor County, KY",2009-2010,24367,24802,435,1.785,18,417,21,217,H1
"Taylor County, KY",2010-2011,24802,24997,195,0.786,23,172,21,217,H1
"Taylor County, KY",2011-2012,24997,25049,52,0.208,49,3,21,217,H1
"Taylor County, KY",2012-2013,25049,25190,141,0.563,29,112,21,217,H1
"Taylor County, KY",2013-2014,25190,25257,67,0.266,15,52,21,217,H1
"Taylor County, KY",2014-2015,25120,25420,300,1.194,43,257,21,217,H1
"Taylor County, KY",2015-2016,25420,25437,17,0.067,-2,19,21,217,H1
"Taylor County, KY",2016-2017,25437,25472,35,0.138,9,26,21,217,H1
"Todd County, KY",2000-2001,11926,12021,95,0.797,67,28,21,219,H1
"Todd County, KY",2001-2002,12021,11975,-46,-0.383,35,-81,21,219,H1
"Todd County, KY",2002-2003,11975,11917,-58,-0.484,43,-101,21,219,H1
"Todd County, KY",2003-2004,11917,11858,-59,-0.495,26,-85,21,219,H1
"Todd County, KY",2004-2005,11858,11965,107,0.902,76,31,21,219,H1
"Todd County, KY",2005-2006,11965,12092,127,1.061,65,62,21,219,H1
"Todd County, KY",2006-2007,12092,12169,77,0.637,39,38,21,219,H1
"Todd County, KY",2007-2008,12169,12340,171,1.405,54,117,21,219,H1
"Todd County, KY",2008-2009,12340,12485,145,1.175,71,74,21,219,H1
"Todd County, KY",2009-2010,12485,12426,-59,-0.473,63,-122,21,219,H1
"Todd County, KY",2010-2011,12426,12427,1,0.008,24,-23,21,219,H1
"Todd County, KY",2011-2012,12427,12640,213,1.714,73,140,21,219,H1
"Todd County, KY",2012-2013,12640,12484,-156,-1.234,57,-213,21,219,H1
"Todd County, KY",2013-2014,12484,12520,36,0.288,57,-21,21,219,H1
"Todd County, KY",2014-2015,12522,12531,9,0.072,61,-52,21,219,H1
"Todd County, KY",2015-2016,12531,12362,-169,-1.349,72,-241,21,219,H1
"Todd County, KY",2016-2017,12362,12243,-119,-0.963,82,-201,21,219,H1
"Trigg County, KY",2000-2001,12657,12803,146,1.154,-5,151,21,221,H1
"Trigg County, KY",2001-2002,12803,12900,97,0.758,-40,137,21,221,H1
"Trigg County, KY",2002-2003,12900,13022,122,0.946,-34,156,21,221,H1
"Trigg County, KY",2003-2004,13022,13438,416,3.195,1,415,21,221,H1
"Trigg County, KY",2004-2005,13438,13619,181,1.347,1,180,21,221,H1
"Trigg County, KY",2005-2006,13619,13780,161,1.182,-19,180,21,221,H1
"Trigg County, KY",2006-2007,13780,14079,299,2.17,0,299,21,221,H1
"Trigg County, KY",2007-2008,14079,14153,74,0.526,-3,77,21,221,H1
"Trigg County, KY",2008-2009,14153,14222,69,0.488,-5,74,21,221,H1
"Trigg County, KY",2009-2010,14222,14346,124,0.872,-29,153,21,221,H1
"Trigg County, KY",2010-2011,14346,14202,-144,-1.004,-31,-113,21,221,H1
"Trigg County, KY",2011-2012,14202,14392,190,1.338,11,179,21,221,H1
"Trigg County, KY",2012-2013,14392,14302,-90,-0.625,-35,-55,21,221,H1
"Trigg County, KY",2013-2014,14302,14142,-160,-1.119,-15,-145,21,221,H1
"Trigg County, KY",2014-2015,14134,14233,99,0.7,-13,112,21,221,H1
"Trigg County, KY",2015-2016,14233,14313,80,0.562,-5,85,21,221,H1
"Trigg County, KY",2016-2017,14313,14444,131,0.915,-8,139,21,221,H1
"Trimble County, KY",2000-2001,8227,8449,222,2.698,13,209,21,223,H1
"Trimble County, KY",2001-2002,8449,8572,123,1.456,24,99,21,223,H1
"Trimble County, KY",2002-2003,8572,8653,81,0.945,34,47,21,223,H1
"Trimble County, KY",2003-2004,8653,8843,190,2.196,43,147,21,223,H1
"Trimble County, KY",2004-2005,8843,8788,-55,-0.622,17,-72,21,223,H1
"Trimble County, KY",2005-2006,8788,8856,68,0.774,13,55,21,223,H1
"Trimble County, KY",2006-2007,8856,8903,47,0.531,36,11,21,223,H1
"Trimble County, KY",2007-2008,8903,8950,47,0.528,35,12,21,223,H1
"Trimble County, KY",2008-2009,8950,8855,-95,-1.061,27,-122,21,223,H1
"Trimble County, KY",2009-2010,8855,8805,-50,-0.565,5,-55,21,223,H1
"Trimble County, KY",2010-2011,8805,8806,1,0.011,24,-23,21,223,H1
"Trimble County, KY",2011-2012,8806,8842,36,0.409,35,1,21,223,H1
"Trimble County, KY",2012-2013,8842,8842,0,0,11,-11,21,223,H1
"Trimble County, KY",2013-2014,8842,8786,-56,-0.633,3,-59,21,223,H1
"Trimble County, KY",2014-2015,8729,8769,40,0.458,1,39,21,223,H1
"Trimble County, KY",2015-2016,8769,8627,-142,-1.619,-2,-140,21,223,H1
"Trimble County, KY",2016-2017,8627,8561,-66,-0.765,-5,-61,21,223,H1
"Union County, KY",2000-2001,15378,15330,-48,-0.312,43,-91,21,225,H1
"Union County, KY",2001-2002,15330,15401,71,0.463,16,55,21,225,H1
"Union County, KY",2002-2003,15401,15395,-6,-0.039,-11,5,21,225,H1
"Union County, KY",2003-2004,15395,15451,56,0.364,26,30,21,225,H1
"Union County, KY",2004-2005,15451,15335,-116,-0.751,-14,-102,21,225,H1
"Union County, KY",2005-2006,15335,15246,-89,-0.58,51,-140,21,225,H1
"Union County, KY",2006-2007,15246,15060,-186,-1.22,85,-271,21,225,H1
"Union County, KY",2007-2008,15060,15072,12,0.08,5,7,21,225,H1
"Union County, KY",2008-2009,15072,15004,-68,-0.451,-5,-63,21,225,H1
"Union County, KY",2009-2010,15004,15293,289,1.926,-28,317,21,225,H1
"Union County, KY",2010-2011,15293,15283,-10,-0.065,5,-15,21,225,H1
"Union County, KY",2011-2012,15283,15119,-164,-1.073,26,-190,21,225,H1
"Union County, KY",2012-2013,15119,15101,-18,-0.119,19,-37,21,225,H1
"Union County, KY",2013-2014,15101,15165,64,0.424,13,51,21,225,H1
"Union County, KY",2014-2015,15154,15050,-104,-0.686,10,-114,21,225,H1
"Union County, KY",2015-2016,15050,14792,-258,-1.714,-4,-254,21,225,H1
"Union County, KY",2016-2017,14792,14668,-124,-0.838,-7,-117,21,225,H1
"Warren County, KY",2000-2001,92917,94211,1294,1.393,471,823,21,227,H1
"Warren County, KY",2001-2002,94211,95576,1365,1.449,459,906,21,227,H1
"Warren County, KY",2002-2003,95576,97721,2145,2.244,476,1669,21,227,H1
"Warren County, KY",2003-2004,97721,99497,1776,1.817,528,1248,21,227,H1
"Warren County, KY",2004-2005,99497,102121,2624,2.637,614,2010,21,227,H1
"Warren County, KY",2005-2006,102121,105170,3049,2.986,649,2400,21,227,H1
"Warren County, KY",2006-2007,105170,107356,2186,2.079,719,1467,21,227,H1
"Warren County, KY",2007-2008,107356,109803,2447,2.279,670,1777,21,227,H1
"Warren County, KY",2008-2009,109803,112375,2572,2.342,628,1944,21,227,H1
"Warren County, KY",2009-2010,112375,114234,1859,1.654,616,1243,21,227,H1
"Warren County, KY",2010-2011,114234,115304,1070,0.937,540,530,21,227,H1
"Warren County, KY",2011-2012,115304,117185,1881,1.631,561,1320,21,227,H1
"Warren County, KY",2012-2013,117185,118664,1479,1.262,671,808,21,227,H1
"Warren County, KY",2013-2014,118664,120460,1796,1.514,653,1143,21,227,H1
"Warren County, KY",2014-2015,120601,122851,2250,1.866,698,1552,21,227,H1
"Warren County, KY",2015-2016,122851,126341,3490,2.841,726,2764,21,227,H1
"Warren County, KY",2016-2017,126341,128845,2504,1.982,725,1779,21,227,H1
"Washington County, KY",2000-2001,10920,10997,77,0.705,17,60,21,229,H1
"Washington County, KY",2001-2002,10997,11143,146,1.328,19,127,21,229,H1
"Washington County, KY",2002-2003,11143,11222,79,0.709,34,45,21,229,H1
"Washington County, KY",2003-2004,11222,11260,38,0.339,41,-3,21,229,H1
"Washington County, KY",2004-2005,11260,11339,79,0.702,24,55,21,229,H1
"Washington County, KY",2005-2006,11339,11456,117,1.032,32,85,21,229,H1
"Washington County, KY",2006-2007,11456,11640,184,1.606,21,163,21,229,H1
"Washington County, KY",2007-2008,11640,11551,-89,-0.765,8,-97,21,229,H1
"Washington County, KY",2008-2009,11551,11550,-1,-0.009,24,-25,21,229,H1
"Washington County, KY",2009-2010,11550,11728,178,1.541,29,149,21,229,H1
"Washington County, KY",2010-2011,11728,11875,147,1.253,-17,164,21,229,H1
"Washington County, KY",2011-2012,11875,11882,7,0.059,-3,10,21,229,H1
"Washington County, KY",2012-2013,11882,11912,30,0.252,31,-1,21,229,H1
"Washington County, KY",2013-2014,11912,11959,47,0.395,20,27,21,229,H1
"Washington County, KY",2014-2015,11955,12063,108,0.903,29,79,21,229,H1
"Washington County, KY",2015-2016,12063,12130,67,0.555,14,53,21,229,H1
"Washington County, KY",2016-2017,12130,12126,-4,-0.033,1,-5,21,229,H1
"Wayne County, KY",2000-2001,19958,19949,-9,-0.045,26,-35,21,231,H1
"Wayne County, KY",2001-2002,19949,20078,129,0.647,23,106,21,231,H1
"Wayne County, KY",2002-2003,20078,20353,275,1.37,21,254,21,231,H1
"Wayne County, KY",2003-2004,20353,20473,120,0.59,26,94,21,231,H1
"Wayne County, KY",2004-2005,20473,20516,43,0.21,33,10,21,231,H1
"Wayne County, KY",2005-2006,20516,20547,31,0.151,39,-8,21,231,H1
"Wayne County, KY",2006-2007,20547,20667,120,0.584,28,92,21,231,H1
"Wayne County, KY",2007-2008,20667,20757,90,0.435,40,50,21,231,H1
"Wayne County, KY",2008-2009,20757,20793,36,0.173,23,13,21,231,H1
"Wayne County, KY",2009-2010,20793,20840,47,0.226,1,46,21,231,H1
"Wayne County, KY",2010-2011,20840,20880,40,0.192,11,29,21,231,H1
"Wayne County, KY",2011-2012,20880,20775,-105,-0.503,5,-110,21,231,H1
"Wayne County, KY",2012-2013,20775,20659,-116,-0.558,50,-166,21,231,H1
"Wayne County, KY",2013-2014,20659,20486,-173,-0.837,47,-220,21,231,H1
"Wayne County, KY",2014-2015,20486,20464,-22,-0.107,30,-52,21,231,H1
"Wayne County, KY",2015-2016,20464,20753,289,1.412,35,254,21,231,H1
"Wayne County, KY",2016-2017,20753,20716,-37,-0.178,64,-101,21,231,H1
"Webster County, KY",2000-2001,14097,13945,-152,-1.078,32,-184,21,233,H1
"Webster County, KY",2001-2002,13945,13982,37,0.265,48,-11,21,233,H1
"Webster County, KY",2002-2003,13982,13912,-70,-0.501,10,-80,21,233,H1
"Webster County, KY",2003-2004,13912,13969,57,0.41,43,14,21,233,H1
"Webster County, KY",2004-2005,13969,14004,35,0.251,37,-2,21,233,H1
"Webster County, KY",2005-2006,14004,13875,-129,-0.921,46,-175,21,233,H1
"Webster County, KY",2006-2007,13875,13867,-8,-0.058,38,-46,21,233,H1
"Webster County, KY",2007-2008,13867,13646,-221,-1.594,27,-248,21,233,H1
"Webster County, KY",2008-2009,13646,13681,35,0.256,32,3,21,233,H1
"Webster County, KY",2009-2010,13681,13602,-79,-0.577,25,-104,21,233,H1
"Webster County, KY",2010-2011,13602,13550,-52,-0.382,-15,-37,21,233,H1
"Webster County, KY",2011-2012,13550,13479,-71,-0.524,-29,-42,21,233,H1
"Webster County, KY",2012-2013,13479,13401,-78,-0.579,18,-96,21,233,H1
"Webster County, KY",2013-2014,13401,13236,-165,-1.231,1,-166,21,233,H1
"Webster County, KY",2014-2015,13220,13170,-50,-0.378,-6,-44,21,233,H1
"Webster County, KY",2015-2016,13170,13174,4,0.03,-33,37,21,233,H1
"Webster County, KY",2016-2017,13174,13018,-156,-1.184,-12,-144,21,233,H1
"Whitley County, KY",2000-2001,35895,36091,196,0.546,95,101,21,235,H1
"Whitley County, KY",2001-2002,36091,36043,-48,-0.133,70,-118,21,235,H1
"Whitley County, KY",2002-2003,36043,36099,56,0.155,113,-57,21,235,H1
"Whitley County, KY",2003-2004,36099,36163,64,0.177,-22,86,21,235,H1
"Whitley County, KY",2004-2005,36163,36253,90,0.249,-2,92,21,235,H1
"Whitley County, KY",2005-2006,36253,36149,-104,-0.287,62,-166,21,235,H1
"Whitley County, KY",2006-2007,36149,36138,-11,-0.03,243,-254,21,235,H1
"Whitley County, KY",2007-2008,36138,36163,25,0.069,156,-131,21,235,H1
"Whitley County, KY",2008-2009,36163,35994,-169,-0.467,16,-185,21,235,H1
"Whitley County, KY",2009-2010,35994,35681,-313,-0.87,-29,-284,21,235,H1
"Whitley County, KY",2010-2011,35681,35509,-172,-0.482,67,-239,21,235,H1
"Whitley County, KY",2011-2012,35509,35505,-4,-0.011,98,-102,21,235,H1
"Whitley County, KY",2012-2013,35505,35586,81,0.228,39,42,21,235,H1
"Whitley County, KY",2013-2014,35586,35503,-83,-0.233,49,-132,21,235,H1
"Whitley County, KY",2014-2015,35784,36129,345,0.964,166,179,21,235,H1
"Whitley County, KY",2015-2016,36129,36103,-26,-0.072,115,-141,21,235,H1
"Whitley County, KY",2016-2017,36103,36214,111,0.307,145,-34,21,235,H1
"Wolfe County, KY",2000-2001,7126,6965,-161,-2.259,20,-181,21,237,H1
"Wolfe County, KY",2001-2002,6965,7015,50,0.718,37,13,21,237,H1
"Wolfe County, KY",2002-2003,7015,7053,38,0.542,6,32,21,237,H1
"Wolfe County, KY",2003-2004,7053,7076,23,0.326,17,6,21,237,H1
"Wolfe County, KY",2004-2005,7076,7201,125,1.767,1,124,21,237,H1
"Wolfe County, KY",2005-2006,7201,7256,55,0.764,33,22,21,237,H1
"Wolfe County, KY",2006-2007,7256,7323,67,0.923,49,18,21,237,H1
"Wolfe County, KY",2007-2008,7323,7294,-29,-0.396,15,-44,21,237,H1
"Wolfe County, KY",2008-2009,7294,7351,57,0.781,-6,63,21,237,H1
"Wolfe County, KY",2009-2010,7351,7349,-2,-0.027,-14,12,21,237,H1
"Wolfe County, KY",2010-2011,7349,7359,10,0.136,12,-2,21,237,H1
"Wolfe County, KY",2011-2012,7359,7188,-171,-2.324,-20,-151,21,237,H1
"Wolfe County, KY",2012-2013,7188,7253,65,0.904,-26,91,21,237,H1
"Wolfe County, KY",2013-2014,7253,7214,-39,-0.538,-15,-24,21,237,H1
"Wolfe County, KY",2014-2015,7232,7259,27,0.373,-10,37,21,237,H1
"Wolfe County, KY",2015-2016,7259,7215,-44,-0.606,-13,-31,21,237,H1
"Wolfe County, KY",2016-2017,7215,7264,49,0.679,-15,64,21,237,H1
"Woodford County, KY",2000-2001,23278,23331,53,0.228,126,-73,21,239,H1
"Woodford County, KY",2001-2002,23331,23406,75,0.321,103,-28,21,239,H1
"Woodford County, KY",2002-2003,23406,23555,149,0.637,148,1,21,239,H1
"Woodford County, KY",2003-2004,23555,23695,140,0.594,99,41,21,239,H1
"Woodford County, KY",2004-2005,23695,23933,238,1.004,109,129,21,239,H1
"Woodford County, KY",2005-2006,23933,24134,201,0.84,50,151,21,239,H1
"Woodford County, KY",2006-2007,24134,24214,80,0.331,60,20,21,239,H1
"Woodford County, KY",2007-2008,24214,24541,327,1.35,142,185,21,239,H1
"Woodford County, KY",2008-2009,24541,24702,161,0.656,113,48,21,239,H1
"Woodford County, KY",2009-2010,24702,25005,303,1.227,69,234,21,239,H1
"Woodford County, KY",2010-2011,25005,24893,-112,-0.448,70,-182,21,239,H1
"Woodford County, KY",2011-2012,24893,25039,146,0.587,46,100,21,239,H1
"Woodford County, KY",2012-2013,25039,25254,215,0.859,58,157,21,239,H1
"Woodford County, KY",2013-2014,25254,25563,309,1.224,87,222,21,239,H1
"Woodford County, KY",2014-2015,25539,25793,254,0.995,48,206,21,239,H1
"Woodford County, KY",2015-2016,25793,26091,298,1.155,102,196,21,239,H1
"Woodford County, KY",2016-2017,26091,26368,277,1.062,76,201,21,239,H1
Louisiana,2000-2001,4471885,4477875,5990,0.134,24427,-18437,22,0,STATE
Louisiana,2001-2002,4477875,4497267,19392,0.433,23884,-4492,22,0,STATE
Louisiana,2002-2003,4497267,4521042,23775,0.529,22512,1263,22,0,STATE
Louisiana,2003-2004,4521042,4552238,31196,0.69,22817,8379,22,0,STATE
Louisiana,2004-2005,4552238,4576628,24390,0.536,22451,1939,22,0,STATE
Louisiana,2005-2006,4576628,4302665,-273963,-5.986,16550,-290513,22,0,STATE
Louisiana,2006-2007,4302665,4375581,72916,1.695,25214,47702,22,0,STATE
Louisiana,2007-2008,4375581,4435586,60005,1.371,27190,32815,22,0,STATE
Louisiana,2008-2009,4435586,4491648,56062,1.264,21964,34098,22,0,STATE
Louisiana,2009-2010,4491648,4544951,53303,1.187,20078,33225,22,0,STATE
Louisiana,2010-2011,4544951,4575381,30430,0.67,21561,8869,22,0,STATE
Louisiana,2011-2012,4575381,4603676,28295,0.618,21530,6765,22,0,STATE
Louisiana,2012-2013,4603676,4627491,23815,0.517,18750,5065,22,0,STATE
Louisiana,2013-2014,4627491,4648990,21499,0.465,20301,1198,22,0,STATE
Louisiana,2014-2015,4648990,4670724,21734,0.467,20391,1343,22,0,STATE
Louisiana,2015-2016,4670724,4686157,15433,0.33,19955,-4522,22,0,STATE
Louisiana,2016-2017,4686157,4684333,-1824,-0.039,18017,-19841,22,0,STATE
"Acadia Parish, LA",2000-2001,58795,58844,49,0.083,273,-224,22,1,H1
"Acadia Parish, LA",2001-2002,58844,59065,221,0.376,294,-73,22,1,H1
"Acadia Parish, LA",2002-2003,59065,59194,129,0.218,309,-180,22,1,H1
"Acadia Parish, LA",2003-2004,59194,59223,29,0.049,323,-294,22,1,H1
"Acadia Parish, LA",2004-2005,59223,59524,301,0.508,304,-3,22,1,H1
"Acadia Parish, LA",2005-2006,59524,60522,998,1.677,281,717,22,1,H1
"Acadia Parish, LA",2006-2007,60522,60762,240,0.397,280,-40,22,1,H1
"Acadia Parish, LA",2007-2008,60762,61115,353,0.581,350,3,22,1,H1
"Acadia Parish, LA",2008-2009,61115,61451,336,0.55,335,1,22,1,H1
"Acadia Parish, LA",2009-2010,61451,61861,410,0.667,281,129,22,1,H1
"Acadia Parish, LA",2010-2011,61861,61766,-95,-0.154,176,-271,22,1,H1
"Acadia Parish, LA",2011-2012,61766,61873,107,0.173,260,-153,22,1,H1
"Acadia Parish, LA",2012-2013,61873,62169,296,0.478,228,68,22,1,H1
"Acadia Parish, LA",2013-2014,62169,62486,317,0.51,237,80,22,1,H1
"Acadia Parish, LA",2014-2015,62498,62577,79,0.126,285,-206,22,1,H1
"Acadia Parish, LA",2015-2016,62577,62800,223,0.356,279,-56,22,1,H1
"Acadia Parish, LA",2016-2017,62800,62590,-210,-0.334,239,-449,22,1,H1
"Allen Parish, LA",2000-2001,25401,25399,-2,-0.008,111,-113,22,3,H1
"Allen Parish, LA",2001-2002,25399,25194,-205,-0.807,105,-310,22,3,H1
"Allen Parish, LA",2002-2003,25194,25327,133,0.528,98,35,22,3,H1
"Allen Parish, LA",2003-2004,25327,25338,11,0.043,106,-95,22,3,H1
"Allen Parish, LA",2004-2005,25338,25076,-262,-1.034,83,-345,22,3,H1
"Allen Parish, LA",2005-2006,25076,25692,616,2.457,179,437,22,3,H1
"Allen Parish, LA",2006-2007,25692,25937,245,0.954,351,-106,22,3,H1
"Allen Parish, LA",2007-2008,25937,25854,-83,-0.32,220,-303,22,3,H1
"Allen Parish, LA",2008-2009,25854,25863,9,0.035,98,-89,22,3,H1
"Allen Parish, LA",2009-2010,25863,25743,-120,-0.464,75,-195,22,3,H1
"Allen Parish, LA",2010-2011,25743,25750,7,0.027,104,-97,22,3,H1
"Allen Parish, LA",2011-2012,25750,25613,-137,-0.532,69,-206,22,3,H1
"Allen Parish, LA",2012-2013,25613,25635,22,0.086,104,-82,22,3,H1
"Allen Parish, LA",2013-2014,25635,25713,78,0.304,76,2,22,3,H1
"Allen Parish, LA",2014-2015,25691,25683,-8,-0.031,132,-140,22,3,H1
"Allen Parish, LA",2015-2016,25683,25686,3,0.012,72,-69,22,3,H1
"Allen Parish, LA",2016-2017,25686,25621,-65,-0.253,49,-114,22,3,H1
"Ascension Parish, LA",2000-2001,77335,79210,1875,2.425,819,1056,22,5,H1
"Ascension Parish, LA",2001-2002,79210,81379,2169,2.738,856,1313,22,5,H1
"Ascension Parish, LA",2002-2003,81379,83967,2588,3.18,828,1760,22,5,H1
"Ascension Parish, LA",2003-2004,83967,86352,2385,2.84,905,1480,22,5,H1
"Ascension Parish, LA",2004-2005,86352,89741,3389,3.925,918,2471,22,5,H1
"Ascension Parish, LA",2005-2006,89741,96421,6680,7.444,1049,5631,22,5,H1
"Ascension Parish, LA",2006-2007,96421,100132,3711,3.849,1065,2646,22,5,H1
"Ascension Parish, LA",2007-2008,100132,102891,2759,2.755,1046,1713,22,5,H1
"Ascension Parish, LA",2008-2009,102891,105172,2281,2.217,1057,1224,22,5,H1
"Ascension Parish, LA",2009-2010,105172,107863,2691,2.559,864,1827,22,5,H1
"Ascension Parish, LA",2010-2011,107863,110041,2178,2.019,992,1186,22,5,H1
"Ascension Parish, LA",2011-2012,110041,112173,2132,1.937,920,1212,22,5,H1
"Ascension Parish, LA",2012-2013,112173,114432,2259,2.014,863,1396,22,5,H1
"Ascension Parish, LA",2013-2014,114432,117029,2597,2.269,850,1747,22,5,H1
"Ascension Parish, LA",2014-2015,117364,119455,2091,1.782,982,1109,22,5,H1
"Ascension Parish, LA",2015-2016,119455,121488,2033,1.702,921,1112,22,5,H1
"Ascension Parish, LA",2016-2017,121488,122948,1460,1.202,808,652,22,5,H1
"Assumption Parish, LA",2000-2001,23324,23194,-130,-0.557,115,-245,22,7,H1
"Assumption Parish, LA",2001-2002,23194,23210,16,0.069,98,-82,22,7,H1
"Assumption Parish, LA",2002-2003,23210,23262,52,0.224,106,-54,22,7,H1
"Assumption Parish, LA",2003-2004,23262,23319,57,0.245,48,9,22,7,H1
"Assumption Parish, LA",2004-2005,23319,23199,-120,-0.515,88,-208,22,7,H1
"Assumption Parish, LA",2005-2006,23199,23477,278,1.198,59,219,22,7,H1
"Assumption Parish, LA",2006-2007,23477,23543,66,0.281,120,-54,22,7,H1
"Assumption Parish, LA",2007-2008,23543,23534,-9,-0.038,99,-108,22,7,H1
"Assumption Parish, LA",2008-2009,23534,23508,-26,-0.11,56,-82,22,7,H1
"Assumption Parish, LA",2009-2010,23508,23360,-148,-0.63,46,-194,22,7,H1
"Assumption Parish, LA",2010-2011,23360,23187,-173,-0.741,50,-223,22,7,H1
"Assumption Parish, LA",2011-2012,23187,23073,-114,-0.492,55,-169,22,7,H1
"Assumption Parish, LA",2012-2013,23073,23196,123,0.533,64,59,22,7,H1
"Assumption Parish, LA",2013-2014,23196,23034,-162,-0.698,49,-211,22,7,H1
"Assumption Parish, LA",2014-2015,23020,22842,-178,-0.773,46,-224,22,7,H1
"Assumption Parish, LA",2015-2016,22842,22755,-87,-0.381,21,-108,22,7,H1
"Assumption Parish, LA",2016-2017,22755,22526,-229,-1.006,25,-254,22,7,H1
"Avoyelles Parish, LA",2000-2001,41459,41274,-185,-0.446,170,-355,22,9,H1
"Avoyelles Parish, LA",2001-2002,41274,41233,-41,-0.099,119,-160,22,9,H1
"Avoyelles Parish, LA",2002-2003,41233,41446,213,0.517,141,72,22,9,H1
"Avoyelles Parish, LA",2003-2004,41446,41271,-175,-0.422,147,-322,22,9,H1
"Avoyelles Parish, LA",2004-2005,41271,41036,-235,-0.569,108,-343,22,9,H1
"Avoyelles Parish, LA",2005-2006,41036,42080,1044,2.544,113,931,22,9,H1
"Avoyelles Parish, LA",2006-2007,42080,41809,-271,-0.644,189,-460,22,9,H1
"Avoyelles Parish, LA",2007-2008,41809,42040,231,0.553,170,61,22,9,H1
"Avoyelles Parish, LA",2008-2009,42040,42034,-6,-0.014,144,-150,22,9,H1
"Avoyelles Parish, LA",2009-2010,42034,42110,76,0.181,100,-24,22,9,H1
"Avoyelles Parish, LA",2010-2011,42110,41836,-274,-0.651,55,-329,22,9,H1
"Avoyelles Parish, LA",2011-2012,41836,41602,-234,-0.559,67,-301,22,9,H1
"Avoyelles Parish, LA",2012-2013,41602,41327,-275,-0.661,57,-332,22,9,H1
"Avoyelles Parish, LA",2013-2014,41327,41145,-182,-0.44,88,-270,22,9,H1
"Avoyelles Parish, LA",2014-2015,41145,41103,-42,-0.102,124,-166,22,9,H1
"Avoyelles Parish, LA",2015-2016,41103,41040,-63,-0.153,74,-137,22,9,H1
"Avoyelles Parish, LA",2016-2017,41040,40980,-60,-0.146,83,-143,22,9,H1
"Beauregard Parish, LA",2000-2001,32979,33001,22,0.067,96,-74,22,11,H1
"Beauregard Parish, LA",2001-2002,33001,3.30E+04,-1,-0.003,131,-132,22,11,H1
"Beauregard Parish, LA",2002-2003,3.30E+04,33221,221,0.67,122,99,22,11,H1
"Beauregard Parish, LA",2003-2004,33221,33614,393,1.183,110,283,22,11,H1
"Beauregard Parish, LA",2004-2005,33614,34130,516,1.535,103,413,22,11,H1
"Beauregard Parish, LA",2005-2006,34130,34510,380,1.113,122,258,22,11,H1
"Beauregard Parish, LA",2006-2007,34510,34623,113,0.327,158,-45,22,11,H1
"Beauregard Parish, LA",2007-2008,34623,34893,270,0.78,177,93,22,11,H1
"Beauregard Parish, LA",2008-2009,34893,35142,249,0.714,158,91,22,11,H1
"Beauregard Parish, LA",2009-2010,35142,35824,682,1.941,99,583,22,11,H1
"Beauregard Parish, LA",2010-2011,35824,36046,222,0.62,147,75,22,11,H1
"Beauregard Parish, LA",2011-2012,36046,36254,208,0.577,193,15,22,11,H1
"Beauregard Parish, LA",2012-2013,36254,36223,-31,-0.086,145,-176,22,11,H1
"Beauregard Parish, LA",2013-2014,36223,36198,-25,-0.069,133,-158,22,11,H1
"Beauregard Parish, LA",2014-2015,36220,36462,242,0.668,107,135,22,11,H1
"Beauregard Parish, LA",2015-2016,36462,36998,536,1.47,196,340,22,11,H1
"Beauregard Parish, LA",2016-2017,36998,36928,-70,-0.189,138,-208,22,11,H1
"Bienville Parish, LA",2000-2001,15717,15400,-317,-2.017,-29,-288,22,13,H1
"Bienville Parish, LA",2001-2002,15400,15279,-121,-0.786,-58,-63,22,13,H1
"Bienville Parish, LA",2002-2003,15279,15077,-202,-1.322,-31,-171,22,13,H1
"Bienville Parish, LA",2003-2004,15077,15017,-60,-0.398,-35,-25,22,13,H1
"Bienville Parish, LA",2004-2005,15017,14852,-165,-1.099,-27,-138,22,13,H1
"Bienville Parish, LA",2005-2006,14852,14773,-79,-0.532,-28,-51,22,13,H1
"Bienville Parish, LA",2006-2007,14773,14699,-74,-0.501,-22,-52,22,13,H1
"Bienville Parish, LA",2007-2008,14699,14494,-205,-1.395,15,-220,22,13,H1
"Bienville Parish, LA",2008-2009,14494,14435,-59,-0.407,-12,-47,22,13,H1
"Bienville Parish, LA",2009-2010,14435,14334,-101,-0.7,-24,-77,22,13,H1
"Bienville Parish, LA",2010-2011,14334,14234,-100,-0.698,-30,-70,22,13,H1
"Bienville Parish, LA",2011-2012,14234,14163,-71,-0.499,7,-78,22,13,H1
"Bienville Parish, LA",2012-2013,14163,13995,-168,-1.186,27,-195,22,13,H1
"Bienville Parish, LA",2013-2014,13995,13885,-110,-0.786,6,-116,22,13,H1
"Bienville Parish, LA",2014-2015,13769,13786,17,0.123,-70,87,22,13,H1
"Bienville Parish, LA",2015-2016,13786,13806,20,0.145,4,16,22,13,H1
"Bienville Parish, LA",2016-2017,13806,13638,-168,-1.217,-40,-128,22,13,H1
"Bossier Parish, LA",2000-2001,99658,100986,1328,1.333,745,583,22,15,H1
"Bossier Parish, LA",2001-2002,100986,102227,1241,1.229,722,519,22,15,H1
"Bossier Parish, LA",2002-2003,102227,103088,861,0.842,760,101,22,15,H1
"Bossier Parish, LA",2003-2004,103088,105435,2347,2.277,804,1543,22,15,H1
"Bossier Parish, LA",2004-2005,105435,107477,2042,1.937,774,1268,22,15,H1
"Bossier Parish, LA",2005-2006,107477,110606,3129,2.911,818,2311,22,15,H1
"Bossier Parish, LA",2006-2007,110606,112048,1442,1.304,906,536,22,15,H1
"Bossier Parish, LA",2007-2008,112048,113824,1776,1.585,840,936,22,15,H1
"Bossier Parish, LA",2008-2009,113824,115187,1363,1.197,858,505,22,15,H1
"Bossier Parish, LA",2009-2010,115187,117601,2414,2.096,842,1572,22,15,H1
"Bossier Parish, LA",2010-2011,117601,120003,2402,2.042,812,1590,22,15,H1
"Bossier Parish, LA",2011-2012,120003,123073,3070,2.558,919,2151,22,15,H1
"Bossier Parish, LA",2012-2013,123073,123848,775,0.63,910,-135,22,15,H1
"Bossier Parish, LA",2013-2014,123848,125064,1216,0.982,871,345,22,15,H1
"Bossier Parish, LA",2014-2015,124769,125175,406,0.325,748,-342,22,15,H1
"Bossier Parish, LA",2015-2016,125175,126252,1077,0.86,785,292,22,15,H1
"Bossier Parish, LA",2016-2017,126252,127634,1382,1.095,758,624,22,15,H1
"Caddo Parish, LA",2000-2001,250990,249815,-1175,-0.468,1103,-2278,22,17,H1
"Caddo Parish, LA",2001-2002,249815,248753,-1062,-0.425,1102,-2164,22,17,H1
"Caddo Parish, LA",2002-2003,248753,248346,-407,-0.164,975,-1382,22,17,H1
"Caddo Parish, LA",2003-2004,248346,249157,811,0.327,944,-133,22,17,H1
"Caddo Parish, LA",2004-2005,249157,249593,436,0.175,1057,-621,22,17,H1
"Caddo Parish, LA",2005-2006,249593,252740,3147,1.261,1021,2126,22,17,H1
"Caddo Parish, LA",2006-2007,252740,251760,-980,-0.388,1216,-2196,22,17,H1
"Caddo Parish, LA",2007-2008,251760,251953,193,0.077,1332,-1139,22,17,H1
"Caddo Parish, LA",2008-2009,251953,253245,1292,0.513,1172,120,22,17,H1
"Caddo Parish, LA",2009-2010,253245,255609,2364,0.933,1099,1265,22,17,H1
"Caddo Parish, LA",2010-2011,255609,256942,1333,0.521,1228,105,22,17,H1
"Caddo Parish, LA",2011-2012,256942,257328,386,0.15,1230,-844,22,17,H1
"Caddo Parish, LA",2012-2013,257328,255164,-2164,-0.841,982,-3146,22,17,H1
"Caddo Parish, LA",2013-2014,255164,252603,-2561,-1.004,1027,-3588,22,17,H1
"Caddo Parish, LA",2014-2015,252702,251460,-1242,-0.491,1078,-2320,22,17,H1
"Caddo Parish, LA",2015-2016,251460,249145,-2315,-0.921,713,-3028,22,17,H1
"Caddo Parish, LA",2016-2017,249145,246581,-2564,-1.029,691,-3255,22,17,H1
"Calcasieu Parish, LA",2000-2001,183554,183296,-258,-0.141,1019,-1277,22,19,H1
"Calcasieu Parish, LA",2001-2002,183296,183487,191,0.104,980,-789,22,19,H1
"Calcasieu Parish, LA",2002-2003,183487,184701,1214,0.662,1040,174,22,19,H1
"Calcasieu Parish, LA",2003-2004,184701,185593,892,0.483,902,-10,22,19,H1
"Calcasieu Parish, LA",2004-2005,185593,186417,824,0.444,946,-122,22,19,H1
"Calcasieu Parish, LA",2005-2006,186417,185350,-1067,-0.572,704,-1771,22,19,H1
"Calcasieu Parish, LA",2006-2007,185350,187081,1731,0.934,1112,619,22,19,H1
"Calcasieu Parish, LA",2007-2008,187081,188928,1847,0.987,1138,709,22,19,H1
"Calcasieu Parish, LA",2008-2009,188928,191080,2152,1.139,988,1164,22,19,H1
"Calcasieu Parish, LA",2009-2010,191080,193170,2090,1.094,879,1211,22,19,H1
"Calcasieu Parish, LA",2010-2011,193170,193907,737,0.382,752,-15,22,19,H1
"Calcasieu Parish, LA",2011-2012,193907,194653,746,0.385,910,-164,22,19,H1
"Calcasieu Parish, LA",2012-2013,194653,195782,1129,0.58,896,233,22,19,H1
"Calcasieu Parish, LA",2013-2014,195782,197204,1422,0.726,873,549,22,19,H1
"Calcasieu Parish, LA",2014-2015,196839,198788,1949,0.99,864,1085,22,19,H1
"Calcasieu Parish, LA",2015-2016,198788,200632,1844,0.928,905,939,22,19,H1
"Calcasieu Parish, LA",2016-2017,200632,202445,1813,0.904,869,944,22,19,H1
"Caldwell Parish, LA",2000-2001,10559,10429,-130,-1.231,32,-162,22,21,H1
"Caldwell Parish, LA",2001-2002,10429,10429,0,0,14,-14,22,21,H1
"Caldwell Parish, LA",2002-2003,10429,10352,-77,-0.738,24,-101,22,21,H1
"Caldwell Parish, LA",2003-2004,10352,10382,30,0.29,-29,59,22,21,H1
"Caldwell Parish, LA",2004-2005,10382,10247,-135,-1.3,7,-142,22,21,H1
"Caldwell Parish, LA",2005-2006,10247,10224,-23,-0.224,31,-54,22,21,H1
"Caldwell Parish, LA",2006-2007,10224,10189,-35,-0.342,25,-60,22,21,H1
"Caldwell Parish, LA",2007-2008,10189,10224,35,0.344,-21,56,22,21,H1
"Caldwell Parish, LA",2008-2009,10224,10185,-39,-0.381,8,-47,22,21,H1
"Caldwell Parish, LA",2009-2010,10185,10131,-54,-0.53,-2,-52,22,21,H1
"Caldwell Parish, LA",2010-2011,10131,10081,-50,-0.494,25,-75,22,21,H1
"Caldwell Parish, LA",2011-2012,10081,1.00E+04,-81,-0.803,-48,-33,22,21,H1
"Caldwell Parish, LA",2012-2013,1.00E+04,9933,-67,-0.67,-14,-53,22,21,H1
"Caldwell Parish, LA",2013-2014,9933,9894,-39,-0.393,-16,-23,22,21,H1
"Caldwell Parish, LA",2014-2015,9922,9993,71,0.716,-3,74,22,21,H1
"Caldwell Parish, LA",2015-2016,9993,10071,78,0.781,-5,83,22,21,H1
"Caldwell Parish, LA",2016-2017,10071,9950,-121,-1.201,-7,-114,22,21,H1
"Cameron Parish, LA",2000-2001,9937,9875,-62,-0.624,41,-103,22,23,H1
"Cameron Parish, LA",2001-2002,9875,9834,-41,-0.415,26,-67,22,23,H1
"Cameron Parish, LA",2002-2003,9834,9851,17,0.173,31,-14,22,23,H1
"Cameron Parish, LA",2003-2004,9851,9851,0,0,21,-21,22,23,H1
"Cameron Parish, LA",2004-2005,9851,9846,-5,-0.051,16,-21,22,23,H1
"Cameron Parish, LA",2005-2006,9846,7719,-2127,-21.603,2,-2129,22,23,H1
"Cameron Parish, LA",2006-2007,7719,7517,-202,-2.617,24,-226,22,23,H1
"Cameron Parish, LA",2007-2008,7517,7434,-83,-1.104,45,-128,22,23,H1
"Cameron Parish, LA",2008-2009,7434,6930,-504,-6.78,17,-521,22,23,H1
"Cameron Parish, LA",2009-2010,6930,6899,-31,-0.447,21,-52,22,23,H1
"Cameron Parish, LA",2010-2011,6899,6685,-214,-3.102,37,-251,22,23,H1
"Cameron Parish, LA",2011-2012,6685,6623,-62,-0.927,14,-76,22,23,H1
"Cameron Parish, LA",2012-2013,6623,6679,56,0.846,3,53,22,23,H1
"Cameron Parish, LA",2013-2014,6679,6679,0,0,-3,3,22,23,H1
"Cameron Parish, LA",2014-2015,6705,6817,112,1.67,9,103,22,23,H1
"Cameron Parish, LA",2015-2016,6817,6886,69,1.012,12,57,22,23,H1
"Cameron Parish, LA",2016-2017,6886,6912,26,0.378,11,15,22,23,H1
"Catahoula Parish, LA",2000-2001,10882,10767,-115,-1.057,0,-115,22,25,H1
"Catahoula Parish, LA",2001-2002,10767,10635,-132,-1.226,-4,-128,22,25,H1
"Catahoula Parish, LA",2002-2003,10635,10542,-93,-0.874,5,-98,22,25,H1
"Catahoula Parish, LA",2003-2004,10542,10448,-94,-0.892,14,-108,22,25,H1
"Catahoula Parish, LA",2004-2005,10448,10258,-190,-1.819,8,-198,22,25,H1
"Catahoula Parish, LA",2005-2006,10258,10423,165,1.609,42,123,22,25,H1
"Catahoula Parish, LA",2006-2007,10423,10481,58,0.556,31,27,22,25,H1
"Catahoula Parish, LA",2007-2008,10481,10567,86,0.821,45,41,22,25,H1
"Catahoula Parish, LA",2008-2009,10567,10471,-96,-0.908,42,-138,22,25,H1
"Catahoula Parish, LA",2009-2010,10471,10380,-91,-0.869,21,-112,22,25,H1
"Catahoula Parish, LA",2010-2011,10380,10317,-63,-0.607,-6,-57,22,25,H1
"Catahoula Parish, LA",2011-2012,10317,10250,-67,-0.649,-3,-64,22,25,H1
"Catahoula Parish, LA",2012-2013,10250,10266,16,0.156,9,7,22,25,H1
"Catahoula Parish, LA",2013-2014,10266,10151,-115,-1.12,16,-131,22,25,H1
"Catahoula Parish, LA",2014-2015,10215,10147,-68,-0.666,32,-100,22,25,H1
"Catahoula Parish, LA",2015-2016,10147,9910,-237,-2.336,6,-243,22,25,H1
"Catahoula Parish, LA",2016-2017,9910,9875,-35,-0.353,0,-35,22,25,H1
"Claiborne Parish, LA",2000-2001,16811,16810,-1,-0.006,-40,39,22,27,H1
"Claiborne Parish, LA",2001-2002,16810,16728,-82,-0.488,-63,-19,22,27,H1
"Claiborne Parish, LA",2002-2003,16728,16825,97,0.58,-15,112,22,27,H1
"Claiborne Parish, LA",2003-2004,16825,16855,30,0.178,-17,47,22,27,H1
"Claiborne Parish, LA",2004-2005,16855,16908,53,0.314,-49,102,22,27,H1
"Claiborne Parish, LA",2005-2006,16908,17109,201,1.189,-4,205,22,27,H1
"Claiborne Parish, LA",2006-2007,17109,17149,40,0.234,17,23,22,27,H1
"Claiborne Parish, LA",2007-2008,17149,17169,20,0.117,0,20,22,27,H1
"Claiborne Parish, LA",2008-2009,17169,17230,61,0.355,-22,83,22,27,H1
"Claiborne Parish, LA",2009-2010,17230,17155,-75,-0.435,-30,-45,22,27,H1
"Claiborne Parish, LA",2010-2011,17155,16953,-202,-1.177,-39,-163,22,27,H1
"Claiborne Parish, LA",2011-2012,16953,16861,-92,-0.543,-12,-80,22,27,H1
"Claiborne Parish, LA",2012-2013,16861,16702,-159,-0.943,0,-159,22,27,H1
"Claiborne Parish, LA",2013-2014,16702,16412,-290,-1.736,-19,-271,22,27,H1
"Claiborne Parish, LA",2014-2015,16399,16295,-104,-0.634,-20,-84,22,27,H1
"Claiborne Parish, LA",2015-2016,16295,16164,-131,-0.804,-20,-111,22,27,H1
"Claiborne Parish, LA",2016-2017,16164,15969,-195,-1.206,-41,-154,22,27,H1
"Concordia Parish, LA",2000-2001,20225,20134,-91,-0.45,61,-152,22,29,H1
"Concordia Parish, LA",2001-2002,20134,20132,-2,-0.01,73,-75,22,29,H1
"Concordia Parish, LA",2002-2003,20132,20074,-58,-0.288,33,-91,22,29,H1
"Concordia Parish, LA",2003-2004,20074,19972,-102,-0.508,11,-113,22,29,H1
"Concordia Parish, LA",2004-2005,19972,19885,-87,-0.436,33,-120,22,29,H1
"Concordia Parish, LA",2005-2006,19885,20315,430,2.162,28,402,22,29,H1
"Concordia Parish, LA",2006-2007,20315,20244,-71,-0.349,41,-112,22,29,H1
"Concordia Parish, LA",2007-2008,20244,20420,176,0.869,77,99,22,29,H1
"Concordia Parish, LA",2008-2009,20420,20726,306,1.499,54,252,22,29,H1
"Concordia Parish, LA",2009-2010,20726,20833,107,0.516,46,61,22,29,H1
"Concordia Parish, LA",2010-2011,20833,20823,-10,-0.048,4,-14,22,29,H1
"Concordia Parish, LA",2011-2012,20823,20446,-377,-1.81,90,-467,22,29,H1
"Concordia Parish, LA",2012-2013,20446,20475,29,0.142,34,-5,22,29,H1
"Concordia Parish, LA",2013-2014,20475,20466,-9,-0.044,37,-46,22,29,H1
"Concordia Parish, LA",2014-2015,20398,20142,-256,-1.255,2,-258,22,29,H1
"Concordia Parish, LA",2015-2016,20142,19994,-148,-0.735,27,-175,22,29,H1
"Concordia Parish, LA",2016-2017,19994,19866,-128,-0.64,11,-139,22,29,H1
"De Soto Parish, LA",2000-2001,25502,25449,-53,-0.208,56,-109,22,31,H1
"De Soto Parish, LA",2001-2002,25449,25598,149,0.585,96,53,22,31,H1
"De Soto Parish, LA",2002-2003,25598,25675,77,0.301,9,68,22,31,H1
"De Soto Parish, LA",2003-2004,25675,25958,283,1.102,89,194,22,31,H1
"De Soto Parish, LA",2004-2005,25958,26029,71,0.274,66,5,22,31,H1
"De Soto Parish, LA",2005-2006,26029,26175,146,0.561,81,65,22,31,H1
"De Soto Parish, LA",2006-2007,26175,26413,238,0.909,140,98,22,31,H1
"De Soto Parish, LA",2007-2008,26413,26590,177,0.67,132,45,22,31,H1
"De Soto Parish, LA",2008-2009,26590,26413,-177,-0.666,90,-267,22,31,H1
"De Soto Parish, LA",2009-2010,26413,26733,320,1.212,28,292,22,31,H1
"De Soto Parish, LA",2010-2011,26733,26820,87,0.325,66,21,22,31,H1
"De Soto Parish, LA",2011-2012,26820,27035,215,0.802,99,116,22,31,H1
"De Soto Parish, LA",2012-2013,27035,27112,77,0.285,110,-33,22,31,H1
"De Soto Parish, LA",2013-2014,27112,27142,30,0.111,111,-81,22,31,H1
"De Soto Parish, LA",2014-2015,27011,27052,41,0.152,54,-13,22,31,H1
"De Soto Parish, LA",2015-2016,27052,27211,159,0.588,47,112,22,31,H1
"De Soto Parish, LA",2016-2017,27211,27340,129,0.474,67,62,22,31,H1
"East Baton Rouge Parish, LA",2000-2001,412958,411666,-1292,-0.313,2743,-4035,22,33,H1
"East Baton Rouge Parish, LA",2001-2002,411666,411024,-642,-0.156,2658,-3300,22,33,H1
"East Baton Rouge Parish, LA",2002-2003,411024,412553,1529,0.372,2400,-871,22,33,H1
"East Baton Rouge Parish, LA",2003-2004,412553,414162,1609,0.39,2400,-791,22,33,H1
"East Baton Rouge Parish, LA",2004-2005,414162,413812,-350,-0.085,2294,-2644,22,33,H1
"East Baton Rouge Parish, LA",2005-2006,413812,433474,19662,4.751,2256,17406,22,33,H1
"East Baton Rouge Parish, LA",2006-2007,433474,433344,-130,-0.03,2845,-2975,22,33,H1
"East Baton Rouge Parish, LA",2007-2008,433344,433723,379,0.087,2840,-2461,22,33,H1
"East Baton Rouge Parish, LA",2008-2009,433723,437623,3900,0.899,2507,1393,22,33,H1
"East Baton Rouge Parish, LA",2009-2010,437623,440854,3231,0.738,2969,262,22,33,H1
"East Baton Rouge Parish, LA",2010-2011,440854,441518,664,0.151,2543,-1879,22,33,H1
"East Baton Rouge Parish, LA",2011-2012,441518,444296,2778,0.629,2470,308,22,33,H1
"East Baton Rouge Parish, LA",2012-2013,444296,445279,983,0.221,2369,-1386,22,33,H1
"East Baton Rouge Parish, LA",2013-2014,445279,446042,763,0.171,2353,-1590,22,33,H1
"East Baton Rouge Parish, LA",2014-2015,446064,446753,689,0.154,2426,-1737,22,33,H1
"East Baton Rouge Parish, LA",2015-2016,446753,447731,978,0.219,2278,-1300,22,33,H1
"East Baton Rouge Parish, LA",2016-2017,447731,446268,-1463,-0.327,2243,-3706,22,33,H1
"East Carroll Parish, LA",2000-2001,9384,9136,-248,-2.643,36,-284,22,35,H1
"East Carroll Parish, LA",2001-2002,9136,8911,-225,-2.463,47,-272,22,35,H1
"East Carroll Parish, LA",2002-2003,8911,8750,-161,-1.807,41,-202,22,35,H1
"East Carroll Parish, LA",2003-2004,8750,8588,-162,-1.851,32,-194,22,35,H1
"East Carroll Parish, LA",2004-2005,8588,8374,-214,-2.492,59,-273,22,35,H1
"East Carroll Parish, LA",2005-2006,8374,8188,-186,-2.221,40,-226,22,35,H1
"East Carroll Parish, LA",2006-2007,8188,8102,-86,-1.05,30,-116,22,35,H1
"East Carroll Parish, LA",2007-2008,8102,7939,-163,-2.012,68,-231,22,35,H1
"East Carroll Parish, LA",2008-2009,7939,7862,-77,-0.97,57,-134,22,35,H1
"East Carroll Parish, LA",2009-2010,7862,7735,-127,-1.615,32,-159,22,35,H1
"East Carroll Parish, LA",2010-2011,7735,7674,-61,-0.789,44,-105,22,35,H1
"East Carroll Parish, LA",2011-2012,7674,7578,-96,-1.251,60,-156,22,35,H1
"East Carroll Parish, LA",2012-2013,7578,7537,-41,-0.541,56,-97,22,35,H1
"East Carroll Parish, LA",2013-2014,7537,7487,-50,-0.663,59,-109,22,35,H1
"East Carroll Parish, LA",2014-2015,7466,7307,-159,-2.13,48,-207,22,35,H1
"East Carroll Parish, LA",2015-2016,7307,7249,-58,-0.794,33,-91,22,35,H1
"East Carroll Parish, LA",2016-2017,7249,7126,-123,-1.697,22,-145,22,35,H1
"East Feliciana Parish, LA",2000-2001,21298,20978,-320,-1.502,62,-382,22,37,H1
"East Feliciana Parish, LA",2001-2002,20978,20667,-311,-1.483,49,-360,22,37,H1
"East Feliciana Parish, LA",2002-2003,20667,20502,-165,-0.798,23,-188,22,37,H1
"East Feliciana Parish, LA",2003-2004,20502,20266,-236,-1.151,67,-303,22,37,H1
"East Feliciana Parish, LA",2004-2005,20266,20093,-173,-0.854,5,-178,22,37,H1
"East Feliciana Parish, LA",2005-2006,20093,20559,466,2.319,36,430,22,37,H1
"East Feliciana Parish, LA",2006-2007,20559,20432,-127,-0.618,29,-156,22,37,H1
"East Feliciana Parish, LA",2007-2008,20432,20415,-17,-0.083,37,-54,22,37,H1
"East Feliciana Parish, LA",2008-2009,20415,20487,72,0.353,21,51,22,37,H1
"East Feliciana Parish, LA",2009-2010,20487,20178,-309,-1.508,5,-314,22,37,H1
"East Feliciana Parish, LA",2010-2011,20178,20155,-23,-0.114,19,-42,22,37,H1
"East Feliciana Parish, LA",2011-2012,20155,19970,-185,-0.918,-28,-157,22,37,H1
"East Feliciana Parish, LA",2012-2013,19970,19705,-265,-1.327,-16,-249,22,37,H1
"East Feliciana Parish, LA",2013-2014,19705,19813,108,0.548,-18,126,22,37,H1
"East Feliciana Parish, LA",2014-2015,19818,19696,-122,-0.616,4,-126,22,37,H1
"East Feliciana Parish, LA",2015-2016,19696,19523,-173,-0.878,-15,-158,22,37,H1
"East Feliciana Parish, LA",2016-2017,19523,19412,-111,-0.569,-40,-71,22,37,H1
"Evangeline Parish, LA",2000-2001,35414,35155,-259,-0.731,126,-385,22,39,H1
"Evangeline Parish, LA",2001-2002,35155,34894,-261,-0.742,119,-380,22,39,H1
"Evangeline Parish, LA",2002-2003,34894,34513,-381,-1.092,69,-450,22,39,H1
"Evangeline Parish, LA",2003-2004,34513,34399,-114,-0.33,116,-230,22,39,H1
"Evangeline Parish, LA",2004-2005,34399,34532,133,0.387,170,-37,22,39,H1
"Evangeline Parish, LA",2005-2006,34532,34839,307,0.889,155,152,22,39,H1
"Evangeline Parish, LA",2006-2007,34839,34873,34,0.098,169,-135,22,39,H1
"Evangeline Parish, LA",2007-2008,34873,34316,-557,-1.597,190,-747,22,39,H1
"Evangeline Parish, LA",2008-2009,34316,34078,-238,-0.694,138,-376,22,39,H1
"Evangeline Parish, LA",2009-2010,34078,33967,-111,-0.326,120,-231,22,39,H1
"Evangeline Parish, LA",2010-2011,33967,33821,-146,-0.43,104,-250,22,39,H1
"Evangeline Parish, LA",2011-2012,33821,33657,-164,-0.485,160,-324,22,39,H1
"Evangeline Parish, LA",2012-2013,33657,33746,89,0.264,121,-32,22,39,H1
"Evangeline Parish, LA",2013-2014,33746,33700,-46,-0.136,153,-199,22,39,H1
"Evangeline Parish, LA",2014-2015,33745,33743,-2,-0.006,91,-93,22,39,H1
"Evangeline Parish, LA",2015-2016,33743,33710,-33,-0.098,143,-176,22,39,H1
"Evangeline Parish, LA",2016-2017,33710,33708,-2,-0.006,111,-113,22,39,H1
"Franklin Parish, LA",2000-2001,21261,21070,-191,-0.898,37,-228,22,41,H1
"Franklin Parish, LA",2001-2002,21070,20939,-131,-0.622,66,-197,22,41,H1
"Franklin Parish, LA",2002-2003,20939,20942,3,0.014,55,-52,22,41,H1
"Franklin Parish, LA",2003-2004,20942,20895,-47,-0.224,6,-53,22,41,H1
"Franklin Parish, LA",2004-2005,20895,20660,-235,-1.125,23,-258,22,41,H1
"Franklin Parish, LA",2005-2006,20660,20685,25,0.121,42,-17,22,41,H1
"Franklin Parish, LA",2006-2007,20685,20740,55,0.266,61,-6,22,41,H1
"Franklin Parish, LA",2007-2008,20740,20758,18,0.087,76,-58,22,41,H1
"Franklin Parish, LA",2008-2009,20758,20677,-81,-0.39,38,-119,22,41,H1
"Franklin Parish, LA",2009-2010,20677,20836,159,0.769,18,141,22,41,H1
"Franklin Parish, LA",2010-2011,20836,20788,-48,-0.23,31,-79,22,41,H1
"Franklin Parish, LA",2011-2012,20788,20613,-175,-0.842,37,-212,22,41,H1
"Franklin Parish, LA",2012-2013,20613,20545,-68,-0.33,-8,-60,22,41,H1
"Franklin Parish, LA",2013-2014,20545,20441,-104,-0.506,-9,-95,22,41,H1
"Franklin Parish, LA",2014-2015,20449,20410,-39,-0.191,4,-43,22,41,H1
"Franklin Parish, LA",2015-2016,20410,20364,-46,-0.225,27,-73,22,41,H1
"Franklin Parish, LA",2016-2017,20364,20260,-104,-0.511,32,-136,22,41,H1
"Grant Parish, LA",2000-2001,18734,18896,162,0.865,68,94,22,43,H1
"Grant Parish, LA",2001-2002,18896,19133,237,1.254,83,154,22,43,H1
"Grant Parish, LA",2002-2003,19133,19420,287,1.5,39,248,22,43,H1
"Grant Parish, LA",2003-2004,19420,19878,458,2.358,54,404,22,43,H1
"Grant Parish, LA",2004-2005,19878,20386,508,2.556,43,465,22,43,H1
"Grant Parish, LA",2005-2006,20386,21039,653,3.203,64,589,22,43,H1
"Grant Parish, LA",2006-2007,21039,21268,229,1.088,75,154,22,43,H1
"Grant Parish, LA",2007-2008,21268,21657,389,1.829,48,341,22,43,H1
"Grant Parish, LA",2008-2009,21657,22069,412,1.902,64,348,22,43,H1
"Grant Parish, LA",2009-2010,22069,22340,271,1.228,48,223,22,43,H1
"Grant Parish, LA",2010-2011,22340,22364,24,0.107,44,-20,22,43,H1
"Grant Parish, LA",2011-2012,22364,22376,12,0.054,47,-35,22,43,H1
"Grant Parish, LA",2012-2013,22376,22351,-25,-0.112,36,-61,22,43,H1
"Grant Parish, LA",2013-2014,22351,22384,33,0.148,77,-44,22,43,H1
"Grant Parish, LA",2014-2015,22382,22343,-39,-0.174,79,-118,22,43,H1
"Grant Parish, LA",2015-2016,22343,22297,-46,-0.206,62,-108,22,43,H1
"Grant Parish, LA",2016-2017,22297,22336,39,0.175,65,-26,22,43,H1
"Iberia Parish, LA",2000-2001,73170,72993,-177,-0.242,501,-678,22,45,H1
"Iberia Parish, LA",2001-2002,72993,72862,-131,-0.179,540,-671,22,45,H1
"Iberia Parish, LA",2002-2003,72862,72760,-102,-0.14,499,-601,22,45,H1
"Iberia Parish, LA",2003-2004,72760,72590,-170,-0.234,420,-590,22,45,H1
"Iberia Parish, LA",2004-2005,72590,72641,51,0.07,459,-408,22,45,H1
"Iberia Parish, LA",2005-2006,72641,73362,721,0.993,435,286,22,45,H1
"Iberia Parish, LA",2006-2007,73362,73482,120,0.164,509,-389,22,45,H1
"Iberia Parish, LA",2007-2008,73482,73522,40,0.054,555,-515,22,45,H1
"Iberia Parish, LA",2008-2009,73522,73372,-150,-0.204,450,-600,22,45,H1
"Iberia Parish, LA",2009-2010,73372,73272,-100,-0.136,392,-492,22,45,H1
"Iberia Parish, LA",2010-2011,73272,73543,271,0.37,433,-162,22,45,H1
"Iberia Parish, LA",2011-2012,73543,73916,373,0.507,311,62,22,45,H1
"Iberia Parish, LA",2012-2013,73916,74030,114,0.154,280,-166,22,45,H1
"Iberia Parish, LA",2013-2014,74030,73913,-117,-0.158,250,-367,22,45,H1
"Iberia Parish, LA",2014-2015,74048,74103,55,0.074,336,-281,22,45,H1
"Iberia Parish, LA",2015-2016,74103,73077,-1026,-1.385,330,-1356,22,45,H1
"Iberia Parish, LA",2016-2017,73077,72176,-901,-1.233,291,-1192,22,45,H1
"Iberville Parish, LA",2000-2001,33321,33327,6,0.018,209,-203,22,47,H1
"Iberville Parish, LA",2001-2002,33327,33242,-85,-0.255,106,-191,22,47,H1
"Iberville Parish, LA",2002-2003,33242,33042,-200,-0.602,133,-333,22,47,H1
"Iberville Parish, LA",2003-2004,33042,32717,-325,-0.984,70,-395,22,47,H1
"Iberville Parish, LA",2004-2005,32717,32697,-20,-0.061,137,-157,22,47,H1
"Iberville Parish, LA",2005-2006,32697,33519,822,2.514,92,730,22,47,H1
"Iberville Parish, LA",2006-2007,33519,33603,84,0.251,176,-92,22,47,H1
"Iberville Parish, LA",2007-2008,33603,33685,82,0.244,147,-65,22,47,H1
"Iberville Parish, LA",2008-2009,33685,33393,-292,-0.867,115,-407,22,47,H1
"Iberville Parish, LA",2009-2010,33393,33395,2,0.006,87,-85,22,47,H1
"Iberville Parish, LA",2010-2011,33395,33367,-28,-0.084,140,-168,22,47,H1
"Iberville Parish, LA",2011-2012,33367,33350,-17,-0.051,169,-186,22,47,H1
"Iberville Parish, LA",2012-2013,33350,33438,88,0.264,145,-57,22,47,H1
"Iberville Parish, LA",2013-2014,33438,33327,-111,-0.332,178,-289,22,47,H1
"Iberville Parish, LA",2014-2015,33079,33095,16,0.048,68,-52,22,47,H1
"Iberville Parish, LA",2015-2016,33095,32917,-178,-0.538,55,-233,22,47,H1
"Iberville Parish, LA",2016-2017,32917,33027,110,0.334,80,30,22,47,H1
"Jackson Parish, LA",2000-2001,15415,15517,102,0.662,-1,103,22,49,H1
"Jackson Parish, LA",2001-2002,15517,15470,-47,-0.303,-8,-39,22,49,H1
"Jackson Parish, LA",2002-2003,15470,15575,105,0.679,9,96,22,49,H1
"Jackson Parish, LA",2003-2004,15575,15650,75,0.482,2,73,22,49,H1
"Jackson Parish, LA",2004-2005,15650,15674,24,0.153,-21,45,22,49,H1
"Jackson Parish, LA",2005-2006,15674,15950,276,1.761,-1,277,22,49,H1
"Jackson Parish, LA",2006-2007,15950,15922,-28,-0.176,40,-68,22,49,H1
"Jackson Parish, LA",2007-2008,15922,16105,183,1.149,36,147,22,49,H1
"Jackson Parish, LA",2008-2009,16105,16118,13,0.081,12,1,22,49,H1
"Jackson Parish, LA",2009-2010,16118,16292,174,1.08,3,171,22,49,H1
"Jackson Parish, LA",2010-2011,16292,16346,54,0.331,20,34,22,49,H1
"Jackson Parish, LA",2011-2012,16346,16236,-110,-0.673,17,-127,22,49,H1
"Jackson Parish, LA",2012-2013,16236,16128,-108,-0.665,-40,-68,22,49,H1
"Jackson Parish, LA",2013-2014,16128,15994,-134,-0.831,-42,-92,22,49,H1
"Jackson Parish, LA",2014-2015,15980,15858,-122,-0.763,-38,-84,22,49,H1
"Jackson Parish, LA",2015-2016,15858,15847,-11,-0.069,-63,52,22,49,H1
"Jackson Parish, LA",2016-2017,15847,15846,-1,-0.006,-44,43,22,49,H1
"Jefferson Parish, LA",2000-2001,454936,453154,-1782,-0.392,2102,-3884,22,51,H1
"Jefferson Parish, LA",2001-2002,453154,453429,275,0.061,2050,-1775,22,51,H1
"Jefferson Parish, LA",2002-2003,453429,454533,1104,0.243,2071,-967,22,51,H1
"Jefferson Parish, LA",2003-2004,454533,456602,2069,0.455,2119,-50,22,51,H1
"Jefferson Parish, LA",2004-2005,456602,456554,-48,-0.011,2104,-2152,22,51,H1
"Jefferson Parish, LA",2005-2006,456554,426285,-30269,-6.63,822,-31091,22,51,H1
"Jefferson Parish, LA",2006-2007,426285,432683,6398,1.501,2041,4357,22,51,H1
"Jefferson Parish, LA",2007-2008,432683,431759,-924,-0.214,2045,-2969,22,51,H1
"Jefferson Parish, LA",2008-2009,431759,431921,162,0.038,1176,-1014,22,51,H1
"Jefferson Parish, LA",2009-2010,431921,432767,846,0.196,1225,-379,22,51,H1
"Jefferson Parish, LA",2010-2011,432767,434056,1289,0.298,1906,-617,22,51,H1
"Jefferson Parish, LA",2011-2012,434056,434575,519,0.12,1624,-1105,22,51,H1
"Jefferson Parish, LA",2012-2013,434575,435524,949,0.218,1445,-496,22,51,H1
"Jefferson Parish, LA",2013-2014,435524,435716,192,0.044,1492,-1300,22,51,H1
"Jefferson Parish, LA",2014-2015,435536,436275,739,0.17,1510,-771,22,51,H1
"Jefferson Parish, LA",2015-2016,436275,438485,2210,0.507,1773,437,22,51,H1
"Jefferson Parish, LA",2016-2017,438485,439036,551,0.126,1666,-1115,22,51,H1
"Jefferson Davis Parish, LA",2000-2001,31506,31232,-274,-0.87,162,-436,22,53,H1
"Jefferson Davis Parish, LA",2001-2002,31232,31113,-119,-0.381,143,-262,22,53,H1
"Jefferson Davis Parish, LA",2002-2003,31113,31091,-22,-0.071,133,-155,22,53,H1
"Jefferson Davis Parish, LA",2003-2004,31091,31076,-15,-0.048,141,-156,22,53,H1
"Jefferson Davis Parish, LA",2004-2005,31076,31202,126,0.405,101,25,22,53,H1
"Jefferson Davis Parish, LA",2005-2006,31202,31489,287,0.92,95,192,22,53,H1
"Jefferson Davis Parish, LA",2006-2007,31489,31379,-110,-0.349,171,-281,22,53,H1
"Jefferson Davis Parish, LA",2007-2008,31379,31497,118,0.376,162,-44,22,53,H1
"Jefferson Davis Parish, LA",2008-2009,31497,31530,33,0.105,131,-98,22,53,H1
"Jefferson Davis Parish, LA",2009-2010,31530,31639,109,0.346,89,20,22,53,H1
"Jefferson Davis Parish, LA",2010-2011,31639,31586,-53,-0.168,55,-108,22,53,H1
"Jefferson Davis Parish, LA",2011-2012,31586,31439,-147,-0.465,92,-239,22,53,H1
"Jefferson Davis Parish, LA",2012-2013,31439,31321,-118,-0.375,67,-185,22,53,H1
"Jefferson Davis Parish, LA",2013-2014,31321,31477,156,0.498,49,107,22,53,H1
"Jefferson Davis Parish, LA",2014-2015,31439,31439,0,0,50,-50,22,53,H1
"Jefferson Davis Parish, LA",2015-2016,31439,31370,-69,-0.219,70,-139,22,53,H1
"Jefferson Davis Parish, LA",2016-2017,31370,31477,107,0.341,47,60,22,53,H1
"Lafayette Parish, LA",2000-2001,190516,191725,1209,0.635,1442,-233,22,55,H1
"Lafayette Parish, LA",2001-2002,191725,194565,2840,1.481,1534,1306,22,55,H1
"Lafayette Parish, LA",2002-2003,194565,196710,2145,1.102,1502,643,22,55,H1
"Lafayette Parish, LA",2003-2004,196710,199338,2628,1.336,1521,1107,22,55,H1
"Lafayette Parish, LA",2004-2005,199338,202053,2715,1.362,1501,1214,22,55,H1
"Lafayette Parish, LA",2005-2006,202053,209424,7371,3.648,1498,5873,22,55,H1
"Lafayette Parish, LA",2006-2007,209424,211826,2402,1.147,1588,814,22,55,H1
"Lafayette Parish, LA",2007-2008,211826,215139,3313,1.564,1649,1664,22,55,H1
"Lafayette Parish, LA",2008-2009,215139,219466,4327,2.011,1574,2753,22,55,H1
"Lafayette Parish, LA",2009-2010,219466,222152,2686,1.224,1566,1120,22,55,H1
"Lafayette Parish, LA",2010-2011,222152,224257,2105,0.948,1445,660,22,55,H1
"Lafayette Parish, LA",2011-2012,224257,227055,2798,1.248,1507,1291,22,55,H1
"Lafayette Parish, LA",2012-2013,227055,231310,4255,1.874,1623,2632,22,55,H1
"Lafayette Parish, LA",2013-2014,231310,235644,4334,1.874,1650,2684,22,55,H1
"Lafayette Parish, LA",2014-2015,236047,240098,4051,1.716,1837,2214,22,55,H1
"Lafayette Parish, LA",2015-2016,240098,241746,1648,0.686,1687,-39,22,55,H1
"Lafayette Parish, LA",2016-2017,241746,242485,739,0.306,1552,-813,22,55,H1
"Lafourche Parish, LA",2000-2001,89775,90105,330,0.368,425,-95,22,57,H1
"Lafourche Parish, LA",2001-2002,90105,90994,889,0.987,434,455,22,57,H1
"Lafourche Parish, LA",2002-2003,90994,91899,905,0.995,521,384,22,57,H1
"Lafourche Parish, LA",2003-2004,91899,92580,681,0.741,482,199,22,57,H1
"Lafourche Parish, LA",2004-2005,92580,92656,76,0.082,453,-377,22,57,H1
"Lafourche Parish, LA",2005-2006,92656,94385,1729,1.866,312,1417,22,57,H1
"Lafourche Parish, LA",2006-2007,94385,94745,360,0.381,555,-195,22,57,H1
"Lafourche Parish, LA",2007-2008,94745,95603,858,0.906,555,303,22,57,H1
"Lafourche Parish, LA",2008-2009,95603,96080,477,0.499,376,101,22,57,H1
"Lafourche Parish, LA",2009-2010,96080,96699,619,0.644,363,256,22,57,H1
"Lafourche Parish, LA",2010-2011,96699,97008,309,0.32,375,-66,22,57,H1
"Lafourche Parish, LA",2011-2012,97008,97125,117,0.121,371,-254,22,57,H1
"Lafourche Parish, LA",2012-2013,97125,97325,200,0.206,392,-192,22,57,H1
"Lafourche Parish, LA",2013-2014,97325,98020,695,0.714,391,304,22,57,H1
"Lafourche Parish, LA",2014-2015,97875,98325,450,0.46,460,-10,22,57,H1
"Lafourche Parish, LA",2015-2016,98325,98617,292,0.297,453,-161,22,57,H1
"Lafourche Parish, LA",2016-2017,98617,98426,-191,-0.194,423,-614,22,57,H1
"La Salle Parish, LA",2000-2001,14271,14207,-64,-0.448,7,-71,22,59,H1
"La Salle Parish, LA",2001-2002,14207,14359,152,1.07,44,108,22,59,H1
"La Salle Parish, LA",2002-2003,14359,14356,-3,-0.021,4,-7,22,59,H1
"La Salle Parish, LA",2003-2004,14356,14366,10,0.07,8,2,22,59,H1
"La Salle Parish, LA",2004-2005,14366,14313,-53,-0.369,2,-55,22,59,H1
"La Salle Parish, LA",2005-2006,14313,14519,206,1.439,-11,217,22,59,H1
"La Salle Parish, LA",2006-2007,14519,14570,51,0.351,54,-3,22,59,H1
"La Salle Parish, LA",2007-2008,14570,14667,97,0.666,53,44,22,59,H1
"La Salle Parish, LA",2008-2009,14667,14717,50,0.341,22,28,22,59,H1
"La Salle Parish, LA",2009-2010,14717,14910,193,1.311,4,189,22,59,H1
"La Salle Parish, LA",2010-2011,14910,14943,33,0.221,11,22,22,59,H1
"La Salle Parish, LA",2011-2012,14943,14858,-85,-0.569,-9,-76,22,59,H1
"La Salle Parish, LA",2012-2013,14858,14820,-38,-0.256,21,-59,22,59,H1
"La Salle Parish, LA",2013-2014,14820,14839,19,0.128,4,15,22,59,H1
"La Salle Parish, LA",2014-2015,14871,14974,103,0.693,9,94,22,59,H1
"La Salle Parish, LA",2015-2016,14974,15052,78,0.521,37,41,22,59,H1
"La Salle Parish, LA",2016-2017,15052,14933,-119,-0.791,4,-123,22,59,H1
"Lincoln Parish, LA",2000-2001,42575,42625,50,0.117,142,-92,22,61,H1
"Lincoln Parish, LA",2001-2002,42625,42808,183,0.429,278,-95,22,61,H1
"Lincoln Parish, LA",2002-2003,42808,43539,731,1.708,255,476,22,61,H1
"Lincoln Parish, LA",2003-2004,43539,44272,733,1.684,144,589,22,61,H1
"Lincoln Parish, LA",2004-2005,44272,44580,308,0.696,207,101,22,61,H1
"Lincoln Parish, LA",2005-2006,44580,44867,287,0.644,279,8,22,61,H1
"Lincoln Parish, LA",2006-2007,44867,45323,456,1.016,237,219,22,61,H1
"Lincoln Parish, LA",2007-2008,45323,45726,403,0.889,229,174,22,61,H1
"Lincoln Parish, LA",2008-2009,45726,46270,544,1.19,228,316,22,61,H1
"Lincoln Parish, LA",2009-2010,46270,46868,598,1.292,230,368,22,61,H1
"Lincoln Parish, LA",2010-2011,46868,47055,187,0.399,216,-29,22,61,H1
"Lincoln Parish, LA",2011-2012,47055,47146,91,0.193,262,-171,22,61,H1
"Lincoln Parish, LA",2012-2013,47146,47528,382,0.81,184,198,22,61,H1
"Lincoln Parish, LA",2013-2014,47528,47617,89,0.187,186,-97,22,61,H1
"Lincoln Parish, LA",2014-2015,47429,47774,345,0.727,195,150,22,61,H1
"Lincoln Parish, LA",2015-2016,47774,47647,-127,-0.266,158,-285,22,61,H1
"Lincoln Parish, LA",2016-2017,47647,47744,97,0.204,158,-61,22,61,H1
"Livingston Parish, LA",2000-2001,92648,95597,2949,3.183,778,2171,22,63,H1
"Livingston Parish, LA",2001-2002,95597,99007,3410,3.567,709,2701,22,63,H1
"Livingston Parish, LA",2002-2003,99007,102146,3139,3.17,857,2282,22,63,H1
"Livingston Parish, LA",2003-2004,102146,106048,3902,3.82,883,3019,22,63,H1
"Livingston Parish, LA",2004-2005,106048,109208,3160,2.98,856,2304,22,63,H1
"Livingston Parish, LA",2005-2006,109208,115722,6514,5.965,918,5596,22,63,H1
"Livingston Parish, LA",2006-2007,115722,119528,3806,3.289,1028,2778,22,63,H1
"Livingston Parish, LA",2007-2008,119528,123962,4434,3.71,1103,3331,22,63,H1
"Livingston Parish, LA",2008-2009,123962,126230,2268,1.83,952,1316,22,63,H1
"Livingston Parish, LA",2009-2010,126230,128689,2459,1.948,721,1738,22,63,H1
"Livingston Parish, LA",2010-2011,128689,130180,1491,1.159,857,634,22,63,H1
"Livingston Parish, LA",2011-2012,130180,131944,1764,1.355,868,896,22,63,H1
"Livingston Parish, LA",2012-2013,131944,134238,2294,1.739,755,1539,22,63,H1
"Livingston Parish, LA",2013-2014,134238,135751,1513,1.127,774,739,22,63,H1
"Livingston Parish, LA",2014-2015,135717,137788,2071,1.526,852,1219,22,63,H1
"Livingston Parish, LA",2015-2016,137788,140080,2292,1.663,795,1497,22,63,H1
"Livingston Parish, LA",2016-2017,140080,138228,-1852,-1.322,777,-2629,22,63,H1
"Madison Parish, LA",2000-2001,13704,13493,-211,-1.54,76,-287,22,65,H1
"Madison Parish, LA",2001-2002,13493,13180,-313,-2.32,45,-358,22,65,H1
"Madison Parish, LA",2002-2003,13180,12959,-221,-1.677,21,-242,22,65,H1
"Madison Parish, LA",2003-2004,12959,12806,-153,-1.181,7,-160,22,65,H1
"Madison Parish, LA",2004-2005,12806,12663,-143,-1.117,80,-223,22,65,H1
"Madison Parish, LA",2005-2006,12663,12537,-126,-0.995,43,-169,22,65,H1
"Madison Parish, LA",2006-2007,12537,12410,-127,-1.013,20,-147,22,65,H1
"Madison Parish, LA",2007-2008,12410,12340,-70,-0.564,51,-121,22,65,H1
"Madison Parish, LA",2008-2009,12340,12040,-300,-2.431,57,-357,22,65,H1
"Madison Parish, LA",2009-2010,12040,12104,64,0.532,39,25,22,65,H1
"Madison Parish, LA",2010-2011,12104,11973,-131,-1.082,44,-175,22,65,H1
"Madison Parish, LA",2011-2012,11973,12194,221,1.846,63,158,22,65,H1
"Madison Parish, LA",2012-2013,12194,11927,-267,-2.19,66,-333,22,65,H1
"Madison Parish, LA",2013-2014,11927,11843,-84,-0.704,28,-112,22,65,H1
"Madison Parish, LA",2014-2015,11793,11514,-279,-2.366,-10,-269,22,65,H1
"Madison Parish, LA",2015-2016,11514,11485,-29,-0.252,21,-50,22,65,H1
"Madison Parish, LA",2016-2017,11485,11316,-169,-1.471,-7,-162,22,65,H1
"Morehouse Parish, LA",2000-2001,30961,30605,-356,-1.15,155,-511,22,67,H1
"Morehouse Parish, LA",2001-2002,30605,30319,-286,-0.934,80,-366,22,67,H1
"Morehouse Parish, LA",2002-2003,30319,30224,-95,-0.313,37,-132,22,67,H1
"Morehouse Parish, LA",2003-2004,30224,29891,-333,-1.102,40,-373,22,67,H1
"Morehouse Parish, LA",2004-2005,29891,29355,-536,-1.793,22,-558,22,67,H1
"Morehouse Parish, LA",2005-2006,29355,29079,-276,-0.94,-17,-259,22,67,H1
"Morehouse Parish, LA",2006-2007,29079,28478,-601,-2.067,31,-632,22,67,H1
"Morehouse Parish, LA",2007-2008,28478,28311,-167,-0.586,62,-229,22,67,H1
"Morehouse Parish, LA",2008-2009,28311,28147,-164,-0.579,4,-168,22,67,H1
"Morehouse Parish, LA",2009-2010,28147,27888,-259,-0.92,9,-268,22,67,H1
"Morehouse Parish, LA",2010-2011,27888,27482,-406,-1.456,-1,-405,22,67,H1
"Morehouse Parish, LA",2011-2012,27482,27431,-51,-0.186,2,-53,22,67,H1
"Morehouse Parish, LA",2012-2013,27431,27035,-396,-1.444,-7,-389,22,67,H1
"Morehouse Parish, LA",2013-2014,27035,26760,-275,-1.017,-4,-271,22,67,H1
"Morehouse Parish, LA",2014-2015,26744,26395,-349,-1.305,2,-351,22,67,H1
"Morehouse Parish, LA",2015-2016,26395,25914,-481,-1.822,9,-490,22,67,H1
"Morehouse Parish, LA",2016-2017,25914,25641,-273,-1.053,-20,-253,22,67,H1
"Natchitoches Parish, LA",2000-2001,39089,38844,-245,-0.627,253,-498,22,69,H1
"Natchitoches Parish, LA",2001-2002,38844,39178,334,0.86,223,111,22,69,H1
"Natchitoches Parish, LA",2002-2003,39178,38924,-254,-0.648,201,-455,22,69,H1
"Natchitoches Parish, LA",2003-2004,38924,38950,26,0.067,217,-191,22,69,H1
"Natchitoches Parish, LA",2004-2005,38950,39107,157,0.403,181,-24,22,69,H1
"Natchitoches Parish, LA",2005-2006,39107,38984,-123,-0.315,220,-343,22,69,H1
"Natchitoches Parish, LA",2006-2007,38984,39114,130,0.333,256,-126,22,69,H1
"Natchitoches Parish, LA",2007-2008,39114,39244,130,0.332,234,-104,22,69,H1
"Natchitoches Parish, LA",2008-2009,39244,39425,181,0.461,235,-54,22,69,H1
"Natchitoches Parish, LA",2009-2010,39425,39509,84,0.213,192,-108,22,69,H1
"Natchitoches Parish, LA",2010-2011,39509,39517,8,0.02,186,-178,22,69,H1
"Natchitoches Parish, LA",2011-2012,39517,39461,-56,-0.142,161,-217,22,69,H1
"Natchitoches Parish, LA",2012-2013,39461,39140,-321,-0.813,102,-423,22,69,H1
"Natchitoches Parish, LA",2013-2014,39140,39166,26,0.066,134,-108,22,69,H1
"Natchitoches Parish, LA",2014-2015,39242,39179,-63,-0.161,176,-239,22,69,H1
"Natchitoches Parish, LA",2015-2016,39179,38995,-184,-0.47,79,-263,22,69,H1
"Natchitoches Parish, LA",2016-2017,38995,39021,26,0.067,87,-61,22,69,H1
"Orleans Parish, LA",2000-2001,485610,487363,1753,0.361,2362,-609,22,71,H6
"Orleans Parish, LA",2001-2002,487363,489722,2359,0.484,2208,151,22,71,H6
"Orleans Parish, LA",2002-2003,489722,492187,2465,0.503,1922,543,22,71,H6
"Orleans Parish, LA",2003-2004,492187,493765,1578,0.321,2014,-436,22,71,H6
"Orleans Parish, LA",2004-2005,493765,494294,529,0.107,1822,-1293,22,71,H6
"Orleans Parish, LA",2005-2006,494294,230172,-264122,-53.434,-1191,-262931,22,71,H6
"Orleans Parish, LA",2006-2007,230172,268751,38579,16.761,662,37917,22,71,H6
"Orleans Parish, LA",2007-2008,268751,301842,33091,12.313,1801,31290,22,71,H6
"Orleans Parish, LA",2008-2009,301842,327803,25961,8.601,1041,24920,22,71,H6
"Orleans Parish, LA",2009-2010,327803,347987,20184,6.157,1200,18984,22,71,H6
"Orleans Parish, LA",2010-2011,347987,360877,12890,3.704,1808,11082,22,71,H6
"Orleans Parish, LA",2011-2012,360877,370167,9290,2.574,1712,7578,22,71,H6
"Orleans Parish, LA",2012-2013,370167,379006,8839,2.388,1553,7286,22,71,H6
"Orleans Parish, LA",2013-2014,379006,384320,5314,1.402,1617,3697,22,71,H6
"Orleans Parish, LA",2014-2015,384360,389617,5257,1.368,1685,3572,22,71,H6
"Orleans Parish, LA",2015-2016,389617,393021,3404,0.874,1726,1678,22,71,H6
"Orleans Parish, LA",2016-2017,393021,393292,271,0.069,1501,-1230,22,71,H6
"Ouachita Parish, LA",2000-2001,147271,146789,-482,-0.327,938,-1420,22,73,H1
"Ouachita Parish, LA",2001-2002,146789,147728,939,0.64,888,51,22,73,H1
"Ouachita Parish, LA",2002-2003,147728,148549,821,0.556,890,-69,22,73,H1
"Ouachita Parish, LA",2003-2004,148549,149293,744,0.501,1012,-268,22,73,H1
"Ouachita Parish, LA",2004-2005,149293,149476,183,0.123,905,-722,22,73,H1
"Ouachita Parish, LA",2005-2006,149476,151183,1707,1.142,771,936,22,73,H1
"Ouachita Parish, LA",2006-2007,151183,151157,-26,-0.017,1044,-1070,22,73,H1
"Ouachita Parish, LA",2007-2008,151157,151727,570,0.377,1021,-451,22,73,H1
"Ouachita Parish, LA",2008-2009,151727,153058,1331,0.877,931,400,22,73,H1
"Ouachita Parish, LA",2009-2010,153058,153950,892,0.583,869,23,22,73,H1
"Ouachita Parish, LA",2010-2011,153950,154619,669,0.435,794,-125,22,73,H1
"Ouachita Parish, LA",2011-2012,154619,155350,731,0.473,904,-173,22,73,H1
"Ouachita Parish, LA",2012-2013,155350,156182,832,0.536,679,153,22,73,H1
"Ouachita Parish, LA",2013-2014,156182,156325,143,0.092,670,-527,22,73,H1
"Ouachita Parish, LA",2014-2015,156141,156761,620,0.397,681,-61,22,73,H1
"Ouachita Parish, LA",2015-2016,156761,156937,176,0.112,618,-442,22,73,H1
"Ouachita Parish, LA",2016-2017,156937,155874,-1063,-0.677,561,-1624,22,73,H1
"Plaquemines Parish, LA",2000-2001,26758,27029,271,1.013,165,106,22,75,H1
"Plaquemines Parish, LA",2001-2002,27029,27462,433,1.602,182,251,22,75,H1
"Plaquemines Parish, LA",2002-2003,27462,28169,707,2.574,182,525,22,75,H1
"Plaquemines Parish, LA",2003-2004,28169,29390,1221,4.335,238,983,22,75,H1
"Plaquemines Parish, LA",2004-2005,29390,29558,168,0.572,173,-5,22,75,H1
"Plaquemines Parish, LA",2005-2006,29558,22329,-7229,-24.457,59,-7288,22,75,H1
"Plaquemines Parish, LA",2006-2007,22329,22709,380,1.702,165,215,22,75,H1
"Plaquemines Parish, LA",2007-2008,22709,22677,-32,-0.141,168,-200,22,75,H1
"Plaquemines Parish, LA",2008-2009,22677,22730,53,0.234,79,-26,22,75,H1
"Plaquemines Parish, LA",2009-2010,22730,23118,388,1.707,103,285,22,75,H1
"Plaquemines Parish, LA",2010-2011,23118,23639,521,2.254,122,399,22,75,H1
"Plaquemines Parish, LA",2011-2012,23639,23901,262,1.108,96,166,22,75,H1
"Plaquemines Parish, LA",2012-2013,23901,23620,-281,-1.176,163,-444,22,75,H1
"Plaquemines Parish, LA",2013-2014,23620,23447,-173,-0.732,147,-320,22,75,H1
"Plaquemines Parish, LA",2014-2015,23375,23495,120,0.513,106,14,22,75,H1
"Plaquemines Parish, LA",2015-2016,23495,23327,-168,-0.715,108,-276,22,75,H1
"Plaquemines Parish, LA",2016-2017,23327,23348,21,0.09,87,-66,22,75,H1
"Pointe Coupee Parish, LA",2000-2001,22759,22574,-185,-0.813,100,-285,22,77,H1
"Pointe Coupee Parish, LA",2001-2002,22574,22451,-123,-0.545,82,-205,22,77,H1
"Pointe Coupee Parish, LA",2002-2003,22451,22369,-82,-0.365,48,-130,22,77,H1
"Pointe Coupee Parish, LA",2003-2004,22369,22332,-37,-0.165,52,-89,22,77,H1
"Pointe Coupee Parish, LA",2004-2005,22332,22075,-257,-1.151,47,-304,22,77,H1
"Pointe Coupee Parish, LA",2005-2006,22075,22754,679,3.076,60,619,22,77,H1
"Pointe Coupee Parish, LA",2006-2007,22754,22848,94,0.413,103,-9,22,77,H1
"Pointe Coupee Parish, LA",2007-2008,22848,22966,118,0.516,98,20,22,77,H1
"Pointe Coupee Parish, LA",2008-2009,22966,22847,-119,-0.518,41,-160,22,77,H1
"Pointe Coupee Parish, LA",2009-2010,22847,22767,-80,-0.35,19,-99,22,77,H1
"Pointe Coupee Parish, LA",2010-2011,22767,22828,61,0.268,82,-21,22,77,H1
"Pointe Coupee Parish, LA",2011-2012,22828,22711,-117,-0.513,59,-176,22,77,H1
"Pointe Coupee Parish, LA",2012-2013,22711,22443,-268,-1.18,25,-293,22,77,H1
"Pointe Coupee Parish, LA",2013-2014,22443,22406,-37,-0.165,37,-74,22,77,H1
"Pointe Coupee Parish, LA",2014-2015,22325,22251,-74,-0.331,16,-90,22,77,H1
"Pointe Coupee Parish, LA",2015-2016,22251,22156,-95,-0.427,72,-167,22,77,H1
"Pointe Coupee Parish, LA",2016-2017,22156,22268,112,0.506,45,67,22,77,H1
"Rapides Parish, LA",2000-2001,126445,126206,-239,-0.189,519,-758,22,79,H1
"Rapides Parish, LA",2001-2002,126206,126283,77,0.061,574,-497,22,79,H1
"Rapides Parish, LA",2002-2003,126283,126597,314,0.249,449,-135,22,79,H1
"Rapides Parish, LA",2003-2004,126597,127095,498,0.393,570,-72,22,79,H1
"Rapides Parish, LA",2004-2005,127095,127544,449,0.353,538,-89,22,79,H1
"Rapides Parish, LA",2005-2006,127544,130103,2559,2.006,575,1984,22,79,H1
"Rapides Parish, LA",2006-2007,130103,130238,135,0.104,750,-615,22,79,H1
"Rapides Parish, LA",2007-2008,130238,130785,547,0.42,840,-293,22,79,H1
"Rapides Parish, LA",2008-2009,130785,131095,310,0.237,588,-278,22,79,H1
"Rapides Parish, LA",2009-2010,131095,131787,692,0.528,469,223,22,79,H1
"Rapides Parish, LA",2010-2011,131787,132055,268,0.203,513,-245,22,79,H1
"Rapides Parish, LA",2011-2012,132055,132111,56,0.042,392,-336,22,79,H1
"Rapides Parish, LA",2012-2013,132111,132552,441,0.334,353,88,22,79,H1
"Rapides Parish, LA",2013-2014,132552,132488,-64,-0.048,380,-444,22,79,H1
"Rapides Parish, LA",2014-2015,132416,132141,-275,-0.208,403,-678,22,79,H1
"Rapides Parish, LA",2015-2016,132141,132097,-44,-0.033,393,-437,22,79,H1
"Rapides Parish, LA",2016-2017,132097,131648,-449,-0.34,324,-773,22,79,H1
"Red River Parish, LA",2000-2001,9598,9494,-104,-1.084,11,-115,22,81,H1
"Red River Parish, LA",2001-2002,9494,9464,-30,-0.316,26,-56,22,81,H1
"Red River Parish, LA",2002-2003,9464,9468,4,0.042,38,-34,22,81,H1
"Red River Parish, LA",2003-2004,9468,9433,-35,-0.37,47,-82,22,81,H1
"Red River Parish, LA",2004-2005,9433,9295,-138,-1.463,53,-191,22,81,H1
"Red River Parish, LA",2005-2006,9295,9281,-14,-0.151,5,-19,22,81,H1
"Red River Parish, LA",2006-2007,9281,9245,-36,-0.388,69,-105,22,81,H1
"Red River Parish, LA",2007-2008,9245,9185,-60,-0.649,59,-119,22,81,H1
"Red River Parish, LA",2008-2009,9185,9117,-68,-0.74,43,-111,22,81,H1
"Red River Parish, LA",2009-2010,9117,9064,-53,-0.581,30,-83,22,81,H1
"Red River Parish, LA",2010-2011,9064,9054,-10,-0.11,42,-52,22,81,H1
"Red River Parish, LA",2011-2012,9054,9027,-27,-0.298,42,-69,22,81,H1
"Red River Parish, LA",2012-2013,9027,8871,-156,-1.728,22,-178,22,81,H1
"Red River Parish, LA",2013-2014,8871,8669,-202,-2.277,9,-211,22,81,H1
"Red River Parish, LA",2014-2015,8661,8593,-68,-0.785,5,-73,22,81,H1
"Red River Parish, LA",2015-2016,8593,8634,41,0.477,4,37,22,81,H1
"Red River Parish, LA",2016-2017,8634,8536,-98,-1.135,-2,-96,22,81,H1
"Richland Parish, LA",2000-2001,20935,20880,-55,-0.263,55,-110,22,83,H1
"Richland Parish, LA",2001-2002,20880,20784,-96,-0.46,52,-148,22,83,H1
"Richland Parish, LA",2002-2003,20784,20576,-208,-1.001,24,-232,22,83,H1
"Richland Parish, LA",2003-2004,20576,20487,-89,-0.433,26,-115,22,83,H1
"Richland Parish, LA",2004-2005,20487,20466,-21,-0.103,59,-80,22,83,H1
"Richland Parish, LA",2005-2006,20466,20661,195,0.953,73,122,22,83,H1
"Richland Parish, LA",2006-2007,20661,20670,9,0.044,96,-87,22,83,H1
"Richland Parish, LA",2007-2008,20670,20727,57,0.276,81,-24,22,83,H1
"Richland Parish, LA",2008-2009,20727,20664,-63,-0.304,60,-123,22,83,H1
"Richland Parish, LA",2009-2010,20664,20756,92,0.445,26,66,22,83,H1
"Richland Parish, LA",2010-2011,20756,20908,152,0.732,-1,153,22,83,H1
"Richland Parish, LA",2011-2012,20908,20923,15,0.072,40,-25,22,83,H1
"Richland Parish, LA",2012-2013,20923,20900,-23,-0.11,85,-108,22,83,H1
"Richland Parish, LA",2013-2014,20900,20740,-160,-0.766,66,-226,22,83,H1
"Richland Parish, LA",2014-2015,20684,20523,-161,-0.778,33,-194,22,83,H1
"Richland Parish, LA",2015-2016,20523,20452,-71,-0.346,33,-104,22,83,H1
"Richland Parish, LA",2016-2017,20452,20411,-41,-0.2,11,-52,22,83,H1
"Sabine Parish, LA",2000-2001,23475,23379,-96,-0.409,62,-158,22,85,H1
"Sabine Parish, LA",2001-2002,23379,23380,1,0.004,19,-18,22,85,H1
"Sabine Parish, LA",2002-2003,23380,23527,147,0.629,93,54,22,85,H1
"Sabine Parish, LA",2003-2004,23527,23539,12,0.051,85,-73,22,85,H1
"Sabine Parish, LA",2004-2005,23539,23690,151,0.641,43,108,22,85,H1
"Sabine Parish, LA",2005-2006,23690,23954,264,1.114,80,184,22,85,H1
"Sabine Parish, LA",2006-2007,23954,24090,136,0.568,80,56,22,85,H1
"Sabine Parish, LA",2007-2008,24090,24124,34,0.141,76,-42,22,85,H1
"Sabine Parish, LA",2008-2009,24124,24199,75,0.311,114,-39,22,85,H1
"Sabine Parish, LA",2009-2010,24199,24237,38,0.157,76,-38,22,85,H1
"Sabine Parish, LA",2010-2011,24237,24433,196,0.809,22,174,22,85,H1
"Sabine Parish, LA",2011-2012,24433,24306,-127,-0.52,46,-173,22,85,H1
"Sabine Parish, LA",2012-2013,24306,24257,-49,-0.202,80,-129,22,85,H1
"Sabine Parish, LA",2013-2014,24257,24199,-58,-0.239,101,-159,22,85,H1
"Sabine Parish, LA",2014-2015,24116,24186,70,0.29,69,1,22,85,H1
"Sabine Parish, LA",2015-2016,24186,24093,-93,-0.385,21,-114,22,85,H1
"Sabine Parish, LA",2016-2017,24093,24018,-75,-0.311,28,-103,22,85,H1
"St. Bernard Parish, LA",2000-2001,67278,68028,750,1.115,88,662,22,87,H1
"St. Bernard Parish, LA",2001-2002,68028,68964,936,1.376,127,809,22,87,H1
"St. Bernard Parish, LA",2002-2003,68964,69621,657,0.953,53,604,22,87,H1
"St. Bernard Parish, LA",2003-2004,69621,70547,926,1.33,113,813,22,87,H1
"St. Bernard Parish, LA",2004-2005,70547,71300,753,1.067,32,721,22,87,H1
"St. Bernard Parish, LA",2005-2006,71300,16563,-54737,-76.77,-244,-54493,22,87,H1
"St. Bernard Parish, LA",2006-2007,16563,23613,7050,42.565,7,7043,22,87,H1
"St. Bernard Parish, LA",2007-2008,23613,28879,5266,22.301,306,4960,22,87,H1
"St. Bernard Parish, LA",2008-2009,28879,32878,3999,13.847,238,3761,22,87,H1
"St. Bernard Parish, LA",2009-2010,32878,36796,3918,11.917,216,3702,22,87,H1
"St. Bernard Parish, LA",2010-2011,36796,39489,2693,7.319,344,2349,22,87,H1
"St. Bernard Parish, LA",2011-2012,39489,41498,2009,5.087,276,1733,22,87,H1
"St. Bernard Parish, LA",2012-2013,41498,43380,1882,4.535,298,1584,22,87,H1
"St. Bernard Parish, LA",2013-2014,43380,44409,1029,2.372,335,694,22,87,H1
"St. Bernard Parish, LA",2014-2015,44462,45408,946,2.128,335,611,22,87,H1
"St. Bernard Parish, LA",2015-2016,45408,45814,406,0.894,301,105,22,87,H1
"St. Bernard Parish, LA",2016-2017,45814,46202,388,0.847,259,129,22,87,H1
"St. Charles Parish, LA",2000-2001,48118,48461,343,0.713,377,-34,22,89,H1
"St. Charles Parish, LA",2001-2002,48461,49117,656,1.354,354,302,22,89,H1
"St. Charles Parish, LA",2002-2003,49117,49338,221,0.45,309,-88,22,89,H1
"St. Charles Parish, LA",2003-2004,49338,49939,601,1.218,333,268,22,89,H1
"St. Charles Parish, LA",2004-2005,49939,50670,731,1.464,337,394,22,89,H1
"St. Charles Parish, LA",2005-2006,50670,52453,1783,3.519,272,1511,22,89,H1
"St. Charles Parish, LA",2006-2007,52453,52765,312,0.595,367,-55,22,89,H1
"St. Charles Parish, LA",2007-2008,52765,52516,-249,-0.472,376,-625,22,89,H1
"St. Charles Parish, LA",2008-2009,52516,52719,203,0.387,307,-104,22,89,H1
"St. Charles Parish, LA",2009-2010,52719,52868,149,0.283,280,-131,22,89,H1
"St. Charles Parish, LA",2010-2011,52868,52407,-461,-0.872,196,-657,22,89,H1
"St. Charles Parish, LA",2011-2012,52407,52437,30,0.057,249,-219,22,89,H1
"St. Charles Parish, LA",2012-2013,52437,52622,185,0.353,287,-102,22,89,H1
"St. Charles Parish, LA",2013-2014,52622,52745,123,0.234,270,-147,22,89,H1
"St. Charles Parish, LA",2014-2015,52832,52812,-20,-0.038,274,-294,22,89,H1
"St. Charles Parish, LA",2015-2016,52812,52864,52,0.098,243,-191,22,89,H1
"St. Charles Parish, LA",2016-2017,52864,52749,-115,-0.218,232,-347,22,89,H1
"St. Helena Parish, LA",2000-2001,10548,10524,-24,-0.228,39,-63,22,91,H1
"St. Helena Parish, LA",2001-2002,10524,10592,68,0.646,2,66,22,91,H1
"St. Helena Parish, LA",2002-2003,10592,10549,-43,-0.406,9,-52,22,91,H1
"St. Helena Parish, LA",2003-2004,10549,10548,-1,-0.009,-11,10,22,91,H1
"St. Helena Parish, LA",2004-2005,10548,10521,-27,-0.256,15,-42,22,91,H1
"St. Helena Parish, LA",2005-2006,10521,11089,568,5.399,-7,575,22,91,H1
"St. Helena Parish, LA",2006-2007,11089,11070,-19,-0.171,14,-33,22,91,H1
"St. Helena Parish, LA",2007-2008,11070,11106,36,0.325,29,7,22,91,H1
"St. Helena Parish, LA",2008-2009,11106,11154,48,0.432,-2,50,22,91,H1
"St. Helena Parish, LA",2009-2010,11154,11171,17,0.152,-10,27,22,91,H1
"St. Helena Parish, LA",2010-2011,11171,11014,-157,-1.405,-18,-139,22,91,H1
"St. Helena Parish, LA",2011-2012,11014,11032,18,0.163,17,1,22,91,H1
"St. Helena Parish, LA",2012-2013,11032,10851,-181,-1.641,22,-203,22,91,H1
"St. Helena Parish, LA",2013-2014,10851,10619,-232,-2.138,15,-247,22,91,H1
"St. Helena Parish, LA",2014-2015,10629,10567,-62,-0.583,-2,-60,22,91,H1
"St. Helena Parish, LA",2015-2016,10567,10439,-128,-1.211,36,-164,22,91,H1
"St. Helena Parish, LA",2016-2017,10439,10363,-76,-0.728,15,-91,22,91,H1
"St. James Parish, LA",2000-2001,21201,21291,90,0.425,193,-103,22,93,H1
"St. James Parish, LA",2001-2002,21291,21365,74,0.348,110,-36,22,93,H1
"St. James Parish, LA",2002-2003,21365,21274,-91,-0.426,89,-180,22,93,H1
"St. James Parish, LA",2003-2004,21274,21229,-45,-0.212,106,-151,22,93,H1
"St. James Parish, LA",2004-2005,21229,21399,170,0.801,151,19,22,93,H1
"St. James Parish, LA",2005-2006,21399,21964,565,2.64,82,483,22,93,H1
"St. James Parish, LA",2006-2007,21964,22164,200,0.911,85,115,22,93,H1
"St. James Parish, LA",2007-2008,22164,22095,-69,-0.311,155,-224,22,93,H1
"St. James Parish, LA",2008-2009,22095,22231,136,0.616,117,19,22,93,H1
"St. James Parish, LA",2009-2010,22231,22030,-201,-0.904,122,-323,22,93,H1
"St. James Parish, LA",2010-2011,22030,21842,-188,-0.853,101,-289,22,93,H1
"St. James Parish, LA",2011-2012,21842,21698,-144,-0.659,114,-258,22,93,H1
"St. James Parish, LA",2012-2013,21698,21700,2,0.009,47,-45,22,93,H1
"St. James Parish, LA",2013-2014,21700,21638,-62,-0.286,73,-135,22,93,H1
"St. James Parish, LA",2014-2015,21568,21567,-1,-0.005,60,-61,22,93,H1
"St. James Parish, LA",2015-2016,21567,21432,-135,-0.626,29,-164,22,93,H1
"St. James Parish, LA",2016-2017,21432,21367,-65,-0.303,27,-92,22,93,H1
"St. John the Baptist Parish, LA",2000-2001,43248,43580,332,0.768,354,-22,22,95,H1
"St. John the Baptist Parish, LA",2001-2002,43580,43878,298,0.684,374,-76,22,95,H1
"St. John the Baptist Parish, LA",2002-2003,43878,44316,438,0.998,360,78,22,95,H1
"St. John the Baptist Parish, LA",2003-2004,44316,44822,506,1.142,392,114,22,95,H1
"St. John the Baptist Parish, LA",2004-2005,44822,45296,474,1.058,321,153,22,95,H1
"St. John the Baptist Parish, LA",2005-2006,45296,47296,2.00E+03,4.415,348,1652,22,95,H1
"St. John the Baptist Parish, LA",2006-2007,47296,47386,90,0.19,465,-375,22,95,H1
"St. John the Baptist Parish, LA",2007-2008,47386,46811,-575,-1.213,439,-1014,22,95,H1
"St. John the Baptist Parish, LA",2008-2009,46811,46336,-475,-1.015,342,-817,22,95,H1
"St. John the Baptist Parish, LA",2009-2010,46336,45652,-684,-1.476,281,-965,22,95,H1
"St. John the Baptist Parish, LA",2010-2011,45652,45082,-570,-1.249,221,-791,22,95,H1
"St. John the Baptist Parish, LA",2011-2012,45082,44753,-329,-0.73,262,-591,22,95,H1
"St. John the Baptist Parish, LA",2012-2013,44753,43619,-1134,-2.534,147,-1281,22,95,H1
"St. John the Baptist Parish, LA",2013-2014,43619,43745,126,0.289,137,-11,22,95,H1
"St. John the Baptist Parish, LA",2014-2015,43773,43626,-147,-0.336,155,-302,22,95,H1
"St. John the Baptist Parish, LA",2015-2016,43626,43480,-146,-0.335,135,-281,22,95,H1
"St. John the Baptist Parish, LA",2016-2017,43480,43441,-39,-0.09,127,-166,22,95,H1
"St. Landry Parish, LA",2000-2001,87420,86416,-1004,-1.148,453,-1457,22,97,H1
"St. Landry Parish, LA",2001-2002,86416,85713,-703,-0.814,523,-1226,22,97,H1
"St. Landry Parish, LA",2002-2003,85713,85034,-679,-0.792,419,-1098,22,97,H1
"St. Landry Parish, LA",2003-2004,85034,84487,-547,-0.643,471,-1018,22,97,H1
"St. Landry Parish, LA",2004-2005,84487,83952,-535,-0.633,384,-919,22,97,H1
"St. Landry Parish, LA",2005-2006,83952,85128,1176,1.401,490,686,22,97,H1
"St. Landry Parish, LA",2006-2007,85128,84710,-418,-0.491,636,-1054,22,97,H1
"St. Landry Parish, LA",2007-2008,84710,84427,-283,-0.334,505,-788,22,97,H1
"St. Landry Parish, LA",2008-2009,84427,83825,-602,-0.713,494,-1096,22,97,H1
"St. Landry Parish, LA",2009-2010,83825,83500,-325,-0.388,374,-699,22,97,H1
"St. Landry Parish, LA",2010-2011,83500,83426,-74,-0.089,466,-540,22,97,H1
"St. Landry Parish, LA",2011-2012,83426,83483,57,0.068,347,-290,22,97,H1
"St. Landry Parish, LA",2012-2013,83483,83472,-11,-0.013,258,-269,22,97,H1
"St. Landry Parish, LA",2013-2014,83472,83709,237,0.284,261,-24,22,97,H1
"St. Landry Parish, LA",2014-2015,83803,83848,45,0.054,322,-277,22,97,H1
"St. Landry Parish, LA",2015-2016,83848,83703,-145,-0.173,336,-481,22,97,H1
"St. Landry Parish, LA",2016-2017,83703,83497,-206,-0.246,314,-520,22,97,H1
"St. Martin Parish, LA",2000-2001,48583,48971,388,0.799,356,32,22,99,H1
"St. Martin Parish, LA",2001-2002,48971,49228,257,0.525,326,-69,22,99,H1
"St. Martin Parish, LA",2002-2003,49228,49482,254,0.516,241,13,22,99,H1
"St. Martin Parish, LA",2003-2004,49482,49754,272,0.55,295,-23,22,99,H1
"St. Martin Parish, LA",2004-2005,49754,49890,136,0.273,374,-238,22,99,H1
"St. Martin Parish, LA",2005-2006,49890,51044,1154,2.313,285,869,22,99,H1
"St. Martin Parish, LA",2006-2007,51044,51410,366,0.717,354,12,22,99,H1
"St. Martin Parish, LA",2007-2008,51410,51914,504,0.98,398,106,22,99,H1
"St. Martin Parish, LA",2008-2009,51914,52025,111,0.214,310,-199,22,99,H1
"St. Martin Parish, LA",2009-2010,52025,52275,250,0.481,253,-3,22,99,H1
"St. Martin Parish, LA",2010-2011,52275,52863,588,1.125,268,320,22,99,H1
"St. Martin Parish, LA",2011-2012,52863,52716,-147,-0.278,293,-440,22,99,H1
"St. Martin Parish, LA",2012-2013,52716,52946,230,0.436,279,-49,22,99,H1
"St. Martin Parish, LA",2013-2014,52946,53315,369,0.697,254,115,22,99,H1
"St. Martin Parish, LA",2014-2015,53300,53835,535,1.004,248,287,22,99,H1
"St. Martin Parish, LA",2015-2016,53835,53809,-26,-0.048,257,-283,22,99,H1
"St. Martin Parish, LA",2016-2017,53809,54171,362,0.673,232,130,22,99,H1
"St. Mary Parish, LA",2000-2001,53377,53044,-333,-0.624,315,-648,22,101,H1
"St. Mary Parish, LA",2001-2002,53044,53109,65,0.123,325,-260,22,101,H1
"St. Mary Parish, LA",2002-2003,53109,53245,136,0.256,238,-102,22,101,H1
"St. Mary Parish, LA",2003-2004,53245,53288,43,0.081,213,-170,22,101,H1
"St. Mary Parish, LA",2004-2005,53288,53015,-273,-0.512,267,-540,22,101,H1
"St. Mary Parish, LA",2005-2006,53015,54152,1137,2.145,198,939,22,101,H1
"St. Mary Parish, LA",2006-2007,54152,54104,-48,-0.089,285,-333,22,101,H1
"St. Mary Parish, LA",2007-2008,54104,54352,248,0.458,397,-149,22,101,H1
"St. Mary Parish, LA",2008-2009,54352,54551,199,0.366,258,-59,22,101,H1
"St. Mary Parish, LA",2009-2010,54551,54562,11,0.02,238,-227,22,101,H1
"St. Mary Parish, LA",2010-2011,54562,54136,-426,-0.781,165,-591,22,101,H1
"St. Mary Parish, LA",2011-2012,54136,53526,-610,-1.127,219,-829,22,101,H1
"St. Mary Parish, LA",2012-2013,53526,53533,7,0.013,218,-211,22,101,H1
"St. Mary Parish, LA",2013-2014,53533,53162,-371,-0.693,229,-600,22,101,H1
"St. Mary Parish, LA",2014-2015,53223,52810,-413,-0.776,237,-650,22,101,H1
"St. Mary Parish, LA",2015-2016,52810,52174,-636,-1.204,203,-839,22,101,H1
"St. Mary Parish, LA",2016-2017,52174,50973,-1201,-2.302,208,-1409,22,101,H1
"St. Tammany Parish, LA",2000-2001,192131,195622,3491,1.817,1151,2340,22,103,H1
"St. Tammany Parish, LA",2001-2002,195622,200701,5079,2.596,1233,3846,22,103,H1
"St. Tammany Parish, LA",2002-2003,200701,205708,5007,2.495,1327,3680,22,103,H1
"St. Tammany Parish, LA",2003-2004,205708,211405,5697,2.769,1317,4380,22,103,H1
"St. Tammany Parish, LA",2004-2005,211405,217358,5953,2.816,1265,4688,22,103,H1
"St. Tammany Parish, LA",2005-2006,217358,223133,5775,2.657,897,4878,22,103,H1
"St. Tammany Parish, LA",2006-2007,223133,226294,3161,1.417,1424,1737,22,103,H1
"St. Tammany Parish, LA",2007-2008,226294,229252,2958,1.307,1374,1584,22,103,H1
"St. Tammany Parish, LA",2008-2009,229252,231224,1972,0.86,1259,713,22,103,H1
"St. Tammany Parish, LA",2009-2010,231224,234576,3352,1.45,811,2541,22,103,H1
"St. Tammany Parish, LA",2010-2011,234576,236843,2267,0.966,797,1470,22,103,H1
"St. Tammany Parish, LA",2011-2012,236843,239346,2503,1.057,725,1778,22,103,H1
"St. Tammany Parish, LA",2012-2013,239346,242478,3132,1.309,512,2620,22,103,H1
"St. Tammany Parish, LA",2013-2014,242478,245829,3351,1.382,600,2751,22,103,H1
"St. Tammany Parish, LA",2014-2015,246056,250088,4032,1.639,771,3261,22,103,H1
"St. Tammany Parish, LA",2015-2016,250088,252772,2684,1.073,767,1917,22,103,H1
"St. Tammany Parish, LA",2016-2017,252772,256327,3555,1.406,712,2843,22,103,H1
"Tangipahoa Parish, LA",2000-2001,100716,101657,941,0.934,687,254,22,105,H1
"Tangipahoa Parish, LA",2001-2002,101657,102511,854,0.84,671,183,22,105,H1
"Tangipahoa Parish, LA",2002-2003,102511,103782,1271,1.24,492,779,22,105,H1
"Tangipahoa Parish, LA",2003-2004,103782,105335,1553,1.496,624,929,22,105,H1
"Tangipahoa Parish, LA",2004-2005,105335,106987,1652,1.568,563,1089,22,105,H1
"Tangipahoa Parish, LA",2005-2006,106987,114102,7115,6.65,561,6554,22,105,H1
"Tangipahoa Parish, LA",2006-2007,114102,116792,2690,2.358,856,1834,22,105,H1
"Tangipahoa Parish, LA",2007-2008,116792,118621,1829,1.566,880,949,22,105,H1
"Tangipahoa Parish, LA",2008-2009,118621,120009,1388,1.17,742,646,22,105,H1
"Tangipahoa Parish, LA",2009-2010,120009,121572,1563,1.302,553,1010,22,105,H1
"Tangipahoa Parish, LA",2010-2011,121572,122727,1155,0.95,776,379,22,105,H1
"Tangipahoa Parish, LA",2011-2012,122727,123767,1040,0.847,756,284,22,105,H1
"Tangipahoa Parish, LA",2012-2013,123767,125508,1741,1.407,734,1007,22,105,H1
"Tangipahoa Parish, LA",2013-2014,125508,127049,1541,1.228,726,815,22,105,H1
"Tangipahoa Parish, LA",2014-2015,126948,128755,1807,1.423,741,1066,22,105,H1
"Tangipahoa Parish, LA",2015-2016,128755,130623,1868,1.451,755,1113,22,105,H1
"Tangipahoa Parish, LA",2016-2017,130623,132497,1874,1.435,659,1215,22,105,H1
"Tensas Parish, LA",2000-2001,6535,6334,-201,-3.076,30,-231,22,107,H1
"Tensas Parish, LA",2001-2002,6334,6150,-184,-2.905,16,-200,22,107,H1
"Tensas Parish, LA",2002-2003,6150,5941,-209,-3.398,3,-212,22,107,H1
"Tensas Parish, LA",2003-2004,5941,5785,-156,-2.626,25,-181,22,107,H1
"Tensas Parish, LA",2004-2005,5785,5700,-85,-1.469,2,-87,22,107,H1
"Tensas Parish, LA",2005-2006,5700,5719,19,0.333,-18,37,22,107,H1
"Tensas Parish, LA",2006-2007,5719,5513,-206,-3.602,-13,-193,22,107,H1
"Tensas Parish, LA",2007-2008,5513,5376,-137,-2.485,48,-185,22,107,H1
"Tensas Parish, LA",2008-2009,5376,5311,-65,-1.209,19,-84,22,107,H1
"Tensas Parish, LA",2009-2010,5311,5235,-76,-1.431,7,-83,22,107,H1
"Tensas Parish, LA",2010-2011,5235,5096,-139,-2.655,12,-151,22,107,H1
"Tensas Parish, LA",2011-2012,5096,4971,-125,-2.453,23,-148,22,107,H1
"Tensas Parish, LA",2012-2013,4971,4907,-64,-1.287,8,-72,22,107,H1
"Tensas Parish, LA",2013-2014,4907,4830,-77,-1.569,14,-91,22,107,H1
"Tensas Parish, LA",2014-2015,4802,4740,-62,-1.291,11,-73,22,107,H1
"Tensas Parish, LA",2015-2016,4740,4677,-63,-1.329,20,-83,22,107,H1
"Tensas Parish, LA",2016-2017,4677,4615,-62,-1.326,8,-70,22,107,H1
"Terrebonne Parish, LA",2000-2001,104756,105255,499,0.476,932,-433,22,109,H1
"Terrebonne Parish, LA",2001-2002,105255,105698,443,0.421,794,-351,22,109,H1
"Terrebonne Parish, LA",2002-2003,105698,106257,559,0.529,883,-324,22,109,H1
"Terrebonne Parish, LA",2003-2004,106257,106783,526,0.495,878,-352,22,109,H1
"Terrebonne Parish, LA",2004-2005,106783,107811,1028,0.963,827,201,22,109,H1
"Terrebonne Parish, LA",2005-2006,107811,109994,2183,2.025,657,1526,22,109,H1
"Terrebonne Parish, LA",2006-2007,109994,110656,662,0.602,809,-147,22,109,H1
"Terrebonne Parish, LA",2007-2008,110656,111453,797,0.72,904,-107,22,109,H1
"Terrebonne Parish, LA",2008-2009,111453,111689,236,0.212,817,-581,22,109,H1
"Terrebonne Parish, LA",2009-2010,111689,111522,-167,-0.15,747,-914,22,109,H1
"Terrebonne Parish, LA",2010-2011,111522,111618,96,0.086,711,-615,22,109,H1
"Terrebonne Parish, LA",2011-2012,111618,111731,113,0.101,705,-592,22,109,H1
"Terrebonne Parish, LA",2012-2013,111731,112638,907,0.812,442,465,22,109,H1
"Terrebonne Parish, LA",2013-2014,112638,113328,690,0.613,502,188,22,109,H1
"Terrebonne Parish, LA",2014-2015,113579,113972,393,0.346,669,-276,22,109,H1
"Terrebonne Parish, LA",2015-2016,113972,113123,-849,-0.745,686,-1535,22,109,H1
"Terrebonne Parish, LA",2016-2017,113123,112086,-1037,-0.917,572,-1609,22,109,H1
"Union Parish, LA",2000-2001,22762,22783,21,0.092,88,-67,22,111,H1
"Union Parish, LA",2001-2002,22783,22624,-159,-0.698,86,-245,22,111,H1
"Union Parish, LA",2002-2003,22624,22757,133,0.588,18,115,22,111,H1
"Union Parish, LA",2003-2004,22757,22676,-81,-0.356,79,-160,22,111,H1
"Union Parish, LA",2004-2005,22676,22765,89,0.392,104,-15,22,111,H1
"Union Parish, LA",2005-2006,22765,22919,154,0.676,57,97,22,111,H1
"Union Parish, LA",2006-2007,22919,22770,-149,-0.65,56,-205,22,111,H1
"Union Parish, LA",2007-2008,22770,22698,-72,-0.316,106,-178,22,111,H1
"Union Parish, LA",2008-2009,22698,22609,-89,-0.392,51,-140,22,111,H1
"Union Parish, LA",2009-2010,22609,22835,226,1,17,209,22,111,H1
"Union Parish, LA",2010-2011,22835,22771,-64,-0.28,53,-117,22,111,H1
"Union Parish, LA",2011-2012,22771,22535,-236,-1.036,59,-295,22,111,H1
"Union Parish, LA",2012-2013,22535,22436,-99,-0.439,37,-136,22,111,H1
"Union Parish, LA",2013-2014,22436,22539,103,0.459,60,43,22,111,H1
"Union Parish, LA",2014-2015,22481,22477,-4,-0.018,50,-54,22,111,H1
"Union Parish, LA",2015-2016,22477,22609,132,0.587,75,57,22,111,H1
"Union Parish, LA",2016-2017,22609,22571,-38,-0.168,51,-89,22,111,H1
"Vermilion Parish, LA",2000-2001,54094,54217,123,0.227,286,-163,22,113,H1
"Vermilion Parish, LA",2001-2002,54217,54638,421,0.777,249,172,22,113,H1
"Vermilion Parish, LA",2002-2003,54638,54754,116,0.212,256,-140,22,113,H1
"Vermilion Parish, LA",2003-2004,54754,55113,359,0.656,221,138,22,113,H1
"Vermilion Parish, LA",2004-2005,55113,55828,715,1.297,321,394,22,113,H1
"Vermilion Parish, LA",2005-2006,55828,56388,560,1.003,164,396,22,113,H1
"Vermilion Parish, LA",2006-2007,56388,56835,447,0.793,358,89,22,113,H1
"Vermilion Parish, LA",2007-2008,56835,57421,586,1.031,323,263,22,113,H1
"Vermilion Parish, LA",2008-2009,57421,57684,263,0.458,261,2,22,113,H1
"Vermilion Parish, LA",2009-2010,57684,58090,406,0.704,202,204,22,113,H1
"Vermilion Parish, LA",2010-2011,58090,58248,158,0.272,171,-13,22,113,H1
"Vermilion Parish, LA",2011-2012,58248,58660,412,0.707,297,115,22,113,H1
"Vermilion Parish, LA",2012-2013,58660,59308,648,1.105,249,399,22,113,H1
"Vermilion Parish, LA",2013-2014,59308,59616,308,0.519,247,61,22,113,H1
"Vermilion Parish, LA",2014-2015,59518,59875,357,0.6,226,131,22,113,H1
"Vermilion Parish, LA",2015-2016,59875,60214,339,0.566,286,53,22,113,H1
"Vermilion Parish, LA",2016-2017,60214,60136,-78,-0.13,221,-299,22,113,H1
"Vernon Parish, LA",2000-2001,52744,52958,214,0.406,675,-461,22,115,H1
"Vernon Parish, LA",2001-2002,52958,52319,-639,-1.207,641,-1280,22,115,H1
"Vernon Parish, LA",2002-2003,52319,51288,-1031,-1.971,695,-1726,22,115,H1
"Vernon Parish, LA",2003-2004,51288,51402,114,0.222,518,-404,22,115,H1
"Vernon Parish, LA",2004-2005,51402,51808,406,0.79,630,-224,22,115,H1
"Vernon Parish, LA",2005-2006,51808,50781,-1027,-1.982,552,-1579,22,115,H1
"Vernon Parish, LA",2006-2007,50781,49796,-985,-1.94,627,-1612,22,115,H1
"Vernon Parish, LA",2007-2008,49796,48007,-1789,-3.593,573,-2362,22,115,H1
"Vernon Parish, LA",2008-2009,48007,50903,2896,6.032,428,2468,22,115,H1
"Vernon Parish, LA",2009-2010,50903,52752,1849,3.632,664,1185,22,115,H1
"Vernon Parish, LA",2010-2011,52752,52334,-418,-0.792,767,-1185,22,115,H1
"Vernon Parish, LA",2011-2012,52334,54176,1842,3.52,659,1183,22,115,H1
"Vernon Parish, LA",2012-2013,54176,52828,-1348,-2.488,759,-2107,22,115,H1
"Vernon Parish, LA",2013-2014,52828,52132,-696,-1.317,641,-1337,22,115,H1
"Vernon Parish, LA",2014-2015,52217,50803,-1414,-2.708,695,-2109,22,115,H1
"Vernon Parish, LA",2015-2016,50803,51621,818,1.61,674,144,22,115,H1
"Vernon Parish, LA",2016-2017,51621,50726,-895,-1.734,599,-1494,22,115,H1
"Washington Parish, LA",2000-2001,43936,43992,56,0.127,93,-37,22,117,H1
"Washington Parish, LA",2001-2002,43992,44156,164,0.373,172,-8,22,117,H1
"Washington Parish, LA",2002-2003,44156,44277,121,0.274,68,53,22,117,H1
"Washington Parish, LA",2003-2004,44277,44521,244,0.551,46,198,22,117,H1
"Washington Parish, LA",2004-2005,44521,44880,359,0.806,-9,368,22,117,H1
"Washington Parish, LA",2005-2006,44880,45157,277,0.617,19,258,22,117,H1
"Washington Parish, LA",2006-2007,45157,46376,1219,2.699,121,1098,22,117,H1
"Washington Parish, LA",2007-2008,46376,4.70E+04,624,1.346,117,507,22,117,H1
"Washington Parish, LA",2008-2009,4.70E+04,47262,262,0.557,94,168,22,117,H1
"Washington Parish, LA",2009-2010,47262,47119,-143,-0.303,17,-160,22,117,H1
"Washington Parish, LA",2010-2011,47119,47164,45,0.096,29,16,22,117,H1
"Washington Parish, LA",2011-2012,47164,46664,-500,-1.06,-12,-488,22,117,H1
"Washington Parish, LA",2012-2013,46664,46384,-280,-0.6,-50,-230,22,117,H1
"Washington Parish, LA",2013-2014,46384,46286,-98,-0.211,-51,-47,22,117,H1
"Washington Parish, LA",2014-2015,46287,46371,84,0.181,-22,106,22,117,H1
"Washington Parish, LA",2015-2016,46371,46424,53,0.114,36,17,22,117,H1
"Washington Parish, LA",2016-2017,46424,46633,209,0.45,28,181,22,117,H1
"Webster Parish, LA",2000-2001,41700,41372,-328,-0.787,5,-333,22,119,H1
"Webster Parish, LA",2001-2002,41372,41375,3,0.007,-15,18,22,119,H1
"Webster Parish, LA",2002-2003,41375,41125,-250,-0.604,-32,-218,22,119,H1
"Webster Parish, LA",2003-2004,41125,41145,20,0.049,-15,35,22,119,H1
"Webster Parish, LA",2004-2005,41145,41203,58,0.141,0,58,22,119,H1
"Webster Parish, LA",2005-2006,41203,41331,128,0.311,-52,180,22,119,H1
"Webster Parish, LA",2006-2007,41331,41275,-56,-0.135,12,-68,22,119,H1
"Webster Parish, LA",2007-2008,41275,41240,-35,-0.085,27,-62,22,119,H1
"Webster Parish, LA",2008-2009,41240,41131,-109,-0.264,2,-111,22,119,H1
"Webster Parish, LA",2009-2010,41131,41218,87,0.212,-43,130,22,119,H1
"Webster Parish, LA",2010-2011,41218,41256,38,0.092,29,9,22,119,H1
"Webster Parish, LA",2011-2012,41256,40943,-313,-0.759,65,-378,22,119,H1
"Webster Parish, LA",2012-2013,40943,40701,-242,-0.591,-37,-205,22,119,H1
"Webster Parish, LA",2013-2014,40701,40333,-368,-0.904,-33,-335,22,119,H1
"Webster Parish, LA",2014-2015,40276,40021,-255,-0.633,-35,-220,22,119,H1
"Webster Parish, LA",2015-2016,40021,39795,-226,-0.565,5,-231,22,119,H1
"Webster Parish, LA",2016-2017,39795,39378,-417,-1.048,-15,-402,22,119,H1
"West Baton Rouge Parish, LA",2000-2001,21577,21703,126,0.584,156,-30,22,121,H1
"West Baton Rouge Parish, LA",2001-2002,21703,21801,98,0.452,128,-30,22,121,H1
"West Baton Rouge Parish, LA",2002-2003,21801,21820,19,0.087,124,-105,22,121,H1
"West Baton Rouge Parish, LA",2003-2004,21820,22049,229,1.049,137,92,22,121,H1
"West Baton Rouge Parish, LA",2004-2005,22049,21929,-120,-0.544,122,-242,22,121,H1
"West Baton Rouge Parish, LA",2005-2006,21929,22666,737,3.361,107,630,22,121,H1
"West Baton Rouge Parish, LA",2006-2007,22666,23184,518,2.285,161,357,22,121,H1
"West Baton Rouge Parish, LA",2007-2008,23184,23252,68,0.293,177,-109,22,121,H1
"West Baton Rouge Parish, LA",2008-2009,23252,23352,100,0.43,113,-13,22,121,H1
"West Baton Rouge Parish, LA",2009-2010,23352,23949,597,2.557,122,475,22,121,H1
"West Baton Rouge Parish, LA",2010-2011,23949,24079,130,0.543,158,-28,22,121,H1
"West Baton Rouge Parish, LA",2011-2012,24079,24068,-11,-0.046,151,-162,22,121,H1
"West Baton Rouge Parish, LA",2012-2013,24068,24555,487,2.023,144,343,22,121,H1
"West Baton Rouge Parish, LA",2013-2014,24555,25085,530,2.158,139,391,22,121,H1
"West Baton Rouge Parish, LA",2014-2015,25140,25490,350,1.392,183,167,22,121,H1
"West Baton Rouge Parish, LA",2015-2016,25490,25937,447,1.754,179,268,22,121,H1
"West Baton Rouge Parish, LA",2016-2017,25937,26265,328,1.265,174,154,22,121,H1
"West Carroll Parish, LA",2000-2001,12285,12095,-190,-1.547,4,-194,22,123,H1
"West Carroll Parish, LA",2001-2002,12095,12134,39,0.322,30,9,22,123,H1
"West Carroll Parish, LA",2002-2003,12134,12155,21,0.173,-9,30,22,123,H1
"West Carroll Parish, LA",2003-2004,12155,12009,-146,-1.201,-38,-108,22,123,H1
"West Carroll Parish, LA",2004-2005,12009,11958,-51,-0.425,7,-58,22,123,H1
"West Carroll Parish, LA",2005-2006,11958,11851,-107,-0.895,-13,-94,22,123,H1
"West Carroll Parish, LA",2006-2007,11851,11708,-143,-1.207,27,-170,22,123,H1
"West Carroll Parish, LA",2007-2008,11708,11670,-38,-0.325,39,-77,22,123,H1
"West Carroll Parish, LA",2008-2009,11670,11633,-37,-0.317,12,-49,22,123,H1
"West Carroll Parish, LA",2009-2010,11633,11584,-49,-0.421,11,-60,22,123,H1
"West Carroll Parish, LA",2010-2011,11584,11527,-57,-0.492,26,-83,22,123,H1
"West Carroll Parish, LA",2011-2012,11527,11506,-21,-0.182,17,-38,22,123,H1
"West Carroll Parish, LA",2012-2013,11506,11467,-39,-0.339,-30,-9,22,123,H1
"West Carroll Parish, LA",2013-2014,11467,11525,58,0.506,-19,77,22,123,H1
"West Carroll Parish, LA",2014-2015,11518,11293,-225,-1.953,5,-230,22,123,H1
"West Carroll Parish, LA",2015-2016,11293,11128,-165,-1.461,3,-168,22,123,H1
"West Carroll Parish, LA",2016-2017,11128,10981,-147,-1.321,-19,-128,22,123,H1
"West Feliciana Parish, LA",2000-2001,15145,15152,7,0.046,46,-39,22,125,H1
"West Feliciana Parish, LA",2001-2002,15152,15216,64,0.422,25,39,22,125,H1
"West Feliciana Parish, LA",2002-2003,15216,15326,110,0.723,18,92,22,125,H1
"West Feliciana Parish, LA",2003-2004,15326,15300,-26,-0.17,33,-59,22,125,H1
"West Feliciana Parish, LA",2004-2005,15300,15431,131,0.856,-11,142,22,125,H1
"West Feliciana Parish, LA",2005-2006,15431,15736,305,1.977,-34,339,22,125,H1
"West Feliciana Parish, LA",2006-2007,15736,15655,-81,-0.515,12,-93,22,125,H1
"West Feliciana Parish, LA",2007-2008,15655,15767,112,0.715,32,80,22,125,H1
"West Feliciana Parish, LA",2008-2009,15767,15639,-128,-0.812,-6,-122,22,125,H1
"West Feliciana Parish, LA",2009-2010,15639,15625,-14,-0.09,-33,19,22,125,H1
"West Feliciana Parish, LA",2010-2011,15625,15475,-150,-0.96,10,-160,22,125,H1
"West Feliciana Parish, LA",2011-2012,15475,15449,-26,-0.168,29,-55,22,125,H1
"West Feliciana Parish, LA",2012-2013,15449,15468,19,0.123,20,-1,22,125,H1
"West Feliciana Parish, LA",2013-2014,15468,15406,-62,-0.401,22,-84,22,125,H1
"West Feliciana Parish, LA",2014-2015,15363,15385,22,0.143,6,16,22,125,H1
"West Feliciana Parish, LA",2015-2016,15385,15325,-60,-0.39,-5,-55,22,125,H1
"West Feliciana Parish, LA",2016-2017,15325,15380,55,0.359,-20,75,22,125,H1
"Winn Parish, LA",2000-2001,16816,16498,-318,-1.891,-8,-310,22,127,H1
"Winn Parish, LA",2001-2002,16498,16427,-71,-0.43,-9,-62,22,127,H1
"Winn Parish, LA",2002-2003,16427,16165,-262,-1.595,0,-262,22,127,H1
"Winn Parish, LA",2003-2004,16165,15908,-257,-1.59,-36,-221,22,127,H1
"Winn Parish, LA",2004-2005,15908,15751,-157,-0.987,-2,-155,22,127,H1
"Winn Parish, LA",2005-2006,15751,15720,-31,-0.197,21,-52,22,127,H1
"Winn Parish, LA",2006-2007,15720,15588,-132,-0.84,14,-146,22,127,H1
"Winn Parish, LA",2007-2008,15588,15398,-190,-1.219,36,-226,22,127,H1
"Winn Parish, LA",2008-2009,15398,15393,-5,-0.032,11,-16,22,127,H1
"Winn Parish, LA",2009-2010,15393,15284,-109,-0.708,0,-109,22,127,H1
"Winn Parish, LA",2010-2011,15284,15138,-146,-0.955,37,-183,22,127,H1
"Winn Parish, LA",2011-2012,15138,15049,-89,-0.588,32,-121,22,127,H1
"Winn Parish, LA",2012-2013,15049,14787,-262,-1.741,-46,-216,22,127,H1
"Winn Parish, LA",2013-2014,14787,14743,-44,-0.298,-37,-7,22,127,H1
"Winn Parish, LA",2014-2015,14746,14568,-178,-1.207,-5,-173,22,127,H1
"Winn Parish, LA",2015-2016,14568,14533,-35,-0.24,-10,-25,22,127,H1
"Winn Parish, LA",2016-2017,14533,14311,-222,-1.528,-30,-192,22,127,H1
Maine,2000-2001,1277072,1285692,8620,0.675,1444,7176,23,0,STATE
Maine,2001-2002,1285692,1295960,10268,0.799,794,9474,23,0,STATE
Maine,2002-2003,1295960,1306513,10553,0.814,1092,9461,23,0,STATE
Maine,2003-2004,1306513,1313688,7175,0.549,1515,5660,23,0,STATE
Maine,2004-2005,1313688,1318787,5099,0.388,1130,3969,23,0,STATE
Maine,2005-2006,1318787,1323619,4832,0.366,1689,3143,23,0,STATE
Maine,2006-2007,1323619,1327040,3421,0.258,1920,1501,23,0,STATE
Maine,2007-2008,1327040,1330509,3469,0.261,1243,2226,23,0,STATE
Maine,2008-2009,1330509,1329590,-919,-0.069,789,-1708,23,0,STATE
Maine,2009-2010,1329590,1327695,-1895,-0.143,268,-2163,23,0,STATE
Maine,2010-2011,1327695,1328257,562,0.042,-401,963,23,0,STATE
Maine,2011-2012,1328257,1328888,631,0.048,52,579,23,0,STATE
Maine,2012-2013,1328888,1328778,-110,-0.008,-538,428,23,0,STATE
Maine,2013-2014,1328778,1330256,1478,0.111,-653,2131,23,0,STATE
Maine,2014-2015,1330256,1329328,-928,-0.07,-450,-478,23,0,STATE
Maine,2015-2016,1329328,1330232,904,0.068,-1513,2417,23,0,STATE
Maine,2016-2017,1330232,1335907,5675,0.427,-1235,6910,23,0,STATE
"Androscoggin County, ME",2000-2001,103852,104260,408,0.393,160,248,23,1,H1
"Androscoggin County, ME",2001-2002,104260,105063,803,0.77,199,604,23,1,H1
"Androscoggin County, ME",2002-2003,105063,106140,1077,1.025,221,856,23,1,H1
"Androscoggin County, ME",2003-2004,106140,106867,727,0.685,258,469,23,1,H1
"Androscoggin County, ME",2004-2005,106867,107352,485,0.454,283,202,23,1,H1
"Androscoggin County, ME",2005-2006,107352,107932,580,0.54,369,211,23,1,H1
"Androscoggin County, ME",2006-2007,107932,107739,-193,-0.179,442,-635,23,1,H1
"Androscoggin County, ME",2007-2008,107739,108284,545,0.506,257,288,23,1,H1
"Androscoggin County, ME",2008-2009,108284,107830,-454,-0.419,234,-688,23,1,H1
"Androscoggin County, ME",2009-2010,107830,107661,-169,-0.157,188,-357,23,1,H1
"Androscoggin County, ME",2010-2011,107661,107353,-308,-0.286,321,-629,23,1,H1
"Androscoggin County, ME",2011-2012,107353,107506,153,0.143,296,-143,23,1,H1
"Androscoggin County, ME",2012-2013,107506,107391,-115,-0.107,278,-393,23,1,H1
"Androscoggin County, ME",2013-2014,107391,107440,49,0.046,281,-232,23,1,H1
"Androscoggin County, ME",2014-2015,107408,107233,-175,-0.163,227,-402,23,1,H1
"Androscoggin County, ME",2015-2016,107233,107269,36,0.034,161,-125,23,1,H1
"Androscoggin County, ME",2016-2017,107269,107651,382,0.356,200,182,23,1,H1
"Aroostook County, ME",2000-2001,73872,72962,-910,-1.232,-120,-790,23,3,H1
"Aroostook County, ME",2001-2002,72962,72942,-20,-0.027,-90,70,23,3,H1
"Aroostook County, ME",2002-2003,72942,72944,2,0.003,-252,254,23,3,H1
"Aroostook County, ME",2003-2004,72944,72959,15,0.021,-227,242,23,3,H1
"Aroostook County, ME",2004-2005,72959,72881,-78,-0.107,-162,84,23,3,H1
"Aroostook County, ME",2005-2006,72881,72827,-54,-0.074,-110,56,23,3,H1
"Aroostook County, ME",2006-2007,72827,72711,-116,-0.159,-64,-52,23,3,H1
"Aroostook County, ME",2007-2008,72711,72542,-169,-0.232,-175,6,23,3,H1
"Aroostook County, ME",2008-2009,72542,72258,-284,-0.391,-196,-88,23,3,H1
"Aroostook County, ME",2009-2010,72258,71704,-554,-0.767,-224,-330,23,3,H1
"Aroostook County, ME",2010-2011,71704,71330,-374,-0.522,-198,-176,23,3,H1
"Aroostook County, ME",2011-2012,71330,70744,-586,-0.822,-218,-368,23,3,H1
"Aroostook County, ME",2012-2013,70744,70039,-705,-0.997,-93,-612,23,3,H1
"Aroostook County, ME",2013-2014,70039,69447,-592,-0.845,-143,-449,23,3,H1
"Aroostook County, ME",2014-2015,69361,68628,-733,-1.057,-151,-582,23,3,H1
"Aroostook County, ME",2015-2016,68628,68116,-512,-0.746,-202,-310,23,3,H1
"Aroostook County, ME",2016-2017,68116,67653,-463,-0.68,-168,-295,23,3,H1
"Cumberland County, ME",2000-2001,266109,268391,2282,0.858,662,1620,23,5,H1
"Cumberland County, ME",2001-2002,268391,270533,2142,0.798,433,1709,23,5,H1
"Cumberland County, ME",2002-2003,270533,273041,2508,0.927,621,1887,23,5,H1
"Cumberland County, ME",2003-2004,273041,274920,1879,0.688,659,1220,23,5,H1
"Cumberland County, ME",2004-2005,274920,276275,1355,0.493,609,746,23,5,H1
"Cumberland County, ME",2005-2006,276275,277084,809,0.293,700,109,23,5,H1
"Cumberland County, ME",2006-2007,277084,278781,1697,0.612,727,970,23,5,H1
"Cumberland County, ME",2007-2008,278781,280681,1900,0.682,517,1383,23,5,H1
"Cumberland County, ME",2008-2009,280681,281969,1288,0.459,383,905,23,5,H1
"Cumberland County, ME",2009-2010,281969,281390,-579,-0.205,566,-1145,23,5,H1
"Cumberland County, ME",2010-2011,281390,282651,1261,0.448,267,994,23,5,H1
"Cumberland County, ME",2011-2012,282651,284050,1399,0.495,282,1117,23,5,H1
"Cumberland County, ME",2012-2013,284050,285866,1816,0.639,311,1505,23,5,H1
"Cumberland County, ME",2013-2014,285866,287797,1931,0.675,286,1645,23,5,H1
"Cumberland County, ME",2014-2015,287875,289977,2102,0.73,405,1697,23,5,H1
"Cumberland County, ME",2015-2016,289977,290905,928,0.32,108,820,23,5,H1
"Cumberland County, ME",2016-2017,290905,292500,1595,0.548,124,1471,23,5,H1
"Franklin County, ME",2000-2001,29498,29631,133,0.451,14,119,23,7,H1
"Franklin County, ME",2001-2002,29631,30019,388,1.309,-9,397,23,7,H1
"Franklin County, ME",2002-2003,30019,30026,7,0.023,1,6,23,7,H1
"Franklin County, ME",2003-2004,30026,30096,70,0.233,-17,87,23,7,H1
"Franklin County, ME",2004-2005,30096,30226,130,0.432,13,117,23,7,H1
"Franklin County, ME",2005-2006,30226,30528,302,0.999,34,268,23,7,H1
"Franklin County, ME",2006-2007,30528,30596,68,0.223,-9,77,23,7,H1
"Franklin County, ME",2007-2008,30596,30652,56,0.183,23,33,23,7,H1
"Franklin County, ME",2008-2009,30652,30779,127,0.414,32,95,23,7,H1
"Franklin County, ME",2009-2010,30779,30704,-75,-0.244,1,-76,23,7,H1
"Franklin County, ME",2010-2011,30704,30701,-3,-0.01,-61,58,23,7,H1
"Franklin County, ME",2011-2012,30701,30627,-74,-0.241,-20,-54,23,7,H1
"Franklin County, ME",2012-2013,30627,30519,-108,-0.353,-41,-67,23,7,H1
"Franklin County, ME",2013-2014,30519,30296,-223,-0.731,-47,-176,23,7,H1
"Franklin County, ME",2014-2015,30206,29991,-215,-0.712,-43,-172,23,7,H1
"Franklin County, ME",2015-2016,29991,30071,80,0.267,-87,167,23,7,H1
"Franklin County, ME",2016-2017,30071,29988,-83,-0.276,-72,-11,23,7,H1
"Hancock County, ME",2000-2001,51967,52109,142,0.273,-48,190,23,9,H1
"Hancock County, ME",2001-2002,52109,52327,218,0.418,-122,340,23,9,H1
"Hancock County, ME",2002-2003,52327,53030,703,1.343,-48,751,23,9,H1
"Hancock County, ME",2003-2004,53030,53613,583,1.099,-34,617,23,9,H1
"Hancock County, ME",2004-2005,53613,53745,132,0.246,-109,241,23,9,H1
"Hancock County, ME",2005-2006,53745,54009,264,0.491,20,244,23,9,H1
"Hancock County, ME",2006-2007,54009,54300,291,0.539,4,287,23,9,H1
"Hancock County, ME",2007-2008,54300,54371,71,0.131,-28,99,23,9,H1
"Hancock County, ME",2008-2009,54371,54499,128,0.235,-47,175,23,9,H1
"Hancock County, ME",2009-2010,54499,54353,-146,-0.268,-61,-85,23,9,H1
"Hancock County, ME",2010-2011,54353,54532,179,0.329,-76,255,23,9,H1
"Hancock County, ME",2011-2012,54532,54536,4,0.007,-96,100,23,9,H1
"Hancock County, ME",2012-2013,54536,54790,254,0.466,-131,385,23,9,H1
"Hancock County, ME",2013-2014,54790,54696,-94,-0.172,-160,66,23,9,H1
"Hancock County, ME",2014-2015,54738,54659,-79,-0.144,-119,40,23,9,H1
"Hancock County, ME",2015-2016,54659,54398,-261,-0.478,-176,-85,23,9,H1
"Hancock County, ME",2016-2017,54398,54497,99,0.182,-166,265,23,9,H1
"Kennebec County, ME",2000-2001,117177,118024,847,0.723,191,656,23,11,H1
"Kennebec County, ME",2001-2002,118024,118611,587,0.497,63,524,23,11,H1
"Kennebec County, ME",2002-2003,118611,119538,927,0.782,-5,932,23,11,H1
"Kennebec County, ME",2003-2004,119538,120303,765,0.64,162,603,23,11,H1
"Kennebec County, ME",2004-2005,120303,120957,654,0.544,-11,665,23,11,H1
"Kennebec County, ME",2005-2006,120957,121508,551,0.456,141,410,23,11,H1
"Kennebec County, ME",2006-2007,121508,121741,233,0.192,94,139,23,11,H1
"Kennebec County, ME",2007-2008,121741,122147,406,0.333,131,275,23,11,H1
"Kennebec County, ME",2008-2009,122147,122084,-63,-0.052,76,-139,23,11,H1
"Kennebec County, ME",2009-2010,122084,122053,-31,-0.025,-57,26,23,11,H1
"Kennebec County, ME",2010-2011,122053,121727,-326,-0.267,-93,-233,23,11,H1
"Kennebec County, ME",2011-2012,121727,121586,-141,-0.116,16,-157,23,11,H1
"Kennebec County, ME",2012-2013,121586,121056,-530,-0.436,-58,-472,23,11,H1
"Kennebec County, ME",2013-2014,121056,121112,56,0.046,-79,135,23,11,H1
"Kennebec County, ME",2014-2015,121026,119980,-1046,-0.864,-195,-851,23,11,H1
"Kennebec County, ME",2015-2016,119980,121328,1348,1.124,-174,1522,23,11,H1
"Kennebec County, ME",2016-2017,121328,121821,493,0.406,-83,576,23,11,H1
"Knox County, ME",2000-2001,39666,39884,218,0.55,-66,284,23,13,H1
"Knox County, ME",2001-2002,39884,40258,374,0.938,-88,462,23,13,H1
"Knox County, ME",2002-2003,40258,40393,135,0.335,-32,167,23,13,H1
"Knox County, ME",2003-2004,40393,40514,121,0.3,-37,158,23,13,H1
"Knox County, ME",2004-2005,40514,40571,57,0.141,14,43,23,13,H1
"Knox County, ME",2005-2006,40571,40417,-154,-0.38,-16,-138,23,13,H1
"Knox County, ME",2006-2007,40417,40297,-120,-0.297,-49,-71,23,13,H1
"Knox County, ME",2007-2008,40297,40225,-72,-0.179,-21,-51,23,13,H1
"Knox County, ME",2008-2009,40225,39924,-301,-0.748,-53,-248,23,13,H1
"Knox County, ME",2009-2010,39924,39707,-217,-0.544,-95,-122,23,13,H1
"Knox County, ME",2010-2011,39707,39684,-23,-0.058,-111,88,23,13,H1
"Knox County, ME",2011-2012,39684,39608,-76,-0.192,-38,-38,23,13,H1
"Knox County, ME",2012-2013,39608,39588,-20,-0.05,-53,33,23,13,H1
"Knox County, ME",2013-2014,39588,39676,88,0.222,-72,160,23,13,H1
"Knox County, ME",2014-2015,39798,39855,57,0.143,-47,104,23,13,H1
"Knox County, ME",2015-2016,39855,39655,-200,-0.502,-180,-20,23,13,H1
"Knox County, ME",2016-2017,39655,39790,135,0.34,-114,249,23,13,H1
"Lincoln County, ME",2000-2001,33697,33968,271,0.804,-96,367,23,15,H1
"Lincoln County, ME",2001-2002,33968,34206,238,0.701,-94,332,23,15,H1
"Lincoln County, ME",2002-2003,34206,34495,289,0.845,-61,350,23,15,H1
"Lincoln County, ME",2003-2004,34495,34827,332,0.962,-59,391,23,15,H1
"Lincoln County, ME",2004-2005,34827,34864,37,0.106,-69,106,23,15,H1
"Lincoln County, ME",2005-2006,34864,34904,40,0.115,-70,110,23,15,H1
"Lincoln County, ME",2006-2007,34904,34899,-5,-0.014,-90,85,23,15,H1
"Lincoln County, ME",2007-2008,34899,34768,-131,-0.375,-86,-45,23,15,H1
"Lincoln County, ME",2008-2009,34768,34627,-141,-0.406,-59,-82,23,15,H1
"Lincoln County, ME",2009-2010,34627,34382,-245,-0.708,-93,-152,23,15,H1
"Lincoln County, ME",2010-2011,34382,34269,-113,-0.329,-97,-16,23,15,H1
"Lincoln County, ME",2011-2012,34269,34195,-74,-0.216,-137,63,23,15,H1
"Lincoln County, ME",2012-2013,34195,34170,-25,-0.073,-139,114,23,15,H1
"Lincoln County, ME",2013-2014,34170,34170,0,0,-133,133,23,15,H1
"Lincoln County, ME",2014-2015,34149,33969,-180,-0.527,-151,-29,23,15,H1
"Lincoln County, ME",2015-2016,33969,33993,24,0.071,-104,128,23,15,H1
"Lincoln County, ME",2016-2017,33993,34204,211,0.621,-137,348,23,15,H1
"Oxford County, ME",2000-2001,54787,55157,370,0.675,-56,426,23,17,H1
"Oxford County, ME",2001-2002,55157,55843,686,1.244,-56,742,23,17,H1
"Oxford County, ME",2002-2003,55843,56206,363,0.65,-91,454,23,17,H1
"Oxford County, ME",2003-2004,56206,56763,557,0.991,-47,604,23,17,H1
"Oxford County, ME",2004-2005,56763,57235,472,0.832,-64,536,23,17,H1
"Oxford County, ME",2005-2006,57235,57556,321,0.561,-31,352,23,17,H1
"Oxford County, ME",2006-2007,57556,57966,410,0.712,-15,425,23,17,H1
"Oxford County, ME",2007-2008,57966,58138,172,0.297,-24,196,23,17,H1
"Oxford County, ME",2008-2009,58138,57923,-215,-0.37,-27,-188,23,17,H1
"Oxford County, ME",2009-2010,57923,57785,-138,-0.238,-89,-49,23,17,H1
"Oxford County, ME",2010-2011,57785,57778,-7,-0.012,-100,93,23,17,H1
"Oxford County, ME",2011-2012,57778,57496,-282,-0.488,-110,-172,23,17,H1
"Oxford County, ME",2012-2013,57496,57290,-206,-0.358,-82,-124,23,17,H1
"Oxford County, ME",2013-2014,57290,57238,-52,-0.091,-122,70,23,17,H1
"Oxford County, ME",2014-2015,57301,57202,-99,-0.173,-80,-19,23,17,H1
"Oxford County, ME",2015-2016,57202,57096,-106,-0.185,-142,36,23,17,H1
"Oxford County, ME",2016-2017,57096,57439,343,0.601,-183,526,23,17,H1
"Penobscot County, ME",2000-2001,144937,146110,1173,0.809,204,969,23,19,H1
"Penobscot County, ME",2001-2002,146110,147298,1188,0.813,133,1055,23,19,H1
"Penobscot County, ME",2002-2003,147298,148759,1461,0.992,163,1298,23,19,H1
"Penobscot County, ME",2003-2004,148759,148814,55,0.037,233,-178,23,19,H1
"Penobscot County, ME",2004-2005,148814,149726,912,0.613,176,736,23,19,H1
"Penobscot County, ME",2005-2006,149726,151446,1720,1.149,175,1545,23,19,H1
"Penobscot County, ME",2006-2007,151446,152232,786,0.519,328,458,23,19,H1
"Penobscot County, ME",2007-2008,152232,153372,1140,0.749,256,884,23,19,H1
"Penobscot County, ME",2008-2009,153372,153770,398,0.259,211,187,23,19,H1
"Penobscot County, ME",2009-2010,153770,153831,61,0.04,79,-18,23,19,H1
"Penobscot County, ME",2010-2011,153831,153799,-32,-0.021,11,-43,23,19,H1
"Penobscot County, ME",2011-2012,153799,153612,-187,-0.122,-10,-177,23,19,H1
"Penobscot County, ME",2012-2013,153612,153479,-133,-0.087,-84,-49,23,19,H1
"Penobscot County, ME",2013-2014,153479,153414,-65,-0.042,-42,-23,23,19,H1
"Penobscot County, ME",2014-2015,153535,152692,-843,-0.549,-23,-820,23,19,H1
"Penobscot County, ME",2015-2016,152692,151515,-1177,-0.771,-186,-991,23,19,H1
"Penobscot County, ME",2016-2017,151515,151957,442,0.292,-188,630,23,19,H1
"Piscataquis County, ME",2000-2001,17245,17203,-42,-0.244,-33,-9,23,21,H1
"Piscataquis County, ME",2001-2002,17203,17269,66,0.384,-82,148,23,21,H1
"Piscataquis County, ME",2002-2003,17269,17433,164,0.95,-97,261,23,21,H1
"Piscataquis County, ME",2003-2004,17433,17493,60,0.344,-52,112,23,21,H1
"Piscataquis County, ME",2004-2005,17493,17614,121,0.692,-48,169,23,21,H1
"Piscataquis County, ME",2005-2006,17614,17597,-17,-0.097,-58,41,23,21,H1
"Piscataquis County, ME",2006-2007,17597,17660,63,0.358,-57,120,23,21,H1
"Piscataquis County, ME",2007-2008,17660,17534,-126,-0.713,-41,-85,23,21,H1
"Piscataquis County, ME",2008-2009,17534,17433,-101,-0.576,-60,-41,23,21,H1
"Piscataquis County, ME",2009-2010,17433,17540,107,0.614,-74,181,23,21,H1
"Piscataquis County, ME",2010-2011,17540,17353,-187,-1.066,-94,-93,23,21,H1
"Piscataquis County, ME",2011-2012,17353,17260,-93,-0.536,-91,-2,23,21,H1
"Piscataquis County, ME",2012-2013,17260,17176,-84,-0.487,-44,-40,23,21,H1
"Piscataquis County, ME",2013-2014,17176,17026,-150,-0.873,-62,-88,23,21,H1
"Piscataquis County, ME",2014-2015,17040,16931,-109,-0.64,-74,-35,23,21,H1
"Piscataquis County, ME",2015-2016,16931,16876,-55,-0.325,-93,38,23,21,H1
"Piscataquis County, ME",2016-2017,16876,16773,-103,-0.61,-84,-19,23,21,H1
"Sagadahoc County, ME",2000-2001,35176,35323,147,0.418,112,35,23,23,H1
"Sagadahoc County, ME",2001-2002,35323,35545,222,0.628,87,135,23,23,H1
"Sagadahoc County, ME",2002-2003,35545,35966,421,1.184,107,314,23,23,H1
"Sagadahoc County, ME",2003-2004,35966,36100,134,0.373,161,-27,23,23,H1
"Sagadahoc County, ME",2004-2005,36100,35813,-287,-0.795,24,-311,23,23,H1
"Sagadahoc County, ME",2005-2006,35813,35895,82,0.229,64,18,23,23,H1
"Sagadahoc County, ME",2006-2007,35895,35890,-5,-0.014,94,-99,23,23,H1
"Sagadahoc County, ME",2007-2008,35890,35860,-30,-0.084,55,-85,23,23,H1
"Sagadahoc County, ME",2008-2009,35860,35567,-293,-0.817,42,-335,23,23,H1
"Sagadahoc County, ME",2009-2010,35567,35221,-346,-0.973,46,-392,23,23,H1
"Sagadahoc County, ME",2010-2011,35221,35097,-124,-0.352,-10,-114,23,23,H1
"Sagadahoc County, ME",2011-2012,35097,35114,17,0.048,45,-28,23,23,H1
"Sagadahoc County, ME",2012-2013,35114,35034,-80,-0.228,-35,-45,23,23,H1
"Sagadahoc County, ME",2013-2014,35034,35045,11,0.031,-50,61,23,23,H1
"Sagadahoc County, ME",2014-2015,35063,35149,86,0.245,-45,131,23,23,H1
"Sagadahoc County, ME",2015-2016,35149,35133,-16,-0.046,-69,53,23,23,H1
"Sagadahoc County, ME",2016-2017,35133,35392,259,0.737,-77,336,23,23,H1
"Somerset County, ME",2000-2001,50874,50871,-3,-0.006,40,-43,23,25,H1
"Somerset County, ME",2001-2002,50871,51017,146,0.287,78,68,23,25,H1
"Somerset County, ME",2002-2003,51017,51336,319,0.625,29,290,23,25,H1
"Somerset County, ME",2003-2004,51336,51328,-8,-0.016,25,-33,23,25,H1
"Somerset County, ME",2004-2005,51328,51600,272,0.53,55,217,23,25,H1
"Somerset County, ME",2005-2006,51600,52195,595,1.153,10,585,23,25,H1
"Somerset County, ME",2006-2007,52195,52459,264,0.506,76,188,23,25,H1
"Somerset County, ME",2007-2008,52459,52316,-143,-0.273,-33,-110,23,25,H1
"Somerset County, ME",2008-2009,52316,52104,-212,-0.405,5,-217,23,25,H1
"Somerset County, ME",2009-2010,52104,52227,123,0.236,-46,169,23,25,H1
"Somerset County, ME",2010-2011,52227,51909,-318,-0.609,-77,-241,23,25,H1
"Somerset County, ME",2011-2012,51909,51829,-80,-0.154,-36,-44,23,25,H1
"Somerset County, ME",2012-2013,51829,51680,-149,-0.287,-47,-102,23,25,H1
"Somerset County, ME",2013-2014,51680,51163,-517,-1,-69,-448,23,25,H1
"Somerset County, ME",2014-2015,51260,51113,-147,-0.287,-20,-127,23,25,H1
"Somerset County, ME",2015-2016,51113,50663,-450,-0.88,-80,-370,23,25,H1
"Somerset County, ME",2016-2017,50663,50626,-37,-0.073,-71,34,23,25,H1
"Waldo County, ME",2000-2001,36445,37039,594,1.63,41,553,23,27,H1
"Waldo County, ME",2001-2002,37039,37584,545,1.471,50,495,23,27,H1
"Waldo County, ME",2002-2003,37584,37952,368,0.979,46,322,23,27,H1
"Waldo County, ME",2003-2004,37952,38209,257,0.677,36,221,23,27,H1
"Waldo County, ME",2004-2005,38209,38410,201,0.526,86,115,23,27,H1
"Waldo County, ME",2005-2006,38410,38763,353,0.919,99,254,23,27,H1
"Waldo County, ME",2006-2007,38763,38751,-12,-0.031,25,-37,23,27,H1
"Waldo County, ME",2007-2008,38751,38680,-71,-0.183,37,-108,23,27,H1
"Waldo County, ME",2008-2009,38680,38706,26,0.067,13,13,23,27,H1
"Waldo County, ME",2009-2010,38706,38797,91,0.235,-11,102,23,27,H1
"Waldo County, ME",2010-2011,38797,38806,9,0.023,3,6,23,27,H1
"Waldo County, ME",2011-2012,38806,38889,83,0.214,33,50,23,27,H1
"Waldo County, ME",2012-2013,38889,38975,86,0.221,24,62,23,27,H1
"Waldo County, ME",2013-2014,38975,39051,76,0.195,-12,88,23,27,H1
"Waldo County, ME",2014-2015,39025,39155,130,0.333,-50,180,23,27,H1
"Waldo County, ME",2015-2016,39155,39425,270,0.69,-40,310,23,27,H1
"Waldo County, ME",2016-2017,39425,39832,407,1.032,-60,467,23,27,H1
"Washington County, ME",2000-2001,33876,33499,-377,-1.113,-70,-307,23,29,H1
"Washington County, ME",2001-2002,33499,33345,-154,-0.46,-105,-49,23,29,H1
"Washington County, ME",2002-2003,33345,33403,58,0.174,-65,123,23,29,H1
"Washington County, ME",2003-2004,33403,33474,71,0.213,-114,185,23,29,H1
"Washington County, ME",2004-2005,33474,33319,-155,-0.463,-69,-86,23,29,H1
"Washington County, ME",2005-2006,33319,33323,4,0.012,-69,73,23,29,H1
"Washington County, ME",2006-2007,33323,33424,101,0.303,-11,112,23,29,H1
"Washington County, ME",2007-2008,33424,33289,-135,-0.404,-92,-43,23,29,H1
"Washington County, ME",2008-2009,33289,32925,-364,-1.093,-104,-260,23,29,H1
"Washington County, ME",2009-2010,32925,32810,-115,-0.349,-114,-1,23,29,H1
"Washington County, ME",2010-2011,32810,32694,-116,-0.354,-112,-4,23,29,H1
"Washington County, ME",2011-2012,32694,32485,-209,-0.639,-94,-115,23,29,H1
"Washington County, ME",2012-2013,32485,32186,-299,-0.92,-124,-175,23,29,H1
"Washington County, ME",2013-2014,32186,31808,-378,-1.174,-105,-273,23,29,H1
"Washington County, ME",2014-2015,31863,31625,-238,-0.747,-86,-152,23,29,H1
"Washington County, ME",2015-2016,31625,31566,-59,-0.187,-119,60,23,29,H1
"Washington County, ME",2016-2017,31566,31593,27,0.086,-101,128,23,29,H1
"York County, ME",2000-2001,187894,191261,3367,1.792,509,2858,23,31,H1
"York County, ME",2001-2002,191261,194100,2839,1.484,397,2442,23,31,H1
"York County, ME",2002-2003,194100,195851,1751,0.902,555,1196,23,31,H1
"York County, ME",2003-2004,195851,197408,1557,0.795,568,989,23,31,H1
"York County, ME",2004-2005,197408,198199,791,0.401,402,389,23,31,H1
"York County, ME",2005-2006,198199,197635,-564,-0.285,431,-995,23,31,H1
"York County, ME",2006-2007,197635,197594,-41,-0.021,425,-466,23,31,H1
"York County, ME",2007-2008,197594,197650,56,0.028,467,-411,23,31,H1
"York County, ME",2008-2009,197650,197192,-458,-0.232,339,-797,23,31,H1
"York County, ME",2009-2010,197192,197196,4,0.002,252,-248,23,31,H1
"York County, ME",2010-2011,197196,198247,1051,0.533,30,1021,23,31,H1
"York County, ME",2011-2012,198247,199055,808,0.408,223,585,23,31,H1
"York County, ME",2012-2013,199055,199463,408,0.205,78,330,23,31,H1
"York County, ME",2013-2014,199463,200710,1247,0.625,54,1193,23,31,H1
"York County, ME",2014-2015,200608,201169,561,0.28,2,559,23,31,H1
"York County, ME",2015-2016,201169,202223,1054,0.524,-130,1184,23,31,H1
"York County, ME",2016-2017,202223,204191,1968,0.973,-55,2023,23,31,H1
Maryland,2000-2001,5311034,5374691,63657,1.199,30019,33638,24,0,STATE
Maryland,2001-2002,5374691,5440389,65698,1.222,28998,36700,24,0,STATE
Maryland,2002-2003,5440389,5496269,55880,1.027,29959,25921,24,0,STATE
Maryland,2003-2004,5496269,5546935,50666,0.922,31044,19622,24,0,STATE
Maryland,2004-2005,5546935,5592379,45444,0.819,30893,14551,24,0,STATE
Maryland,2005-2006,5592379,5627367,34988,0.626,33146,1842,24,0,STATE
Maryland,2006-2007,5627367,5653408,26041,0.463,33994,-7953,24,0,STATE
Maryland,2007-2008,5653408,5684965,31557,0.558,34169,-2612,24,0,STATE
Maryland,2008-2009,5684965,5730388,45423,0.799,32765,12658,24,0,STATE
Maryland,2009-2010,5730388,5788409,58021,1.013,29821,28200,24,0,STATE
Maryland,2010-2011,5788409,5844171,55762,0.963,29878,25884,24,0,STATE
Maryland,2011-2012,5844171,5890740,46569,0.797,29259,17310,24,0,STATE
Maryland,2012-2013,5890740,5936040,45300,0.769,26631,18669,24,0,STATE
Maryland,2013-2014,5936040,5975346,39306,0.662,25203,14103,24,0,STATE
Maryland,2014-2015,5975346,6006401,31055,0.52,24856,6199,24,0,STATE
Maryland,2015-2016,6006401,6024752,18351,0.306,24211,-5860,24,0,STATE
Maryland,2016-2017,6024752,6052177,27425,0.455,22494,4931,24,0,STATE
"Allegany County, MD",2000-2001,74804,74525,-279,-0.373,-134,-145,24,1,H1
"Allegany County, MD",2001-2002,74525,74204,-321,-0.431,-248,-73,24,1,H1
"Allegany County, MD",2002-2003,74204,74076,-128,-0.172,-145,17,24,1,H1
"Allegany County, MD",2003-2004,74076,74408,332,0.448,-278,610,24,1,H1
"Allegany County, MD",2004-2005,74408,73979,-429,-0.577,-328,-101,24,1,H1
"Allegany County, MD",2005-2006,73979,73980,1,0.001,-212,213,24,1,H1
"Allegany County, MD",2006-2007,73980,74449,469,0.634,-231,700,24,1,H1
"Allegany County, MD",2007-2008,74449,74638,189,0.254,-118,307,24,1,H1
"Allegany County, MD",2008-2009,74638,75101,463,0.62,-175,638,24,1,H1
"Allegany County, MD",2009-2010,75101,74988,-113,-0.15,-139,26,24,1,H1
"Allegany County, MD",2010-2011,74988,74527,-461,-0.615,-204,-257,24,1,H1
"Allegany County, MD",2011-2012,74527,73883,-644,-0.864,-236,-408,24,1,H1
"Allegany County, MD",2012-2013,73883,73531,-352,-0.476,-204,-148,24,1,H1
"Allegany County, MD",2013-2014,73531,72952,-579,-0.787,-231,-348,24,1,H1
"Allegany County, MD",2014-2015,73008,72528,-480,-0.657,-236,-244,24,1,H1
"Allegany County, MD",2015-2016,72528,72194,-334,-0.461,-185,-149,24,1,H1
"Allegany County, MD",2016-2017,72194,71615,-579,-0.802,-190,-389,24,1,H1
"Anne Arundel County, MD",2000-2001,491670,498559,6889,1.401,3220,3669,24,3,H1
"Anne Arundel County, MD",2001-2002,498559,504884,6325,1.269,3201,3124,24,3,H1
"Anne Arundel County, MD",2002-2003,504884,507769,2885,0.571,3241,-356,24,3,H1
"Anne Arundel County, MD",2003-2004,507769,513259,5490,1.081,3367,2123,24,3,H1
"Anne Arundel County, MD",2004-2005,513259,516171,2912,0.567,3113,-201,24,3,H1
"Anne Arundel County, MD",2005-2006,516171,517698,1527,0.296,3104,-1577,24,3,H1
"Anne Arundel County, MD",2006-2007,517698,520503,2805,0.542,3369,-564,24,3,H1
"Anne Arundel County, MD",2007-2008,520503,525304,4801,0.922,3347,1454,24,3,H1
"Anne Arundel County, MD",2008-2009,525304,532395,7091,1.35,3101,3990,24,3,H1
"Anne Arundel County, MD",2009-2010,532395,539174,6779,1.273,2988,3791,24,3,H1
"Anne Arundel County, MD",2010-2011,539174,544976,5802,1.076,3201,2601,24,3,H1
"Anne Arundel County, MD",2011-2012,544976,550715,5739,1.053,3040,2699,24,3,H1
"Anne Arundel County, MD",2012-2013,550715,556348,5633,1.023,2717,2916,24,3,H1
"Anne Arundel County, MD",2013-2014,556348,560133,3785,0.68,2789,996,24,3,H1
"Anne Arundel County, MD",2014-2015,560286,564195,3909,0.698,2676,1233,24,3,H1
"Anne Arundel County, MD",2015-2016,564195,568916,4721,0.837,2733,1988,24,3,H1
"Anne Arundel County, MD",2016-2017,568916,573235,4319,0.759,2498,1821,24,3,H1
"Baltimore County, MD",2000-2001,755598,762925,7327,0.97,1577,5750,24,5,H1
"Baltimore County, MD",2001-2002,762925,770147,7222,0.947,1231,5991,24,5,H1
"Baltimore County, MD",2002-2003,770147,777756,7609,0.988,1597,6012,24,5,H1
"Baltimore County, MD",2003-2004,777756,784371,6615,0.851,1779,4836,24,5,H1
"Baltimore County, MD",2004-2005,784371,789110,4739,0.604,1757,2982,24,5,H1
"Baltimore County, MD",2005-2006,789110,793733,4623,0.586,2214,2409,24,5,H1
"Baltimore County, MD",2006-2007,793733,796073,2340,0.295,2617,-277,24,5,H1
"Baltimore County, MD",2007-2008,796073,798651,2578,0.324,2646,-68,24,5,H1
"Baltimore County, MD",2008-2009,798651,801808,3157,0.395,2288,869,24,5,H1
"Baltimore County, MD",2009-2010,801808,806233,4425,0.552,2153,2272,24,5,H1
"Baltimore County, MD",2010-2011,806233,813136,6903,0.856,2361,4542,24,5,H1
"Baltimore County, MD",2011-2012,813136,818425,5289,0.65,2153,3136,24,5,H1
"Baltimore County, MD",2012-2013,818425,823883,5458,0.667,1630,3828,24,5,H1
"Baltimore County, MD",2013-2014,823883,826925,3042,0.369,1495,1547,24,5,H1
"Baltimore County, MD",2014-2015,827794,831128,3334,0.403,1457,1877,24,5,H1
"Baltimore County, MD",2015-2016,831128,831431,303,0.036,1457,-1154,24,5,H1
"Baltimore County, MD",2016-2017,831431,832468,1037,0.125,1361,-324,24,5,H1
"Calvert County, MD",2000-2001,75118,77218,2100,2.796,491,1609,24,9,H1
"Calvert County, MD",2001-2002,77218,80153,2935,3.801,491,2444,24,9,H1
"Calvert County, MD",2002-2003,80153,83007,2854,3.561,435,2419,24,9,H1
"Calvert County, MD",2003-2004,83007,84928,1921,2.314,451,1470,24,9,H1
"Calvert County, MD",2004-2005,84928,86294,1366,1.608,450,916,24,9,H1
"Calvert County, MD",2005-2006,86294,87043,749,0.868,416,333,24,9,H1
"Calvert County, MD",2006-2007,87043,87445,402,0.462,349,53,24,9,H1
"Calvert County, MD",2007-2008,87445,87788,343,0.392,367,-24,24,9,H1
"Calvert County, MD",2008-2009,87788,88244,456,0.519,392,64,24,9,H1
"Calvert County, MD",2009-2010,88244,88940,696,0.789,261,435,24,9,H1
"Calvert County, MD",2010-2011,88940,89272,332,0.373,280,52,24,9,H1
"Calvert County, MD",2011-2012,89272,89661,389,0.436,292,97,24,9,H1
"Calvert County, MD",2012-2013,89661,90480,819,0.913,321,498,24,9,H1
"Calvert County, MD",2013-2014,90480,90613,133,0.147,272,-139,24,9,H1
"Calvert County, MD",2014-2015,90562,90595,33,0.036,231,-198,24,9,H1
"Calvert County, MD",2015-2016,90595,91099,504,0.556,275,229,24,9,H1
"Calvert County, MD",2016-2017,91099,91502,403,0.442,219,184,24,9,H1
"Caroline County, MD",2000-2001,29773,29814,41,0.138,59,-18,24,11,H1
"Caroline County, MD",2001-2002,29814,30054,240,0.805,77,163,24,11,H1
"Caroline County, MD",2002-2003,30054,30553,499,1.66,129,370,24,11,H1
"Caroline County, MD",2003-2004,30553,30653,100,0.327,86,14,24,11,H1
"Caroline County, MD",2004-2005,30653,31416,763,2.489,160,603,24,11,H1
"Caroline County, MD",2005-2006,31416,32214,798,2.54,181,617,24,11,H1
"Caroline County, MD",2006-2007,32214,32720,506,1.571,140,366,24,11,H1
"Caroline County, MD",2007-2008,32720,32983,263,0.804,167,96,24,11,H1
"Caroline County, MD",2008-2009,32983,33013,30,0.091,207,-177,24,11,H1
"Caroline County, MD",2009-2010,33013,33068,55,0.167,167,-112,24,11,H1
"Caroline County, MD",2010-2011,33068,32919,-149,-0.451,128,-277,24,11,H1
"Caroline County, MD",2011-2012,32919,32628,-291,-0.884,74,-365,24,11,H1
"Caroline County, MD",2012-2013,32628,32642,14,0.043,61,-47,24,11,H1
"Caroline County, MD",2013-2014,32642,32538,-104,-0.319,54,-158,24,11,H1
"Caroline County, MD",2014-2015,32525,32579,54,0.166,52,2,24,11,H1
"Caroline County, MD",2015-2016,32579,32887,308,0.945,55,253,24,11,H1
"Caroline County, MD",2016-2017,32887,33193,306,0.93,56,250,24,11,H1
"Carroll County, MD",2000-2001,151454,154037,2583,1.705,736,1847,24,13,H1
"Carroll County, MD",2001-2002,154037,157930,3893,2.527,700,3193,24,13,H1
"Carroll County, MD",2002-2003,157930,161389,3459,2.19,682,2777,24,13,H1
"Carroll County, MD",2003-2004,161389,163915,2526,1.565,655,1871,24,13,H1
"Carroll County, MD",2004-2005,163915,165519,1604,0.979,743,861,24,13,H1
"Carroll County, MD",2005-2006,165519,166950,1431,0.865,595,836,24,13,H1
"Carroll County, MD",2006-2007,166950,167390,440,0.264,653,-213,24,13,H1
"Carroll County, MD",2007-2008,167390,167433,43,0.026,572,-529,24,13,H1
"Carroll County, MD",2008-2009,167433,167028,-405,-0.242,555,-960,24,13,H1
"Carroll County, MD",2009-2010,167028,167220,192,0.115,253,-61,24,13,H1
"Carroll County, MD",2010-2011,167220,167260,40,0.024,151,-111,24,13,H1
"Carroll County, MD",2011-2012,167260,167190,-70,-0.042,243,-313,24,13,H1
"Carroll County, MD",2012-2013,167190,167494,304,0.182,108,196,24,13,H1
"Carroll County, MD",2013-2014,167494,167830,336,0.201,152,184,24,13,H1
"Carroll County, MD",2014-2015,167682,167627,-55,-0.033,92,-147,24,13,H1
"Carroll County, MD",2015-2016,167627,167140,-487,-0.291,211,-698,24,13,H1
"Carroll County, MD",2016-2017,167140,167781,641,0.384,170,471,24,13,H1
"Cecil County, MD",2000-2001,86448,88228,1780,2.059,386,1394,24,15,H1
"Cecil County, MD",2001-2002,88228,90061,1833,2.078,435,1398,24,15,H1
"Cecil County, MD",2002-2003,90061,92444,2383,2.646,472,1911,24,15,H1
"Cecil County, MD",2003-2004,92444,94809,2365,2.558,461,1904,24,15,H1
"Cecil County, MD",2004-2005,94809,96836,2027,2.138,499,1528,24,15,H1
"Cecil County, MD",2005-2006,96836,98821,1985,2.05,544,1441,24,15,H1
"Cecil County, MD",2006-2007,98821,99628,807,0.817,585,222,24,15,H1
"Cecil County, MD",2007-2008,99628,100232,604,0.606,447,157,24,15,H1
"Cecil County, MD",2008-2009,100232,100816,584,0.583,493,91,24,15,H1
"Cecil County, MD",2009-2010,100816,101160,344,0.341,363,-19,24,15,H1
"Cecil County, MD",2010-2011,101160,101653,493,0.487,317,176,24,15,H1
"Cecil County, MD",2011-2012,101653,101822,169,0.166,360,-191,24,15,H1
"Cecil County, MD",2012-2013,101822,101999,177,0.174,220,-43,24,15,H1
"Cecil County, MD",2013-2014,101999,102383,384,0.376,229,155,24,15,H1
"Cecil County, MD",2014-2015,102135,102382,247,0.242,138,109,24,15,H1
"Cecil County, MD",2015-2016,102382,102701,319,0.312,247,72,24,15,H1
"Cecil County, MD",2016-2017,102701,102746,45,0.044,190,-145,24,15,H1
"Charles County, MD",2000-2001,121229,124745,3516,2.9,1002,2514,24,17,H1
"Charles County, MD",2001-2002,124745,128079,3334,2.673,795,2539,24,17,H1
"Charles County, MD",2002-2003,128079,131942,3863,3.016,1061,2802,24,17,H1
"Charles County, MD",2003-2004,131942,135601,3659,2.773,989,2670,24,17,H1
"Charles County, MD",2004-2005,135601,138560,2959,2.182,1069,1890,24,17,H1
"Charles County, MD",2005-2006,138560,141164,2604,1.879,1082,1522,24,17,H1
"Charles County, MD",2006-2007,141164,142721,1557,1.103,1071,486,24,17,H1
"Charles County, MD",2007-2008,142721,143783,1062,0.744,1086,-24,24,17,H1
"Charles County, MD",2008-2009,143783,144804,1021,0.71,1020,1,24,17,H1
"Charles County, MD",2009-2010,144804,147118,2314,1.598,812,1502,24,17,H1
"Charles County, MD",2010-2011,147118,149242,2124,1.444,899,1225,24,17,H1
"Charles County, MD",2011-2012,149242,150791,1549,1.038,1025,524,24,17,H1
"Charles County, MD",2012-2013,150791,152900,2109,1.399,846,1263,24,17,H1
"Charles County, MD",2013-2014,152900,154747,1847,1.208,947,900,24,17,H1
"Charles County, MD",2014-2015,154687,156118,1431,0.925,845,586,24,17,H1
"Charles County, MD",2015-2016,156118,157430,1312,0.84,738,574,24,17,H1
"Charles County, MD",2016-2017,157430,159700,2270,1.442,739,1531,24,17,H1
"Dorchester County, MD",2000-2001,30581,30647,66,0.216,-33,99,24,19,H1
"Dorchester County, MD",2001-2002,30647,30526,-121,-0.395,-119,-2,24,19,H1
"Dorchester County, MD",2002-2003,30526,30628,102,0.334,-77,179,24,19,H1
"Dorchester County, MD",2003-2004,30628,31086,458,1.495,33,425,24,19,H1
"Dorchester County, MD",2004-2005,31086,31422,336,1.081,-90,426,24,19,H1
"Dorchester County, MD",2005-2006,31422,31677,255,0.812,4,251,24,19,H1
"Dorchester County, MD",2006-2007,31677,32172,495,1.563,43,452,24,19,H1
"Dorchester County, MD",2007-2008,32172,32466,294,0.914,73,221,24,19,H1
"Dorchester County, MD",2008-2009,32466,32470,4,0.012,37,-33,24,19,H1
"Dorchester County, MD",2009-2010,32470,32681,211,0.65,-10,221,24,19,H1
"Dorchester County, MD",2010-2011,32681,32712,31,0.095,44,-13,24,19,H1
"Dorchester County, MD",2011-2012,32712,32488,-224,-0.685,-17,-207,24,19,H1
"Dorchester County, MD",2012-2013,32488,32612,124,0.382,29,95,24,19,H1
"Dorchester County, MD",2013-2014,32612,32578,-34,-0.104,33,-67,24,19,H1
"Dorchester County, MD",2014-2015,32527,32384,-143,-0.44,-3,-140,24,19,H1
"Dorchester County, MD",2015-2016,32384,32267,-117,-0.361,-25,-92,24,19,H1
"Dorchester County, MD",2016-2017,32267,32162,-105,-0.325,-24,-81,24,19,H1
"Frederick County, MD",2000-2001,196563,202315,5752,2.926,1591,4161,24,21,H1
"Frederick County, MD",2001-2002,202315,209194,6879,3.4,1636,5243,24,21,H1
"Frederick County, MD",2002-2003,209194,213827,4633,2.215,1638,2995,24,21,H1
"Frederick County, MD",2003-2004,213827,217776,3949,1.847,1615,2334,24,21,H1
"Frederick County, MD",2004-2005,217776,221201,3425,1.573,1540,1885,24,21,H1
"Frederick County, MD",2005-2006,221201,224211,3010,1.361,1710,1300,24,21,H1
"Frederick County, MD",2006-2007,224211,227463,3252,1.45,1610,1642,24,21,H1
"Frederick County, MD",2007-2008,227463,229286,1823,0.801,1537,286,24,21,H1
"Frederick County, MD",2008-2009,229286,230942,1656,0.722,1525,131,24,21,H1
"Frederick County, MD",2009-2010,230942,234172,3230,1.399,1293,1937,24,21,H1
"Frederick County, MD",2010-2011,234172,237338,3166,1.352,1344,1822,24,21,H1
"Frederick County, MD",2011-2012,237338,239668,2330,0.982,1147,1183,24,21,H1
"Frederick County, MD",2012-2013,239668,241414,1746,0.729,1049,697,24,21,H1
"Frederick County, MD",2013-2014,241414,243675,2261,0.937,1143,1118,24,21,H1
"Frederick County, MD",2014-2015,243475,245322,1847,0.759,1149,698,24,21,H1
"Frederick County, MD",2015-2016,245322,247881,2559,1.043,1132,1427,24,21,H1
"Frederick County, MD",2016-2017,247881,252022,4141,1.671,1118,3023,24,21,H1
"Garrett County, MD",2000-2001,29838,29812,-26,-0.087,42,-68,24,23,H1
"Garrett County, MD",2001-2002,29812,29987,175,0.587,-12,187,24,23,H1
"Garrett County, MD",2002-2003,29987,30182,195,0.65,8,187,24,23,H1
"Garrett County, MD",2003-2004,30182,30147,-35,-0.116,40,-75,24,23,H1
"Garrett County, MD",2004-2005,30147,30083,-64,-0.212,-5,-59,24,23,H1
"Garrett County, MD",2005-2006,30083,30147,64,0.213,36,28,24,23,H1
"Garrett County, MD",2006-2007,30147,30148,1,0.003,19,-18,24,23,H1
"Garrett County, MD",2007-2008,30148,30222,74,0.245,-34,108,24,23,H1
"Garrett County, MD",2008-2009,30222,30145,-77,-0.255,-21,-56,24,23,H1
"Garrett County, MD",2009-2010,30145,30087,-58,-0.192,-14,-44,24,23,H1
"Garrett County, MD",2010-2011,30087,30107,20,0.066,-31,51,24,23,H1
"Garrett County, MD",2011-2012,30107,29901,-206,-0.684,-5,-201,24,23,H1
"Garrett County, MD",2012-2013,29901,29950,49,0.164,-13,62,24,23,H1
"Garrett County, MD",2013-2014,29950,29679,-271,-0.905,-33,-238,24,23,H1
"Garrett County, MD",2014-2015,29652,29460,-192,-0.648,-20,-172,24,23,H1
"Garrett County, MD",2015-2016,29460,29344,-116,-0.394,-59,-57,24,23,H1
"Garrett County, MD",2016-2017,29344,29233,-111,-0.378,-41,-70,24,23,H1
"Harford County, MD",2000-2001,219797,222753,2956,1.345,1310,1646,24,25,H1
"Harford County, MD",2001-2002,222753,227369,4616,2.072,1348,3268,24,25,H1
"Harford County, MD",2002-2003,227369,231411,4042,1.778,1289,2753,24,25,H1
"Harford County, MD",2003-2004,231411,234849,3438,1.486,1248,2190,24,25,H1
"Harford County, MD",2004-2005,234849,238402,3553,1.513,1191,2362,24,25,H1
"Harford County, MD",2005-2006,238402,241163,2761,1.158,1319,1442,24,25,H1
"Harford County, MD",2006-2007,241163,241634,471,0.195,1269,-798,24,25,H1
"Harford County, MD",2007-2008,241634,242779,1145,0.474,1198,-53,24,25,H1
"Harford County, MD",2008-2009,242779,243685,906,0.373,1207,-301,24,25,H1
"Harford County, MD",2009-2010,243685,245205,1520,0.624,1015,505,24,25,H1
"Harford County, MD",2010-2011,245205,246725,1520,0.62,938,582,24,25,H1
"Harford County, MD",2011-2012,246725,248696,1971,0.799,770,1201,24,25,H1
"Harford County, MD",2012-2013,248696,249415,719,0.289,698,21,24,25,H1
"Harford County, MD",2013-2014,249415,250105,690,0.277,665,25,24,25,H1
"Harford County, MD",2014-2015,249949,250290,341,0.136,677,-336,24,25,H1
"Harford County, MD",2015-2016,250290,250439,149,0.06,587,-438,24,25,H1
"Harford County, MD",2016-2017,250439,252160,1721,0.687,583,1138,24,25,H1
"Howard County, MD",2000-2001,249590,255211,5621,2.252,2282,3339,24,27,H1
"Howard County, MD",2001-2002,255211,259532,4321,1.693,2267,2054,24,27,H1
"Howard County, MD",2002-2003,259532,263186,3654,1.408,2213,1441,24,27,H1
"Howard County, MD",2003-2004,263186,265919,2733,1.038,2315,418,24,27,H1
"Howard County, MD",2004-2005,265919,268590,2671,1.004,2070,601,24,27,H1
"Howard County, MD",2005-2006,268590,271793,3203,1.193,2091,1112,24,27,H1
"Howard County, MD",2006-2007,271793,275196,3403,1.252,1994,1409,24,27,H1
"Howard County, MD",2007-2008,275196,278405,3209,1.166,2155,1054,24,27,H1
"Howard County, MD",2008-2009,278405,283061,4656,1.672,1994,2662,24,27,H1
"Howard County, MD",2009-2010,283061,288605,5544,1.959,1867,3677,24,27,H1
"Howard County, MD",2010-2011,288605,293839,5234,1.814,1900,3334,24,27,H1
"Howard County, MD",2011-2012,293839,299685,5846,1.99,1918,3928,24,27,H1
"Howard County, MD",2012-2013,299685,304934,5249,1.752,1923,3326,24,27,H1
"Howard County, MD",2013-2014,304934,309284,4350,1.427,1893,2457,24,27,H1
"Howard County, MD",2014-2015,308705,313414,4709,1.525,1812,2897,24,27,H1
"Howard County, MD",2015-2016,313414,316966,3552,1.133,1800,1752,24,27,H1
"Howard County, MD",2016-2017,316966,321113,4147,1.308,1773,2374,24,27,H1
"Kent County, MD",2000-2001,19252,19330,78,0.405,-70,148,24,29,H1
"Kent County, MD",2001-2002,19330,19443,113,0.585,-85,198,24,29,H1
"Kent County, MD",2002-2003,19443,19505,62,0.319,-73,135,24,29,H1
"Kent County, MD",2003-2004,19505,19513,8,0.041,-102,110,24,29,H1
"Kent County, MD",2004-2005,19513,19695,182,0.933,-28,210,24,29,H1
"Kent County, MD",2005-2006,19695,19786,91,0.462,-39,130,24,29,H1
"Kent County, MD",2006-2007,19786,19801,15,0.076,-89,104,24,29,H1
"Kent County, MD",2007-2008,19801,20150,349,1.763,-42,391,24,29,H1
"Kent County, MD",2008-2009,20150,20132,-18,-0.089,-10,-8,24,29,H1
"Kent County, MD",2009-2010,20132,20212,80,0.397,-27,107,24,29,H1
"Kent County, MD",2010-2011,20212,20251,39,0.193,-74,113,24,29,H1
"Kent County, MD",2011-2012,20251,19999,-252,-1.244,-46,-206,24,29,H1
"Kent County, MD",2012-2013,19999,19799,-200,-1,-55,-145,24,29,H1
"Kent County, MD",2013-2014,19799,19820,21,0.106,-103,124,24,29,H1
"Kent County, MD",2014-2015,19793,19787,-6,-0.03,-88,82,24,29,H1
"Kent County, MD",2015-2016,19787,19654,-133,-0.672,-99,-34,24,29,H1
"Kent County, MD",2016-2017,19654,19384,-270,-1.374,-140,-130,24,29,H1
"Montgomery County, MD",2000-2001,877478,891764,14286,1.628,7861,6425,24,31,H1
"Montgomery County, MD",2001-2002,891764,903140,11376,1.276,7481,3895,24,31,H1
"Montgomery County, MD",2002-2003,903140,910498,7358,0.815,8092,-734,24,31,H1
"Montgomery County, MD",2003-2004,910498,914991,4493,0.493,7952,-3459,24,31,H1
"Montgomery County, MD",2004-2005,914991,921531,6540,0.715,8057,-1517,24,31,H1
"Montgomery County, MD",2005-2006,921531,926492,4961,0.538,8385,-3424,24,31,H1
"Montgomery County, MD",2006-2007,926492,931694,5202,0.561,8124,-2922,24,31,H1
"Montgomery County, MD",2007-2008,931694,942748,11054,1.186,8529,2525,24,31,H1
"Montgomery County, MD",2008-2009,942748,959013,16265,1.725,8165,8100,24,31,H1
"Montgomery County, MD",2009-2010,959013,975934,16921,1.764,8030,8891,24,31,H1
"Montgomery County, MD",2010-2011,975934,992738,16804,1.722,7521,9283,24,31,H1
"Montgomery County, MD",2011-2012,992738,1006547,13809,1.391,7372,6437,24,31,H1
"Montgomery County, MD",2012-2013,1006547,1019767,13220,1.313,7184,6036,24,31,H1
"Montgomery County, MD",2013-2014,1019767,1030447,10680,1.047,7294,3386,24,31,H1
"Montgomery County, MD",2014-2015,1030476,1040116,9640,0.935,7156,2484,24,31,H1
"Montgomery County, MD",2015-2016,1040116,1048332,8216,0.79,7086,1130,24,31,H1
"Montgomery County, MD",2016-2017,1048332,1058810,10478,0.999,6738,3740,24,31,H1
"Prince George's County, MD",2000-2001,803111,817360,14249,1.774,7393,6856,24,33,H1
"Prince George's County, MD",2001-2002,817360,828893,11533,1.411,7117,4416,24,33,H1
"Prince George's County, MD",2002-2003,828893,837648,8755,1.056,7048,1707,24,33,H1
"Prince George's County, MD",2003-2004,837648,845950,8302,0.991,7264,1038,24,33,H1
"Prince George's County, MD",2004-2005,845950,853271,7321,0.865,7197,124,24,33,H1
"Prince George's County, MD",2005-2006,853271,852097,-1174,-0.138,7411,-8585,24,33,H1
"Prince George's County, MD",2006-2007,852097,849916,-2181,-0.256,7839,-10020,24,33,H1
"Prince George's County, MD",2007-2008,849916,850167,251,0.03,7300,-7049,24,33,H1
"Prince George's County, MD",2008-2009,850167,856161,5994,0.705,6996,-1002,24,33,H1
"Prince George's County, MD",2009-2010,856161,865905,9744,1.138,6374,3370,24,33,H1
"Prince George's County, MD",2010-2011,865905,875524,9619,1.111,6973,2646,24,33,H1
"Prince George's County, MD",2011-2012,875524,883764,8240,0.941,7034,1206,24,33,H1
"Prince George's County, MD",2012-2013,883764,894199,10435,1.181,6515,3920,24,33,H1
"Prince George's County, MD",2013-2014,894199,904430,10231,1.144,5978,4253,24,33,H1
"Prince George's County, MD",2014-2015,903357,909535,6178,0.684,5924,254,24,33,H1
"Prince George's County, MD",2015-2016,909535,911154,1619,0.178,5657,-4038,24,33,H1
"Prince George's County, MD",2016-2017,911154,912756,1602,0.176,5182,-3580,24,33,H1
"Queen Anne's County, MD",2000-2001,40763,41253,490,1.202,128,362,24,35,H1
"Queen Anne's County, MD",2001-2002,41253,42524,1271,3.081,174,1097,24,35,H1
"Queen Anne's County, MD",2002-2003,42524,43688,1164,2.737,134,1030,24,35,H1
"Queen Anne's County, MD",2003-2004,43688,44411,723,1.655,162,561,24,35,H1
"Queen Anne's County, MD",2004-2005,44411,44879,468,1.054,156,312,24,35,H1
"Queen Anne's County, MD",2005-2006,44879,45716,837,1.865,156,681,24,35,H1
"Queen Anne's County, MD",2006-2007,45716,46517,801,1.752,167,634,24,35,H1
"Queen Anne's County, MD",2007-2008,46517,47063,546,1.174,141,405,24,35,H1
"Queen Anne's County, MD",2008-2009,47063,47532,469,0.997,172,297,24,35,H1
"Queen Anne's County, MD",2009-2010,47532,47871,339,0.713,104,235,24,35,H1
"Queen Anne's County, MD",2010-2011,47871,48380,509,1.063,140,369,24,35,H1
"Queen Anne's County, MD",2011-2012,48380,48570,190,0.393,26,164,24,35,H1
"Queen Anne's County, MD",2012-2013,48570,48572,2,0.004,55,-53,24,35,H1
"Queen Anne's County, MD",2013-2014,48572,48804,232,0.478,79,153,24,35,H1
"Queen Anne's County, MD",2014-2015,48726,48904,178,0.365,52,126,24,35,H1
"Queen Anne's County, MD",2015-2016,48904,49178,274,0.56,84,190,24,35,H1
"Queen Anne's County, MD",2016-2017,49178,49770,592,1.204,79,513,24,35,H1
"St. Mary's County, MD",2000-2001,86498,87455,957,1.106,635,322,24,37,H1
"St. Mary's County, MD",2001-2002,87455,89819,2364,2.703,763,1601,24,37,H1
"St. Mary's County, MD",2002-2003,89819,92333,2514,2.799,717,1797,24,37,H1
"St. Mary's County, MD",2003-2004,92333,94900,2567,2.78,802,1765,24,37,H1
"St. Mary's County, MD",2004-2005,94900,96871,1971,2.077,787,1184,24,37,H1
"St. Mary's County, MD",2005-2006,96871,98849,1978,2.042,736,1242,24,37,H1
"St. Mary's County, MD",2006-2007,98849,100599,1750,1.77,859,891,24,37,H1
"St. Mary's County, MD",2007-2008,100599,101921,1322,1.314,824,498,24,37,H1
"St. Mary's County, MD",2008-2009,101921,103273,1352,1.327,862,490,24,37,H1
"St. Mary's County, MD",2009-2010,103273,105740,2467,2.389,766,1701,24,37,H1
"St. Mary's County, MD",2010-2011,105740,107757,2017,1.908,839,1178,24,37,H1
"St. Mary's County, MD",2011-2012,107757,108999,1242,1.153,693,549,24,37,H1
"St. Mary's County, MD",2012-2013,108999,109484,485,0.445,594,-109,24,37,H1
"St. Mary's County, MD",2013-2014,109484,110382,898,0.82,615,283,24,37,H1
"St. Mary's County, MD",2014-2015,110350,111413,1063,0.963,638,425,24,37,H1
"St. Mary's County, MD",2015-2016,111413,111835,422,0.379,573,-151,24,37,H1
"St. Mary's County, MD",2016-2017,111835,112667,832,0.744,598,234,24,37,H1
"Somerset County, MD",2000-2001,24710,25157,447,1.809,2,445,24,39,H1
"Somerset County, MD",2001-2002,25157,25445,288,1.145,-21,309,24,39,H1
"Somerset County, MD",2002-2003,25445,25541,96,0.377,-8,104,24,39,H1
"Somerset County, MD",2003-2004,25541,25807,266,1.041,4,262,24,39,H1
"Somerset County, MD",2004-2005,25807,25793,-14,-0.054,6,-20,24,39,H1
"Somerset County, MD",2005-2006,25793,26139,346,1.341,41,305,24,39,H1
"Somerset County, MD",2006-2007,26139,26534,395,1.511,-28,423,24,39,H1
"Somerset County, MD",2007-2008,26534,26474,-60,-0.226,42,-102,24,39,H1
"Somerset County, MD",2008-2009,26474,26425,-49,-0.185,29,-78,24,39,H1
"Somerset County, MD",2009-2010,26425,26483,58,0.219,-15,73,24,39,H1
"Somerset County, MD",2010-2011,26483,26352,-131,-0.495,-42,-89,24,39,H1
"Somerset County, MD",2011-2012,26352,26153,-199,-0.755,41,-240,24,39,H1
"Somerset County, MD",2012-2013,26153,26139,-14,-0.054,27,-41,24,39,H1
"Somerset County, MD",2013-2014,26139,25859,-280,-1.071,6,-286,24,39,H1
"Somerset County, MD",2014-2015,25632,25768,136,0.531,-11,147,24,39,H1
"Somerset County, MD",2015-2016,25768,25833,65,0.252,-24,89,24,39,H1
"Somerset County, MD",2016-2017,25833,25918,85,0.329,-25,110,24,39,H1
"Talbot County, MD",2000-2001,33895,34231,336,0.991,-70,406,24,41,H1
"Talbot County, MD",2001-2002,34231,34628,397,1.16,-43,440,24,41,H1
"Talbot County, MD",2002-2003,34628,34994,366,1.057,-81,447,24,41,H1
"Talbot County, MD",2003-2004,34994,35793,799,2.283,6,793,24,41,H1
"Talbot County, MD",2004-2005,35793,36423,630,1.76,-80,710,24,41,H1
"Talbot County, MD",2005-2006,36423,3.70E+04,577,1.584,-66,643,24,41,H1
"Talbot County, MD",2006-2007,3.70E+04,37167,167,0.451,-102,269,24,41,H1
"Talbot County, MD",2007-2008,37167,37307,140,0.377,-62,202,24,41,H1
"Talbot County, MD",2008-2009,37307,37496,189,0.507,-41,230,24,41,H1
"Talbot County, MD",2009-2010,37496,37864,368,0.981,-55,423,24,41,H1
"Talbot County, MD",2010-2011,37864,37954,90,0.238,-67,157,24,41,H1
"Talbot County, MD",2011-2012,37954,38062,108,0.285,-97,205,24,41,H1
"Talbot County, MD",2012-2013,38062,37949,-113,-0.297,-110,-3,24,41,H1
"Talbot County, MD",2013-2014,37949,37643,-306,-0.806,-113,-193,24,41,H1
"Talbot County, MD",2014-2015,37560,37512,-48,-0.128,-120,72,24,41,H1
"Talbot County, MD",2015-2016,37512,37204,-308,-0.821,-152,-156,24,41,H1
"Talbot County, MD",2016-2017,37204,37103,-101,-0.271,-155,54,24,41,H1
"Washington County, MD",2000-2001,132051,133093,1042,0.789,332,710,24,43,H1
"Washington County, MD",2001-2002,133093,134831,1738,1.306,321,1417,24,43,H1
"Washington County, MD",2002-2003,134831,136872,2041,1.514,313,1728,24,43,H1
"Washington County, MD",2003-2004,136872,139423,2551,1.864,376,2175,24,43,H1
"Washington County, MD",2004-2005,139423,142084,2661,1.909,354,2307,24,43,H1
"Washington County, MD",2005-2006,142084,144286,2202,1.55,624,1578,24,43,H1
"Washington County, MD",2006-2007,144286,146173,1887,1.308,609,1278,24,43,H1
"Washington County, MD",2007-2008,146173,146674,501,0.343,530,-29,24,43,H1
"Washington County, MD",2008-2009,146674,146953,279,0.19,500,-221,24,43,H1
"Washington County, MD",2009-2010,146953,147749,796,0.542,348,448,24,43,H1
"Washington County, MD",2010-2011,147749,148814,1065,0.721,332,733,24,43,H1
"Washington County, MD",2011-2012,148814,149162,348,0.234,325,23,24,43,H1
"Washington County, MD",2012-2013,149162,149266,104,0.07,197,-93,24,43,H1
"Washington County, MD",2013-2014,149266,149573,307,0.206,262,45,24,43,H1
"Washington County, MD",2014-2015,149423,149585,162,0.108,245,-83,24,43,H1
"Washington County, MD",2015-2016,149585,149810,225,0.15,208,17,24,43,H1
"Washington County, MD",2016-2017,149810,150578,768,0.513,177,591,24,43,H1
"Wicomico County, MD",2000-2001,84899,85637,738,0.869,343,395,24,45,H1
"Wicomico County, MD",2001-2002,85637,86679,1042,1.217,337,705,24,45,H1
"Wicomico County, MD",2002-2003,86679,88463,1784,2.058,340,1444,24,45,H1
"Wicomico County, MD",2003-2004,88463,90210,1747,1.975,297,1450,24,45,H1
"Wicomico County, MD",2004-2005,90210,92508,2298,2.547,395,1903,24,45,H1
"Wicomico County, MD",2005-2006,92508,94621,2113,2.284,376,1737,24,45,H1
"Wicomico County, MD",2006-2007,94621,96110,1489,1.574,505,984,24,45,H1
"Wicomico County, MD",2007-2008,96110,97111,1001,1.042,383,618,24,45,H1
"Wicomico County, MD",2008-2009,97111,98069,958,0.986,466,492,24,45,H1
"Wicomico County, MD",2009-2010,98069,98899,830,0.846,415,415,24,45,H1
"Wicomico County, MD",2010-2011,98899,100010,1111,1.123,412,699,24,45,H1
"Wicomico County, MD",2011-2012,100010,100472,462,0.462,340,122,24,45,H1
"Wicomico County, MD",2012-2013,100472,100961,489,0.487,287,202,24,45,H1
"Wicomico County, MD",2013-2014,100961,101539,578,0.572,209,369,24,45,H1
"Wicomico County, MD",2014-2015,101768,102370,602,0.592,197,405,24,45,H1
"Wicomico County, MD",2015-2016,102370,102585,215,0.21,253,-38,24,45,H1
"Wicomico County, MD",2016-2017,102585,102923,338,0.329,197,141,24,45,H1
"Worcester County, MD",2000-2001,46828,47889,1061,2.266,-37,1098,24,47,H1
"Worcester County, MD",2001-2002,47889,48752,863,1.802,-97,960,24,47,H1
"Worcester County, MD",2002-2003,48752,49524,772,1.584,-48,820,24,47,H1
"Worcester County, MD",2003-2004,49524,49994,470,0.949,-136,606,24,47,H1
"Worcester County, MD",2004-2005,49994,50181,187,0.374,-28,215,24,47,H1
"Worcester County, MD",2005-2006,50181,50678,497,0.99,-90,587,24,47,H1
"Worcester County, MD",2006-2007,50678,51049,371,0.732,-100,471,24,47,H1
"Worcester County, MD",2007-2008,51049,51196,147,0.288,-66,213,24,47,H1
"Worcester County, MD",2008-2009,51196,51313,117,0.229,-100,217,24,47,H1
"Worcester County, MD",2009-2010,51313,51476,163,0.318,-93,256,24,47,H1
"Worcester County, MD",2010-2011,51476,51458,-18,-0.035,-163,145,24,47,H1
"Worcester County, MD",2011-2012,51458,51588,130,0.253,-128,258,24,47,H1
"Worcester County, MD",2012-2013,51588,51595,7,0.014,-164,171,24,47,H1
"Worcester County, MD",2013-2014,51595,51675,80,0.155,-180,260,24,47,H1
"Worcester County, MD",2014-2015,51563,51540,-23,-0.045,-197,174,24,47,H1
"Worcester County, MD",2015-2016,51540,51514,-26,-0.05,-186,160,24,47,H1
"Worcester County, MD",2016-2017,51514,51690,176,0.342,-238,414,24,47,H1
"Baltimore city, MD",2000-2001,649086,640733,-8353,-1.287,973,-9326,24,510,C7
"Baltimore city, MD",2001-2002,640733,634115,-6618,-1.033,1249,-7867,24,510,C7
"Baltimore city, MD",2002-2003,634115,629033,-5082,-0.801,982,-6064,24,510,C7
"Baltimore city, MD",2003-2004,629033,624222,-4811,-0.765,1658,-6469,24,510,C7
"Baltimore city, MD",2004-2005,624222,621560,-2662,-0.426,1908,-4570,24,510,C7
"Baltimore city, MD",2005-2006,621560,621109,-451,-0.073,2528,-2979,24,510,C7
"Baltimore city, MD",2006-2007,621109,620306,-803,-0.129,2722,-3525,24,510,C7
"Baltimore city, MD",2007-2008,620306,620184,-122,-0.02,3147,-3269,24,510,C7
"Baltimore city, MD",2008-2009,620184,620509,325,0.052,3103,-2778,24,510,C7
"Baltimore city, MD",2009-2010,620509,621317,808,0.13,2965,-2157,24,510,C7
"Baltimore city, MD",2010-2011,621317,620889,-428,-0.069,2684,-3112,24,510,C7
"Baltimore city, MD",2011-2012,620889,622950,2061,0.332,2936,-875,24,510,C7
"Baltimore city, MD",2012-2013,622950,623404,454,0.073,2458,-2004,24,510,C7
"Baltimore city, MD",2013-2014,623404,622793,-611,-0.098,2219,-2830,24,510,C7
"Baltimore city, MD",2014-2015,623711,621849,-1862,-0.299,2190,-4052,24,510,C7
"Baltimore city, MD",2015-2016,621849,616958,-4891,-0.787,1845,-6736,24,510,C7
"Baltimore city, MD",2016-2017,616958,611648,-5310,-0.861,1629,-6939,24,510,C7
Massachusetts,2000-2001,6361104,6397634,36530,0.574,24383,12147,25,0,STATE
Massachusetts,2001-2002,6397634,6417206,19572,0.306,24039,-4467,25,0,STATE
Massachusetts,2002-2003,6417206,6422565,5359,0.084,24094,-18735,25,0,STATE
Massachusetts,2003-2004,6422565,6412281,-10284,-0.16,23542,-33826,25,0,STATE
Massachusetts,2004-2005,6412281,6403290,-8991,-0.14,22778,-31769,25,0,STATE
Massachusetts,2005-2006,6403290,6410084,6794,0.106,23588,-16794,25,0,STATE
Massachusetts,2006-2007,6410084,6431559,21475,0.335,24567,-3092,25,0,STATE
Massachusetts,2007-2008,6431559,6468967,37408,0.582,23537,13871,25,0,STATE
Massachusetts,2008-2009,6468967,6517613,48646,0.752,22487,26159,25,0,STATE
Massachusetts,2009-2010,6517613,6565036,47423,0.728,18424,28999,25,0,STATE
Massachusetts,2010-2011,6565036,6611797,46761,0.712,19169,27592,25,0,STATE
Massachusetts,2011-2012,6611797,6657780,45983,0.695,19790,26193,25,0,STATE
Massachusetts,2012-2013,6657780,6708810,51030,0.766,17376,33654,25,0,STATE
Massachusetts,2013-2014,6708810,6755124,46314,0.69,17338,28976,25,0,STATE
Massachusetts,2014-2015,6755124,6794422,39298,0.582,17813,21485,25,0,STATE
Massachusetts,2015-2016,6794422,6823721,29299,0.431,14326,14973,25,0,STATE
Massachusetts,2016-2017,6823721,6859819,36098,0.529,14049,22049,25,0,STATE
"Barnstable County, MA",2000-2001,223031,224087,1056,0.473,-721,1777,25,1,H1
"Barnstable County, MA",2001-2002,224087,225421,1334,0.595,-761,2095,25,1,H1
"Barnstable County, MA",2002-2003,225421,226011,590,0.262,-786,1376,25,1,H1
"Barnstable County, MA",2003-2004,226011,224264,-1747,-0.773,-927,-820,25,1,H1
"Barnstable County, MA",2004-2005,224264,221995,-2269,-1.012,-731,-1538,25,1,H1
"Barnstable County, MA",2005-2006,221995,220037,-1958,-0.882,-765,-1193,25,1,H1
"Barnstable County, MA",2006-2007,220037,218380,-1657,-0.753,-738,-919,25,1,H1
"Barnstable County, MA",2007-2008,218380,217066,-1314,-0.602,-803,-511,25,1,H1
"Barnstable County, MA",2008-2009,217066,215994,-1072,-0.494,-882,-190,25,1,H1
"Barnstable County, MA",2009-2010,215994,215903,-91,-0.042,-1099,1008,25,1,H1
"Barnstable County, MA",2010-2011,215903,215335,-568,-0.263,-1221,653,25,1,H1
"Barnstable County, MA",2011-2012,215335,214845,-490,-0.228,-1089,599,25,1,H1
"Barnstable County, MA",2012-2013,214845,214836,-9,-0.004,-1257,1248,25,1,H1
"Barnstable County, MA",2013-2014,214836,214914,78,0.036,-1245,1323,25,1,H1
"Barnstable County, MA",2014-2015,214665,214333,-332,-0.155,-1275,943,25,1,H1
"Barnstable County, MA",2015-2016,214333,213440,-893,-0.417,-1286,393,25,1,H1
"Barnstable County, MA",2016-2017,213440,213444,4,0.002,-1313,1317,25,1,H1
"Berkshire County, MA",2000-2001,134769,133928,-841,-0.624,-420,-421,25,3,H4
"Berkshire County, MA",2001-2002,133928,133529,-399,-0.298,-330,-69,25,3,H4
"Berkshire County, MA",2002-2003,133529,133423,-106,-0.079,-319,213,25,3,H4
"Berkshire County, MA",2003-2004,133423,133076,-347,-0.26,-249,-98,25,3,H4
"Berkshire County, MA",2004-2005,133076,132563,-513,-0.385,-321,-192,25,3,H4
"Berkshire County, MA",2005-2006,132563,131977,-586,-0.442,-207,-379,25,3,H4
"Berkshire County, MA",2006-2007,131977,131883,-94,-0.071,-211,117,25,3,H4
"Berkshire County, MA",2007-2008,131883,131372,-511,-0.387,-248,-263,25,3,H4
"Berkshire County, MA",2008-2009,131372,131264,-108,-0.082,-193,85,25,3,H4
"Berkshire County, MA",2009-2010,131264,131310,46,0.035,-348,394,25,3,H4
"Berkshire County, MA",2010-2011,131310,130575,-735,-0.56,-244,-491,25,3,H4
"Berkshire County, MA",2011-2012,130575,130230,-345,-0.264,-221,-124,25,3,H4
"Berkshire County, MA",2012-2013,130230,129489,-741,-0.569,-388,-353,25,3,H4
"Berkshire County, MA",2013-2014,129489,128715,-774,-0.598,-318,-456,25,3,H4
"Berkshire County, MA",2014-2015,128565,127828,-737,-0.573,-287,-450,25,3,H4
"Berkshire County, MA",2015-2016,127828,126858,-970,-0.759,-466,-504,25,3,H4
"Berkshire County, MA",2016-2017,126858,126313,-545,-0.43,-375,-170,25,3,H4
"Bristol County, MA",2000-2001,535817,538282,2465,0.46,1388,1077,25,5,H1
"Bristol County, MA",2001-2002,538282,542721,4439,0.825,1479,2960,25,5,H1
"Bristol County, MA",2002-2003,542721,546281,3560,0.656,1489,2071,25,5,H1
"Bristol County, MA",2003-2004,546281,545988,-293,-0.054,1387,-1680,25,5,H1
"Bristol County, MA",2004-2005,545988,545437,-551,-0.101,1730,-2281,25,5,H1
"Bristol County, MA",2005-2006,545437,544487,-950,-0.174,1691,-2641,25,5,H1
"Bristol County, MA",2006-2007,544487,545288,801,0.147,1563,-762,25,5,H1
"Bristol County, MA",2007-2008,545288,546456,1168,0.214,1515,-347,25,5,H1
"Bristol County, MA",2008-2009,546456,547324,868,0.159,1518,-650,25,5,H1
"Bristol County, MA",2009-2010,547324,549076,1752,0.32,953,799,25,5,H1
"Bristol County, MA",2010-2011,549076,549125,49,0.009,721,-672,25,5,H1
"Bristol County, MA",2011-2012,549125,550765,1640,0.299,884,756,25,5,H1
"Bristol County, MA",2012-2013,550765,552167,1402,0.255,610,792,25,5,H1
"Bristol County, MA",2013-2014,552167,554194,2027,0.367,568,1459,25,5,H1
"Bristol County, MA",2014-2015,554626,556772,2146,0.387,637,1509,25,5,H1
"Bristol County, MA",2015-2016,556772,558312,1540,0.277,396,1144,25,5,H1
"Bristol County, MA",2016-2017,558312,561483,3171,0.568,356,2815,25,5,H1
"Dukes County, MA",2000-2001,15090,15261,171,1.133,11,160,25,7,H1
"Dukes County, MA",2001-2002,15261,15482,221,1.448,42,179,25,7,H1
"Dukes County, MA",2002-2003,15482,15630,148,0.956,23,125,25,7,H1
"Dukes County, MA",2003-2004,15630,15704,74,0.473,14,60,25,7,H1
"Dukes County, MA",2004-2005,15704,15743,39,0.248,38,1,25,7,H1
"Dukes County, MA",2005-2006,15743,15768,25,0.159,34,-9,25,7,H1
"Dukes County, MA",2006-2007,15768,15919,151,0.958,74,77,25,7,H1
"Dukes County, MA",2007-2008,15919,16132,213,1.338,45,168,25,7,H1
"Dukes County, MA",2008-2009,16132,16373,241,1.494,11,230,25,7,H1
"Dukes County, MA",2009-2010,16373,16553,180,1.099,2,178,25,7,H1
"Dukes County, MA",2010-2011,16553,16679,126,0.761,26,100,25,7,H1
"Dukes County, MA",2011-2012,16679,16796,117,0.701,15,102,25,7,H1
"Dukes County, MA",2012-2013,16796,17190,394,2.346,32,362,25,7,H1
"Dukes County, MA",2013-2014,17190,17356,166,0.966,30,136,25,7,H1
"Dukes County, MA",2014-2015,17320,17299,-21,-0.121,39,-60,25,7,H1
"Dukes County, MA",2015-2016,17299,17312,13,0.075,-2,15,25,7,H1
"Dukes County, MA",2016-2017,17312,17325,13,0.075,24,-11,25,7,H1
"Essex County, MA",2000-2001,725025,730206,5181,0.715,2987,2194,25,9,H4
"Essex County, MA",2001-2002,730206,732232,2026,0.277,2991,-965,25,9,H4
"Essex County, MA",2002-2003,732232,731544,-688,-0.094,3048,-3736,25,9,H4
"Essex County, MA",2003-2004,731544,729783,-1761,-0.241,2889,-4650,25,9,H4
"Essex County, MA",2004-2005,729783,728877,-906,-0.124,2839,-3745,25,9,H4
"Essex County, MA",2005-2006,728877,729455,578,0.079,2820,-2242,25,9,H4
"Essex County, MA",2006-2007,729455,730664,1209,0.166,2858,-1649,25,9,H4
"Essex County, MA",2007-2008,730664,734361,3697,0.506,2719,978,25,9,H4
"Essex County, MA",2008-2009,734361,739086,4725,0.643,2727,1998,25,9,H4
"Essex County, MA",2009-2010,739086,745478,6392,0.865,2203,4189,25,9,H4
"Essex County, MA",2010-2011,745478,751550,6072,0.815,2204,3868,25,9,H4
"Essex County, MA",2011-2012,751550,756763,5213,0.694,2207,3006,25,9,H4
"Essex County, MA",2012-2013,756763,764093,7330,0.969,2168,5162,25,9,H4
"Essex County, MA",2013-2014,764093,769091,4998,0.654,2160,2838,25,9,H4
"Essex County, MA",2014-2015,770486,776043,5557,0.721,2159,3398,25,9,H4
"Essex County, MA",2015-2016,776043,780633,4590,0.591,1655,2935,25,9,H4
"Essex County, MA",2016-2017,780633,785205,4572,0.586,1670,2902,25,9,H4
"Franklin County, MA",2000-2001,71471,71557,86,0.12,51,35,25,11,H4
"Franklin County, MA",2001-2002,71557,71761,204,0.285,44,160,25,11,H4
"Franklin County, MA",2002-2003,71761,71837,76,0.106,66,10,25,11,H4
"Franklin County, MA",2003-2004,71837,71875,38,0.053,31,7,25,11,H4
"Franklin County, MA",2004-2005,71875,71879,4,0.006,24,-20,25,11,H4
"Franklin County, MA",2005-2006,71879,71708,-171,-0.238,5,-176,25,11,H4
"Franklin County, MA",2006-2007,71708,71577,-131,-0.183,79,-210,25,11,H4
"Franklin County, MA",2007-2008,71577,71571,-6,-0.008,37,-43,25,11,H4
"Franklin County, MA",2008-2009,71571,71392,-179,-0.25,60,-239,25,11,H4
"Franklin County, MA",2009-2010,71392,71317,-75,-0.105,-26,-49,25,11,H4
"Franklin County, MA",2010-2011,71317,71624,307,0.43,-35,342,25,11,H4
"Franklin County, MA",2011-2012,71624,71544,-80,-0.112,29,-109,25,11,H4
"Franklin County, MA",2012-2013,71544,71155,-389,-0.544,-51,-338,25,11,H4
"Franklin County, MA",2013-2014,71155,70862,-293,-0.412,-38,-255,25,11,H4
"Franklin County, MA",2014-2015,70927,70601,-326,-0.46,-47,-279,25,11,H4
"Franklin County, MA",2015-2016,70601,70618,17,0.024,-85,102,25,11,H4
"Franklin County, MA",2016-2017,70618,70702,84,0.119,-93,177,25,11,H4
"Hampden County, MA",2000-2001,456533,456557,24,0.005,1088,-1064,25,13,H4
"Hampden County, MA",2001-2002,456557,458780,2223,0.487,1151,1072,25,13,H4
"Hampden County, MA",2002-2003,458780,460673,1893,0.413,1253,640,25,13,H4
"Hampden County, MA",2003-2004,460673,460841,168,0.036,1074,-906,25,13,H4
"Hampden County, MA",2004-2005,460841,461147,306,0.066,1225,-919,25,13,H4
"Hampden County, MA",2005-2006,461147,461408,261,0.057,1239,-978,25,13,H4
"Hampden County, MA",2006-2007,461408,461434,26,0.006,1405,-1379,25,13,H4
"Hampden County, MA",2007-2008,461434,462053,619,0.134,1492,-873,25,13,H4
"Hampden County, MA",2008-2009,462053,462777,724,0.157,1561,-837,25,13,H4
"Hampden County, MA",2009-2010,462777,464160,1383,0.299,1091,292,25,13,H4
"Hampden County, MA",2010-2011,464160,465963,1803,0.388,1302,501,25,13,H4
"Hampden County, MA",2011-2012,465963,466539,576,0.124,1219,-643,25,13,H4
"Hampden County, MA",2012-2013,466539,467414,875,0.188,1029,-154,25,13,H4
"Hampden County, MA",2013-2014,467414,468161,747,0.16,1150,-403,25,13,H4
"Hampden County, MA",2014-2015,469566,470690,1124,0.239,1141,-17,25,13,H4
"Hampden County, MA",2015-2016,470690,469003,-1687,-0.358,544,-2231,25,13,H4
"Hampden County, MA",2016-2017,469003,469818,815,0.174,659,156,25,13,H4
"Hampshire County, MA",2000-2001,152364,152518,154,0.101,86,68,25,15,H4
"Hampshire County, MA",2001-2002,152518,153461,943,0.618,102,841,25,15,H4
"Hampshire County, MA",2002-2003,153461,154621,1160,0.756,131,1029,25,15,H4
"Hampshire County, MA",2003-2004,154621,155019,398,0.257,47,351,25,15,H4
"Hampshire County, MA",2004-2005,155019,155383,364,0.235,50,314,25,15,H4
"Hampshire County, MA",2005-2006,155383,156168,785,0.505,16,769,25,15,H4
"Hampshire County, MA",2006-2007,156168,156842,674,0.432,74,600,25,15,H4
"Hampshire County, MA",2007-2008,156842,157615,773,0.493,-7,780,25,15,H4
"Hampshire County, MA",2008-2009,157615,157910,295,0.187,64,231,25,15,H4
"Hampshire County, MA",2009-2010,157910,159266,1356,0.859,-118,1474,25,15,H4
"Hampshire County, MA",2010-2011,159266,160112,846,0.531,-78,924,25,15,H4
"Hampshire County, MA",2011-2012,160112,160351,239,0.149,-28,267,25,15,H4
"Hampshire County, MA",2012-2013,160351,160970,619,0.386,-130,749,25,15,H4
"Hampshire County, MA",2013-2014,160970,160939,-31,-0.019,-106,75,25,15,H4
"Hampshire County, MA",2014-2015,161106,161292,186,0.115,-115,301,25,15,H4
"Hampshire County, MA",2015-2016,161292,161658,366,0.227,-192,558,25,15,H4
"Hampshire County, MA",2016-2017,161658,161834,176,0.109,-215,391,25,15,H4
"Middlesex County, MA",2000-2001,1467248,1473021,5773,0.393,7332,-1559,25,17,H4
"Middlesex County, MA",2001-2002,1473021,1468488,-4533,-0.308,7079,-11612,25,17,H4
"Middlesex County, MA",2002-2003,1468488,1464083,-4405,-0.3,7113,-11518,25,17,H4
"Middlesex County, MA",2003-2004,1464083,1459232,-4851,-0.331,6892,-11743,25,17,H4
"Middlesex County, MA",2004-2005,1459232,1454868,-4364,-0.299,6637,-11001,25,17,H4
"Middlesex County, MA",2005-2006,1454868,1456528,1660,0.114,6867,-5207,25,17,H4
"Middlesex County, MA",2006-2007,1456528,1463106,6578,0.452,7058,-480,25,17,H4
"Middlesex County, MA",2007-2008,1463106,1477049,13943,0.953,6887,7056,25,17,H4
"Middlesex County, MA",2008-2009,1477049,1494764,17715,1.199,6032,11683,25,17,H4
"Middlesex County, MA",2009-2010,1494764,1506852,12088,0.809,5985,6103,25,17,H4
"Middlesex County, MA",2010-2011,1506852,1523671,16819,1.116,6586,10233,25,17,H4
"Middlesex County, MA",2011-2012,1523671,1540192,16521,1.084,6681,9840,25,17,H4
"Middlesex County, MA",2012-2013,1540192,1558131,17939,1.165,6932,11007,25,17,H4
"Middlesex County, MA",2013-2014,1558131,1570315,12184,0.782,6723,5461,25,17,H4
"Middlesex County, MA",2014-2015,1572523,1585139,12616,0.802,6507,6109,25,17,H4
"Middlesex County, MA",2015-2016,1585139,1594314,9175,0.579,5610,3565,25,17,H4
"Middlesex County, MA",2016-2017,1594314,1602947,8633,0.541,5491,3142,25,17,H4
"Nantucket County, MA",2000-2001,9503,9415,-88,-0.926,91,-179,25,19,H4
"Nantucket County, MA",2001-2002,9415,9556,141,1.498,69,72,25,19,H4
"Nantucket County, MA",2002-2003,9556,9629,73,0.764,73,0,25,19,H4
"Nantucket County, MA",2003-2004,9629,9732,103,1.07,105,-2,25,19,H4
"Nantucket County, MA",2004-2005,9732,9703,-29,-0.298,74,-103,25,19,H4
"Nantucket County, MA",2005-2006,9703,9811,108,1.113,83,25,25,19,H4
"Nantucket County, MA",2006-2007,9811,9985,174,1.774,110,64,25,19,H4
"Nantucket County, MA",2007-2008,9985,10170,185,1.853,118,67,25,19,H4
"Nantucket County, MA",2008-2009,10170,10225,55,0.541,91,-36,25,19,H4
"Nantucket County, MA",2009-2010,10225,10154,-71,-0.694,77,-148,25,19,H4
"Nantucket County, MA",2010-2011,10154,10148,-6,-0.059,66,-72,25,19,H4
"Nantucket County, MA",2011-2012,10148,10342,194,1.912,65,129,25,19,H4
"Nantucket County, MA",2012-2013,10342,10568,226,2.185,107,119,25,19,H4
"Nantucket County, MA",2013-2014,10568,10856,288,2.725,100,188,25,19,H4
"Nantucket County, MA",2014-2015,10821,10925,104,0.961,81,23,25,19,H4
"Nantucket County, MA",2015-2016,10925,11089,164,1.501,115,49,25,19,H4
"Nantucket County, MA",2016-2017,11089,11229,140,1.263,111,29,25,19,H4
"Norfolk County, MA",2000-2001,650865,653137,2272,0.349,2722,-450,25,21,H1
"Norfolk County, MA",2001-2002,653137,653860,723,0.111,2405,-1682,25,21,H1
"Norfolk County, MA",2002-2003,653860,653032,-828,-0.127,2525,-3353,25,21,H1
"Norfolk County, MA",2003-2004,653032,652630,-402,-0.062,2660,-3062,25,21,H1
"Norfolk County, MA",2004-2005,652630,651538,-1092,-0.167,2156,-3248,25,21,H1
"Norfolk County, MA",2005-2006,651538,653421,1883,0.289,2190,-307,25,21,H1
"Norfolk County, MA",2006-2007,653421,656582,3161,0.484,2320,841,25,21,H1
"Norfolk County, MA",2007-2008,656582,661703,5121,0.78,2108,3013,25,21,H1
"Norfolk County, MA",2008-2009,661703,666301,4598,0.695,2052,2546,25,21,H1
"Norfolk County, MA",2009-2010,666301,672645,6344,0.952,1859,4485,25,21,H1
"Norfolk County, MA",2010-2011,672645,677943,5298,0.788,1626,3672,25,21,H1
"Norfolk County, MA",2011-2012,677943,682749,4806,0.709,1857,2949,25,21,H1
"Norfolk County, MA",2012-2013,682749,688709,5960,0.873,1672,4288,25,21,H1
"Norfolk County, MA",2013-2014,688709,692254,3545,0.515,1647,1898,25,21,H1
"Norfolk County, MA",2014-2015,692688,696023,3335,0.481,1668,1667,25,21,H1
"Norfolk County, MA",2015-2016,696023,696818,795,0.114,1454,-659,25,21,H1
"Norfolk County, MA",2016-2017,696818,700322,3504,0.503,1340,2164,25,21,H1
"Plymouth County, MA",2000-2001,474131,478222,4091,0.863,2304,1787,25,23,H1
"Plymouth County, MA",2001-2002,478222,482092,3870,0.809,2335,1535,25,23,H1
"Plymouth County, MA",2002-2003,482092,484245,2153,0.447,2345,-192,25,23,H1
"Plymouth County, MA",2003-2004,484245,485010,765,0.158,2158,-1393,25,23,H1
"Plymouth County, MA",2004-2005,485010,486292,1282,0.264,2035,-753,25,23,H1
"Plymouth County, MA",2005-2006,486292,486779,487,0.1,1882,-1395,25,23,H1
"Plymouth County, MA",2006-2007,486779,488251,1472,0.302,1950,-478,25,23,H1
"Plymouth County, MA",2007-2008,488251,490371,2120,0.434,1933,187,25,23,H1
"Plymouth County, MA",2008-2009,490371,492738,2367,0.483,1844,523,25,23,H1
"Plymouth County, MA",2009-2010,492738,495856,3118,0.633,1109,2009,25,23,H1
"Plymouth County, MA",2010-2011,495856,498269,2413,0.487,960,1453,25,23,H1
"Plymouth County, MA",2011-2012,498269,499076,807,0.162,936,-129,25,23,H1
"Plymouth County, MA",2012-2013,499076,503636,4560,0.914,1032,3528,25,23,H1
"Plymouth County, MA",2013-2014,503636,507022,3386,0.672,828,2558,25,23,H1
"Plymouth County, MA",2014-2015,507050,510393,3343,0.659,819,2524,25,23,H1
"Plymouth County, MA",2015-2016,510393,511820,1427,0.28,496,931,25,23,H1
"Plymouth County, MA",2016-2017,511820,515142,3322,0.649,523,2799,25,23,H1
"Suffolk County, MA",2000-2001,692745,700232,7487,1.081,4143,3344,25,25,H4
"Suffolk County, MA",2001-2002,700232,701333,1101,0.157,4226,-3125,25,25,H4
"Suffolk County, MA",2002-2003,701333,697080,-4253,-0.606,3897,-8150,25,25,H4
"Suffolk County, MA",2003-2004,697080,691272,-5808,-0.833,4099,-9907,25,25,H4
"Suffolk County, MA",2004-2005,691272,686600,-4672,-0.676,4057,-8729,25,25,H4
"Suffolk County, MA",2005-2006,686600,687192,592,0.086,4521,-3929,25,25,H4
"Suffolk County, MA",2006-2007,687192,693368,6176,0.899,4614,1562,25,25,H4
"Suffolk County, MA",2007-2008,693368,702201,8833,1.274,4678,4155,25,25,H4
"Suffolk County, MA",2008-2009,702201,716214,14013,1.996,4482,9531,25,25,H4
"Suffolk County, MA",2009-2010,716214,725319,9105,1.271,4464,4641,25,25,H4
"Suffolk County, MA",2010-2011,725319,737471,12152,1.675,5056,7096,25,25,H4
"Suffolk County, MA",2011-2012,737471,749504,12033,1.632,5026,7007,25,25,H4
"Suffolk County, MA",2012-2013,749504,760093,10589,1.413,4857,5732,25,25,H4
"Suffolk County, MA",2013-2014,760093,767254,7161,0.942,4764,2397,25,25,H4
"Suffolk County, MA",2014-2015,769809,778121,8312,1.08,4549,3763,25,25,H4
"Suffolk County, MA",2015-2016,778121,791165,13044,1.676,4411,8633,25,25,H4
"Suffolk County, MA",2016-2017,791165,797939,6774,0.856,4232,2542,25,25,H4
"Worcester County, MA",2000-2001,752512,761211,8699,1.156,3321,5378,25,27,H4
"Worcester County, MA",2001-2002,761211,768490,7279,0.956,3207,4072,25,27,H4
"Worcester County, MA",2002-2003,768490,774476,5986,0.779,3236,2750,25,27,H4
"Worcester County, MA",2003-2004,774476,777855,3379,0.436,3362,17,25,27,H4
"Worcester County, MA",2004-2005,777855,781265,3410,0.438,2965,445,25,27,H4
"Worcester County, MA",2005-2006,781265,785345,4080,0.522,3212,868,25,27,H4
"Worcester County, MA",2006-2007,785345,788280,2935,0.374,3411,-476,25,27,H4
"Worcester County, MA",2007-2008,788280,790847,2567,0.326,3063,-496,25,27,H4
"Worcester County, MA",2008-2009,790847,795251,4404,0.557,3120,1284,25,27,H4
"Worcester County, MA",2009-2010,795251,800184,4933,0.62,2272,2661,25,27,H4
"Worcester County, MA",2010-2011,800184,803805,3621,0.453,2201,1420,25,27,H4
"Worcester County, MA",2011-2012,803805,806133,2328,0.29,2221,107,25,27,H4
"Worcester County, MA",2012-2013,806133,810423,4290,0.532,1966,2324,25,27,H4
"Worcester County, MA",2013-2014,810423,813475,3052,0.377,1965,1087,25,27,H4
"Worcester County, MA",2014-2015,814972,818963,3991,0.49,1937,2054,25,27,H4
"Worcester County, MA",2015-2016,818963,820681,1718,0.21,1676,42,25,27,H4
"Worcester County, MA",2016-2017,820681,826116,5435,0.662,1639,3796,25,27,H4
Michigan,2000-2001,9952450,9991120,38670,0.389,47520,-8850,26,0,STATE
Michigan,2001-2002,9991120,10015710,24590,0.246,44136,-19546,26,0,STATE
Michigan,2002-2003,10015710,10041152,25442,0.254,43344,-17902,26,0,STATE
Michigan,2003-2004,10041152,10055315,14163,0.141,44768,-30605,26,0,STATE
Michigan,2004-2005,10055315,10051137,-4178,-0.042,40960,-45138,26,0,STATE
Michigan,2005-2006,10051137,10036081,-15056,-0.15,42061,-57117,26,0,STATE
Michigan,2006-2007,10036081,10001284,-34797,-0.347,39401,-74198,26,0,STATE
Michigan,2007-2008,10001284,9946889,-54395,-0.544,38736,-93131,26,0,STATE
Michigan,2008-2009,9946889,9901591,-45298,-0.455,38734,-84032,26,0,STATE
Michigan,2009-2010,9901591,9877369,-24222,-0.245,32345,-56567,26,0,STATE
Michigan,2010-2011,9877369,9876589,-780,-0.008,24111,-24891,26,0,STATE
Michigan,2011-2012,9876589,9886879,10290,0.104,24030,-13740,26,0,STATE
Michigan,2012-2013,9886879,9900506,13627,0.138,20693,-7066,26,0,STATE
Michigan,2013-2014,9900506,9916306,15800,0.16,22643,-6843,26,0,STATE
Michigan,2014-2015,9916306,9922576,6270,0.063,23699,-17429,26,0,STATE
Michigan,2015-2016,9922576,9933445,10869,0.11,18768,-7899,26,0,STATE
Michigan,2016-2017,9933445,9962311,28866,0.291,18648,10218,26,0,STATE
"Alcona County, MI",2000-2001,11677,11665,-12,-0.103,-84,72,26,1,H1
"Alcona County, MI",2001-2002,11665,11480,-185,-1.586,-106,-79,26,1,H1
"Alcona County, MI",2002-2003,11480,11495,15,0.131,-94,109,26,1,H1
"Alcona County, MI",2003-2004,11495,11459,-36,-0.313,-112,76,26,1,H1
"Alcona County, MI",2004-2005,11459,11517,58,0.506,-97,155,26,1,H1
"Alcona County, MI",2005-2006,11517,11503,-14,-0.122,-79,65,26,1,H1
"Alcona County, MI",2006-2007,11503,11412,-91,-0.791,-109,18,26,1,H1
"Alcona County, MI",2007-2008,11412,11286,-126,-1.104,-99,-27,26,1,H1
"Alcona County, MI",2008-2009,11286,11106,-180,-1.595,-106,-74,26,1,H1
"Alcona County, MI",2009-2010,11106,10885,-221,-1.99,-98,-123,26,1,H1
"Alcona County, MI",2010-2011,10885,10769,-116,-1.066,-115,-1,26,1,H1
"Alcona County, MI",2011-2012,10769,10599,-170,-1.579,-141,-29,26,1,H1
"Alcona County, MI",2012-2013,10599,10577,-22,-0.208,-115,93,26,1,H1
"Alcona County, MI",2013-2014,10577,10454,-123,-1.163,-101,-22,26,1,H1
"Alcona County, MI",2014-2015,10448,10349,-99,-0.948,-102,3,26,1,H1
"Alcona County, MI",2015-2016,10349,10383,34,0.329,-104,138,26,1,H1
"Alcona County, MI",2016-2017,10383,10351,-32,-0.308,-110,78,26,1,H1
"Alger County, MI",2000-2001,9819,9815,-4,-0.041,-8,4,26,3,H1
"Alger County, MI",2001-2002,9815,9764,-51,-0.52,-30,-21,26,3,H1
"Alger County, MI",2002-2003,9764,9694,-70,-0.717,-46,-24,26,3,H1
"Alger County, MI",2003-2004,9694,9680,-14,-0.144,-44,30,26,3,H1
"Alger County, MI",2004-2005,9680,9633,-47,-0.486,-39,-8,26,3,H1
"Alger County, MI",2005-2006,9633,9687,54,0.561,-23,77,26,3,H1
"Alger County, MI",2006-2007,9687,9779,92,0.95,-55,147,26,3,H1
"Alger County, MI",2007-2008,9779,9647,-132,-1.35,-26,-106,26,3,H1
"Alger County, MI",2008-2009,9647,9334,-313,-3.245,-16,-297,26,3,H1
"Alger County, MI",2009-2010,9334,9560,226,2.421,-27,253,26,3,H1
"Alger County, MI",2010-2011,9560,9551,-9,-0.094,-44,35,26,3,H1
"Alger County, MI",2011-2012,9551,9494,-57,-0.597,-63,6,26,3,H1
"Alger County, MI",2012-2013,9494,9515,21,0.221,-44,65,26,3,H1
"Alger County, MI",2013-2014,9515,9459,-56,-0.589,-47,-9,26,3,H1
"Alger County, MI",2014-2015,9452,9383,-69,-0.73,-45,-24,26,3,H1
"Alger County, MI",2015-2016,9383,9115,-268,-2.856,-59,-209,26,3,H1
"Alger County, MI",2016-2017,9115,9121,6,0.066,-60,66,26,3,H1
"Allegan County, MI",2000-2001,105904,107367,1463,1.381,658,805,26,5,H1
"Allegan County, MI",2001-2002,107367,108203,836,0.779,474,362,26,5,H1
"Allegan County, MI",2002-2003,108203,109192,989,0.914,689,300,26,5,H1
"Allegan County, MI",2003-2004,109192,110225,1033,0.946,695,338,26,5,H1
"Allegan County, MI",2004-2005,110225,110865,640,0.581,607,33,26,5,H1
"Allegan County, MI",2005-2006,110865,111156,291,0.262,735,-444,26,5,H1
"Allegan County, MI",2006-2007,111156,111427,271,0.244,652,-381,26,5,H1
"Allegan County, MI",2007-2008,111427,111589,162,0.145,638,-476,26,5,H1
"Allegan County, MI",2008-2009,111589,111252,-337,-0.302,661,-998,26,5,H1
"Allegan County, MI",2009-2010,111252,111507,255,0.229,535,-280,26,5,H1
"Allegan County, MI",2010-2011,111507,111552,45,0.04,452,-407,26,5,H1
"Allegan County, MI",2011-2012,111552,111939,387,0.347,431,-44,26,5,H1
"Allegan County, MI",2012-2013,111939,112485,546,0.488,407,139,26,5,H1
"Allegan County, MI",2013-2014,112485,113847,1362,1.211,447,915,26,5,H1
"Allegan County, MI",2014-2015,113743,114625,882,0.775,484,398,26,5,H1
"Allegan County, MI",2015-2016,114625,114955,330,0.288,447,-117,26,5,H1
"Allegan County, MI",2016-2017,114955,116447,1492,1.298,437,1055,26,5,H1
"Alpena County, MI",2000-2001,31269,31179,-90,-0.288,-25,-65,26,7,H1
"Alpena County, MI",2001-2002,31179,30956,-223,-0.715,-29,-194,26,7,H1
"Alpena County, MI",2002-2003,30956,30824,-132,-0.426,-39,-93,26,7,H1
"Alpena County, MI",2003-2004,30824,30735,-89,-0.289,-53,-36,26,7,H1
"Alpena County, MI",2004-2005,30735,30494,-241,-0.784,-82,-159,26,7,H1
"Alpena County, MI",2005-2006,30494,30209,-285,-0.935,-40,-245,26,7,H1
"Alpena County, MI",2006-2007,30209,30180,-29,-0.096,-48,19,26,7,H1
"Alpena County, MI",2007-2008,30180,30119,-61,-0.202,-53,-8,26,7,H1
"Alpena County, MI",2008-2009,30119,29755,-364,-1.209,-58,-306,26,7,H1
"Alpena County, MI",2009-2010,29755,29546,-209,-0.702,-72,-137,26,7,H1
"Alpena County, MI",2010-2011,29546,29356,-190,-0.643,-81,-109,26,7,H1
"Alpena County, MI",2011-2012,29356,29240,-116,-0.395,-125,9,26,7,H1
"Alpena County, MI",2012-2013,29240,29081,-159,-0.544,-83,-76,26,7,H1
"Alpena County, MI",2013-2014,29081,28988,-93,-0.32,-86,-7,26,7,H1
"Alpena County, MI",2014-2015,28952,28803,-149,-0.515,-69,-80,26,7,H1
"Alpena County, MI",2015-2016,28803,28657,-146,-0.507,-100,-46,26,7,H1
"Alpena County, MI",2016-2017,28657,28462,-195,-0.68,-83,-112,26,7,H1
"Antrim County, MI",2000-2001,23264,23485,221,0.95,-17,238,26,9,H1
"Antrim County, MI",2001-2002,23485,23773,288,1.226,-1,289,26,9,H1
"Antrim County, MI",2002-2003,23773,24129,356,1.497,25,331,26,9,H1
"Antrim County, MI",2003-2004,24129,24263,134,0.555,-20,154,26,9,H1
"Antrim County, MI",2004-2005,24263,24261,-2,-0.008,-7,5,26,9,H1
"Antrim County, MI",2005-2006,24261,24278,17,0.07,19,-2,26,9,H1
"Antrim County, MI",2006-2007,24278,24248,-30,-0.124,22,-52,26,9,H1
"Antrim County, MI",2007-2008,24248,24047,-201,-0.829,-16,-185,26,9,H1
"Antrim County, MI",2008-2009,24047,23796,-251,-1.044,-6,-245,26,9,H1
"Antrim County, MI",2009-2010,23796,23521,-275,-1.156,-27,-248,26,9,H1
"Antrim County, MI",2010-2011,23521,23404,-117,-0.497,-55,-62,26,9,H1
"Antrim County, MI",2011-2012,23404,23361,-43,-0.184,-37,-6,26,9,H1
"Antrim County, MI",2012-2013,23361,23289,-72,-0.308,-70,-2,26,9,H1
"Antrim County, MI",2013-2014,23289,23267,-22,-0.094,-75,53,26,9,H1
"Antrim County, MI",2014-2015,23243,23154,-89,-0.383,-51,-38,26,9,H1
"Antrim County, MI",2015-2016,23154,23066,-88,-0.38,-77,-11,26,9,H1
"Antrim County, MI",2016-2017,23066,23292,226,0.98,-62,288,26,9,H1
"Arenac County, MI",2000-2001,17278,17206,-72,-0.417,-15,-57,26,11,H1
"Arenac County, MI",2001-2002,17206,17245,39,0.227,-6,45,26,11,H1
"Arenac County, MI",2002-2003,17245,17184,-61,-0.354,-23,-38,26,11,H1
"Arenac County, MI",2003-2004,17184,17128,-56,-0.326,-56,0,26,11,H1
"Arenac County, MI",2004-2005,17128,17094,-34,-0.199,-45,11,26,11,H1
"Arenac County, MI",2005-2006,17094,16968,-126,-0.737,9,-135,26,11,H1
"Arenac County, MI",2006-2007,16968,16811,-157,-0.925,-39,-118,26,11,H1
"Arenac County, MI",2007-2008,16811,16547,-264,-1.57,-23,-241,26,11,H1
"Arenac County, MI",2008-2009,16547,16243,-304,-1.837,-22,-282,26,11,H1
"Arenac County, MI",2009-2010,16243,15868,-375,-2.309,-39,-336,26,11,H1
"Arenac County, MI",2010-2011,15868,15634,-234,-1.475,-70,-164,26,11,H1
"Arenac County, MI",2011-2012,15634,15512,-122,-0.78,-77,-45,26,11,H1
"Arenac County, MI",2012-2013,15512,15451,-61,-0.393,-93,32,26,11,H1
"Arenac County, MI",2013-2014,15451,15353,-98,-0.634,-99,1,26,11,H1
"Arenac County, MI",2014-2015,15326,15261,-65,-0.424,-87,22,26,11,H1
"Arenac County, MI",2015-2016,15261,15127,-134,-0.878,-77,-57,26,11,H1
"Arenac County, MI",2016-2017,15127,15045,-82,-0.542,-75,-7,26,11,H1
"Baraga County, MI",2000-2001,8875,8899,24,0.27,-25,49,26,13,H1
"Baraga County, MI",2001-2002,8899,8889,-10,-0.112,-10,0,26,13,H1
"Baraga County, MI",2002-2003,8889,8873,-16,-0.18,-17,1,26,13,H1
"Baraga County, MI",2003-2004,8873,8884,11,0.124,-26,37,26,13,H1
"Baraga County, MI",2004-2005,8884,8851,-33,-0.371,-1,-32,26,13,H1
"Baraga County, MI",2005-2006,8851,8940,89,1.006,-9,98,26,13,H1
"Baraga County, MI",2006-2007,8940,8930,-10,-0.112,8,-18,26,13,H1
"Baraga County, MI",2007-2008,8930,8822,-108,-1.209,-12,-96,26,13,H1
"Baraga County, MI",2008-2009,8822,8874,52,0.589,-7,59,26,13,H1
"Baraga County, MI",2009-2010,8874,8835,-39,-0.439,-13,-26,26,13,H1
"Baraga County, MI",2010-2011,8835,8813,-22,-0.249,-33,11,26,13,H1
"Baraga County, MI",2011-2012,8813,8706,-107,-1.214,-31,-76,26,13,H1
"Baraga County, MI",2012-2013,8706,8688,-18,-0.207,-13,-5,26,13,H1
"Baraga County, MI",2013-2014,8688,8654,-34,-0.391,-22,-12,26,13,H1
"Baraga County, MI",2014-2015,8643,8575,-68,-0.787,-24,-44,26,13,H1
"Baraga County, MI",2015-2016,8575,8536,-39,-0.455,-35,-4,26,13,H1
"Baraga County, MI",2016-2017,8536,8441,-95,-1.113,-37,-58,26,13,H1
"Barry County, MI",2000-2001,56931,57572,641,1.126,228,413,26,15,H1
"Barry County, MI",2001-2002,57572,58061,489,0.849,274,215,26,15,H1
"Barry County, MI",2002-2003,58061,58682,621,1.07,222,399,26,15,H1
"Barry County, MI",2003-2004,58682,59005,323,0.55,228,95,26,15,H1
"Barry County, MI",2004-2005,59005,59621,616,1.044,188,428,26,15,H1
"Barry County, MI",2005-2006,59621,59610,-11,-0.018,185,-196,26,15,H1
"Barry County, MI",2006-2007,59610,59969,359,0.602,214,145,26,15,H1
"Barry County, MI",2007-2008,59969,59788,-181,-0.302,232,-413,26,15,H1
"Barry County, MI",2008-2009,59788,59469,-319,-0.534,231,-550,26,15,H1
"Barry County, MI",2009-2010,59469,59080,-389,-0.654,126,-515,26,15,H1
"Barry County, MI",2010-2011,59080,58971,-109,-0.184,142,-251,26,15,H1
"Barry County, MI",2011-2012,58971,59073,102,0.173,133,-31,26,15,H1
"Barry County, MI",2012-2013,59073,59131,58,0.098,56,2,26,15,H1
"Barry County, MI",2013-2014,59131,59281,150,0.254,80,70,26,15,H1
"Barry County, MI",2014-2015,59239,59314,75,0.127,47,28,26,15,H1
"Barry County, MI",2015-2016,59314,59712,398,0.671,44,354,26,15,H1
"Barry County, MI",2016-2017,59712,60586,874,1.464,73,801,26,15,H1
"Bay County, MI",2000-2001,110192,109836,-356,-0.323,224,-580,26,17,H1
"Bay County, MI",2001-2002,109836,109861,25,0.023,211,-186,26,17,H1
"Bay County, MI",2002-2003,109861,109559,-302,-0.275,116,-418,26,17,H1
"Bay County, MI",2003-2004,109559,109453,-106,-0.097,187,-293,26,17,H1
"Bay County, MI",2004-2005,109453,109165,-288,-0.263,126,-414,26,17,H1
"Bay County, MI",2005-2006,109165,108711,-454,-0.416,145,-599,26,17,H1
"Bay County, MI",2006-2007,108711,108132,-579,-0.533,70,-649,26,17,H1
"Bay County, MI",2007-2008,108132,108320,188,0.174,185,3,26,17,H1
"Bay County, MI",2008-2009,108320,107913,-407,-0.376,211,-618,26,17,H1
"Bay County, MI",2009-2010,107913,107695,-218,-0.202,114,-332,26,17,H1
"Bay County, MI",2010-2011,107695,107477,-218,-0.202,0,-218,26,17,H1
"Bay County, MI",2011-2012,107477,107084,-393,-0.366,-117,-276,26,17,H1
"Bay County, MI",2012-2013,107084,106936,-148,-0.138,-58,-90,26,17,H1
"Bay County, MI",2013-2014,106936,106179,-757,-0.708,-97,-660,26,17,H1
"Bay County, MI",2014-2015,106256,105659,-597,-0.562,-106,-491,26,17,H1
"Bay County, MI",2015-2016,105659,104481,-1178,-1.115,-149,-1029,26,17,H1
"Bay County, MI",2016-2017,104481,104239,-242,-0.232,-143,-99,26,17,H1
"Benzie County, MI",2000-2001,16090,16490,400,2.486,24,376,26,19,H1
"Benzie County, MI",2001-2002,16490,16793,303,1.837,8,295,26,19,H1
"Benzie County, MI",2002-2003,16793,17239,446,2.656,55,391,26,19,H1
"Benzie County, MI",2003-2004,17239,17420,181,1.05,16,165,26,19,H1
"Benzie County, MI",2004-2005,17420,17697,277,1.59,34,243,26,19,H1
"Benzie County, MI",2005-2006,17697,17867,170,0.961,55,115,26,19,H1
"Benzie County, MI",2006-2007,17867,17863,-4,-0.022,-14,10,26,19,H1
"Benzie County, MI",2007-2008,17863,17733,-130,-0.728,0,-130,26,19,H1
"Benzie County, MI",2008-2009,17733,17564,-169,-0.953,1,-170,26,19,H1
"Benzie County, MI",2009-2010,17564,17503,-61,-0.347,-10,-51,26,19,H1
"Benzie County, MI",2010-2011,17503,17433,-70,-0.4,-53,-17,26,19,H1
"Benzie County, MI",2011-2012,17433,17387,-46,-0.264,-57,11,26,19,H1
"Benzie County, MI",2012-2013,17387,17406,19,0.109,-53,72,26,19,H1
"Benzie County, MI",2013-2014,17406,17519,113,0.649,-47,160,26,19,H1
"Benzie County, MI",2014-2015,17505,17457,-48,-0.274,-33,-15,26,19,H1
"Benzie County, MI",2015-2016,17457,17524,67,0.384,-73,140,26,19,H1
"Benzie County, MI",2016-2017,17524,17573,49,0.28,-55,104,26,19,H1
"Berrien County, MI",2000-2001,162471,161153,-1318,-0.811,614,-1932,26,21,H1
"Berrien County, MI",2001-2002,161153,160604,-549,-0.341,458,-1007,26,21,H1
"Berrien County, MI",2002-2003,160604,160314,-290,-0.181,577,-867,26,21,H1
"Berrien County, MI",2003-2004,160314,159742,-572,-0.357,414,-986,26,21,H1
"Berrien County, MI",2004-2005,159742,158510,-1232,-0.771,465,-1697,26,21,H1
"Berrien County, MI",2005-2006,158510,157537,-973,-0.614,530,-1503,26,21,H1
"Berrien County, MI",2006-2007,157537,157378,-159,-0.101,484,-643,26,21,H1
"Berrien County, MI",2007-2008,157378,157380,2,0.001,415,-413,26,21,H1
"Berrien County, MI",2008-2009,157380,157059,-321,-0.204,478,-799,26,21,H1
"Berrien County, MI",2009-2010,157059,156803,-256,-0.163,434,-690,26,21,H1
"Berrien County, MI",2010-2011,156803,156544,-259,-0.165,331,-590,26,21,H1
"Berrien County, MI",2011-2012,156544,156057,-487,-0.311,144,-631,26,21,H1
"Berrien County, MI",2012-2013,156057,155321,-736,-0.472,62,-798,26,21,H1
"Berrien County, MI",2013-2014,155321,155233,-88,-0.057,213,-301,26,21,H1
"Berrien County, MI",2014-2015,155299,154636,-663,-0.427,252,-915,26,21,H1
"Berrien County, MI",2015-2016,154636,154157,-479,-0.31,34,-513,26,21,H1
"Berrien County, MI",2016-2017,154157,154259,102,0.066,79,23,26,21,H1
"Branch County, MI",2000-2001,45875,46099,224,0.488,266,-42,26,23,H1
"Branch County, MI",2001-2002,46099,46651,552,1.197,115,437,26,23,H1
"Branch County, MI",2002-2003,46651,46680,29,0.062,165,-136,26,23,H1
"Branch County, MI",2003-2004,46680,46791,111,0.238,203,-92,26,23,H1
"Branch County, MI",2004-2005,46791,46733,-58,-0.124,166,-224,26,23,H1
"Branch County, MI",2005-2006,46733,46805,72,0.154,208,-136,26,23,H1
"Branch County, MI",2006-2007,46805,46788,-17,-0.036,177,-194,26,23,H1
"Branch County, MI",2007-2008,46788,46305,-483,-1.032,206,-689,26,23,H1
"Branch County, MI",2008-2009,46305,45378,-927,-2.002,180,-1107,26,23,H1
"Branch County, MI",2009-2010,45378,45164,-214,-0.472,151,-365,26,23,H1
"Branch County, MI",2010-2011,45164,43886,-1278,-2.83,114,-1392,26,23,H1
"Branch County, MI",2011-2012,43886,43756,-130,-0.296,31,-161,26,23,H1
"Branch County, MI",2012-2013,43756,43472,-284,-0.649,71,-355,26,23,H1
"Branch County, MI",2013-2014,43472,43545,73,0.168,74,-1,26,23,H1
"Branch County, MI",2014-2015,43668,43664,-4,-0.009,168,-172,26,23,H1
"Branch County, MI",2015-2016,43664,43457,-207,-0.474,110,-317,26,23,H1
"Branch County, MI",2016-2017,43457,43410,-47,-0.108,100,-147,26,23,H1
"Calhoun County, MI",2000-2001,138014,138158,144,0.104,494,-350,26,25,H1
"Calhoun County, MI",2001-2002,138158,138580,422,0.305,355,67,26,25,H1
"Calhoun County, MI",2002-2003,138580,138962,382,0.276,456,-74,26,25,H1
"Calhoun County, MI",2003-2004,138962,139443,481,0.346,489,-8,26,25,H1
"Calhoun County, MI",2004-2005,139443,138946,-497,-0.356,462,-959,26,25,H1
"Calhoun County, MI",2005-2006,138946,138291,-655,-0.471,410,-1065,26,25,H1
"Calhoun County, MI",2006-2007,138291,137582,-709,-0.513,399,-1108,26,25,H1
"Calhoun County, MI",2007-2008,137582,137313,-269,-0.196,502,-771,26,25,H1
"Calhoun County, MI",2008-2009,137313,136301,-1012,-0.737,462,-1474,26,25,H1
"Calhoun County, MI",2009-2010,136301,135998,-303,-0.222,339,-642,26,25,H1
"Calhoun County, MI",2010-2011,135998,135282,-716,-0.526,195,-911,26,25,H1
"Calhoun County, MI",2011-2012,135282,134760,-522,-0.386,170,-692,26,25,H1
"Calhoun County, MI",2012-2013,134760,134830,70,0.052,242,-172,26,25,H1
"Calhoun County, MI",2013-2014,134830,134878,48,0.036,310,-262,26,25,H1
"Calhoun County, MI",2014-2015,134821,134314,-507,-0.376,338,-845,26,25,H1
"Calhoun County, MI",2015-2016,134314,134178,-136,-0.101,155,-291,26,25,H1
"Calhoun County, MI",2016-2017,134178,134128,-50,-0.037,223,-273,26,25,H1
"Cass County, MI",2000-2001,51146,51395,249,0.487,79,170,26,27,H1
"Cass County, MI",2001-2002,51395,51588,193,0.376,53,140,26,27,H1
"Cass County, MI",2002-2003,51588,51783,195,0.378,29,166,26,27,H1
"Cass County, MI",2003-2004,51783,52290,507,0.979,102,405,26,27,H1
"Cass County, MI",2004-2005,52290,52358,68,0.13,-3,71,26,27,H1
"Cass County, MI",2005-2006,52358,52282,-76,-0.145,-12,-64,26,27,H1
"Cass County, MI",2006-2007,52282,52623,341,0.652,71,270,26,27,H1
"Cass County, MI",2007-2008,52623,52684,61,0.116,63,-2,26,27,H1
"Cass County, MI",2008-2009,52684,52362,-322,-0.611,76,-398,26,27,H1
"Cass County, MI",2009-2010,52362,52197,-165,-0.315,83,-248,26,27,H1
"Cass County, MI",2010-2011,52197,52466,269,0.515,-8,277,26,27,H1
"Cass County, MI",2011-2012,52466,52054,-412,-0.785,-31,-381,26,27,H1
"Cass County, MI",2012-2013,52054,51682,-372,-0.715,-113,-259,26,27,H1
"Cass County, MI",2013-2014,51682,51608,-74,-0.143,-36,-38,26,27,H1
"Cass County, MI",2014-2015,51775,51657,-118,-0.228,3,-121,26,27,H1
"Cass County, MI",2015-2016,51657,51209,-448,-0.867,-55,-393,26,27,H1
"Cass County, MI",2016-2017,51209,51381,172,0.336,-54,226,26,27,H1
"Charlevoix County, MI",2000-2001,26171,26437,266,1.016,81,185,26,29,H1
"Charlevoix County, MI",2001-2002,26437,26542,105,0.397,67,38,26,29,H1
"Charlevoix County, MI",2002-2003,26542,26656,114,0.43,23,91,26,29,H1
"Charlevoix County, MI",2003-2004,26656,26601,-55,-0.206,86,-141,26,29,H1
"Charlevoix County, MI",2004-2005,26601,26534,-67,-0.252,26,-93,26,29,H1
"Charlevoix County, MI",2005-2006,26534,26394,-140,-0.528,48,-188,26,29,H1
"Charlevoix County, MI",2006-2007,26394,26499,105,0.398,20,85,26,29,H1
"Charlevoix County, MI",2007-2008,26499,26280,-219,-0.826,32,-251,26,29,H1
"Charlevoix County, MI",2008-2009,26280,26068,-212,-0.807,24,-236,26,29,H1
"Charlevoix County, MI",2009-2010,26068,25910,-158,-0.606,-4,-154,26,29,H1
"Charlevoix County, MI",2010-2011,25910,26006,96,0.371,-37,133,26,29,H1
"Charlevoix County, MI",2011-2012,26006,26039,33,0.127,9,24,26,29,H1
"Charlevoix County, MI",2012-2013,26039,26115,76,0.292,-39,115,26,29,H1
"Charlevoix County, MI",2013-2014,26115,26121,6,0.023,-15,21,26,29,H1
"Charlevoix County, MI",2014-2015,26171,26238,67,0.256,-40,107,26,29,H1
"Charlevoix County, MI",2015-2016,26238,26122,-116,-0.442,-51,-65,26,29,H1
"Charlevoix County, MI",2016-2017,26122,26139,17,0.065,-53,70,26,29,H1
"Cheboygan County, MI",2000-2001,26530,26881,351,1.323,4,347,26,31,H1
"Cheboygan County, MI",2001-2002,26881,27138,257,0.956,15,242,26,31,H1
"Cheboygan County, MI",2002-2003,27138,27232,94,0.346,-37,131,26,31,H1
"Cheboygan County, MI",2003-2004,27232,27228,-4,-0.015,-24,20,26,31,H1
"Cheboygan County, MI",2004-2005,27228,27274,46,0.169,-13,59,26,31,H1
"Cheboygan County, MI",2005-2006,27274,27249,-25,-0.092,-13,-12,26,31,H1
"Cheboygan County, MI",2006-2007,27249,27093,-156,-0.572,-9,-147,26,31,H1
"Cheboygan County, MI",2007-2008,27093,26738,-355,-1.31,-22,-333,26,31,H1
"Cheboygan County, MI",2008-2009,26738,26330,-408,-1.526,-38,-370,26,31,H1
"Cheboygan County, MI",2009-2010,26330,26083,-247,-0.938,-50,-197,26,31,H1
"Cheboygan County, MI",2010-2011,26083,25940,-143,-0.548,-119,-24,26,31,H1
"Cheboygan County, MI",2011-2012,25940,25774,-166,-0.64,-105,-61,26,31,H1
"Cheboygan County, MI",2012-2013,25774,25635,-139,-0.539,-95,-44,26,31,H1
"Cheboygan County, MI",2013-2014,25635,25675,40,0.156,-134,174,26,31,H1
"Cheboygan County, MI",2014-2015,25685,25427,-258,-1.004,-148,-110,26,31,H1
"Cheboygan County, MI",2015-2016,25427,25404,-23,-0.09,-138,115,26,31,H1
"Cheboygan County, MI",2016-2017,25404,25369,-35,-0.138,-146,111,26,31,H1
"Chippewa County, MI",2000-2001,38593,38518,-75,-0.194,83,-158,26,33,H1
"Chippewa County, MI",2001-2002,38518,38748,230,0.597,78,152,26,33,H1
"Chippewa County, MI",2002-2003,38748,38789,41,0.106,77,-36,26,33,H1
"Chippewa County, MI",2003-2004,38789,38803,14,0.036,77,-63,26,33,H1
"Chippewa County, MI",2004-2005,38803,38990,187,0.482,92,95,26,33,H1
"Chippewa County, MI",2005-2006,38990,39051,61,0.156,113,-52,26,33,H1
"Chippewa County, MI",2006-2007,39051,39314,263,0.673,63,200,26,33,H1
"Chippewa County, MI",2007-2008,39314,39247,-67,-0.17,64,-131,26,33,H1
"Chippewa County, MI",2008-2009,39247,39174,-73,-0.186,110,-183,26,33,H1
"Chippewa County, MI",2009-2010,39174,38598,-576,-1.47,93,-669,26,33,H1
"Chippewa County, MI",2010-2011,38598,38897,299,0.775,15,284,26,33,H1
"Chippewa County, MI",2011-2012,38897,38996,99,0.255,-17,116,26,33,H1
"Chippewa County, MI",2012-2013,38996,38679,-317,-0.813,27,-344,26,33,H1
"Chippewa County, MI",2013-2014,38679,38321,-358,-0.926,-11,-347,26,33,H1
"Chippewa County, MI",2014-2015,38320,38033,-287,-0.749,-3,-284,26,33,H1
"Chippewa County, MI",2015-2016,38033,37696,-337,-0.886,-9,-328,26,33,H1
"Chippewa County, MI",2016-2017,37696,37711,15,0.04,-20,35,26,33,H1
"Clare County, MI",2000-2001,31398,31405,7,0.022,-14,21,26,35,H1
"Clare County, MI",2001-2002,31405,31707,302,0.962,0,302,26,35,H1
"Clare County, MI",2002-2003,31707,31710,3,0.009,-39,42,26,35,H1
"Clare County, MI",2003-2004,31710,31821,111,0.35,-86,197,26,35,H1
"Clare County, MI",2004-2005,31821,31701,-120,-0.377,-79,-41,26,35,H1
"Clare County, MI",2005-2006,31701,31612,-89,-0.281,-49,-40,26,35,H1
"Clare County, MI",2006-2007,31612,31353,-259,-0.819,7,-266,26,35,H1
"Clare County, MI",2007-2008,31353,31064,-289,-0.922,-27,-262,26,35,H1
"Clare County, MI",2008-2009,31064,30856,-208,-0.67,-55,-153,26,35,H1
"Clare County, MI",2009-2010,30856,30995,139,0.45,-70,209,26,35,H1
"Clare County, MI",2010-2011,30995,30951,-44,-0.142,-80,36,26,35,H1
"Clare County, MI",2011-2012,30951,30780,-171,-0.552,-89,-82,26,35,H1
"Clare County, MI",2012-2013,30780,30553,-227,-0.737,-33,-194,26,35,H1
"Clare County, MI",2013-2014,30553,30652,99,0.324,-62,161,26,35,H1
"Clare County, MI",2014-2015,30670,30553,-117,-0.381,-72,-45,26,35,H1
"Clare County, MI",2015-2016,30553,30406,-147,-0.481,-72,-75,26,35,H1
"Clare County, MI",2016-2017,30406,30653,247,0.812,-69,316,26,35,H1
"Clinton County, MI",2000-2001,65020,66098,1078,1.658,315,763,26,37,H1
"Clinton County, MI",2001-2002,66098,67596,1498,2.266,324,1174,26,37,H1
"Clinton County, MI",2002-2003,67596,69103,1507,2.229,327,1180,26,37,H1
"Clinton County, MI",2003-2004,69103,70605,1502,2.174,379,1123,26,37,H1
"Clinton County, MI",2004-2005,70605,71700,1095,1.551,304,791,26,37,H1
"Clinton County, MI",2005-2006,71700,72881,1181,1.647,401,780,26,37,H1
"Clinton County, MI",2006-2007,72881,73740,859,1.179,315,544,26,37,H1
"Clinton County, MI",2007-2008,73740,74302,562,0.762,340,222,26,37,H1
"Clinton County, MI",2008-2009,74302,74828,526,0.708,360,166,26,37,H1
"Clinton County, MI",2009-2010,74828,75388,560,0.748,223,337,26,37,H1
"Clinton County, MI",2010-2011,75388,76178,790,1.048,241,549,26,37,H1
"Clinton County, MI",2011-2012,76178,76426,248,0.326,215,33,26,37,H1
"Clinton County, MI",2012-2013,76426,77106,680,0.89,271,409,26,37,H1
"Clinton County, MI",2013-2014,77106,77297,191,0.248,228,-37,26,37,H1
"Clinton County, MI",2014-2015,77353,77390,37,0.048,255,-218,26,37,H1
"Clinton County, MI",2015-2016,77390,77530,140,0.181,182,-42,26,37,H1
"Clinton County, MI",2016-2017,77530,78443,913,1.178,227,686,26,37,H1
"Crawford County, MI",2000-2001,14308,14392,84,0.587,-7,91,26,39,H1
"Crawford County, MI",2001-2002,14392,14527,135,0.938,-29,164,26,39,H1
"Crawford County, MI",2002-2003,14527,14633,106,0.73,-20,126,26,39,H1
"Crawford County, MI",2003-2004,14633,14591,-42,-0.287,-46,4,26,39,H1
"Crawford County, MI",2004-2005,14591,14644,53,0.363,-16,69,26,39,H1
"Crawford County, MI",2005-2006,14644,14597,-47,-0.321,-11,-36,26,39,H1
"Crawford County, MI",2006-2007,14597,14455,-142,-0.973,-11,-131,26,39,H1
"Crawford County, MI",2007-2008,14455,14379,-76,-0.526,-44,-32,26,39,H1
"Crawford County, MI",2008-2009,14379,14157,-222,-1.544,-20,-202,26,39,H1
"Crawford County, MI",2009-2010,14157,14044,-113,-0.798,-24,-89,26,39,H1
"Crawford County, MI",2010-2011,14044,14022,-22,-0.157,-40,18,26,39,H1
"Crawford County, MI",2011-2012,14022,13985,-37,-0.264,-43,6,26,39,H1
"Crawford County, MI",2012-2013,13985,13908,-77,-0.551,-62,-15,26,39,H1
"Crawford County, MI",2013-2014,13908,13745,-163,-1.172,-58,-105,26,39,H1
"Crawford County, MI",2014-2015,13742,13801,59,0.429,-44,103,26,39,H1
"Crawford County, MI",2015-2016,13801,13739,-62,-0.449,-74,12,26,39,H1
"Crawford County, MI",2016-2017,13739,13907,168,1.223,-49,217,26,39,H1
"Delta County, MI",2000-2001,38542,38356,-186,-0.483,40,-226,26,41,H1
"Delta County, MI",2001-2002,38356,38300,-56,-0.146,10,-66,26,41,H1
"Delta County, MI",2002-2003,38300,38157,-143,-0.373,-33,-110,26,41,H1
"Delta County, MI",2003-2004,38157,38123,-34,-0.089,-2,-32,26,41,H1
"Delta County, MI",2004-2005,38123,37982,-141,-0.37,-10,-131,26,41,H1
"Delta County, MI",2005-2006,37982,37898,-84,-0.221,-13,-71,26,41,H1
"Delta County, MI",2006-2007,37898,37584,-314,-0.829,38,-352,26,41,H1
"Delta County, MI",2007-2008,37584,37409,-175,-0.466,-12,-163,26,41,H1
"Delta County, MI",2008-2009,37409,37059,-350,-0.936,-7,-343,26,41,H1
"Delta County, MI",2009-2010,37059,37061,2,0.005,-19,21,26,41,H1
"Delta County, MI",2010-2011,37061,36934,-127,-0.343,-72,-55,26,41,H1
"Delta County, MI",2011-2012,36934,36831,-103,-0.279,-66,-37,26,41,H1
"Delta County, MI",2012-2013,36831,36819,-12,-0.033,-62,50,26,41,H1
"Delta County, MI",2013-2014,36819,36559,-260,-0.706,-75,-185,26,41,H1
"Delta County, MI",2014-2015,36552,36377,-175,-0.479,-53,-122,26,41,H1
"Delta County, MI",2015-2016,36377,36225,-152,-0.418,-57,-95,26,41,H1
"Delta County, MI",2016-2017,36225,35965,-260,-0.718,-76,-184,26,41,H1
"Dickinson County, MI",2000-2001,27460,27136,-324,-1.18,-31,-293,26,43,H1
"Dickinson County, MI",2001-2002,27136,27019,-117,-0.431,-44,-73,26,43,H1
"Dickinson County, MI",2002-2003,27019,26943,-76,-0.281,-50,-26,26,43,H1
"Dickinson County, MI",2003-2004,26943,27231,288,1.069,-19,307,26,43,H1
"Dickinson County, MI",2004-2005,27231,27067,-164,-0.602,-59,-105,26,43,H1
"Dickinson County, MI",2005-2006,27067,26951,-116,-0.429,-58,-58,26,43,H1
"Dickinson County, MI",2006-2007,26951,26881,-70,-0.26,-9,-61,26,43,H1
"Dickinson County, MI",2007-2008,26881,26622,-259,-0.964,-60,-199,26,43,H1
"Dickinson County, MI",2008-2009,26622,26357,-265,-0.995,-83,-182,26,43,H1
"Dickinson County, MI",2009-2010,26357,26157,-200,-0.759,-77,-123,26,43,H1
"Dickinson County, MI",2010-2011,26157,26084,-73,-0.279,-116,43,26,43,H1
"Dickinson County, MI",2011-2012,26084,26228,144,0.552,-29,173,26,43,H1
"Dickinson County, MI",2012-2013,26228,26057,-171,-0.652,-50,-121,26,43,H1
"Dickinson County, MI",2013-2014,26057,25957,-100,-0.384,-41,-59,26,43,H1
"Dickinson County, MI",2014-2015,25947,25788,-159,-0.613,-21,-138,26,43,H1
"Dickinson County, MI",2015-2016,25788,25515,-273,-1.059,-19,-254,26,43,H1
"Dickinson County, MI",2016-2017,25515,25415,-100,-0.392,-49,-51,26,43,H1
"Eaton County, MI",2000-2001,1.04E+05,104848,848,0.815,543,305,26,45,H1
"Eaton County, MI",2001-2002,104848,105794,946,0.902,458,488,26,45,H1
"Eaton County, MI",2002-2003,105794,107090,1296,1.225,500,796,26,45,H1
"Eaton County, MI",2003-2004,107090,107533,443,0.414,332,111,26,45,H1
"Eaton County, MI",2004-2005,107533,108073,540,0.502,299,241,26,45,H1
"Eaton County, MI",2005-2006,108073,108364,291,0.269,317,-26,26,45,H1
"Eaton County, MI",2006-2007,108364,108358,-6,-0.006,231,-237,26,45,H1
"Eaton County, MI",2007-2008,108358,108021,-337,-0.311,391,-728,26,45,H1
"Eaton County, MI",2008-2009,108021,107430,-591,-0.547,397,-988,26,45,H1
"Eaton County, MI",2009-2010,107430,107757,327,0.304,277,50,26,45,H1
"Eaton County, MI",2010-2011,107757,107858,101,0.094,244,-143,26,45,H1
"Eaton County, MI",2011-2012,107858,107968,110,0.102,216,-106,26,45,H1
"Eaton County, MI",2012-2013,107968,108243,275,0.255,160,115,26,45,H1
"Eaton County, MI",2013-2014,108243,108579,336,0.31,146,190,26,45,H1
"Eaton County, MI",2014-2015,108706,108801,95,0.087,213,-118,26,45,H1
"Eaton County, MI",2015-2016,108801,108847,46,0.042,181,-135,26,45,H1
"Eaton County, MI",2016-2017,108847,109027,180,0.165,170,10,26,45,H1
"Emmet County, MI",2000-2001,31517,31998,481,1.526,67,414,26,47,H1
"Emmet County, MI",2001-2002,31998,32279,281,0.878,102,179,26,47,H1
"Emmet County, MI",2002-2003,32279,32402,123,0.381,74,49,26,47,H1
"Emmet County, MI",2003-2004,32402,32824,422,1.302,138,284,26,47,H1
"Emmet County, MI",2004-2005,32824,32856,32,0.097,60,-28,26,47,H1
"Emmet County, MI",2005-2006,32856,32926,70,0.213,70,0,26,47,H1
"Emmet County, MI",2006-2007,32926,32794,-132,-0.401,119,-251,26,47,H1
"Emmet County, MI",2007-2008,32794,32852,58,0.177,48,10,26,47,H1
"Emmet County, MI",2008-2009,32852,32765,-87,-0.265,54,-141,26,47,H1
"Emmet County, MI",2009-2010,32765,32657,-108,-0.33,22,-130,26,47,H1
"Emmet County, MI",2010-2011,32657,32787,130,0.398,27,103,26,47,H1
"Emmet County, MI",2011-2012,32787,32895,108,0.329,-31,139,26,47,H1
"Emmet County, MI",2012-2013,32895,33067,172,0.523,-45,217,26,47,H1
"Emmet County, MI",2013-2014,33067,33204,137,0.414,-25,162,26,47,H1
"Emmet County, MI",2014-2015,33200,33161,-39,-0.117,5,-44,26,47,H1
"Emmet County, MI",2015-2016,33161,32916,-245,-0.739,2,-247,26,47,H1
"Emmet County, MI",2016-2017,32916,33193,277,0.842,-11,288,26,47,H1
"Genesee County, MI",2000-2001,436965,438584,1619,0.371,2441,-822,26,49,H1
"Genesee County, MI",2001-2002,438584,440062,1478,0.337,2199,-721,26,49,H1
"Genesee County, MI",2002-2003,440062,441689,1627,0.37,2367,-740,26,49,H1
"Genesee County, MI",2003-2004,441689,442534,845,0.191,2283,-1438,26,49,H1
"Genesee County, MI",2004-2005,442534,442508,-26,-0.006,2142,-2168,26,49,H1
"Genesee County, MI",2005-2006,442508,441164,-1344,-0.304,1969,-3313,26,49,H1
"Genesee County, MI",2006-2007,441164,438109,-3055,-0.692,2172,-5227,26,49,H1
"Genesee County, MI",2007-2008,438109,433082,-5027,-1.147,1997,-7024,26,49,H1
"Genesee County, MI",2008-2009,433082,427989,-5093,-1.176,1773,-6866,26,49,H1
"Genesee County, MI",2009-2010,427989,424976,-3013,-0.704,1318,-4331,26,49,H1
"Genesee County, MI",2010-2011,424976,421716,-3260,-0.767,1067,-4327,26,49,H1
"Genesee County, MI",2011-2012,421716,418058,-3658,-0.867,770,-4428,26,49,H1
"Genesee County, MI",2012-2013,418058,415623,-2435,-0.582,514,-2949,26,49,H1
"Genesee County, MI",2013-2014,415623,412895,-2728,-0.656,533,-3261,26,49,H1
"Genesee County, MI",2014-2015,412934,410849,-2085,-0.505,633,-2718,26,49,H1
"Genesee County, MI",2015-2016,410849,408607,-2242,-0.546,326,-2568,26,49,H1
"Genesee County, MI",2016-2017,408607,407385,-1222,-0.299,231,-1453,26,49,H1
"Gladwin County, MI",2000-2001,26127,26453,326,1.248,-15,341,26,51,H1
"Gladwin County, MI",2001-2002,26453,26754,301,1.138,-19,320,26,51,H1
"Gladwin County, MI",2002-2003,26754,26875,121,0.452,-35,156,26,51,H1
"Gladwin County, MI",2003-2004,26875,26971,96,0.357,-37,133,26,51,H1
"Gladwin County, MI",2004-2005,26971,26752,-219,-0.812,-57,-162,26,51,H1
"Gladwin County, MI",2005-2006,26752,26726,-26,-0.097,-39,13,26,51,H1
"Gladwin County, MI",2006-2007,26726,26285,-441,-1.65,-66,-375,26,51,H1
"Gladwin County, MI",2007-2008,26285,25956,-329,-1.252,-80,-249,26,51,H1
"Gladwin County, MI",2008-2009,25956,25738,-218,-0.84,-46,-172,26,51,H1
"Gladwin County, MI",2009-2010,25738,25722,-16,-0.062,-75,59,26,51,H1
"Gladwin County, MI",2010-2011,25722,25839,117,0.455,-86,203,26,51,H1
"Gladwin County, MI",2011-2012,25839,25508,-331,-1.281,-127,-204,26,51,H1
"Gladwin County, MI",2012-2013,25508,25514,6,0.024,-93,99,26,51,H1
"Gladwin County, MI",2013-2014,25514,25411,-103,-0.404,-127,24,26,51,H1
"Gladwin County, MI",2014-2015,25451,25164,-287,-1.128,-114,-173,26,51,H1
"Gladwin County, MI",2015-2016,25164,25144,-20,-0.079,-80,60,26,51,H1
"Gladwin County, MI",2016-2017,25144,25234,90,0.358,-97,187,26,51,H1
"Gogebic County, MI",2000-2001,17219,17612,393,2.282,-123,516,26,53,H1
"Gogebic County, MI",2001-2002,17612,17394,-218,-1.238,-132,-86,26,53,H1
"Gogebic County, MI",2002-2003,17394,17213,-181,-1.041,-140,-41,26,53,H1
"Gogebic County, MI",2003-2004,17213,16976,-237,-1.377,-117,-120,26,53,H1
"Gogebic County, MI",2004-2005,16976,16811,-165,-0.972,-117,-48,26,53,H1
"Gogebic County, MI",2005-2006,16811,16552,-259,-1.541,-111,-148,26,53,H1
"Gogebic County, MI",2006-2007,16552,16515,-37,-0.224,-80,43,26,53,H1
"Gogebic County, MI",2007-2008,16515,16499,-16,-0.097,-90,74,26,53,H1
"Gogebic County, MI",2008-2009,16499,16390,-109,-0.661,-92,-17,26,53,H1
"Gogebic County, MI",2009-2010,16390,16394,4,0.024,-74,78,26,53,H1
"Gogebic County, MI",2010-2011,16394,16130,-264,-1.61,-101,-163,26,53,H1
"Gogebic County, MI",2011-2012,16130,16050,-80,-0.496,-107,27,26,53,H1
"Gogebic County, MI",2012-2013,16050,15900,-150,-0.935,-68,-82,26,53,H1
"Gogebic County, MI",2013-2014,15900,15737,-163,-1.025,-81,-82,26,53,H1
"Gogebic County, MI",2014-2015,15678,15431,-247,-1.575,-95,-152,26,53,H1
"Gogebic County, MI",2015-2016,15431,15349,-82,-0.531,-87,5,26,53,H1
"Gogebic County, MI",2016-2017,15349,15342,-7,-0.046,-84,77,26,53,H1
"Grand Traverse County, MI",2000-2001,78004,79915,1911,2.45,363,1548,26,55,H1
"Grand Traverse County, MI",2001-2002,79915,81013,1098,1.374,312,786,26,55,H1
"Grand Traverse County, MI",2002-2003,81013,81869,856,1.057,307,549,26,55,H1
"Grand Traverse County, MI",2003-2004,81869,82768,899,1.098,345,554,26,55,H1
"Grand Traverse County, MI",2004-2005,82768,83699,931,1.125,225,706,26,55,H1
"Grand Traverse County, MI",2005-2006,83699,84705,1006,1.202,238,768,26,55,H1
"Grand Traverse County, MI",2006-2007,84705,85579,874,1.032,277,597,26,55,H1
"Grand Traverse County, MI",2007-2008,85579,86209,630,0.736,352,278,26,55,H1
"Grand Traverse County, MI",2008-2009,86209,86767,558,0.647,310,248,26,55,H1
"Grand Traverse County, MI",2009-2010,86767,86954,187,0.216,198,-11,26,55,H1
"Grand Traverse County, MI",2010-2011,86954,88141,1187,1.365,101,1086,26,55,H1
"Grand Traverse County, MI",2011-2012,88141,89005,864,0.98,149,715,26,55,H1
"Grand Traverse County, MI",2012-2013,89005,90024,1019,1.145,130,889,26,55,H1
"Grand Traverse County, MI",2013-2014,90024,90782,758,0.842,152,606,26,55,H1
"Grand Traverse County, MI",2014-2015,90796,91636,840,0.925,182,658,26,55,H1
"Grand Traverse County, MI",2015-2016,91636,91914,278,0.303,63,215,26,55,H1
"Grand Traverse County, MI",2016-2017,91914,91807,-107,-0.116,92,-199,26,55,H1
"Gratiot County, MI",2000-2001,42472,42521,49,0.115,93,-44,26,57,H1
"Gratiot County, MI",2001-2002,42521,42428,-93,-0.219,44,-137,26,57,H1
"Gratiot County, MI",2002-2003,42428,42546,118,0.278,-4,122,26,57,H1
"Gratiot County, MI",2003-2004,42546,42583,37,0.087,100,-63,26,57,H1
"Gratiot County, MI",2004-2005,42583,42479,-104,-0.244,3,-107,26,57,H1
"Gratiot County, MI",2005-2006,42479,42714,235,0.553,94,141,26,57,H1
"Gratiot County, MI",2006-2007,42714,42824,110,0.258,20,90,26,57,H1
"Gratiot County, MI",2007-2008,42824,42774,-50,-0.117,58,-108,26,57,H1
"Gratiot County, MI",2008-2009,42774,42285,-489,-1.143,70,-559,26,57,H1
"Gratiot County, MI",2009-2010,42285,42409,124,0.293,49,75,26,57,H1
"Gratiot County, MI",2010-2011,42409,42148,-261,-0.615,15,-276,26,57,H1
"Gratiot County, MI",2011-2012,42148,42031,-117,-0.278,37,-154,26,57,H1
"Gratiot County, MI",2012-2013,42031,42034,3,0.007,-41,44,26,57,H1
"Gratiot County, MI",2013-2014,42034,41665,-369,-0.878,-21,-348,26,57,H1
"Gratiot County, MI",2014-2015,41633,41540,-93,-0.223,-25,-68,26,57,H1
"Gratiot County, MI",2015-2016,41540,40932,-608,-1.464,-69,-539,26,57,H1
"Gratiot County, MI",2016-2017,40932,41018,86,0.21,-46,132,26,57,H1
"Hillsdale County, MI",2000-2001,46698,46736,38,0.081,178,-140,26,59,H1
"Hillsdale County, MI",2001-2002,46736,47051,315,0.674,157,158,26,59,H1
"Hillsdale County, MI",2002-2003,47051,47359,308,0.655,159,149,26,59,H1
"Hillsdale County, MI",2003-2004,47359,47392,33,0.07,137,-104,26,59,H1
"Hillsdale County, MI",2004-2005,47392,47476,84,0.177,152,-68,26,59,H1
"Hillsdale County, MI",2005-2006,47476,47499,23,0.048,154,-131,26,59,H1
"Hillsdale County, MI",2006-2007,47499,47336,-163,-0.343,148,-311,26,59,H1
"Hillsdale County, MI",2007-2008,47336,46951,-385,-0.813,147,-532,26,59,H1
"Hillsdale County, MI",2008-2009,46951,46735,-216,-0.46,108,-324,26,59,H1
"Hillsdale County, MI",2009-2010,46735,46600,-135,-0.289,72,-207,26,59,H1
"Hillsdale County, MI",2010-2011,46600,46603,3,0.006,89,-86,26,59,H1
"Hillsdale County, MI",2011-2012,46603,46264,-339,-0.727,47,-386,26,59,H1
"Hillsdale County, MI",2012-2013,46264,46115,-149,-0.322,99,-248,26,59,H1
"Hillsdale County, MI",2013-2014,46115,45830,-285,-0.618,59,-344,26,59,H1
"Hillsdale County, MI",2014-2015,45917,45941,24,0.052,120,-96,26,59,H1
"Hillsdale County, MI",2015-2016,45941,45767,-174,-0.379,77,-251,26,59,H1
"Hillsdale County, MI",2016-2017,45767,45879,112,0.245,72,40,26,59,H1
"Houghton County, MI",2000-2001,35964,35701,-263,-0.731,-31,-232,26,61,H1
"Houghton County, MI",2001-2002,35701,35905,204,0.571,17,187,26,61,H1
"Houghton County, MI",2002-2003,35905,35794,-111,-0.309,-10,-101,26,61,H1
"Houghton County, MI",2003-2004,35794,36154,360,1.006,45,315,26,61,H1
"Houghton County, MI",2004-2005,36154,36169,15,0.041,-7,22,26,61,H1
"Houghton County, MI",2005-2006,36169,35765,-404,-1.117,24,-428,26,61,H1
"Houghton County, MI",2006-2007,35765,35839,74,0.207,27,47,26,61,H1
"Houghton County, MI",2007-2008,35839,36292,453,1.264,72,381,26,61,H1
"Houghton County, MI",2008-2009,36292,36378,86,0.237,83,3,26,61,H1
"Houghton County, MI",2009-2010,36378,36712,334,0.918,72,262,26,61,H1
"Houghton County, MI",2010-2011,36712,36909,197,0.537,40,157,26,61,H1
"Houghton County, MI",2011-2012,36909,36850,-59,-0.16,28,-87,26,61,H1
"Houghton County, MI",2012-2013,36850,36729,-121,-0.328,21,-142,26,61,H1
"Houghton County, MI",2013-2014,36729,36495,-234,-0.637,24,-258,26,61,H1
"Houghton County, MI",2014-2015,36491,36380,-111,-0.304,25,-136,26,61,H1
"Houghton County, MI",2015-2016,36380,36287,-93,-0.256,14,-107,26,61,H1
"Houghton County, MI",2016-2017,36287,36305,18,0.05,20,-2,26,61,H1
"Huron County, MI",2000-2001,36047,35760,-287,-0.796,-93,-194,26,63,H1
"Huron County, MI",2001-2002,35760,35508,-252,-0.705,-112,-140,26,63,H1
"Huron County, MI",2002-2003,35508,35313,-195,-0.549,-109,-86,26,63,H1
"Huron County, MI",2003-2004,35313,35014,-299,-0.847,-134,-165,26,63,H1
"Huron County, MI",2004-2005,35014,34691,-323,-0.922,-92,-231,26,63,H1
"Huron County, MI",2005-2006,34691,34363,-328,-0.945,-95,-233,26,63,H1
"Huron County, MI",2006-2007,34363,34034,-329,-0.957,-87,-242,26,63,H1
"Huron County, MI",2007-2008,34034,33504,-530,-1.557,-160,-370,26,63,H1
"Huron County, MI",2008-2009,33504,33269,-235,-0.701,-117,-118,26,63,H1
"Huron County, MI",2009-2010,33269,33081,-188,-0.565,-104,-84,26,63,H1
"Huron County, MI",2010-2011,33081,32745,-336,-1.016,-97,-239,26,63,H1
"Huron County, MI",2011-2012,32745,32466,-279,-0.852,-185,-94,26,63,H1
"Huron County, MI",2012-2013,32466,32264,-202,-0.622,-130,-72,26,63,H1
"Huron County, MI",2013-2014,32264,32065,-199,-0.617,-152,-47,26,63,H1
"Huron County, MI",2014-2015,32082,31883,-199,-0.62,-146,-53,26,63,H1
"Huron County, MI",2015-2016,31883,31451,-432,-1.355,-150,-282,26,63,H1
"Huron County, MI",2016-2017,31451,31280,-171,-0.544,-136,-35,26,63,H1
"Ingham County, MI",2000-2001,279715,281105,1390,0.497,1812,-422,26,65,H1
"Ingham County, MI",2001-2002,281105,282030,925,0.329,1802,-877,26,65,H1
"Ingham County, MI",2002-2003,282030,282183,153,0.054,1732,-1579,26,65,H1
"Ingham County, MI",2003-2004,282183,283586,1403,0.497,1767,-364,26,65,H1
"Ingham County, MI",2004-2005,283586,282970,-616,-0.217,1707,-2323,26,65,H1
"Ingham County, MI",2005-2006,282970,282104,-866,-0.306,1778,-2644,26,65,H1
"Ingham County, MI",2006-2007,282104,281706,-398,-0.141,1656,-2054,26,65,H1
"Ingham County, MI",2007-2008,281706,281315,-391,-0.139,1653,-2044,26,65,H1
"Ingham County, MI",2008-2009,281315,280889,-426,-0.151,1664,-2090,26,65,H1
"Ingham County, MI",2009-2010,280889,281013,124,0.044,1583,-1459,26,65,H1
"Ingham County, MI",2010-2011,281013,281944,931,0.331,1256,-325,26,65,H1
"Ingham County, MI",2011-2012,281944,282272,328,0.116,1329,-1001,26,65,H1
"Ingham County, MI",2012-2013,282272,282999,727,0.258,1245,-518,26,65,H1
"Ingham County, MI",2013-2014,282999,284582,1583,0.559,1191,392,26,65,H1
"Ingham County, MI",2014-2015,284263,286085,1822,0.641,1211,611,26,65,H1
"Ingham County, MI",2015-2016,286085,287933,1848,0.646,1163,685,26,65,H1
"Ingham County, MI",2016-2017,287933,290186,2253,0.782,1141,1112,26,65,H1
"Ionia County, MI",2000-2001,61712,62079,367,0.595,370,-3,26,67,H1
"Ionia County, MI",2001-2002,62079,63265,1186,1.91,398,788,26,67,H1
"Ionia County, MI",2002-2003,63265,63781,516,0.816,361,155,26,67,H1
"Ionia County, MI",2003-2004,63781,64562,781,1.225,442,339,26,67,H1
"Ionia County, MI",2004-2005,64562,64745,183,0.283,374,-191,26,67,H1
"Ionia County, MI",2005-2006,64745,65157,412,0.636,346,66,26,67,H1
"Ionia County, MI",2006-2007,65157,65189,32,0.049,417,-385,26,67,H1
"Ionia County, MI",2007-2008,65189,65167,-22,-0.034,401,-423,26,67,H1
"Ionia County, MI",2008-2009,65167,63858,-1309,-2.009,382,-1691,26,67,H1
"Ionia County, MI",2009-2010,63858,63848,-10,-0.016,293,-303,26,67,H1
"Ionia County, MI",2010-2011,63848,63845,-3,-0.005,289,-292,26,67,H1
"Ionia County, MI",2011-2012,63845,63896,51,0.08,286,-235,26,67,H1
"Ionia County, MI",2012-2013,63896,63996,100,0.157,234,-134,26,67,H1
"Ionia County, MI",2013-2014,63996,64294,298,0.466,228,70,26,67,H1
"Ionia County, MI",2014-2015,64299,64223,-76,-0.118,258,-334,26,67,H1
"Ionia County, MI",2015-2016,64223,64182,-41,-0.064,209,-250,26,67,H1
"Ionia County, MI",2016-2017,64182,64291,109,0.17,197,-88,26,67,H1
"Iosco County, MI",2000-2001,27334,27204,-130,-0.476,-117,-13,26,69,H1
"Iosco County, MI",2001-2002,27204,27009,-195,-0.717,-124,-71,26,69,H1
"Iosco County, MI",2002-2003,27009,26882,-127,-0.47,-182,55,26,69,H1
"Iosco County, MI",2003-2004,26882,26860,-22,-0.082,-152,130,26,69,H1
"Iosco County, MI",2004-2005,26860,26835,-25,-0.093,-202,177,26,69,H1
"Iosco County, MI",2005-2006,26835,26869,34,0.127,-126,160,26,69,H1
"Iosco County, MI",2006-2007,26869,26749,-120,-0.447,-197,77,26,69,H1
"Iosco County, MI",2007-2008,26749,26542,-207,-0.774,-175,-32,26,69,H1
"Iosco County, MI",2008-2009,26542,26174,-368,-1.386,-153,-215,26,69,H1
"Iosco County, MI",2009-2010,26174,25810,-364,-1.391,-178,-186,26,69,H1
"Iosco County, MI",2010-2011,25810,25536,-274,-1.062,-170,-104,26,69,H1
"Iosco County, MI",2011-2012,25536,25370,-166,-0.65,-182,16,26,69,H1
"Iosco County, MI",2012-2013,25370,25385,15,0.059,-190,205,26,69,H1
"Iosco County, MI",2013-2014,25385,25420,35,0.138,-175,210,26,69,H1
"Iosco County, MI",2014-2015,25391,25345,-46,-0.181,-140,94,26,69,H1
"Iosco County, MI",2015-2016,25345,25271,-74,-0.292,-186,112,26,69,H1
"Iosco County, MI",2016-2017,25271,25162,-109,-0.431,-164,55,26,69,H1
"Iron County, MI",2000-2001,13106,12879,-227,-1.732,-110,-117,26,71,H1
"Iron County, MI",2001-2002,12879,12753,-126,-0.978,-113,-13,26,71,H1
"Iron County, MI",2002-2003,12753,12668,-85,-0.667,-141,56,26,71,H1
"Iron County, MI",2003-2004,12668,12460,-208,-1.642,-102,-106,26,71,H1
"Iron County, MI",2004-2005,12460,12397,-63,-0.506,-81,18,26,71,H1
"Iron County, MI",2005-2006,12397,12248,-149,-1.202,-143,-6,26,71,H1
"Iron County, MI",2006-2007,12248,12183,-65,-0.531,-122,57,26,71,H1
"Iron County, MI",2007-2008,12183,12081,-102,-0.837,-102,0,26,71,H1
"Iron County, MI",2008-2009,12081,11959,-122,-1.01,-80,-42,26,71,H1
"Iron County, MI",2009-2010,11959,11809,-150,-1.254,-62,-88,26,71,H1
"Iron County, MI",2010-2011,11809,11761,-48,-0.406,-108,60,26,71,H1
"Iron County, MI",2011-2012,11761,11586,-175,-1.488,-108,-67,26,71,H1
"Iron County, MI",2012-2013,11586,11530,-56,-0.483,-91,35,26,71,H1
"Iron County, MI",2013-2014,11530,11387,-143,-1.24,-98,-45,26,71,H1
"Iron County, MI",2014-2015,11357,11348,-9,-0.079,-96,87,26,71,H1
"Iron County, MI",2015-2016,11348,11182,-166,-1.463,-92,-74,26,71,H1
"Iron County, MI",2016-2017,11182,11124,-58,-0.519,-98,40,26,71,H1
"Isabella County, MI",2000-2001,63444,64231,787,1.24,262,525,26,73,H1
"Isabella County, MI",2001-2002,64231,64907,676,1.052,340,336,26,73,H1
"Isabella County, MI",2002-2003,64907,66036,1129,1.739,269,860,26,73,H1
"Isabella County, MI",2003-2004,66036,67067,1031,1.561,270,761,26,73,H1
"Isabella County, MI",2004-2005,67067,67788,721,1.075,285,436,26,73,H1
"Isabella County, MI",2005-2006,67788,68556,768,1.133,348,420,26,73,H1
"Isabella County, MI",2006-2007,68556,69012,456,0.665,295,161,26,73,H1
"Isabella County, MI",2007-2008,69012,69328,316,0.458,333,-17,26,73,H1
"Isabella County, MI",2008-2009,69328,70026,698,1.007,334,364,26,73,H1
"Isabella County, MI",2009-2010,70026,70318,292,0.417,247,45,26,73,H1
"Isabella County, MI",2010-2011,70318,70621,303,0.431,181,122,26,73,H1
"Isabella County, MI",2011-2012,70621,70552,-69,-0.098,195,-264,26,73,H1
"Isabella County, MI",2012-2013,70552,70424,-128,-0.181,218,-346,26,73,H1
"Isabella County, MI",2013-2014,70424,70616,192,0.273,204,-12,26,73,H1
"Isabella County, MI",2014-2015,70820,70698,-122,-0.172,225,-347,26,73,H1
"Isabella County, MI",2015-2016,70698,71133,435,0.615,137,298,26,73,H1
"Isabella County, MI",2016-2017,71133,71063,-70,-0.098,197,-267,26,73,H1
"Jackson County, MI",2000-2001,158679,159772,1093,0.689,613,480,26,75,H1
"Jackson County, MI",2001-2002,159772,160893,1121,0.702,543,578,26,75,H1
"Jackson County, MI",2002-2003,160893,162119,1226,0.762,550,676,26,75,H1
"Jackson County, MI",2003-2004,162119,162140,21,0.013,547,-526,26,75,H1
"Jackson County, MI",2004-2005,162140,163047,907,0.559,510,397,26,75,H1
"Jackson County, MI",2005-2006,163047,163387,340,0.209,490,-150,26,75,H1
"Jackson County, MI",2006-2007,163387,163316,-71,-0.043,516,-587,26,75,H1
"Jackson County, MI",2007-2008,163316,160825,-2491,-1.525,538,-3029,26,75,H1
"Jackson County, MI",2008-2009,160825,160114,-711,-0.442,538,-1249,26,75,H1
"Jackson County, MI",2009-2010,160114,160149,35,0.022,379,-344,26,75,H1
"Jackson County, MI",2010-2011,160149,159678,-471,-0.294,329,-800,26,75,H1
"Jackson County, MI",2011-2012,159678,160156,478,0.299,213,265,26,75,H1
"Jackson County, MI",2012-2013,160156,159909,-247,-0.154,157,-404,26,75,H1
"Jackson County, MI",2013-2014,159909,159741,-168,-0.105,164,-332,26,75,H1
"Jackson County, MI",2014-2015,159624,159494,-130,-0.081,159,-289,26,75,H1
"Jackson County, MI",2015-2016,159494,158215,-1279,-0.802,49,-1328,26,75,H1
"Jackson County, MI",2016-2017,158215,158640,425,0.269,112,313,26,75,H1
"Kalamazoo County, MI",2000-2001,239008,240080,1072,0.449,1153,-81,26,77,H1
"Kalamazoo County, MI",2001-2002,240080,241937,1857,0.773,1242,615,26,77,H1
"Kalamazoo County, MI",2002-2003,241937,243834,1897,0.784,1144,753,26,77,H1
"Kalamazoo County, MI",2003-2004,243834,242505,-1329,-0.545,1311,-2640,26,77,H1
"Kalamazoo County, MI",2004-2005,242505,243259,754,0.311,1149,-395,26,77,H1
"Kalamazoo County, MI",2005-2006,243259,244178,919,0.378,1284,-365,26,77,H1
"Kalamazoo County, MI",2006-2007,244178,245431,1253,0.513,1320,-67,26,77,H1
"Kalamazoo County, MI",2007-2008,245431,246862,1431,0.583,1295,136,26,77,H1
"Kalamazoo County, MI",2008-2009,246862,249023,2161,0.875,1281,880,26,77,H1
"Kalamazoo County, MI",2009-2010,249023,250777,1754,0.704,1290,464,26,77,H1
"Kalamazoo County, MI",2010-2011,250777,252525,1748,0.697,982,766,26,77,H1
"Kalamazoo County, MI",2011-2012,252525,255020,2495,0.988,1148,1347,26,77,H1
"Kalamazoo County, MI",2012-2013,255020,257211,2191,0.859,1217,974,26,77,H1
"Kalamazoo County, MI",2013-2014,257211,258818,1607,0.625,1084,523,26,77,H1
"Kalamazoo County, MI",2014-2015,258908,260263,1355,0.523,1102,253,26,77,H1
"Kalamazoo County, MI",2015-2016,260263,261056,793,0.305,1018,-225,26,77,H1
"Kalamazoo County, MI",2016-2017,261056,262985,1929,0.739,989,940,26,77,H1
"Kalkaska County, MI",2000-2001,16640,16873,233,1.4,59,174,26,79,H1
"Kalkaska County, MI",2001-2002,16873,16989,116,0.687,50,66,26,79,H1
"Kalkaska County, MI",2002-2003,16989,17296,307,1.807,77,230,26,79,H1
"Kalkaska County, MI",2003-2004,17296,17400,104,0.601,87,17,26,79,H1
"Kalkaska County, MI",2004-2005,17400,17381,-19,-0.109,79,-98,26,79,H1
"Kalkaska County, MI",2005-2006,17381,17572,191,1.099,57,134,26,79,H1
"Kalkaska County, MI",2006-2007,17572,17540,-32,-0.182,38,-70,26,79,H1
"Kalkaska County, MI",2007-2008,17540,17546,6,0.034,93,-87,26,79,H1
"Kalkaska County, MI",2008-2009,17546,17223,-323,-1.841,72,-395,26,79,H1
"Kalkaska County, MI",2009-2010,17223,17125,-98,-0.569,32,-130,26,79,H1
"Kalkaska County, MI",2010-2011,17125,17144,19,0.111,-27,46,26,79,H1
"Kalkaska County, MI",2011-2012,17144,17082,-62,-0.362,-23,-39,26,79,H1
"Kalkaska County, MI",2012-2013,17082,17274,192,1.124,17,175,26,79,H1
"Kalkaska County, MI",2013-2014,17274,17394,120,0.695,13,107,26,79,H1
"Kalkaska County, MI",2014-2015,17378,17260,-118,-0.679,-1,-117,26,79,H1
"Kalkaska County, MI",2015-2016,17260,17300,40,0.232,-8,48,26,79,H1
"Kalkaska County, MI",2016-2017,17300,17634,334,1.931,0,334,26,79,H1
"Kent County, MI",2000-2001,576178,581224,5046,0.876,5345,-299,26,81,H1
"Kent County, MI",2001-2002,581224,584940,3716,0.639,5113,-1397,26,81,H1
"Kent County, MI",2002-2003,584940,587790,2850,0.487,5262,-2412,26,81,H1
"Kent County, MI",2003-2004,587790,589554,1764,0.3,5258,-3494,26,81,H1
"Kent County, MI",2004-2005,589554,592210,2656,0.451,5151,-2495,26,81,H1
"Kent County, MI",2005-2006,592210,595191,2981,0.503,5257,-2276,26,81,H1
"Kent County, MI",2006-2007,595191,598077,2886,0.485,5403,-2517,26,81,H1
"Kent County, MI",2007-2008,598077,599234,1157,0.193,5339,-4182,26,81,H1
"Kent County, MI",2008-2009,599234,601437,2203,0.368,5107,-2904,26,81,H1
"Kent County, MI",2009-2010,601437,602812,1375,0.229,4888,-3513,26,81,H1
"Kent County, MI",2010-2011,602812,607913,5101,0.846,4419,682,26,81,H1
"Kent County, MI",2011-2012,607913,614545,6632,1.091,4401,2231,26,81,H1
"Kent County, MI",2012-2013,614545,622396,7851,1.278,4624,3227,26,81,H1
"Kent County, MI",2013-2014,622396,629237,6841,1.099,4652,2189,26,81,H1
"Kent County, MI",2014-2015,630225,636369,6144,0.975,4588,1556,26,81,H1
"Kent County, MI",2015-2016,636369,642909,6540,1.028,4126,2414,26,81,H1
"Kent County, MI",2016-2017,642909,648594,5685,0.884,4171,1514,26,81,H1
"Keweenaw County, MI",2000-2001,2274,2264,-10,-0.44,9,-19,26,83,H1
"Keweenaw County, MI",2001-2002,2264,2219,-45,-1.988,-5,-40,26,83,H1
"Keweenaw County, MI",2002-2003,2219,2174,-45,-2.028,2,-47,26,83,H1
"Keweenaw County, MI",2003-2004,2174,2125,-49,-2.254,-7,-42,26,83,H1
"Keweenaw County, MI",2004-2005,2125,2068,-57,-2.682,-19,-38,26,83,H1
"Keweenaw County, MI",2005-2006,2068,2087,19,0.919,13,6,26,83,H1
"Keweenaw County, MI",2006-2007,2087,2104,17,0.815,18,-1,26,83,H1
"Keweenaw County, MI",2007-2008,2104,2119,15,0.713,0,15,26,83,H1
"Keweenaw County, MI",2008-2009,2119,2131,12,0.566,-4,16,26,83,H1
"Keweenaw County, MI",2009-2010,2131,2143,12,0.563,1,11,26,83,H1
"Keweenaw County, MI",2010-2011,2143,2229,86,4.013,-3,89,26,83,H1
"Keweenaw County, MI",2011-2012,2229,2207,-22,-0.987,-2,-20,26,83,H1
"Keweenaw County, MI",2012-2013,2207,2181,-26,-1.178,3,-29,26,83,H1
"Keweenaw County, MI",2013-2014,2181,2217,36,1.651,6,30,26,83,H1
"Keweenaw County, MI",2014-2015,2210,2168,-42,-1.9,1,-43,26,83,H1
"Keweenaw County, MI",2015-2016,2168,2139,-29,-1.338,-3,-26,26,83,H1
"Keweenaw County, MI",2016-2017,2139,2105,-34,-1.59,0,-34,26,83,H1
"Lake County, MI",2000-2001,11338,11444,106,0.935,-40,146,26,85,H1
"Lake County, MI",2001-2002,11444,11390,-54,-0.472,-77,23,26,85,H1
"Lake County, MI",2002-2003,11390,11611,221,1.94,-37,258,26,85,H1
"Lake County, MI",2003-2004,11611,11757,146,1.257,-24,170,26,85,H1
"Lake County, MI",2004-2005,11757,11792,35,0.298,-52,87,26,85,H1
"Lake County, MI",2005-2006,11792,11707,-85,-0.721,-26,-59,26,85,H1
"Lake County, MI",2006-2007,11707,11692,-15,-0.128,-31,16,26,85,H1
"Lake County, MI",2007-2008,11692,11629,-63,-0.539,-45,-18,26,85,H1
"Lake County, MI",2008-2009,11629,11593,-36,-0.31,-27,-9,26,85,H1
"Lake County, MI",2009-2010,11593,11499,-94,-0.811,-38,-56,26,85,H1
"Lake County, MI",2010-2011,11499,11475,-24,-0.209,-63,39,26,85,H1
"Lake County, MI",2011-2012,11475,11468,-7,-0.061,-38,31,26,85,H1
"Lake County, MI",2012-2013,11468,11372,-96,-0.837,-50,-46,26,85,H1
"Lake County, MI",2013-2014,11372,11341,-31,-0.273,-46,15,26,85,H1
"Lake County, MI",2014-2015,11345,11424,79,0.696,-42,121,26,85,H1
"Lake County, MI",2015-2016,11424,11861,437,3.825,-36,473,26,85,H1
"Lake County, MI",2016-2017,11861,12013,152,1.282,-37,189,26,85,H1
"Lapeer County, MI",2000-2001,88271,89102,831,0.941,510,321,26,87,H1
"Lapeer County, MI",2001-2002,89102,90035,933,1.047,496,437,26,87,H1
"Lapeer County, MI",2002-2003,90035,90573,538,0.598,355,183,26,87,H1
"Lapeer County, MI",2003-2004,90573,91125,552,0.609,412,140,26,87,H1
"Lapeer County, MI",2004-2005,91125,91739,614,0.674,458,156,26,87,H1
"Lapeer County, MI",2005-2006,91739,91691,-48,-0.052,263,-311,26,87,H1
"Lapeer County, MI",2006-2007,91691,91130,-561,-0.612,269,-830,26,87,H1
"Lapeer County, MI",2007-2008,91130,89914,-1216,-1.334,326,-1542,26,87,H1
"Lapeer County, MI",2008-2009,89914,88774,-1140,-1.268,338,-1478,26,87,H1
"Lapeer County, MI",2009-2010,88774,88159,-615,-0.693,144,-759,26,87,H1
"Lapeer County, MI",2010-2011,88159,88024,-135,-0.153,31,-166,26,87,H1
"Lapeer County, MI",2011-2012,88024,88184,160,0.182,112,48,26,87,H1
"Lapeer County, MI",2012-2013,88184,88257,73,0.083,34,39,26,87,H1
"Lapeer County, MI",2013-2014,88257,88153,-104,-0.118,6,-110,26,87,H1
"Lapeer County, MI",2014-2015,88199,88373,174,0.197,-20,194,26,87,H1
"Lapeer County, MI",2015-2016,88373,88141,-232,-0.263,-92,-140,26,87,H1
"Lapeer County, MI",2016-2017,88141,88174,33,0.037,-98,131,26,87,H1
"Leelanau County, MI",2000-2001,21257,21490,233,1.096,39,194,26,89,H1
"Leelanau County, MI",2001-2002,21490,21518,28,0.13,-31,59,26,89,H1
"Leelanau County, MI",2002-2003,21518,21792,274,1.273,26,248,26,89,H1
"Leelanau County, MI",2003-2004,21792,21859,67,0.307,2,65,26,89,H1
"Leelanau County, MI",2004-2005,21859,21813,-46,-0.21,7,-53,26,89,H1
"Leelanau County, MI",2005-2006,21813,21818,5,0.023,6,-1,26,89,H1
"Leelanau County, MI",2006-2007,21818,21809,-9,-0.041,-12,3,26,89,H1
"Leelanau County, MI",2007-2008,21809,21731,-78,-0.358,-10,-68,26,89,H1
"Leelanau County, MI",2008-2009,21731,21724,-7,-0.032,3,-10,26,89,H1
"Leelanau County, MI",2009-2010,21724,21725,1,0.005,-27,28,26,89,H1
"Leelanau County, MI",2010-2011,21725,21672,-53,-0.244,-37,-16,26,89,H1
"Leelanau County, MI",2011-2012,21672,21636,-36,-0.166,-54,18,26,89,H1
"Leelanau County, MI",2012-2013,21636,21747,111,0.513,-51,162,26,89,H1
"Leelanau County, MI",2013-2014,21747,21915,168,0.773,-58,226,26,89,H1
"Leelanau County, MI",2014-2015,21884,21981,97,0.443,-36,133,26,89,H1
"Leelanau County, MI",2015-2016,21981,21493,-488,-2.22,-49,-439,26,89,H1
"Leelanau County, MI",2016-2017,21493,21657,164,0.763,-56,220,26,89,H1
"Lenawee County, MI",2000-2001,99069,99626,557,0.562,374,183,26,91,H1
"Lenawee County, MI",2001-2002,99626,100293,667,0.67,323,344,26,91,H1
"Lenawee County, MI",2002-2003,100293,100704,411,0.41,383,28,26,91,H1
"Lenawee County, MI",2003-2004,100704,101216,512,0.508,370,142,26,91,H1
"Lenawee County, MI",2004-2005,101216,101367,151,0.149,394,-243,26,91,H1
"Lenawee County, MI",2005-2006,101367,101715,348,0.343,325,23,26,91,H1
"Lenawee County, MI",2006-2007,101715,101657,-58,-0.057,278,-336,26,91,H1
"Lenawee County, MI",2007-2008,101657,101169,-488,-0.48,322,-810,26,91,H1
"Lenawee County, MI",2008-2009,101169,100250,-919,-0.908,357,-1276,26,91,H1
"Lenawee County, MI",2009-2010,100250,99649,-601,-0.6,229,-830,26,91,H1
"Lenawee County, MI",2010-2011,99649,99391,-258,-0.259,79,-337,26,91,H1
"Lenawee County, MI",2011-2012,99391,99150,-241,-0.242,187,-428,26,91,H1
"Lenawee County, MI",2012-2013,99150,99048,-102,-0.103,19,-121,26,91,H1
"Lenawee County, MI",2013-2014,99048,99047,-1,-0.001,45,-46,26,91,H1
"Lenawee County, MI",2014-2015,98780,98573,-207,-0.21,130,-337,26,91,H1
"Lenawee County, MI",2015-2016,98573,98510,-63,-0.064,45,-108,26,91,H1
"Lenawee County, MI",2016-2017,98510,98623,113,0.115,70,43,26,91,H1
"Livingston County, MI",2000-2001,158345,163146,4801,3.032,1101,3700,26,93,H1
"Livingston County, MI",2001-2002,163146,167833,4687,2.873,1044,3643,26,93,H1
"Livingston County, MI",2002-2003,167833,171357,3524,2.1,1006,2518,26,93,H1
"Livingston County, MI",2003-2004,171357,175245,3888,2.269,1045,2843,26,93,H1
"Livingston County, MI",2004-2005,175245,178819,3574,2.039,942,2632,26,93,H1
"Livingston County, MI",2005-2006,178819,181620,2801,1.566,921,1880,26,93,H1
"Livingston County, MI",2006-2007,181620,181903,283,0.156,773,-490,26,93,H1
"Livingston County, MI",2007-2008,181903,181171,-732,-0.402,759,-1491,26,93,H1
"Livingston County, MI",2008-2009,181171,181082,-89,-0.049,936,-1025,26,93,H1
"Livingston County, MI",2009-2010,181082,180987,-95,-0.052,469,-564,26,93,H1
"Livingston County, MI",2010-2011,180987,182334,1347,0.744,363,984,26,93,H1
"Livingston County, MI",2011-2012,182334,183013,679,0.372,402,277,26,93,H1
"Livingston County, MI",2012-2013,183013,184392,1379,0.753,393,986,26,93,H1
"Livingston County, MI",2013-2014,184392,185596,1204,0.653,316,888,26,93,H1
"Livingston County, MI",2014-2015,185703,187316,1613,0.869,322,1291,26,93,H1
"Livingston County, MI",2015-2016,187316,188358,1042,0.556,288,754,26,93,H1
"Livingston County, MI",2016-2017,188358,189651,1293,0.686,277,1016,26,93,H1
"Luce County, MI",2000-2001,7006,7089,83,1.185,-4,87,26,95,H1
"Luce County, MI",2001-2002,7089,7026,-63,-0.889,-40,-23,26,95,H1
"Luce County, MI",2002-2003,7026,6918,-108,-1.537,-34,-74,26,95,H1
"Luce County, MI",2003-2004,6918,6894,-24,-0.347,-28,4,26,95,H1
"Luce County, MI",2004-2005,6894,6810,-84,-1.218,-12,-72,26,95,H1
"Luce County, MI",2005-2006,6810,6736,-74,-1.087,-9,-65,26,95,H1
"Luce County, MI",2006-2007,6736,6791,55,0.817,-13,68,26,95,H1
"Luce County, MI",2007-2008,6791,6680,-111,-1.635,-6,-105,26,95,H1
"Luce County, MI",2008-2009,6680,6614,-66,-0.988,-13,-53,26,95,H1
"Luce County, MI",2009-2010,6614,6599,-15,-0.227,-13,-2,26,95,H1
"Luce County, MI",2010-2011,6599,6519,-80,-1.212,-22,-58,26,95,H1
"Luce County, MI",2011-2012,6519,6494,-25,-0.383,-9,-16,26,95,H1
"Luce County, MI",2012-2013,6494,6520,26,0.4,-7,33,26,95,H1
"Luce County, MI",2013-2014,6520,6426,-94,-1.442,-24,-70,26,95,H1
"Luce County, MI",2014-2015,6422,6415,-7,-0.109,-42,35,26,95,H1
"Luce County, MI",2015-2016,6415,6341,-74,-1.154,-36,-38,26,95,H1
"Luce County, MI",2016-2017,6341,6358,17,0.268,-34,51,26,95,H1
"Mackinac County, MI",2000-2001,11938,11803,-135,-1.131,-28,-107,26,97,H1
"Mackinac County, MI",2001-2002,11803,11725,-78,-0.661,-35,-43,26,97,H1
"Mackinac County, MI",2002-2003,11725,11656,-69,-0.588,-23,-46,26,97,H1
"Mackinac County, MI",2003-2004,11656,11647,-9,-0.077,-44,35,26,97,H1
"Mackinac County, MI",2004-2005,11647,11596,-51,-0.438,-22,-29,26,97,H1
"Mackinac County, MI",2005-2006,11596,11474,-122,-1.052,-28,-94,26,97,H1
"Mackinac County, MI",2006-2007,11474,11448,-26,-0.227,-32,6,26,97,H1
"Mackinac County, MI",2007-2008,11448,11248,-200,-1.747,-34,-166,26,97,H1
"Mackinac County, MI",2008-2009,11248,11159,-89,-0.791,-23,-66,26,97,H1
"Mackinac County, MI",2009-2010,11159,11087,-72,-0.645,-30,-42,26,97,H1
"Mackinac County, MI",2010-2011,11087,11069,-18,-0.162,-68,50,26,97,H1
"Mackinac County, MI",2011-2012,11069,11129,60,0.542,-37,97,26,97,H1
"Mackinac County, MI",2012-2013,11129,11072,-57,-0.512,-46,-11,26,97,H1
"Mackinac County, MI",2013-2014,11072,11042,-30,-0.271,-60,30,26,97,H1
"Mackinac County, MI",2014-2015,11060,10890,-170,-1.537,-34,-136,26,97,H1
"Mackinac County, MI",2015-2016,10890,10694,-196,-1.8,-59,-137,26,97,H1
"Mackinac County, MI",2016-2017,10694,10712,18,0.168,-55,73,26,97,H1
"Macomb County, MI",2000-2001,790846,800571,9725,1.23,2949,6776,26,99,H1
"Macomb County, MI",2001-2002,800571,808457,7886,0.985,2768,5118,26,99,H1
"Macomb County, MI",2002-2003,808457,815982,7525,0.931,2759,4766,26,99,H1
"Macomb County, MI",2003-2004,815982,823418,7436,0.911,3011,4425,26,99,H1
"Macomb County, MI",2004-2005,823418,828765,5347,0.649,2535,2812,26,99,H1
"Macomb County, MI",2005-2006,828765,833328,4563,0.551,2870,1693,26,99,H1
"Macomb County, MI",2006-2007,833328,835703,2375,0.285,2444,-69,26,99,H1
"Macomb County, MI",2007-2008,835703,837857,2154,0.258,2363,-209,26,99,H1
"Macomb County, MI",2008-2009,837857,839435,1578,0.188,2483,-905,26,99,H1
"Macomb County, MI",2009-2010,839435,841097,1662,0.198,1816,-154,26,99,H1
"Macomb County, MI",2010-2011,841097,842765,1668,0.198,989,679,26,99,H1
"Macomb County, MI",2011-2012,842765,847750,4985,0.592,1132,3853,26,99,H1
"Macomb County, MI",2012-2013,847750,854997,7247,0.855,1050,6197,26,99,H1
"Macomb County, MI",2013-2014,854997,860112,5115,0.598,1078,4037,26,99,H1
"Macomb County, MI",2014-2015,861636,864840,3204,0.372,1418,1786,26,99,H1
"Macomb County, MI",2015-2016,864840,867503,2663,0.308,923,1740,26,99,H1
"Macomb County, MI",2016-2017,867503,871375,3872,0.446,1006,2866,26,99,H1
"Manistee County, MI",2000-2001,24609,24725,116,0.471,-10,126,26,101,H1
"Manistee County, MI",2001-2002,24725,24929,204,0.825,-75,279,26,101,H1
"Manistee County, MI",2002-2003,24929,25194,265,1.063,-50,315,26,101,H1
"Manistee County, MI",2003-2004,25194,25048,-146,-0.58,-32,-114,26,101,H1
"Manistee County, MI",2004-2005,25048,25178,130,0.519,-26,156,26,101,H1
"Manistee County, MI",2005-2006,25178,25201,23,0.091,-21,44,26,101,H1
"Manistee County, MI",2006-2007,25201,25077,-124,-0.492,-57,-67,26,101,H1
"Manistee County, MI",2007-2008,25077,24960,-117,-0.467,-59,-58,26,101,H1
"Manistee County, MI",2008-2009,24960,24818,-142,-0.569,-72,-70,26,101,H1
"Manistee County, MI",2009-2010,24818,24554,-264,-1.064,-93,-171,26,101,H1
"Manistee County, MI",2010-2011,24554,24703,149,0.607,-114,263,26,101,H1
"Manistee County, MI",2011-2012,24703,24604,-99,-0.401,-122,23,26,101,H1
"Manistee County, MI",2012-2013,24604,24444,-160,-0.65,-134,-26,26,101,H1
"Manistee County, MI",2013-2014,24444,24420,-24,-0.098,-109,85,26,101,H1
"Manistee County, MI",2014-2015,24417,24461,44,0.18,-117,161,26,101,H1
"Manistee County, MI",2015-2016,24461,24438,-23,-0.094,-63,40,26,101,H1
"Manistee County, MI",2016-2017,24438,24427,-11,-0.045,-82,71,26,101,H1
"Marquette County, MI",2000-2001,64606,64738,132,0.204,-17,149,26,103,H1
"Marquette County, MI",2001-2002,64738,65012,274,0.423,-8,282,26,103,H1
"Marquette County, MI",2002-2003,65012,65043,31,0.048,-32,63,26,103,H1
"Marquette County, MI",2003-2004,65043,65620,577,0.887,14,563,26,103,H1
"Marquette County, MI",2004-2005,65620,65785,165,0.251,-27,192,26,103,H1
"Marquette County, MI",2005-2006,65785,66002,217,0.33,22,195,26,103,H1
"Marquette County, MI",2006-2007,66002,66131,129,0.195,75,54,26,103,H1
"Marquette County, MI",2007-2008,66131,66539,408,0.617,80,328,26,103,H1
"Marquette County, MI",2008-2009,66539,66765,226,0.34,36,190,26,103,H1
"Marquette County, MI",2009-2010,66765,67101,336,0.503,48,288,26,103,H1
"Marquette County, MI",2010-2011,67101,67446,345,0.514,-15,360,26,103,H1
"Marquette County, MI",2011-2012,67446,67790,344,0.51,103,241,26,103,H1
"Marquette County, MI",2012-2013,67790,67663,-127,-0.187,-9,-118,26,103,H1
"Marquette County, MI",2013-2014,67663,67676,13,0.019,3,10,26,103,H1
"Marquette County, MI",2014-2015,67675,67215,-460,-0.68,-44,-416,26,103,H1
"Marquette County, MI",2015-2016,67215,66461,-754,-1.122,-38,-716,26,103,H1
"Marquette County, MI",2016-2017,66461,66502,41,0.062,-29,70,26,103,H1
"Mason County, MI",2000-2001,28350,28475,125,0.441,-23,148,26,105,H1
"Mason County, MI",2001-2002,28475,28624,149,0.523,-71,220,26,105,H1
"Mason County, MI",2002-2003,28624,28735,111,0.388,20,91,26,105,H1
"Mason County, MI",2003-2004,28735,28842,107,0.372,25,82,26,105,H1
"Mason County, MI",2004-2005,28842,28748,-94,-0.326,-33,-61,26,105,H1
"Mason County, MI",2005-2006,28748,28846,98,0.341,62,36,26,105,H1
"Mason County, MI",2006-2007,28846,28685,-161,-0.558,11,-172,26,105,H1
"Mason County, MI",2007-2008,28685,28668,-17,-0.059,-2,-15,26,105,H1
"Mason County, MI",2008-2009,28668,28656,-12,-0.042,10,-22,26,105,H1
"Mason County, MI",2009-2010,28656,28725,69,0.241,-3,72,26,105,H1
"Mason County, MI",2010-2011,28725,28644,-81,-0.282,-55,-26,26,105,H1
"Mason County, MI",2011-2012,28644,28669,25,0.087,-76,101,26,105,H1
"Mason County, MI",2012-2013,28669,28665,-4,-0.014,-26,22,26,105,H1
"Mason County, MI",2013-2014,28665,28824,159,0.555,-19,178,26,105,H1
"Mason County, MI",2014-2015,28786,28783,-3,-0.01,-12,9,26,105,H1
"Mason County, MI",2015-2016,28783,28846,63,0.219,30,33,26,105,H1
"Mason County, MI",2016-2017,28846,29073,227,0.787,2,225,26,105,H1
"Mecosta County, MI",2000-2001,40657,41003,346,0.851,114,232,26,107,H1
"Mecosta County, MI",2001-2002,41003,41639,636,1.551,153,483,26,107,H1
"Mecosta County, MI",2002-2003,41639,42054,415,0.997,130,285,26,107,H1
"Mecosta County, MI",2003-2004,42054,42553,499,1.187,99,400,26,107,H1
"Mecosta County, MI",2004-2005,42553,42908,355,0.834,133,222,26,107,H1
"Mecosta County, MI",2005-2006,42908,42876,-32,-0.075,156,-188,26,107,H1
"Mecosta County, MI",2006-2007,42876,42640,-236,-0.55,107,-343,26,107,H1
"Mecosta County, MI",2007-2008,42640,42683,43,0.101,72,-29,26,107,H1
"Mecosta County, MI",2008-2009,42683,42621,-62,-0.145,106,-168,26,107,H1
"Mecosta County, MI",2009-2010,42621,42824,203,0.476,106,97,26,107,H1
"Mecosta County, MI",2010-2011,42824,43420,596,1.392,47,549,26,107,H1
"Mecosta County, MI",2011-2012,43420,43482,62,0.143,57,5,26,107,H1
"Mecosta County, MI",2012-2013,43482,43218,-264,-0.607,23,-287,26,107,H1
"Mecosta County, MI",2013-2014,43218,43186,-32,-0.074,50,-82,26,107,H1
"Mecosta County, MI",2014-2015,43207,43067,-140,-0.324,54,-194,26,107,H1
"Mecosta County, MI",2015-2016,43067,43172,105,0.244,68,37,26,107,H1
"Mecosta County, MI",2016-2017,43172,43391,219,0.507,61,158,26,107,H1
"Menominee County, MI",2000-2001,25281,25170,-111,-0.439,-27,-84,26,109,H1
"Menominee County, MI",2001-2002,25170,25023,-147,-0.584,-45,-102,26,109,H1
"Menominee County, MI",2002-2003,25023,24997,-26,-0.104,-8,-18,26,109,H1
"Menominee County, MI",2003-2004,24997,24987,-10,-0.04,-1,-9,26,109,H1
"Menominee County, MI",2004-2005,24987,24719,-268,-1.073,-45,-223,26,109,H1
"Menominee County, MI",2005-2006,24719,24472,-247,-0.999,-44,-203,26,109,H1
"Menominee County, MI",2006-2007,24472,24322,-150,-0.613,-39,-111,26,109,H1
"Menominee County, MI",2007-2008,24322,24317,-5,-0.021,-2,-3,26,109,H1
"Menominee County, MI",2008-2009,24317,24118,-199,-0.818,-3,-196,26,109,H1
"Menominee County, MI",2009-2010,24118,23973,-145,-0.601,-35,-110,26,109,H1
"Menominee County, MI",2010-2011,23973,23922,-51,-0.213,-69,18,26,109,H1
"Menominee County, MI",2011-2012,23922,23748,-174,-0.727,-83,-91,26,109,H1
"Menominee County, MI",2012-2013,23748,23835,87,0.366,22,65,26,109,H1
"Menominee County, MI",2013-2014,23835,23714,-121,-0.508,10,-131,26,109,H1
"Menominee County, MI",2014-2015,23611,23548,-63,-0.267,-22,-41,26,109,H1
"Menominee County, MI",2015-2016,23548,23221,-327,-1.389,-62,-265,26,109,H1
"Menominee County, MI",2016-2017,23221,23046,-175,-0.754,-44,-131,26,109,H1
"Midland County, MI",2000-2001,82913,83576,663,0.8,417,246,26,111,H1
"Midland County, MI",2001-2002,83576,83664,88,0.105,403,-315,26,111,H1
"Midland County, MI",2002-2003,83664,84012,348,0.416,369,-21,26,111,H1
"Midland County, MI",2003-2004,84012,84058,46,0.055,335,-289,26,111,H1
"Midland County, MI",2004-2005,84058,83930,-128,-0.152,265,-393,26,111,H1
"Midland County, MI",2005-2006,83930,83693,-237,-0.282,266,-503,26,111,H1
"Midland County, MI",2006-2007,83693,83600,-93,-0.111,249,-342,26,111,H1
"Midland County, MI",2007-2008,83600,83605,5,0.006,251,-246,26,111,H1
"Midland County, MI",2008-2009,83605,83639,34,0.041,247,-213,26,111,H1
"Midland County, MI",2009-2010,83639,83664,25,0.03,203,-178,26,111,H1
"Midland County, MI",2010-2011,83664,83765,101,0.121,166,-65,26,111,H1
"Midland County, MI",2011-2012,83765,83649,-116,-0.138,167,-283,26,111,H1
"Midland County, MI",2012-2013,83649,83593,-56,-0.067,119,-175,26,111,H1
"Midland County, MI",2013-2014,83593,83427,-166,-0.199,137,-303,26,111,H1
"Midland County, MI",2014-2015,83479,83632,153,0.183,138,15,26,111,H1
"Midland County, MI",2015-2016,83632,83433,-199,-0.238,73,-272,26,111,H1
"Midland County, MI",2016-2017,83433,83411,-22,-0.026,88,-110,26,111,H1
"Missaukee County, MI",2000-2001,14536,14590,54,0.371,35,19,26,113,H1
"Missaukee County, MI",2001-2002,14590,14842,252,1.727,43,209,26,113,H1
"Missaukee County, MI",2002-2003,14842,15031,189,1.273,36,153,26,113,H1
"Missaukee County, MI",2003-2004,15031,15127,96,0.639,39,57,26,113,H1
"Missaukee County, MI",2004-2005,15127,15099,-28,-0.185,14,-42,26,113,H1
"Missaukee County, MI",2005-2006,15099,15043,-56,-0.371,42,-98,26,113,H1
"Missaukee County, MI",2006-2007,15043,15009,-34,-0.226,45,-79,26,113,H1
"Missaukee County, MI",2007-2008,15009,15028,19,0.127,29,-10,26,113,H1
"Missaukee County, MI",2008-2009,15028,14898,-130,-0.865,20,-150,26,113,H1
"Missaukee County, MI",2009-2010,14898,14817,-81,-0.544,17,-98,26,113,H1
"Missaukee County, MI",2010-2011,14817,14945,128,0.864,4,124,26,113,H1
"Missaukee County, MI",2011-2012,14945,15037,92,0.616,56,36,26,113,H1
"Missaukee County, MI",2012-2013,15037,15092,55,0.366,21,34,26,113,H1
"Missaukee County, MI",2013-2014,15092,15037,-55,-0.364,29,-84,26,113,H1
"Missaukee County, MI",2014-2015,14988,14903,-85,-0.567,3,-88,26,113,H1
"Missaukee County, MI",2015-2016,14903,15032,129,0.866,26,103,26,113,H1
"Missaukee County, MI",2016-2017,15032,14998,-34,-0.226,9,-43,26,113,H1
"Monroe County, MI",2000-2001,146364,147605,1241,0.848,554,687,26,115,H1
"Monroe County, MI",2001-2002,147605,148561,956,0.648,463,493,26,115,H1
"Monroe County, MI",2002-2003,148561,149747,1186,0.798,567,619,26,115,H1
"Monroe County, MI",2003-2004,149747,151117,1370,0.915,602,768,26,115,H1
"Monroe County, MI",2004-2005,151117,152374,1257,0.832,479,778,26,115,H1
"Monroe County, MI",2005-2006,152374,153460,1086,0.713,536,550,26,115,H1
"Monroe County, MI",2006-2007,153460,153424,-36,-0.023,420,-456,26,115,H1
"Monroe County, MI",2007-2008,153424,152806,-618,-0.403,509,-1127,26,115,H1
"Monroe County, MI",2008-2009,152806,152296,-510,-0.334,561,-1071,26,115,H1
"Monroe County, MI",2009-2010,152296,151911,-385,-0.253,377,-762,26,115,H1
"Monroe County, MI",2010-2011,151911,151499,-412,-0.271,307,-719,26,115,H1
"Monroe County, MI",2011-2012,151499,150840,-659,-0.435,149,-808,26,115,H1
"Monroe County, MI",2012-2013,150840,150179,-661,-0.438,12,-673,26,115,H1
"Monroe County, MI",2013-2014,150179,149824,-355,-0.236,92,-447,26,115,H1
"Monroe County, MI",2014-2015,149945,149568,-377,-0.251,175,-552,26,115,H1
"Monroe County, MI",2015-2016,149568,149223,-345,-0.231,68,-413,26,115,H1
"Monroe County, MI",2016-2017,149223,149649,426,0.285,87,339,26,115,H1
"Montcalm County, MI",2000-2001,61484,62083,599,0.974,336,263,26,117,H1
"Montcalm County, MI",2001-2002,62083,62547,464,0.747,280,184,26,117,H1
"Montcalm County, MI",2002-2003,62547,62959,412,0.659,254,158,26,117,H1
"Montcalm County, MI",2003-2004,62959,63482,523,0.831,280,243,26,117,H1
"Montcalm County, MI",2004-2005,63482,63621,139,0.219,348,-209,26,117,H1
"Montcalm County, MI",2005-2006,63621,63806,185,0.291,247,-62,26,117,H1
"Montcalm County, MI",2006-2007,63806,63560,-246,-0.386,279,-525,26,117,H1
"Montcalm County, MI",2007-2008,63560,63635,75,0.118,269,-194,26,117,H1
"Montcalm County, MI",2008-2009,63635,63496,-139,-0.218,282,-421,26,117,H1
"Montcalm County, MI",2009-2010,63496,63261,-235,-0.37,175,-410,26,117,H1
"Montcalm County, MI",2010-2011,63261,63173,-88,-0.139,155,-243,26,117,H1
"Montcalm County, MI",2011-2012,63173,63059,-114,-0.18,175,-289,26,117,H1
"Montcalm County, MI",2012-2013,63059,62843,-216,-0.343,130,-346,26,117,H1
"Montcalm County, MI",2013-2014,62843,62893,50,0.08,162,-112,26,117,H1
"Montcalm County, MI",2014-2015,62900,62945,45,0.072,167,-122,26,117,H1
"Montcalm County, MI",2015-2016,62945,62963,18,0.029,131,-113,26,117,H1
"Montcalm County, MI",2016-2017,62963,63550,587,0.932,119,468,26,117,H1
"Montmorency County, MI",2000-2001,10364,10389,25,0.241,-64,89,26,119,H1
"Montmorency County, MI",2001-2002,10389,10397,8,0.077,-83,91,26,119,H1
"Montmorency County, MI",2002-2003,10397,10382,-15,-0.144,-42,27,26,119,H1
"Montmorency County, MI",2003-2004,10382,10326,-56,-0.539,-70,14,26,119,H1
"Montmorency County, MI",2004-2005,10326,10222,-104,-1.007,-71,-33,26,119,H1
"Montmorency County, MI",2005-2006,10222,10125,-97,-0.949,-73,-24,26,119,H1
"Montmorency County, MI",2006-2007,10125,9996,-129,-1.274,-78,-51,26,119,H1
"Montmorency County, MI",2007-2008,9996,9922,-74,-0.74,-58,-16,26,119,H1
"Montmorency County, MI",2008-2009,9922,9794,-128,-1.29,-66,-62,26,119,H1
"Montmorency County, MI",2009-2010,9794,9775,-19,-0.194,-78,59,26,119,H1
"Montmorency County, MI",2010-2011,9775,9595,-180,-1.841,-92,-88,26,119,H1
"Montmorency County, MI",2011-2012,9595,9492,-103,-1.073,-79,-24,26,119,H1
"Montmorency County, MI",2012-2013,9492,9368,-124,-1.306,-107,-17,26,119,H1
"Montmorency County, MI",2013-2014,9368,9300,-68,-0.726,-106,38,26,119,H1
"Montmorency County, MI",2014-2015,9292,9259,-33,-0.355,-96,63,26,119,H1
"Montmorency County, MI",2015-2016,9259,9206,-53,-0.572,-81,28,26,119,H1
"Montmorency County, MI",2016-2017,9206,9250,44,0.478,-80,124,26,119,H1
"Muskegon County, MI",2000-2001,170396,171055,659,0.387,847,-188,26,121,H1
"Muskegon County, MI",2001-2002,171055,171563,508,0.297,719,-211,26,121,H1
"Muskegon County, MI",2002-2003,171563,172269,706,0.412,737,-31,26,121,H1
"Muskegon County, MI",2003-2004,172269,172771,502,0.291,807,-305,26,121,H1
"Muskegon County, MI",2004-2005,172771,173608,837,0.484,714,123,26,121,H1
"Muskegon County, MI",2005-2006,173608,173710,102,0.059,707,-605,26,121,H1
"Muskegon County, MI",2006-2007,173710,173738,28,0.016,779,-751,26,121,H1
"Muskegon County, MI",2007-2008,173738,173846,108,0.062,850,-742,26,121,H1
"Muskegon County, MI",2008-2009,173846,172755,-1091,-0.628,859,-1950,26,121,H1
"Muskegon County, MI",2009-2010,172755,171916,-839,-0.486,701,-1540,26,121,H1
"Muskegon County, MI",2010-2011,171916,169986,-1930,-1.123,501,-2431,26,121,H1
"Muskegon County, MI",2011-2012,169986,170146,160,0.094,480,-320,26,121,H1
"Muskegon County, MI",2012-2013,170146,172246,2100,1.234,448,1652,26,121,H1
"Muskegon County, MI",2013-2014,172246,172344,98,0.057,434,-336,26,121,H1
"Muskegon County, MI",2014-2015,172300,172790,490,0.284,464,26,26,121,H1
"Muskegon County, MI",2015-2016,172790,173102,312,0.181,394,-82,26,121,H1
"Muskegon County, MI",2016-2017,173102,173693,591,0.341,351,240,26,121,H1
"Newaygo County, MI",2000-2001,47972,48564,592,1.234,234,358,26,123,H1
"Newaygo County, MI",2001-2002,48564,48697,133,0.274,136,-3,26,123,H1
"Newaygo County, MI",2002-2003,48697,49072,375,0.77,165,210,26,123,H1
"Newaygo County, MI",2003-2004,49072,49272,200,0.408,172,28,26,123,H1
"Newaygo County, MI",2004-2005,49272,49452,180,0.365,210,-30,26,123,H1
"Newaygo County, MI",2005-2006,49452,49287,-165,-0.334,245,-410,26,123,H1
"Newaygo County, MI",2006-2007,49287,49328,41,0.083,268,-227,26,123,H1
"Newaygo County, MI",2007-2008,49328,49153,-175,-0.355,219,-394,26,123,H1
"Newaygo County, MI",2008-2009,49153,48649,-504,-1.025,192,-696,26,123,H1
"Newaygo County, MI",2009-2010,48649,48389,-260,-0.534,109,-369,26,123,H1
"Newaygo County, MI",2010-2011,48389,48434,45,0.093,93,-48,26,123,H1
"Newaygo County, MI",2011-2012,48434,47962,-472,-0.975,91,-563,26,123,H1
"Newaygo County, MI",2012-2013,47962,47944,-18,-0.038,57,-75,26,123,H1
"Newaygo County, MI",2013-2014,47944,47900,-44,-0.092,74,-118,26,123,H1
"Newaygo County, MI",2014-2015,47883,47948,65,0.136,41,24,26,123,H1
"Newaygo County, MI",2015-2016,47948,47788,-160,-0.334,12,-172,26,123,H1
"Newaygo County, MI",2016-2017,47788,48242,454,0.95,9,445,26,123,H1
"Oakland County, MI",2000-2001,1196165,1200425,4260,0.356,7121,-2861,26,125,H1
"Oakland County, MI",2001-2002,1200425,1198889,-1536,-0.128,6530,-8066,26,125,H1
"Oakland County, MI",2002-2003,1198889,1201756,2867,0.239,6421,-3554,26,125,H1
"Oakland County, MI",2003-2004,1201756,1203812,2056,0.171,6399,-4343,26,125,H1
"Oakland County, MI",2004-2005,1203812,1203253,-559,-0.046,5844,-6403,26,125,H1
"Oakland County, MI",2005-2006,1203253,1202256,-997,-0.083,5499,-6496,26,125,H1
"Oakland County, MI",2006-2007,1202256,1199862,-2394,-0.199,5072,-7466,26,125,H1
"Oakland County, MI",2007-2008,1199862,1199545,-317,-0.026,4678,-4995,26,125,H1
"Oakland County, MI",2008-2009,1199545,1200890,1345,0.112,4582,-3237,26,125,H1
"Oakland County, MI",2009-2010,1200890,1202763,1873,0.156,4439,-2566,26,125,H1
"Oakland County, MI",2010-2011,1202763,1210910,8147,0.677,3352,4795,26,125,H1
"Oakland County, MI",2011-2012,1210910,1220631,9721,0.803,3522,6199,26,125,H1
"Oakland County, MI",2012-2013,1220631,1231820,11189,0.917,3563,7626,26,125,H1
"Oakland County, MI",2013-2014,1231820,1237868,6048,0.491,3502,2546,26,125,H1
"Oakland County, MI",2014-2015,1239897,1242304,2407,0.194,3286,-879,26,125,H1
"Oakland County, MI",2015-2016,1242304,1245762,3458,0.278,2897,561,26,125,H1
"Oakland County, MI",2016-2017,1245762,1250836,5074,0.407,2827,2247,26,125,H1
"Oceana County, MI",2000-2001,26902,26934,32,0.119,145,-113,26,127,H1
"Oceana County, MI",2001-2002,26934,27281,347,1.288,157,190,26,127,H1
"Oceana County, MI",2002-2003,27281,27404,123,0.451,142,-19,26,127,H1
"Oceana County, MI",2003-2004,27404,27556,152,0.555,174,-22,26,127,H1
"Oceana County, MI",2004-2005,27556,27423,-133,-0.483,88,-221,26,127,H1
"Oceana County, MI",2005-2006,27423,27484,61,0.222,189,-128,26,127,H1
"Oceana County, MI",2006-2007,27484,27251,-233,-0.848,142,-375,26,127,H1
"Oceana County, MI",2007-2008,27251,27120,-131,-0.481,147,-278,26,127,H1
"Oceana County, MI",2008-2009,27120,26779,-341,-1.257,164,-505,26,127,H1
"Oceana County, MI",2009-2010,26779,26524,-255,-0.952,109,-364,26,127,H1
"Oceana County, MI",2010-2011,26524,26426,-98,-0.369,103,-201,26,127,H1
"Oceana County, MI",2011-2012,26426,26259,-167,-0.632,66,-233,26,127,H1
"Oceana County, MI",2012-2013,26259,26195,-64,-0.244,66,-130,26,127,H1
"Oceana County, MI",2013-2014,26195,26221,26,0.099,63,-37,26,127,H1
"Oceana County, MI",2014-2015,26174,26105,-69,-0.264,22,-91,26,127,H1
"Oceana County, MI",2015-2016,26105,26281,176,0.674,47,129,26,127,H1
"Oceana County, MI",2016-2017,26281,26442,161,0.613,54,107,26,127,H1
"Ogemaw County, MI",2000-2001,21710,21787,77,0.355,-93,170,26,129,H1
"Ogemaw County, MI",2001-2002,21787,21890,103,0.473,-60,163,26,129,H1
"Ogemaw County, MI",2002-2003,21890,21990,100,0.457,-78,178,26,129,H1
"Ogemaw County, MI",2003-2004,21990,22053,63,0.286,-75,138,26,129,H1
"Ogemaw County, MI",2004-2005,22053,22071,18,0.082,-107,125,26,129,H1
"Ogemaw County, MI",2005-2006,22071,22003,-68,-0.308,-98,30,26,129,H1
"Ogemaw County, MI",2006-2007,22003,21941,-62,-0.282,-122,60,26,129,H1
"Ogemaw County, MI",2007-2008,21941,21885,-56,-0.255,-89,33,26,129,H1
"Ogemaw County, MI",2008-2009,21885,21856,-29,-0.133,-77,48,26,129,H1
"Ogemaw County, MI",2009-2010,21856,21642,-214,-0.979,-107,-107,26,129,H1
"Ogemaw County, MI",2010-2011,21642,21538,-104,-0.481,-100,-4,26,129,H1
"Ogemaw County, MI",2011-2012,21538,21425,-113,-0.525,-82,-31,26,129,H1
"Ogemaw County, MI",2012-2013,21425,21219,-206,-0.961,-120,-86,26,129,H1
"Ogemaw County, MI",2013-2014,21219,21039,-180,-0.848,-109,-71,26,129,H1
"Ogemaw County, MI",2014-2015,21010,20937,-73,-0.347,-97,24,26,129,H1
"Ogemaw County, MI",2015-2016,20937,20902,-35,-0.167,-98,63,26,129,H1
"Ogemaw County, MI",2016-2017,20902,20981,79,0.378,-94,173,26,129,H1
"Ontonagon County, MI",2000-2001,7825,7758,-67,-0.856,-70,3,26,131,H1
"Ontonagon County, MI",2001-2002,7758,7702,-56,-0.722,-60,4,26,131,H1
"Ontonagon County, MI",2002-2003,7702,7598,-104,-1.35,-65,-39,26,131,H1
"Ontonagon County, MI",2003-2004,7598,7497,-101,-1.329,-94,-7,26,131,H1
"Ontonagon County, MI",2004-2005,7497,7375,-122,-1.627,-44,-78,26,131,H1
"Ontonagon County, MI",2005-2006,7375,7241,-134,-1.817,-38,-96,26,131,H1
"Ontonagon County, MI",2006-2007,7241,7133,-108,-1.492,-47,-61,26,131,H1
"Ontonagon County, MI",2007-2008,7133,6922,-211,-2.958,-85,-126,26,131,H1
"Ontonagon County, MI",2008-2009,6922,6828,-94,-1.358,-59,-35,26,131,H1
"Ontonagon County, MI",2009-2010,6828,6742,-86,-1.26,-51,-35,26,131,H1
"Ontonagon County, MI",2010-2011,6742,6610,-132,-1.958,-68,-64,26,131,H1
"Ontonagon County, MI",2011-2012,6610,6404,-206,-3.116,-58,-148,26,131,H1
"Ontonagon County, MI",2012-2013,6404,6312,-92,-1.437,-43,-49,26,131,H1
"Ontonagon County, MI",2013-2014,6312,6172,-140,-2.218,-65,-75,26,131,H1
"Ontonagon County, MI",2014-2015,6158,6007,-151,-2.452,-80,-71,26,131,H1
"Ontonagon County, MI",2015-2016,6007,5931,-76,-1.265,-77,1,26,131,H1
"Ontonagon County, MI",2016-2017,5931,5881,-50,-0.843,-77,27,26,131,H1
"Osceola County, MI",2000-2001,23248,23434,186,0.8,54,132,26,133,H1
"Osceola County, MI",2001-2002,23434,23712,278,1.186,64,214,26,133,H1
"Osceola County, MI",2002-2003,23712,23889,177,0.746,114,63,26,133,H1
"Osceola County, MI",2003-2004,23889,23990,101,0.423,95,6,26,133,H1
"Osceola County, MI",2004-2005,23990,23946,-44,-0.183,88,-132,26,133,H1
"Osceola County, MI",2005-2006,23946,23887,-59,-0.246,78,-137,26,133,H1
"Osceola County, MI",2006-2007,23887,23827,-60,-0.251,57,-117,26,133,H1
"Osceola County, MI",2007-2008,23827,23662,-165,-0.692,49,-214,26,133,H1
"Osceola County, MI",2008-2009,23662,23522,-140,-0.592,91,-231,26,133,H1
"Osceola County, MI",2009-2010,23522,23512,-10,-0.043,65,-75,26,133,H1
"Osceola County, MI",2010-2011,23512,23447,-65,-0.276,25,-90,26,133,H1
"Osceola County, MI",2011-2012,23447,23270,-177,-0.755,47,-224,26,133,H1
"Osceola County, MI",2012-2013,23270,23237,-33,-0.142,60,-93,26,133,H1
"Osceola County, MI",2013-2014,23237,23169,-68,-0.293,46,-114,26,133,H1
"Osceola County, MI",2014-2015,23144,23058,-86,-0.372,31,-117,26,133,H1
"Osceola County, MI",2015-2016,23058,23171,113,0.49,-11,124,26,133,H1
"Osceola County, MI",2016-2017,23171,23260,89,0.384,0,89,26,133,H1
"Oscoda County, MI",2000-2001,9392,9433,41,0.437,-27,68,26,135,H1
"Oscoda County, MI",2001-2002,9433,9360,-73,-0.774,-18,-55,26,135,H1
"Oscoda County, MI",2002-2003,9360,9407,47,0.502,-13,60,26,135,H1
"Oscoda County, MI",2003-2004,9407,9299,-108,-1.148,-8,-100,26,135,H1
"Oscoda County, MI",2004-2005,9299,9108,-191,-2.054,-48,-143,26,135,H1
"Oscoda County, MI",2005-2006,9108,9090,-18,-0.198,-32,14,26,135,H1
"Oscoda County, MI",2006-2007,9090,9039,-51,-0.561,-46,-5,26,135,H1
"Oscoda County, MI",2007-2008,9039,8963,-76,-0.841,-30,-46,26,135,H1
"Oscoda County, MI",2008-2009,8963,8717,-246,-2.745,-21,-225,26,135,H1
"Oscoda County, MI",2009-2010,8717,8611,-106,-1.216,-42,-64,26,135,H1
"Oscoda County, MI",2010-2011,8611,8655,44,0.511,-45,89,26,135,H1
"Oscoda County, MI",2011-2012,8655,8602,-53,-0.612,-33,-20,26,135,H1
"Oscoda County, MI",2012-2013,8602,8388,-214,-2.488,-53,-161,26,135,H1
"Oscoda County, MI",2013-2014,8388,8371,-17,-0.203,-32,15,26,135,H1
"Oscoda County, MI",2014-2015,8350,8251,-99,-1.186,-45,-54,26,135,H1
"Oscoda County, MI",2015-2016,8251,8262,11,0.133,-26,37,26,135,H1
"Oscoda County, MI",2016-2017,8262,8287,25,0.303,-13,38,26,135,H1
"Otsego County, MI",2000-2001,23443,23829,386,1.647,76,310,26,137,H1
"Otsego County, MI",2001-2002,23829,24240,411,1.725,102,309,26,137,H1
"Otsego County, MI",2002-2003,24240,24446,206,0.85,65,141,26,137,H1
"Otsego County, MI",2003-2004,24446,24586,140,0.573,76,64,26,137,H1
"Otsego County, MI",2004-2005,24586,24758,172,0.7,74,98,26,137,H1
"Otsego County, MI",2005-2006,24758,24805,47,0.19,34,13,26,137,H1
"Otsego County, MI",2006-2007,24805,24719,-86,-0.347,71,-157,26,137,H1
"Otsego County, MI",2007-2008,24719,24378,-341,-1.38,43,-384,26,137,H1
"Otsego County, MI",2008-2009,24378,24190,-188,-0.771,36,-224,26,137,H1
"Otsego County, MI",2009-2010,24190,24151,-39,-0.161,23,-62,26,137,H1
"Otsego County, MI",2010-2011,24151,24138,-13,-0.054,19,-32,26,137,H1
"Otsego County, MI",2011-2012,24138,24049,-89,-0.369,22,-111,26,137,H1
"Otsego County, MI",2012-2013,24049,24133,84,0.349,-20,104,26,137,H1
"Otsego County, MI",2013-2014,24133,24158,25,0.104,-39,64,26,137,H1
"Otsego County, MI",2014-2015,24148,24253,105,0.435,-50,155,26,137,H1
"Otsego County, MI",2015-2016,24253,24385,132,0.544,-50,182,26,137,H1
"Otsego County, MI",2016-2017,24385,24538,153,0.627,-23,176,26,137,H1
"Ottawa County, MI",2000-2001,239559,243673,4114,1.717,2226,1888,26,139,H1
"Ottawa County, MI",2001-2002,243673,246637,2964,1.216,2116,848,26,139,H1
"Ottawa County, MI",2002-2003,246637,249828,3191,1.294,1941,1250,26,139,H1
"Ottawa County, MI",2003-2004,249828,253048,3220,1.289,2083,1137,26,139,H1
"Ottawa County, MI",2004-2005,253048,255261,2213,0.875,1990,223,26,139,H1
"Ottawa County, MI",2005-2006,255261,258003,2742,1.074,2058,684,26,139,H1
"Ottawa County, MI",2006-2007,258003,260037,2034,0.788,1945,89,26,139,H1
"Ottawa County, MI",2007-2008,260037,261906,1869,0.719,2031,-162,26,139,H1
"Ottawa County, MI",2008-2009,261906,262879,973,0.372,2149,-1176,26,139,H1
"Ottawa County, MI",2009-2010,262879,264052,1173,0.446,1766,-593,26,139,H1
"Ottawa County, MI",2010-2011,264052,266298,2246,0.851,1628,618,26,139,H1
"Ottawa County, MI",2011-2012,266298,269454,3156,1.185,1663,1493,26,139,H1
"Ottawa County, MI",2012-2013,269454,272877,3423,1.27,1680,1743,26,139,H1
"Ottawa County, MI",2013-2014,272877,276292,3415,1.251,1649,1766,26,139,H1
"Ottawa County, MI",2014-2015,276598,279955,3357,1.214,1746,1611,26,139,H1
"Ottawa County, MI",2015-2016,279955,283242,3287,1.174,1505,1782,26,139,H1
"Ottawa County, MI",2016-2017,283242,286383,3141,1.109,1511,1630,26,139,H1
"Presque Isle County, MI",2000-2001,14378,14273,-105,-0.73,-64,-41,26,141,H1
"Presque Isle County, MI",2001-2002,14273,14233,-40,-0.28,-50,10,26,141,H1
"Presque Isle County, MI",2002-2003,14233,14187,-46,-0.323,-38,-8,26,141,H1
"Presque Isle County, MI",2003-2004,14187,14163,-24,-0.169,-43,19,26,141,H1
"Presque Isle County, MI",2004-2005,14163,14100,-63,-0.445,-39,-24,26,141,H1
"Presque Isle County, MI",2005-2006,14100,14006,-94,-0.667,-72,-22,26,141,H1
"Presque Isle County, MI",2006-2007,14006,13942,-64,-0.457,-66,2,26,141,H1
"Presque Isle County, MI",2007-2008,13942,13701,-241,-1.729,-69,-172,26,141,H1
"Presque Isle County, MI",2008-2009,13701,13505,-196,-1.431,-58,-138,26,141,H1
"Presque Isle County, MI",2009-2010,13505,13299,-206,-1.525,-66,-140,26,141,H1
"Presque Isle County, MI",2010-2011,13299,13181,-118,-0.887,-104,-14,26,141,H1
"Presque Isle County, MI",2011-2012,13181,13112,-69,-0.523,-80,11,26,141,H1
"Presque Isle County, MI",2012-2013,13112,13044,-68,-0.519,-102,34,26,141,H1
"Presque Isle County, MI",2013-2014,13044,13004,-40,-0.307,-80,40,26,141,H1
"Presque Isle County, MI",2014-2015,12989,12841,-148,-1.139,-89,-59,26,141,H1
"Presque Isle County, MI",2015-2016,12841,12725,-116,-0.903,-95,-21,26,141,H1
"Presque Isle County, MI",2016-2017,12725,12791,66,0.519,-80,146,26,141,H1
"Roscommon County, MI",2000-2001,25494,25655,161,0.632,-167,328,26,143,H1
"Roscommon County, MI",2001-2002,25655,25683,28,0.109,-188,216,26,143,H1
"Roscommon County, MI",2002-2003,25683,25938,255,0.993,-141,396,26,143,H1
"Roscommon County, MI",2003-2004,25938,25771,-167,-0.644,-187,20,26,143,H1
"Roscommon County, MI",2004-2005,25771,25678,-93,-0.361,-165,72,26,143,H1
"Roscommon County, MI",2005-2006,25678,25560,-118,-0.46,-158,40,26,143,H1
"Roscommon County, MI",2006-2007,25560,25318,-242,-0.947,-185,-57,26,143,H1
"Roscommon County, MI",2007-2008,25318,24856,-462,-1.825,-176,-286,26,143,H1
"Roscommon County, MI",2008-2009,24856,24499,-357,-1.436,-157,-200,26,143,H1
"Roscommon County, MI",2009-2010,24499,24444,-55,-0.224,-176,121,26,143,H1
"Roscommon County, MI",2010-2011,24444,24283,-161,-0.659,-228,67,26,143,H1
"Roscommon County, MI",2011-2012,24283,24091,-192,-0.791,-220,28,26,143,H1
"Roscommon County, MI",2012-2013,24091,23930,-161,-0.668,-202,41,26,143,H1
"Roscommon County, MI",2013-2014,23930,23955,25,0.104,-208,233,26,143,H1
"Roscommon County, MI",2014-2015,24013,23898,-115,-0.479,-180,65,26,143,H1
"Roscommon County, MI",2015-2016,23898,23847,-51,-0.213,-198,147,26,143,H1
"Roscommon County, MI",2016-2017,23847,23895,48,0.201,-196,244,26,143,H1
"Saginaw County, MI",2000-2001,209899,209460,-439,-0.209,662,-1101,26,145,H1
"Saginaw County, MI",2001-2002,209460,209323,-137,-0.065,723,-860,26,145,H1
"Saginaw County, MI",2002-2003,209323,208755,-568,-0.271,614,-1182,26,145,H1
"Saginaw County, MI",2003-2004,208755,208489,-266,-0.127,646,-912,26,145,H1
"Saginaw County, MI",2004-2005,208489,207368,-1121,-0.538,496,-1617,26,145,H1
"Saginaw County, MI",2005-2006,207368,205822,-1546,-0.746,567,-2113,26,145,H1
"Saginaw County, MI",2006-2007,205822,203144,-2678,-1.301,298,-2976,26,145,H1
"Saginaw County, MI",2007-2008,203144,201966,-1178,-0.58,486,-1664,26,145,H1
"Saginaw County, MI",2008-2009,201966,200835,-1131,-0.56,525,-1656,26,145,H1
"Saginaw County, MI",2009-2010,200835,199882,-953,-0.475,428,-1381,26,145,H1
"Saginaw County, MI",2010-2011,199882,198815,-1067,-0.534,236,-1303,26,145,H1
"Saginaw County, MI",2011-2012,198815,198268,-547,-0.275,372,-919,26,145,H1
"Saginaw County, MI",2012-2013,198268,196660,-1608,-0.811,244,-1852,26,145,H1
"Saginaw County, MI",2013-2014,196660,195012,-1648,-0.838,241,-1889,26,145,H1
"Saginaw County, MI",2014-2015,195142,193307,-1835,-0.94,211,-2046,26,145,H1
"Saginaw County, MI",2015-2016,193307,192285,-1022,-0.529,119,-1141,26,145,H1
"Saginaw County, MI",2016-2017,192285,191934,-351,-0.183,75,-426,26,145,H1
"St. Clair County, MI",2000-2001,164621,165444,823,0.5,591,232,26,147,H1
"St. Clair County, MI",2001-2002,165444,166086,642,0.388,535,107,26,147,H1
"St. Clair County, MI",2002-2003,166086,167549,1463,0.881,617,846,26,147,H1
"St. Clair County, MI",2003-2004,167549,168457,908,0.542,638,270,26,147,H1
"St. Clair County, MI",2004-2005,168457,168209,-248,-0.147,585,-833,26,147,H1
"St. Clair County, MI",2005-2006,168209,168312,103,0.061,485,-382,26,147,H1
"St. Clair County, MI",2006-2007,168312,167526,-786,-0.467,492,-1278,26,147,H1
"St. Clair County, MI",2007-2008,167526,165959,-1567,-0.935,469,-2036,26,147,H1
"St. Clair County, MI",2008-2009,165959,164011,-1948,-1.174,520,-2468,26,147,H1
"St. Clair County, MI",2009-2010,164011,162673,-1338,-0.816,264,-1602,26,147,H1
"St. Clair County, MI",2010-2011,162673,161498,-1175,-0.722,-46,-1129,26,147,H1
"St. Clair County, MI",2011-2012,161498,160564,-934,-0.578,-5,-929,26,147,H1
"St. Clair County, MI",2012-2013,160564,160225,-339,-0.211,-83,-256,26,147,H1
"St. Clair County, MI",2013-2014,160225,160078,-147,-0.092,-114,-33,26,147,H1
"St. Clair County, MI",2014-2015,160037,159875,-162,-0.101,-65,-97,26,147,H1
"St. Clair County, MI",2015-2016,159875,159507,-368,-0.23,-212,-156,26,147,H1
"St. Clair County, MI",2016-2017,159507,159350,-157,-0.098,-169,12,26,147,H1
"St. Joseph County, MI",2000-2001,62480,62404,-76,-0.122,357,-433,26,149,H1
"St. Joseph County, MI",2001-2002,62404,62152,-252,-0.404,328,-580,26,149,H1
"St. Joseph County, MI",2002-2003,62152,62363,211,0.339,382,-171,26,149,H1
"St. Joseph County, MI",2003-2004,62363,62265,-98,-0.157,329,-427,26,149,H1
"St. Joseph County, MI",2004-2005,62265,62273,8,0.013,387,-379,26,149,H1
"St. Joseph County, MI",2005-2006,62273,62236,-37,-0.059,390,-427,26,149,H1
"St. Joseph County, MI",2006-2007,62236,62243,7,0.011,398,-391,26,149,H1
"St. Joseph County, MI",2007-2008,62243,62083,-160,-0.257,339,-499,26,149,H1
"St. Joseph County, MI",2008-2009,62083,61417,-666,-1.073,373,-1039,26,149,H1
"St. Joseph County, MI",2009-2010,61417,61259,-158,-0.257,305,-463,26,149,H1
"St. Joseph County, MI",2010-2011,61259,61043,-216,-0.353,217,-433,26,149,H1
"St. Joseph County, MI",2011-2012,61043,60902,-141,-0.231,253,-394,26,149,H1
"St. Joseph County, MI",2012-2013,60902,60841,-61,-0.1,128,-189,26,149,H1
"St. Joseph County, MI",2013-2014,60841,60946,105,0.173,214,-109,26,149,H1
"St. Joseph County, MI",2014-2015,61120,61018,-102,-0.167,291,-393,26,149,H1
"St. Joseph County, MI",2015-2016,61018,60832,-186,-0.305,168,-354,26,149,H1
"St. Joseph County, MI",2016-2017,60832,60947,115,0.189,203,-88,26,149,H1
"Sanilac County, MI",2000-2001,44516,44713,197,0.443,83,114,26,151,H1
"Sanilac County, MI",2001-2002,44713,44770,57,0.127,114,-57,26,151,H1
"Sanilac County, MI",2002-2003,44770,44694,-76,-0.17,28,-104,26,151,H1
"Sanilac County, MI",2003-2004,44694,44939,245,0.548,113,132,26,151,H1
"Sanilac County, MI",2004-2005,44939,44837,-102,-0.227,56,-158,26,151,H1
"Sanilac County, MI",2005-2006,44837,44917,80,0.178,75,5,26,151,H1
"Sanilac County, MI",2006-2007,44917,44629,-288,-0.641,12,-300,26,151,H1
"Sanilac County, MI",2007-2008,44629,44177,-452,-1.013,83,-535,26,151,H1
"Sanilac County, MI",2008-2009,44177,43319,-858,-1.942,87,-945,26,151,H1
"Sanilac County, MI",2009-2010,43319,43053,-266,-0.614,21,-287,26,151,H1
"Sanilac County, MI",2010-2011,43053,42690,-363,-0.843,32,-395,26,151,H1
"Sanilac County, MI",2011-2012,42690,42311,-379,-0.888,-9,-370,26,151,H1
"Sanilac County, MI",2012-2013,42311,41863,-448,-1.059,-54,-394,26,151,H1
"Sanilac County, MI",2013-2014,41863,41587,-276,-0.659,-73,-203,26,151,H1
"Sanilac County, MI",2014-2015,41652,41475,-177,-0.425,-37,-140,26,151,H1
"Sanilac County, MI",2015-2016,41475,41392,-83,-0.2,-39,-44,26,151,H1
"Sanilac County, MI",2016-2017,41392,41269,-123,-0.297,-60,-63,26,151,H1
"Schoolcraft County, MI",2000-2001,8915,8863,-52,-0.583,-13,-39,26,153,H1
"Schoolcraft County, MI",2001-2002,8863,8817,-46,-0.519,-22,-24,26,153,H1
"Schoolcraft County, MI",2002-2003,8817,8847,30,0.34,-59,89,26,153,H1
"Schoolcraft County, MI",2003-2004,8847,8962,115,1.3,-30,145,26,153,H1
"Schoolcraft County, MI",2004-2005,8962,8905,-57,-0.636,-45,-12,26,153,H1
"Schoolcraft County, MI",2005-2006,8905,8946,41,0.46,-49,90,26,153,H1
"Schoolcraft County, MI",2006-2007,8946,8823,-123,-1.375,-48,-75,26,153,H1
"Schoolcraft County, MI",2007-2008,8823,8471,-352,-3.99,-19,-333,26,153,H1
"Schoolcraft County, MI",2008-2009,8471,8487,16,0.189,-38,54,26,153,H1
"Schoolcraft County, MI",2009-2010,8487,8474,-13,-0.153,-46,33,26,153,H1
"Schoolcraft County, MI",2010-2011,8474,8477,3,0.035,-39,42,26,153,H1
"Schoolcraft County, MI",2011-2012,8477,8355,-122,-1.439,-24,-98,26,153,H1
"Schoolcraft County, MI",2012-2013,8355,8246,-109,-1.305,-32,-77,26,153,H1
"Schoolcraft County, MI",2013-2014,8246,8171,-75,-0.91,-31,-44,26,153,H1
"Schoolcraft County, MI",2014-2015,8171,8173,2,0.024,-41,43,26,153,H1
"Schoolcraft County, MI",2015-2016,8173,7990,-183,-2.239,-22,-161,26,153,H1
"Schoolcraft County, MI",2016-2017,7990,8049,59,0.738,-49,108,26,153,H1
"Shiawassee County, MI",2000-2001,71714,72016,302,0.421,301,1,26,155,H1
"Shiawassee County, MI",2001-2002,72016,72162,146,0.203,278,-132,26,155,H1
"Shiawassee County, MI",2002-2003,72162,72458,296,0.41,212,84,26,155,H1
"Shiawassee County, MI",2003-2004,72458,73034,576,0.795,304,272,26,155,H1
"Shiawassee County, MI",2004-2005,73034,72757,-277,-0.379,258,-535,26,155,H1
"Shiawassee County, MI",2005-2006,72757,72839,82,0.113,267,-185,26,155,H1
"Shiawassee County, MI",2006-2007,72839,72426,-413,-0.567,248,-661,26,155,H1
"Shiawassee County, MI",2007-2008,72426,71523,-903,-1.247,194,-1097,26,155,H1
"Shiawassee County, MI",2008-2009,71523,70710,-813,-1.137,196,-1009,26,155,H1
"Shiawassee County, MI",2009-2010,70710,70637,-73,-0.103,104,-177,26,155,H1
"Shiawassee County, MI",2010-2011,70637,69981,-656,-0.929,29,-685,26,155,H1
"Shiawassee County, MI",2011-2012,69981,69300,-681,-0.973,24,-705,26,155,H1
"Shiawassee County, MI",2012-2013,69300,68916,-384,-0.554,9,-393,26,155,H1
"Shiawassee County, MI",2013-2014,68916,68933,17,0.025,17,0,26,155,H1
"Shiawassee County, MI",2014-2015,68889,68619,-270,-0.392,48,-318,26,155,H1
"Shiawassee County, MI",2015-2016,68619,68541,-78,-0.114,47,-125,26,155,H1
"Shiawassee County, MI",2016-2017,68541,68446,-95,-0.139,2,-97,26,155,H1
"Tuscola County, MI",2000-2001,58251,58220,-31,-0.053,162,-193,26,157,H1
"Tuscola County, MI",2001-2002,58220,58155,-65,-0.112,108,-173,26,157,H1
"Tuscola County, MI",2002-2003,58155,58380,225,0.387,202,23,26,157,H1
"Tuscola County, MI",2003-2004,58380,58230,-150,-0.257,145,-295,26,157,H1
"Tuscola County, MI",2004-2005,58230,57855,-375,-0.644,100,-475,26,157,H1
"Tuscola County, MI",2005-2006,57855,57472,-383,-0.662,147,-530,26,157,H1
"Tuscola County, MI",2006-2007,57472,57169,-303,-0.527,77,-380,26,157,H1
"Tuscola County, MI",2007-2008,57169,56512,-657,-1.149,113,-770,26,157,H1
"Tuscola County, MI",2008-2009,56512,55901,-611,-1.081,127,-738,26,157,H1
"Tuscola County, MI",2009-2010,55901,55681,-220,-0.394,61,-281,26,157,H1
"Tuscola County, MI",2010-2011,55681,55377,-304,-0.546,-39,-265,26,157,H1
"Tuscola County, MI",2011-2012,55377,54705,-672,-1.214,15,-687,26,157,H1
"Tuscola County, MI",2012-2013,54705,54210,-495,-0.905,-4,-491,26,157,H1
"Tuscola County, MI",2013-2014,54210,5.40E+04,-210,-0.387,-53,-157,26,157,H1
"Tuscola County, MI",2014-2015,53993,53777,-216,-0.4,-80,-136,26,157,H1
"Tuscola County, MI",2015-2016,53777,53235,-542,-1.008,-74,-468,26,157,H1
"Tuscola County, MI",2016-2017,53235,52764,-471,-0.885,-95,-376,26,157,H1
"Van Buren County, MI",2000-2001,76242,76432,190,0.249,418,-228,26,159,H1
"Van Buren County, MI",2001-2002,76432,76777,345,0.451,389,-44,26,159,H1
"Van Buren County, MI",2002-2003,76777,77022,245,0.319,258,-13,26,159,H1
"Van Buren County, MI",2003-2004,77022,77241,219,0.284,380,-161,26,159,H1
"Van Buren County, MI",2004-2005,77241,77009,-232,-0.3,330,-562,26,159,H1
"Van Buren County, MI",2005-2006,77009,77019,10,0.013,365,-355,26,159,H1
"Van Buren County, MI",2006-2007,77019,76639,-380,-0.493,376,-756,26,159,H1
"Van Buren County, MI",2007-2008,76639,76501,-138,-0.18,361,-499,26,159,H1
"Van Buren County, MI",2008-2009,76501,76581,80,0.105,354,-274,26,159,H1
"Van Buren County, MI",2009-2010,76581,76143,-438,-0.572,321,-759,26,159,H1
"Van Buren County, MI",2010-2011,76143,75907,-236,-0.31,244,-480,26,159,H1
"Van Buren County, MI",2011-2012,75907,75250,-657,-0.866,244,-901,26,159,H1
"Van Buren County, MI",2012-2013,75250,75346,96,0.128,235,-139,26,159,H1
"Van Buren County, MI",2013-2014,75346,75199,-147,-0.195,199,-346,26,159,H1
"Van Buren County, MI",2014-2015,75177,75077,-100,-0.133,141,-241,26,159,H1
"Van Buren County, MI",2015-2016,75077,75201,124,0.165,127,-3,26,159,H1
"Van Buren County, MI",2016-2017,75201,75353,152,0.202,92,60,26,159,H1
"Washtenaw County, MI",2000-2001,324372,328749,4377,1.349,2241,2136,26,161,H1
"Washtenaw County, MI",2001-2002,328749,332763,4014,1.221,2424,1590,26,161,H1
"Washtenaw County, MI",2002-2003,332763,336154,3391,1.019,2334,1057,26,161,H1
"Washtenaw County, MI",2003-2004,336154,339422,3268,0.972,2391,877,26,161,H1
"Washtenaw County, MI",2004-2005,339422,342234,2812,0.828,2397,415,26,161,H1
"Washtenaw County, MI",2005-2006,342234,344018,1784,0.521,2387,-603,26,161,H1
"Washtenaw County, MI",2006-2007,344018,345310,1292,0.376,2225,-933,26,161,H1
"Washtenaw County, MI",2007-2008,345310,341595,-3715,-1.076,2085,-5800,26,161,H1
"Washtenaw County, MI",2008-2009,341595,343520,1925,0.564,2081,-156,26,161,H1
"Washtenaw County, MI",2009-2010,343520,345525,2005,0.584,1836,169,26,161,H1
"Washtenaw County, MI",2010-2011,345525,349150,3625,1.049,1772,1853,26,161,H1
"Washtenaw County, MI",2011-2012,349150,351301,2151,0.616,1706,445,26,161,H1
"Washtenaw County, MI",2012-2013,351301,354418,3117,0.887,1600,1517,26,161,H1
"Washtenaw County, MI",2013-2014,354418,356874,2456,0.693,1551,905,26,161,H1
"Washtenaw County, MI",2014-2015,357029,358880,1851,0.518,1516,335,26,161,H1
"Washtenaw County, MI",2015-2016,358880,364752,5872,1.636,1444,4428,26,161,H1
"Washtenaw County, MI",2016-2017,364752,367627,2875,0.788,1320,1555,26,161,H1
"Wayne County, MI",2000-2001,2057255,2043167,-14088,-0.685,10445,-24533,26,163,H1
"Wayne County, MI",2001-2002,2043167,2025133,-18034,-0.883,9754,-27788,26,163,H1
"Wayne County, MI",2002-2003,2025133,2006154,-18979,-0.937,9213,-28192,26,163,H1
"Wayne County, MI",2003-2004,2006154,1983830,-22324,-1.113,9431,-31755,26,163,H1
"Wayne County, MI",2004-2005,1983830,1960263,-23567,-1.188,8783,-32350,26,163,H1
"Wayne County, MI",2005-2006,1960263,1932490,-27773,-1.417,8893,-36666,26,163,H1
"Wayne County, MI",2006-2007,1932490,1900992,-31498,-1.63,8261,-39759,26,163,H1
"Wayne County, MI",2007-2008,1900992,1865058,-35934,-1.89,7780,-43714,26,163,H1
"Wayne County, MI",2008-2009,1865058,1837536,-27522,-1.476,7480,-35002,26,163,H1
"Wayne County, MI",2009-2010,1837536,1815497,-22039,-1.199,7148,-29187,26,163,H1
"Wayne County, MI",2010-2011,1815497,1801614,-13883,-0.765,5828,-19711,26,163,H1
"Wayne County, MI",2011-2012,1801614,1792770,-8844,-0.491,5772,-14616,26,163,H1
"Wayne County, MI",2012-2013,1792770,1775703,-17067,-0.952,6314,-23381,26,163,H1
"Wayne County, MI",2013-2014,1775703,1764804,-10899,-0.614,5517,-16416,26,163,H1
"Wayne County, MI",2014-2015,1766008,1759335,-6673,-0.378,5850,-12523,26,163,H1
"Wayne County, MI",2015-2016,1759335,1756598,-2737,-0.156,5216,-7953,26,163,H1
"Wayne County, MI",2016-2017,1756598,1753616,-2982,-0.17,5022,-8004,26,163,H1
"Wexford County, MI",2000-2001,30537,30826,289,0.946,72,217,26,165,H1
"Wexford County, MI",2001-2002,30826,31015,189,0.613,90,99,26,165,H1
"Wexford County, MI",2002-2003,31015,31499,484,1.561,68,416,26,165,H1
"Wexford County, MI",2003-2004,31499,31778,279,0.886,86,193,26,165,H1
"Wexford County, MI",2004-2005,31778,32258,480,1.51,141,339,26,165,H1
"Wexford County, MI",2005-2006,32258,32461,203,0.629,131,72,26,165,H1
"Wexford County, MI",2006-2007,32461,32650,189,0.582,155,34,26,165,H1
"Wexford County, MI",2007-2008,32650,32765,115,0.352,120,-5,26,165,H1
"Wexford County, MI",2008-2009,32765,32658,-107,-0.327,96,-203,26,165,H1
"Wexford County, MI",2009-2010,32658,32758,100,0.306,70,30,26,165,H1
"Wexford County, MI",2010-2011,32758,32695,-63,-0.192,78,-141,26,165,H1
"Wexford County, MI",2011-2012,32695,32594,-101,-0.309,29,-130,26,165,H1
"Wexford County, MI",2012-2013,32594,32561,-33,-0.101,67,-100,26,165,H1
"Wexford County, MI",2013-2014,32561,32886,325,0.998,50,275,26,165,H1
"Wexford County, MI",2014-2015,32922,33003,81,0.246,120,-39,26,165,H1
"Wexford County, MI",2015-2016,33003,33090,87,0.264,45,42,26,165,H1
"Wexford County, MI",2016-2017,33090,33276,186,0.562,80,106,26,165,H1
Minnesota,2000-2001,4933692,4982796,49104,0.995,29842,19262,27,0,STATE
Minnesota,2001-2002,4982796,5018935,36139,0.725,28666,7473,27,0,STATE
Minnesota,2002-2003,5018935,5053572,34637,0.69,31204,3433,27,0,STATE
Minnesota,2003-2004,5053572,5087713,34141,0.676,33246,895,27,0,STATE
Minnesota,2004-2005,5087713,5119598,31885,0.627,33104,-1219,27,0,STATE
Minnesota,2005-2006,5119598,5163555,43957,0.859,35435,8522,27,0,STATE
Minnesota,2006-2007,5163555,5207203,43648,0.845,36405,7243,27,0,STATE
Minnesota,2007-2008,5207203,5247018,39815,0.765,35057,4758,27,0,STATE
Minnesota,2008-2009,5247018,5281203,34185,0.652,34515,-330,27,0,STATE
Minnesota,2009-2010,5281203,5310903,29700,0.562,31982,-2282,27,0,STATE
Minnesota,2010-2011,5310903,5348119,37216,0.701,28390,8826,27,0,STATE
Minnesota,2011-2012,5348119,5380443,32324,0.604,28750,3574,27,0,STATE
Minnesota,2012-2013,5380443,5420541,40098,0.745,27644,12454,27,0,STATE
Minnesota,2013-2014,5420541,5457125,36584,0.675,29386,7198,27,0,STATE
Minnesota,2014-2015,5457125,5489594,32469,0.595,29710,2759,27,0,STATE
Minnesota,2015-2016,5489594,5525050,35456,0.646,27703,7753,27,0,STATE
Minnesota,2016-2017,5525050,5576606,51556,0.933,27379,24177,27,0,STATE
"Aitkin County, MN",2000-2001,15282,15334,52,0.34,-44,96,27,1,H1
"Aitkin County, MN",2001-2002,15334,15616,282,1.839,-49,331,27,1,H1
"Aitkin County, MN",2002-2003,15616,15795,179,1.146,-41,220,27,1,H1
"Aitkin County, MN",2003-2004,15795,16028,233,1.475,8,225,27,1,H1
"Aitkin County, MN",2004-2005,16028,16162,134,0.836,-24,158,27,1,H1
"Aitkin County, MN",2005-2006,16162,16357,195,1.207,-16,211,27,1,H1
"Aitkin County, MN",2006-2007,16357,16481,124,0.758,-36,160,27,1,H1
"Aitkin County, MN",2007-2008,16481,16422,-59,-0.358,-38,-21,27,1,H1
"Aitkin County, MN",2008-2009,16422,16168,-254,-1.547,-37,-217,27,1,H1
"Aitkin County, MN",2009-2010,16168,16219,51,0.315,-62,113,27,1,H1
"Aitkin County, MN",2010-2011,16219,16110,-109,-0.672,-94,-15,27,1,H1
"Aitkin County, MN",2011-2012,16110,15945,-165,-1.024,-59,-106,27,1,H1
"Aitkin County, MN",2012-2013,15945,15774,-171,-1.072,-103,-68,27,1,H1
"Aitkin County, MN",2013-2014,15774,15771,-3,-0.019,-74,71,27,1,H1
"Aitkin County, MN",2014-2015,15708,15702,-6,-0.038,-86,80,27,1,H1
"Aitkin County, MN",2015-2016,15702,15776,74,0.471,-109,183,27,1,H1
"Aitkin County, MN",2016-2017,15776,15829,53,0.336,-105,158,27,1,H1
"Anoka County, MN",2000-2001,299780,304823,5043,1.682,2995,2048,27,3,H1
"Anoka County, MN",2001-2002,304823,308702,3879,1.273,2811,1068,27,3,H1
"Anoka County, MN",2002-2003,308702,311863,3161,1.024,2835,326,27,3,H1
"Anoka County, MN",2003-2004,311863,316643,4780,1.533,3051,1729,27,3,H1
"Anoka County, MN",2004-2005,316643,319830,3187,1.006,2881,306,27,3,H1
"Anoka County, MN",2005-2006,319830,323590,3760,1.176,3068,692,27,3,H1
"Anoka County, MN",2006-2007,323590,325767,2177,0.673,3078,-901,27,3,H1
"Anoka County, MN",2007-2008,325767,327427,1660,0.51,2926,-1266,27,3,H1
"Anoka County, MN",2008-2009,327427,329635,2208,0.674,2780,-572,27,3,H1
"Anoka County, MN",2009-2010,329635,331438,1803,0.547,2564,-761,27,3,H1
"Anoka County, MN",2010-2011,331438,332916,1478,0.446,2284,-806,27,3,H1
"Anoka County, MN",2011-2012,332916,336132,3216,0.966,2334,882,27,3,H1
"Anoka County, MN",2012-2013,336132,339229,3097,0.921,2279,818,27,3,H1
"Anoka County, MN",2013-2014,339229,341864,2635,0.777,2333,302,27,3,H1
"Anoka County, MN",2014-2015,341742,344151,2409,0.705,2397,12,27,3,H1
"Anoka County, MN",2015-2016,344151,347095,2944,0.855,2325,619,27,3,H1
"Anoka County, MN",2016-2017,347095,351373,4278,1.233,2220,2058,27,3,H1
"Becker County, MN",2000-2001,30188,30392,204,0.676,12,192,27,5,H1
"Becker County, MN",2001-2002,30392,30777,385,1.267,38,347,27,5,H1
"Becker County, MN",2002-2003,30777,31244,467,1.517,111,356,27,5,H1
"Becker County, MN",2003-2004,31244,31625,381,1.219,103,278,27,5,H1
"Becker County, MN",2004-2005,31625,31753,128,0.405,106,22,27,5,H1
"Becker County, MN",2005-2006,31753,32057,304,0.957,86,218,27,5,H1
"Becker County, MN",2006-2007,32057,32142,85,0.265,143,-58,27,5,H1
"Becker County, MN",2007-2008,32142,32244,102,0.317,99,3,27,5,H1
"Becker County, MN",2008-2009,32244,32407,163,0.506,124,39,27,5,H1
"Becker County, MN",2009-2010,32407,32534,127,0.392,72,55,27,5,H1
"Becker County, MN",2010-2011,32534,32817,283,0.87,81,202,27,5,H1
"Becker County, MN",2011-2012,32817,33018,201,0.612,83,118,27,5,H1
"Becker County, MN",2012-2013,33018,33224,206,0.624,82,124,27,5,H1
"Becker County, MN",2013-2014,33224,33259,35,0.105,57,-22,27,5,H1
"Becker County, MN",2014-2015,33246,33386,140,0.421,50,90,27,5,H1
"Becker County, MN",2015-2016,33386,33752,366,1.096,69,297,27,5,H1
"Becker County, MN",2016-2017,33752,34098,346,1.025,51,295,27,5,H1
"Beltrami County, MN",2000-2001,39789,40406,617,1.551,257,360,27,7,H1
"Beltrami County, MN",2001-2002,40406,41049,643,1.591,224,419,27,7,H1
"Beltrami County, MN",2002-2003,41049,41659,610,1.486,307,303,27,7,H1
"Beltrami County, MN",2003-2004,41659,42100,441,1.059,294,147,27,7,H1
"Beltrami County, MN",2004-2005,42100,42700,600,1.425,333,267,27,7,H1
"Beltrami County, MN",2005-2006,42700,43066,366,0.857,319,47,27,7,H1
"Beltrami County, MN",2006-2007,43066,43281,215,0.499,338,-123,27,7,H1
"Beltrami County, MN",2007-2008,43281,43815,534,1.234,384,150,27,7,H1
"Beltrami County, MN",2008-2009,43815,44226,411,0.938,349,62,27,7,H1
"Beltrami County, MN",2009-2010,44226,44585,359,0.812,242,117,27,7,H1
"Beltrami County, MN",2010-2011,44585,45108,523,1.173,290,233,27,7,H1
"Beltrami County, MN",2011-2012,45108,45241,133,0.295,326,-193,27,7,H1
"Beltrami County, MN",2012-2013,45241,45582,341,0.754,368,-27,27,7,H1
"Beltrami County, MN",2013-2014,45582,45664,82,0.18,350,-268,27,7,H1
"Beltrami County, MN",2014-2015,45623,45672,49,0.107,271,-222,27,7,H1
"Beltrami County, MN",2015-2016,45672,46011,339,0.742,284,55,27,7,H1
"Beltrami County, MN",2016-2017,46011,46513,502,1.091,269,233,27,7,H1
"Benton County, MN",2000-2001,34470,35346,876,2.541,249,627,27,9,H1
"Benton County, MN",2001-2002,35346,36117,771,2.181,246,525,27,9,H1
"Benton County, MN",2002-2003,36117,36760,643,1.78,283,360,27,9,H1
"Benton County, MN",2003-2004,36760,37072,312,0.849,243,69,27,9,H1
"Benton County, MN",2004-2005,37072,37409,337,0.909,289,48,27,9,H1
"Benton County, MN",2005-2006,37409,37617,208,0.556,311,-103,27,9,H1
"Benton County, MN",2006-2007,37617,38007,390,1.037,290,100,27,9,H1
"Benton County, MN",2007-2008,38007,38200,193,0.508,281,-88,27,9,H1
"Benton County, MN",2008-2009,38200,38418,218,0.571,272,-54,27,9,H1
"Benton County, MN",2009-2010,38418,38455,37,0.096,208,-171,27,9,H1
"Benton County, MN",2010-2011,38455,38823,368,0.957,272,96,27,9,H1
"Benton County, MN",2011-2012,38823,38867,44,0.113,247,-203,27,9,H1
"Benton County, MN",2012-2013,38867,39250,383,0.985,261,122,27,9,H1
"Benton County, MN",2013-2014,39250,39506,256,0.652,286,-30,27,9,H1
"Benton County, MN",2014-2015,39439,39710,271,0.687,241,30,27,9,H1
"Benton County, MN",2015-2016,39710,39468,-242,-0.609,203,-445,27,9,H1
"Benton County, MN",2016-2017,39468,39937,469,1.188,262,207,27,9,H1
"Big Stone County, MN",2000-2001,5777,5678,-99,-1.714,-38,-61,27,11,H1
"Big Stone County, MN",2001-2002,5678,5677,-1,-0.018,-19,18,27,11,H1
"Big Stone County, MN",2002-2003,5677,5598,-79,-1.392,-37,-42,27,11,H1
"Big Stone County, MN",2003-2004,5598,5444,-154,-2.751,-51,-103,27,11,H1
"Big Stone County, MN",2004-2005,5444,5445,1,0.018,-23,24,27,11,H1
"Big Stone County, MN",2005-2006,5445,5375,-70,-1.286,-21,-49,27,11,H1
"Big Stone County, MN",2006-2007,5375,5366,-9,-0.167,4,-13,27,11,H1
"Big Stone County, MN",2007-2008,5366,5328,-38,-0.708,-22,-16,27,11,H1
"Big Stone County, MN",2008-2009,5328,5285,-43,-0.807,-27,-16,27,11,H1
"Big Stone County, MN",2009-2010,5285,5260,-25,-0.473,-29,4,27,11,H1
"Big Stone County, MN",2010-2011,5260,5224,-36,-0.684,-28,-8,27,11,H1
"Big Stone County, MN",2011-2012,5224,5165,-59,-1.129,-28,-31,27,11,H1
"Big Stone County, MN",2012-2013,5165,5124,-41,-0.794,2,-43,27,11,H1
"Big Stone County, MN",2013-2014,5124,5127,3,0.059,-19,22,27,11,H1
"Big Stone County, MN",2014-2015,5125,5040,-85,-1.659,-19,-66,27,11,H1
"Big Stone County, MN",2015-2016,5040,5012,-28,-0.556,-13,-15,27,11,H1
"Big Stone County, MN",2016-2017,5012,5026,14,0.279,-11,25,27,11,H1
"Blue Earth County, MN",2000-2001,55988,56808,820,1.465,216,604,27,13,H1
"Blue Earth County, MN",2001-2002,56808,57542,734,1.292,222,512,27,13,H1
"Blue Earth County, MN",2002-2003,57542,58554,1012,1.759,241,771,27,13,H1
"Blue Earth County, MN",2003-2004,58554,59116,562,0.96,271,291,27,13,H1
"Blue Earth County, MN",2004-2005,59116,59918,802,1.357,241,561,27,13,H1
"Blue Earth County, MN",2005-2006,59918,61100,1182,1.973,342,840,27,13,H1
"Blue Earth County, MN",2006-2007,61100,61974,874,1.43,349,525,27,13,H1
"Blue Earth County, MN",2007-2008,61974,62860,886,1.43,368,518,27,13,H1
"Blue Earth County, MN",2008-2009,62860,63565,705,1.122,352,353,27,13,H1
"Blue Earth County, MN",2009-2010,63565,64069,504,0.793,315,189,27,13,H1
"Blue Earth County, MN",2010-2011,64069,64313,244,0.381,293,-49,27,13,H1
"Blue Earth County, MN",2011-2012,64313,6.50E+04,687,1.068,300,387,27,13,H1
"Blue Earth County, MN",2012-2013,6.50E+04,64835,-165,-0.254,272,-437,27,13,H1
"Blue Earth County, MN",2013-2014,64835,65385,550,0.848,295,255,27,13,H1
"Blue Earth County, MN",2014-2015,65497,65787,290,0.443,276,14,27,13,H1
"Blue Earth County, MN",2015-2016,65787,66244,457,0.695,265,192,27,13,H1
"Blue Earth County, MN",2016-2017,66244,66973,729,1.1,269,460,27,13,H1
"Brown County, MN",2000-2001,26877,26932,55,0.205,43,12,27,15,H1
"Brown County, MN",2001-2002,26932,26905,-27,-0.1,6,-33,27,15,H1
"Brown County, MN",2002-2003,26905,26754,-151,-0.561,24,-175,27,15,H1
"Brown County, MN",2003-2004,26754,26666,-88,-0.329,-18,-70,27,15,H1
"Brown County, MN",2004-2005,26666,26260,-406,-1.523,-7,-399,27,15,H1
"Brown County, MN",2005-2006,26260,26252,-8,-0.03,15,-23,27,15,H1
"Brown County, MN",2006-2007,26252,26130,-122,-0.465,41,-163,27,15,H1
"Brown County, MN",2007-2008,26130,25992,-138,-0.528,-6,-132,27,15,H1
"Brown County, MN",2008-2009,25992,25890,-102,-0.392,40,-142,27,15,H1
"Brown County, MN",2009-2010,25890,25875,-15,-0.058,32,-47,27,15,H1
"Brown County, MN",2010-2011,25875,25680,-195,-0.754,-30,-165,27,15,H1
"Brown County, MN",2011-2012,25680,25423,-257,-1.001,15,-272,27,15,H1
"Brown County, MN",2012-2013,25423,25293,-130,-0.511,-43,-87,27,15,H1
"Brown County, MN",2013-2014,25293,25292,-1,-0.004,-22,21,27,15,H1
"Brown County, MN",2014-2015,25290,25313,23,0.091,-17,40,27,15,H1
"Brown County, MN",2015-2016,25313,25262,-51,-0.201,25,-76,27,15,H1
"Brown County, MN",2016-2017,25262,25194,-68,-0.269,20,-88,27,15,H1
"Carlton County, MN",2000-2001,31784,32110,326,1.026,60,266,27,17,H1
"Carlton County, MN",2001-2002,32110,32740,630,1.962,20,610,27,17,H1
"Carlton County, MN",2002-2003,32740,33343,603,1.842,72,531,27,17,H1
"Carlton County, MN",2003-2004,33343,33950,607,1.82,85,522,27,17,H1
"Carlton County, MN",2004-2005,33950,34367,417,1.228,62,355,27,17,H1
"Carlton County, MN",2005-2006,34367,34538,171,0.498,105,66,27,17,H1
"Carlton County, MN",2006-2007,34538,34596,58,0.168,61,-3,27,17,H1
"Carlton County, MN",2007-2008,34596,34986,390,1.127,82,308,27,17,H1
"Carlton County, MN",2008-2009,34986,35269,283,0.809,112,171,27,17,H1
"Carlton County, MN",2009-2010,35269,35410,141,0.4,38,103,27,17,H1
"Carlton County, MN",2010-2011,35410,35475,65,0.184,17,48,27,17,H1
"Carlton County, MN",2011-2012,35475,35311,-164,-0.462,43,-207,27,17,H1
"Carlton County, MN",2012-2013,35311,35383,72,0.204,10,62,27,17,H1
"Carlton County, MN",2013-2014,35383,35571,188,0.531,18,170,27,17,H1
"Carlton County, MN",2014-2015,35470,35569,99,0.279,6,93,27,17,H1
"Carlton County, MN",2015-2016,35569,35544,-25,-0.07,-16,-9,27,17,H1
"Carlton County, MN",2016-2017,35544,35498,-46,-0.129,-2,-44,27,17,H1
"Carver County, MN",2000-2001,70843,72945,2102,2.967,905,1197,27,19,H1
"Carver County, MN",2001-2002,72945,75393,2448,3.356,900,1548,27,19,H1
"Carver County, MN",2002-2003,75393,78005,2612,3.465,863,1749,27,19,H1
"Carver County, MN",2003-2004,78005,80473,2468,3.164,899,1569,27,19,H1
"Carver County, MN",2004-2005,80473,83258,2785,3.461,949,1836,27,19,H1
"Carver County, MN",2005-2006,83258,85657,2399,2.881,927,1472,27,19,H1
"Carver County, MN",2006-2007,85657,87270,1613,1.883,925,688,27,19,H1
"Carver County, MN",2007-2008,87270,88812,1542,1.767,914,628,27,19,H1
"Carver County, MN",2008-2009,88812,90242,1430,1.61,1002,428,27,19,H1
"Carver County, MN",2009-2010,90242,91376,1134,1.257,816,318,27,19,H1
"Carver County, MN",2010-2011,91376,92811,1435,1.57,679,756,27,19,H1
"Carver County, MN",2011-2012,92811,93890,1079,1.163,694,385,27,19,H1
"Carver County, MN",2012-2013,93890,95644,1754,1.868,668,1086,27,19,H1
"Carver County, MN",2013-2014,95644,97338,1694,1.771,693,1001,27,19,H1
"Carver County, MN",2014-2015,97396,98741,1345,1.381,720,625,27,19,H1
"Carver County, MN",2015-2016,98741,100327,1586,1.606,695,891,27,19,H1
"Carver County, MN",2016-2017,100327,102119,1792,1.786,694,1098,27,19,H1
"Cass County, MN",2000-2001,27292,27587,295,1.081,33,262,27,21,H1
"Cass County, MN",2001-2002,27587,27853,266,0.964,31,235,27,21,H1
"Cass County, MN",2002-2003,27853,28004,151,0.542,25,126,27,21,H1
"Cass County, MN",2003-2004,28004,28338,334,1.193,24,310,27,21,H1
"Cass County, MN",2004-2005,28338,28683,345,1.217,93,252,27,21,H1
"Cass County, MN",2005-2006,28683,28754,71,0.248,129,-58,27,21,H1
"Cass County, MN",2006-2007,28754,28681,-73,-0.254,76,-149,27,21,H1
"Cass County, MN",2007-2008,28681,28733,52,0.181,58,-6,27,21,H1
"Cass County, MN",2008-2009,28733,28483,-250,-0.87,96,-346,27,21,H1
"Cass County, MN",2009-2010,28483,28640,157,0.551,10,147,27,21,H1
"Cass County, MN",2010-2011,28640,28371,-269,-0.939,12,-281,27,21,H1
"Cass County, MN",2011-2012,28371,28398,27,0.095,69,-42,27,21,H1
"Cass County, MN",2012-2013,28398,28527,129,0.454,34,95,27,21,H1
"Cass County, MN",2013-2014,28527,28559,32,0.112,49,-17,27,21,H1
"Cass County, MN",2014-2015,28559,28706,147,0.515,36,111,27,21,H1
"Cass County, MN",2015-2016,28706,2.90E+04,294,1.024,7,287,27,21,H1
"Cass County, MN",2016-2017,2.90E+04,29355,355,1.224,3,352,27,21,H1
"Chippewa County, MN",2000-2001,12913,12815,-98,-0.759,-3,-95,27,23,H1
"Chippewa County, MN",2001-2002,12815,12741,-74,-0.577,-55,-19,27,23,H1
"Chippewa County, MN",2002-2003,12741,12604,-137,-1.075,-16,-121,27,23,H1
"Chippewa County, MN",2003-2004,12604,12531,-73,-0.579,-10,-63,27,23,H1
"Chippewa County, MN",2004-2005,12531,12581,50,0.399,-1,51,27,23,H1
"Chippewa County, MN",2005-2006,12581,12525,-56,-0.445,14,-70,27,23,H1
"Chippewa County, MN",2006-2007,12525,12401,-124,-0.99,28,-152,27,23,H1
"Chippewa County, MN",2007-2008,12401,12376,-25,-0.202,36,-61,27,23,H1
"Chippewa County, MN",2008-2009,12376,12360,-16,-0.129,24,-40,27,23,H1
"Chippewa County, MN",2009-2010,12360,12451,91,0.736,26,65,27,23,H1
"Chippewa County, MN",2010-2011,12451,12333,-118,-0.948,21,-139,27,23,H1
"Chippewa County, MN",2011-2012,12333,12149,-184,-1.492,0,-184,27,23,H1
"Chippewa County, MN",2012-2013,12149,12132,-17,-0.14,34,-51,27,23,H1
"Chippewa County, MN",2013-2014,12132,12110,-22,-0.181,32,-54,27,23,H1
"Chippewa County, MN",2014-2015,12085,12109,24,0.199,29,-5,27,23,H1
"Chippewa County, MN",2015-2016,12109,12036,-73,-0.603,37,-110,27,23,H1
"Chippewa County, MN",2016-2017,12036,11980,-56,-0.465,38,-94,27,23,H1
"Chisago County, MN",2000-2001,41611,43466,1855,4.458,341,1514,27,25,H1
"Chisago County, MN",2001-2002,43466,45375,1909,4.392,424,1485,27,25,H1
"Chisago County, MN",2002-2003,45375,47322,1947,4.291,373,1574,27,25,H1
"Chisago County, MN",2003-2004,47322,49054,1732,3.66,365,1367,27,25,H1
"Chisago County, MN",2004-2005,49054,50283,1229,2.505,409,820,27,25,H1
"Chisago County, MN",2005-2006,50283,51444,1161,2.309,400,761,27,25,H1
"Chisago County, MN",2006-2007,51444,52312,868,1.687,379,489,27,25,H1
"Chisago County, MN",2007-2008,52312,53012,700,1.338,341,359,27,25,H1
"Chisago County, MN",2008-2009,53012,53526,514,0.97,379,135,27,25,H1
"Chisago County, MN",2009-2010,53526,53934,408,0.762,217,191,27,25,H1
"Chisago County, MN",2010-2011,53934,53752,-182,-0.337,189,-371,27,25,H1
"Chisago County, MN",2011-2012,53752,53491,-261,-0.486,224,-485,27,25,H1
"Chisago County, MN",2012-2013,53491,53789,298,0.557,230,68,27,25,H1
"Chisago County, MN",2013-2014,53789,54025,236,0.439,234,2,27,25,H1
"Chisago County, MN",2014-2015,53928,54293,365,0.677,160,205,27,25,H1
"Chisago County, MN",2015-2016,54293,54600,307,0.565,198,109,27,25,H1
"Chisago County, MN",2016-2017,54600,55308,708,1.297,227,481,27,25,H1
"Clay County, MN",2000-2001,51308,51513,205,0.4,79,126,27,27,H1
"Clay County, MN",2001-2002,51513,51772,259,0.503,119,140,27,27,H1
"Clay County, MN",2002-2003,51772,52183,411,0.794,218,193,27,27,H1
"Clay County, MN",2003-2004,52183,53251,1068,2.047,325,743,27,27,H1
"Clay County, MN",2004-2005,53251,54122,871,1.636,305,566,27,27,H1
"Clay County, MN",2005-2006,54122,55072,950,1.755,338,612,27,27,H1
"Clay County, MN",2006-2007,55072,55805,733,1.331,357,376,27,27,H1
"Clay County, MN",2007-2008,55805,57056,1251,2.242,379,872,27,27,H1
"Clay County, MN",2008-2009,57056,58351,1295,2.27,397,898,27,27,H1
"Clay County, MN",2009-2010,58351,59145,794,1.361,406,388,27,27,H1
"Clay County, MN",2010-2011,59145,59957,812,1.373,334,478,27,27,H1
"Clay County, MN",2011-2012,59957,60213,256,0.427,369,-113,27,27,H1
"Clay County, MN",2012-2013,60213,60646,433,0.719,354,79,27,27,H1
"Clay County, MN",2013-2014,60646,61286,640,1.055,380,260,27,27,H1
"Clay County, MN",2014-2015,61281,62324,1043,1.702,403,640,27,27,H1
"Clay County, MN",2015-2016,62324,62858,534,0.857,410,124,27,27,H1
"Clay County, MN",2016-2017,62858,63569,711,1.131,447,264,27,27,H1
"Clearwater County, MN",2000-2001,8389,8384,-5,-0.06,-1,-4,27,29,H1
"Clearwater County, MN",2001-2002,8384,8441,57,0.68,-9,66,27,29,H1
"Clearwater County, MN",2002-2003,8441,8424,-17,-0.201,14,-31,27,29,H1
"Clearwater County, MN",2003-2004,8424,8466,42,0.499,18,24,27,29,H1
"Clearwater County, MN",2004-2005,8466,8471,5,0.059,24,-19,27,29,H1
"Clearwater County, MN",2005-2006,8471,8476,5,0.059,30,-25,27,29,H1
"Clearwater County, MN",2006-2007,8476,8541,65,0.767,56,9,27,29,H1
"Clearwater County, MN",2007-2008,8541,8603,62,0.726,19,43,27,29,H1
"Clearwater County, MN",2008-2009,8603,8645,42,0.488,21,21,27,29,H1
"Clearwater County, MN",2009-2010,8645,8708,63,0.729,11,52,27,29,H1
"Clearwater County, MN",2010-2011,8708,8711,3,0.034,22,-19,27,29,H1
"Clearwater County, MN",2011-2012,8711,8682,-29,-0.333,-1,-28,27,29,H1
"Clearwater County, MN",2012-2013,8682,8781,99,1.14,8,91,27,29,H1
"Clearwater County, MN",2013-2014,8781,8791,10,0.114,16,-6,27,29,H1
"Clearwater County, MN",2014-2015,8796,8803,7,0.08,23,-16,27,29,H1
"Clearwater County, MN",2015-2016,8803,8861,58,0.659,26,32,27,29,H1
"Clearwater County, MN",2016-2017,8861,8878,17,0.192,28,-11,27,29,H1
"Cook County, MN",2000-2001,5178,5155,-23,-0.444,-24,1,27,31,H1
"Cook County, MN",2001-2002,5155,5164,9,0.175,-6,15,27,31,H1
"Cook County, MN",2002-2003,5164,5172,8,0.155,-4,12,27,31,H1
"Cook County, MN",2003-2004,5172,5180,8,0.155,6,2,27,31,H1
"Cook County, MN",2004-2005,5180,5158,-22,-0.425,-2,-20,27,31,H1
"Cook County, MN",2005-2006,5158,5210,52,1.008,10,42,27,31,H1
"Cook County, MN",2006-2007,5210,5217,7,0.134,-5,12,27,31,H1
"Cook County, MN",2007-2008,5217,5255,38,0.728,9,29,27,31,H1
"Cook County, MN",2008-2009,5255,5203,-52,-0.99,17,-69,27,31,H1
"Cook County, MN",2009-2010,5203,5170,-33,-0.634,4,-37,27,31,H1
"Cook County, MN",2010-2011,5170,5211,41,0.793,5,36,27,31,H1
"Cook County, MN",2011-2012,5211,5182,-29,-0.557,11,-40,27,31,H1
"Cook County, MN",2012-2013,5182,5184,2,0.039,10,-8,27,31,H1
"Cook County, MN",2013-2014,5184,5233,49,0.945,-1,50,27,31,H1
"Cook County, MN",2014-2015,5223,5194,-29,-0.555,-3,-26,27,31,H1
"Cook County, MN",2015-2016,5194,5311,117,2.253,22,95,27,31,H1
"Cook County, MN",2016-2017,5311,5398,87,1.638,15,72,27,31,H1
"Cottonwood County, MN",2000-2001,12167,12140,-27,-0.222,-11,-16,27,33,H1
"Cottonwood County, MN",2001-2002,12140,12104,-36,-0.297,-5,-31,27,33,H1
"Cottonwood County, MN",2002-2003,12104,12096,-8,-0.066,-17,9,27,33,H1
"Cottonwood County, MN",2003-2004,12096,12151,55,0.455,3,52,27,33,H1
"Cottonwood County, MN",2004-2005,12151,11967,-184,-1.514,-18,-166,27,33,H1
"Cottonwood County, MN",2005-2006,11967,11789,-178,-1.487,2,-180,27,33,H1
"Cottonwood County, MN",2006-2007,11789,11748,-41,-0.348,-39,-2,27,33,H1
"Cottonwood County, MN",2007-2008,11748,11701,-47,-0.4,-3,-44,27,33,H1
"Cottonwood County, MN",2008-2009,11701,11632,-69,-0.59,8,-77,27,33,H1
"Cottonwood County, MN",2009-2010,11632,11698,66,0.567,7,59,27,33,H1
"Cottonwood County, MN",2010-2011,11698,11741,43,0.368,21,22,27,33,H1
"Cottonwood County, MN",2011-2012,11741,11648,-93,-0.792,17,-110,27,33,H1
"Cottonwood County, MN",2012-2013,11648,11662,14,0.12,20,-6,27,33,H1
"Cottonwood County, MN",2013-2014,11662,11633,-29,-0.249,7,-36,27,33,H1
"Cottonwood County, MN",2014-2015,11589,11549,-40,-0.345,10,-50,27,33,H1
"Cottonwood County, MN",2015-2016,11549,11396,-153,-1.325,28,-181,27,33,H1
"Cottonwood County, MN",2016-2017,11396,11295,-101,-0.886,5,-106,27,33,H1
"Crow Wing County, MN",2000-2001,55184,55973,789,1.43,155,634,27,35,H1
"Crow Wing County, MN",2001-2002,55973,57013,1040,1.858,179,861,27,35,H1
"Crow Wing County, MN",2002-2003,57013,58023,1010,1.772,235,775,27,35,H1
"Crow Wing County, MN",2003-2004,58023,58814,791,1.363,217,574,27,35,H1
"Crow Wing County, MN",2004-2005,58814,59606,792,1.347,239,553,27,35,H1
"Crow Wing County, MN",2005-2006,59606,60654,1048,1.758,224,824,27,35,H1
"Crow Wing County, MN",2006-2007,60654,61484,830,1.368,261,569,27,35,H1
"Crow Wing County, MN",2007-2008,61484,62178,694,1.129,265,429,27,35,H1
"Crow Wing County, MN",2008-2009,62178,62307,129,0.207,248,-119,27,35,H1
"Crow Wing County, MN",2009-2010,62307,62609,302,0.485,101,201,27,35,H1
"Crow Wing County, MN",2010-2011,62609,62652,43,0.069,150,-107,27,35,H1
"Crow Wing County, MN",2011-2012,62652,62850,198,0.316,86,112,27,35,H1
"Crow Wing County, MN",2012-2013,62850,63125,275,0.438,120,155,27,35,H1
"Crow Wing County, MN",2013-2014,63125,63265,140,0.222,88,52,27,35,H1
"Crow Wing County, MN",2014-2015,63220,63428,208,0.329,91,117,27,35,H1
"Crow Wing County, MN",2015-2016,63428,63771,343,0.541,72,271,27,35,H1
"Crow Wing County, MN",2016-2017,63771,64424,653,1.024,38,615,27,35,H1
"Dakota County, MN",2000-2001,357848,363602,5754,1.608,3640,2114,27,37,H1
"Dakota County, MN",2001-2002,363602,368252,4650,1.279,3409,1241,27,37,H1
"Dakota County, MN",2002-2003,368252,372265,4013,1.09,3647,366,27,37,H1
"Dakota County, MN",2003-2004,372265,377143,4878,1.31,3719,1159,27,37,H1
"Dakota County, MN",2004-2005,377143,381829,4686,1.242,3556,1130,27,37,H1
"Dakota County, MN",2005-2006,381829,386228,4399,1.152,3692,707,27,37,H1
"Dakota County, MN",2006-2007,386228,390767,4539,1.175,3724,815,27,37,H1
"Dakota County, MN",2007-2008,390767,393900,3133,0.802,3665,-532,27,37,H1
"Dakota County, MN",2008-2009,393900,396906,3006,0.763,3606,-600,27,37,H1
"Dakota County, MN",2009-2010,396906,399146,2240,0.564,3407,-1167,27,37,H1
"Dakota County, MN",2010-2011,399146,402034,2888,0.724,2854,34,27,37,H1
"Dakota County, MN",2011-2012,402034,405067,3033,0.754,3086,-53,27,37,H1
"Dakota County, MN",2012-2013,405067,408829,3762,0.929,2932,830,27,37,H1
"Dakota County, MN",2013-2014,408829,412529,3700,0.905,2899,801,27,37,H1
"Dakota County, MN",2014-2015,412182,414686,2504,0.607,2837,-333,27,37,H1
"Dakota County, MN",2015-2016,414686,417421,2735,0.66,2782,-47,27,37,H1
"Dakota County, MN",2016-2017,417421,421751,4330,1.037,2644,1686,27,37,H1
"Dodge County, MN",2000-2001,17857,18118,261,1.462,121,140,27,39,H1
"Dodge County, MN",2001-2002,18118,18529,411,2.268,164,247,27,39,H1
"Dodge County, MN",2002-2003,18529,18802,273,1.473,165,108,27,39,H1
"Dodge County, MN",2003-2004,18802,19162,360,1.915,170,190,27,39,H1
"Dodge County, MN",2004-2005,19162,19391,229,1.195,172,57,27,39,H1
"Dodge County, MN",2005-2006,19391,19601,210,1.083,164,46,27,39,H1
"Dodge County, MN",2006-2007,19601,19613,12,0.061,149,-137,27,39,H1
"Dodge County, MN",2007-2008,19613,19876,263,1.341,158,105,27,39,H1
"Dodge County, MN",2008-2009,19876,19921,45,0.226,184,-139,27,39,H1
"Dodge County, MN",2009-2010,19921,20145,224,1.124,135,89,27,39,H1
"Dodge County, MN",2010-2011,20145,20175,30,0.149,137,-107,27,39,H1
"Dodge County, MN",2011-2012,20175,20237,62,0.307,130,-68,27,39,H1
"Dodge County, MN",2012-2013,20237,20319,82,0.405,104,-22,27,39,H1
"Dodge County, MN",2013-2014,20319,20353,34,0.167,120,-86,27,39,H1
"Dodge County, MN",2014-2015,20347,20364,17,0.084,115,-98,27,39,H1
"Dodge County, MN",2015-2016,20364,20547,183,0.899,118,65,27,39,H1
"Dodge County, MN",2016-2017,20547,20762,215,1.046,130,85,27,39,H1
"Douglas County, MN",2000-2001,32882,33201,319,0.97,29,290,27,41,H1
"Douglas County, MN",2001-2002,33201,33601,400,1.205,14,386,27,41,H1
"Douglas County, MN",2002-2003,33601,34125,524,1.559,18,506,27,41,H1
"Douglas County, MN",2003-2004,34125,34555,430,1.26,61,369,27,41,H1
"Douglas County, MN",2004-2005,34555,35110,555,1.606,116,439,27,41,H1
"Douglas County, MN",2005-2006,35110,35472,362,1.031,99,263,27,41,H1
"Douglas County, MN",2006-2007,35472,35903,431,1.215,90,341,27,41,H1
"Douglas County, MN",2007-2008,35903,36108,205,0.571,93,112,27,41,H1
"Douglas County, MN",2008-2009,36108,36076,-32,-0.089,88,-120,27,41,H1
"Douglas County, MN",2009-2010,36076,36008,-68,-0.188,19,-87,27,41,H1
"Douglas County, MN",2010-2011,36008,36258,250,0.694,2,248,27,41,H1
"Douglas County, MN",2011-2012,36258,36446,188,0.519,21,167,27,41,H1
"Douglas County, MN",2012-2013,36446,36563,117,0.321,-6,123,27,41,H1
"Douglas County, MN",2013-2014,36563,36790,227,0.621,-19,246,27,41,H1
"Douglas County, MN",2014-2015,36798,37075,277,0.753,22,255,27,41,H1
"Douglas County, MN",2015-2016,37075,37173,98,0.264,-16,114,27,41,H1
"Douglas County, MN",2016-2017,37173,37575,402,1.081,0,402,27,41,H1
"Faribault County, MN",2000-2001,16143,15929,-214,-1.326,-70,-144,27,43,H1
"Faribault County, MN",2001-2002,15929,15799,-130,-0.816,-69,-61,27,43,H1
"Faribault County, MN",2002-2003,15799,15628,-171,-1.082,-56,-115,27,43,H1
"Faribault County, MN",2003-2004,15628,15554,-74,-0.474,-21,-53,27,43,H1
"Faribault County, MN",2004-2005,15554,15255,-299,-1.922,-58,-241,27,43,H1
"Faribault County, MN",2005-2006,15255,15150,-105,-0.688,-8,-97,27,43,H1
"Faribault County, MN",2006-2007,15150,14986,-164,-1.083,-53,-111,27,43,H1
"Faribault County, MN",2007-2008,14986,14790,-196,-1.308,-28,-168,27,43,H1
"Faribault County, MN",2008-2009,14790,14651,-139,-0.94,-25,-114,27,43,H1
"Faribault County, MN",2009-2010,14651,14502,-149,-1.017,-30,-119,27,43,H1
"Faribault County, MN",2010-2011,14502,14538,36,0.248,-43,79,27,43,H1
"Faribault County, MN",2011-2012,14538,14261,-277,-1.905,-65,-212,27,43,H1
"Faribault County, MN",2012-2013,14261,14191,-70,-0.491,-23,-47,27,43,H1
"Faribault County, MN",2013-2014,14191,14192,1,0.007,-8,9,27,43,H1
"Faribault County, MN",2014-2015,14156,14050,-106,-0.749,-16,-90,27,43,H1
"Faribault County, MN",2015-2016,14050,13855,-195,-1.388,-32,-163,27,43,H1
"Faribault County, MN",2016-2017,13855,13784,-71,-0.512,-13,-58,27,43,H1
"Fillmore County, MN",2000-2001,21142,21184,42,0.199,-15,57,27,45,H1
"Fillmore County, MN",2001-2002,21184,21233,49,0.231,6,43,27,45,H1
"Fillmore County, MN",2002-2003,21233,21248,15,0.071,15,0,27,45,H1
"Fillmore County, MN",2003-2004,21248,21188,-60,-0.282,39,-99,27,45,H1
"Fillmore County, MN",2004-2005,21188,21138,-50,-0.236,13,-63,27,45,H1
"Fillmore County, MN",2005-2006,21138,21043,-95,-0.449,27,-122,27,45,H1
"Fillmore County, MN",2006-2007,21043,21092,49,0.233,86,-37,27,45,H1
"Fillmore County, MN",2007-2008,21092,20991,-101,-0.479,59,-160,27,45,H1
"Fillmore County, MN",2008-2009,20991,20921,-70,-0.333,53,-123,27,45,H1
"Fillmore County, MN",2009-2010,20921,20837,-84,-0.402,31,-115,27,45,H1
"Fillmore County, MN",2010-2011,20837,20878,41,0.197,4,37,27,45,H1
"Fillmore County, MN",2011-2012,20878,20894,16,0.077,0,16,27,45,H1
"Fillmore County, MN",2012-2013,20894,20825,-69,-0.33,19,-88,27,45,H1
"Fillmore County, MN",2013-2014,20825,20776,-49,-0.235,-3,-46,27,45,H1
"Fillmore County, MN",2014-2015,20812,20834,22,0.106,37,-15,27,45,H1
"Fillmore County, MN",2015-2016,20834,20919,85,0.408,52,33,27,45,H1
"Fillmore County, MN",2016-2017,20919,20980,61,0.292,34,27,27,45,H1
"Freeborn County, MN",2000-2001,32555,32474,-81,-0.249,12,-93,27,47,H1
"Freeborn County, MN",2001-2002,32474,32053,-421,-1.296,-31,-390,27,47,H1
"Freeborn County, MN",2002-2003,32053,32031,-22,-0.069,-28,6,27,47,H1
"Freeborn County, MN",2003-2004,32031,31948,-83,-0.259,60,-143,27,47,H1
"Freeborn County, MN",2004-2005,31948,31704,-244,-0.764,-4,-240,27,47,H1
"Freeborn County, MN",2005-2006,31704,31622,-82,-0.259,6,-88,27,47,H1
"Freeborn County, MN",2006-2007,31622,31511,-111,-0.351,38,-149,27,47,H1
"Freeborn County, MN",2007-2008,31511,31270,-241,-0.765,24,-265,27,47,H1
"Freeborn County, MN",2008-2009,31270,31313,43,0.138,27,16,27,47,H1
"Freeborn County, MN",2009-2010,31313,31211,-102,-0.326,15,-117,27,47,H1
"Freeborn County, MN",2010-2011,31211,31097,-114,-0.365,-4,-110,27,47,H1
"Freeborn County, MN",2011-2012,31097,31052,-45,-0.145,-30,-15,27,47,H1
"Freeborn County, MN",2012-2013,31052,30972,-80,-0.258,34,-114,27,47,H1
"Freeborn County, MN",2013-2014,30972,30840,-132,-0.426,3,-135,27,47,H1
"Freeborn County, MN",2014-2015,30789,30613,-176,-0.572,-12,-164,27,47,H1
"Freeborn County, MN",2015-2016,30613,30403,-210,-0.686,9,-219,27,47,H1
"Freeborn County, MN",2016-2017,30403,30535,132,0.434,-31,163,27,47,H1
"Goodhue County, MN",2000-2001,44154,44574,420,0.951,48,372,27,49,H1
"Goodhue County, MN",2001-2002,44574,44927,353,0.792,94,259,27,49,H1
"Goodhue County, MN",2002-2003,44927,45029,102,0.227,94,8,27,49,H1
"Goodhue County, MN",2003-2004,45029,45329,300,0.666,170,130,27,49,H1
"Goodhue County, MN",2004-2005,45329,45339,10,0.022,111,-101,27,49,H1
"Goodhue County, MN",2005-2006,45339,45598,259,0.571,203,56,27,49,H1
"Goodhue County, MN",2006-2007,45598,45866,268,0.588,179,89,27,49,H1
"Goodhue County, MN",2007-2008,45866,45919,53,0.116,153,-100,27,49,H1
"Goodhue County, MN",2008-2009,45919,46035,116,0.253,177,-61,27,49,H1
"Goodhue County, MN",2009-2010,46035,46184,149,0.324,118,31,27,49,H1
"Goodhue County, MN",2010-2011,46184,46264,80,0.173,48,32,27,49,H1
"Goodhue County, MN",2011-2012,46264,46393,129,0.279,104,25,27,49,H1
"Goodhue County, MN",2012-2013,46393,46416,23,0.05,49,-26,27,49,H1
"Goodhue County, MN",2013-2014,46416,46423,7,0.015,58,-51,27,49,H1
"Goodhue County, MN",2014-2015,46375,46435,60,0.129,43,17,27,49,H1
"Goodhue County, MN",2015-2016,46435,46240,-195,-0.42,57,-252,27,49,H1
"Goodhue County, MN",2016-2017,46240,46304,64,0.138,46,18,27,49,H1
"Grant County, MN",2000-2001,6265,6261,-4,-0.064,-21,17,27,51,H1
"Grant County, MN",2001-2002,6261,6295,34,0.543,-8,42,27,51,H1
"Grant County, MN",2002-2003,6295,6236,-59,-0.937,-36,-23,27,51,H1
"Grant County, MN",2003-2004,6236,6174,-62,-0.994,-20,-42,27,51,H1
"Grant County, MN",2004-2005,6174,6165,-9,-0.146,-27,18,27,51,H1
"Grant County, MN",2005-2006,6165,6127,-38,-0.616,-4,-34,27,51,H1
"Grant County, MN",2006-2007,6127,6138,11,0.18,-8,19,27,51,H1
"Grant County, MN",2007-2008,6138,6113,-25,-0.407,-7,-18,27,51,H1
"Grant County, MN",2008-2009,6113,6022,-91,-1.489,-11,-80,27,51,H1
"Grant County, MN",2009-2010,6022,5999,-23,-0.382,-10,-13,27,51,H1
"Grant County, MN",2010-2011,5999,6001,2,0.033,-10,12,27,51,H1
"Grant County, MN",2011-2012,6001,5945,-56,-0.933,-1,-55,27,51,H1
"Grant County, MN",2012-2013,5945,5986,41,0.69,-12,53,27,51,H1
"Grant County, MN",2013-2014,5986,5956,-30,-0.501,4,-34,27,51,H1
"Grant County, MN",2014-2015,5969,5903,-66,-1.106,13,-79,27,51,H1
"Grant County, MN",2015-2016,5903,5931,28,0.474,-1,29,27,51,H1
"Grant County, MN",2016-2017,5931,5941,10,0.169,9,1,27,51,H1
"Hennepin County, MN",2000-2001,1117775,1123375,5600,0.501,8663,-3063,27,53,H1
"Hennepin County, MN",2001-2002,1123375,1120730,-2645,-0.235,8064,-10709,27,53,H1
"Hennepin County, MN",2002-2003,1120730,1119458,-1272,-0.113,8411,-9683,27,53,H1
"Hennepin County, MN",2003-2004,1119458,1118756,-702,-0.063,9059,-9761,27,53,H1
"Hennepin County, MN",2004-2005,1118756,1117015,-1741,-0.156,8853,-10594,27,53,H1
"Hennepin County, MN",2005-2006,1117015,1119507,2492,0.223,9022,-6530,27,53,H1
"Hennepin County, MN",2006-2007,1119507,1126585,7078,0.632,9505,-2427,27,53,H1
"Hennepin County, MN",2007-2008,1126585,1135173,8588,0.762,8550,38,27,53,H1
"Hennepin County, MN",2008-2009,1135173,1146721,11548,1.017,8246,3302,27,53,H1
"Hennepin County, MN",2009-2010,1146721,1154184,7463,0.651,9446,-1983,27,53,H1
"Hennepin County, MN",2010-2011,1154184,1169360,15176,1.315,8118,7058,27,53,H1
"Hennepin County, MN",2011-2012,1169360,1184787,15427,1.319,8293,7134,27,53,H1
"Hennepin County, MN",2012-2013,1184787,1200060,15273,1.289,8411,6862,27,53,H1
"Hennepin County, MN",2013-2014,1200060,1212064,12004,1,8549,3455,27,53,H1
"Hennepin County, MN",2014-2015,1212097,1223149,11052,0.912,8745,2307,27,53,H1
"Hennepin County, MN",2015-2016,1223149,1237027,13878,1.135,8145,5733,27,53,H1
"Hennepin County, MN",2016-2017,1237027,1252024,14997,1.212,8062,6935,27,53,H1
"Houston County, MN",2000-2001,19730,19863,133,0.674,4,129,27,55,H1
"Houston County, MN",2001-2002,19863,19784,-79,-0.398,45,-124,27,55,H1
"Houston County, MN",2002-2003,19784,19715,-69,-0.349,15,-84,27,55,H1
"Houston County, MN",2003-2004,19715,19582,-133,-0.675,33,-166,27,55,H1
"Houston County, MN",2004-2005,19582,19573,-9,-0.046,37,-46,27,55,H1
"Houston County, MN",2005-2006,19573,19506,-67,-0.342,15,-82,27,55,H1
"Houston County, MN",2006-2007,19506,19392,-114,-0.584,83,-197,27,55,H1
"Houston County, MN",2007-2008,19392,19159,-233,-1.202,34,-267,27,55,H1
"Houston County, MN",2008-2009,19159,19051,-108,-0.564,40,-148,27,55,H1
"Houston County, MN",2009-2010,19051,18997,-54,-0.283,16,-70,27,55,H1
"Houston County, MN",2010-2011,18997,18918,-79,-0.416,-6,-73,27,55,H1
"Houston County, MN",2011-2012,18918,18816,-102,-0.539,26,-128,27,55,H1
"Houston County, MN",2012-2013,18816,18826,10,0.053,17,-7,27,55,H1
"Houston County, MN",2013-2014,18826,18738,-88,-0.467,7,-95,27,55,H1
"Houston County, MN",2014-2015,18743,18773,30,0.16,22,8,27,55,H1
"Houston County, MN",2015-2016,18773,18719,-54,-0.288,27,-81,27,55,H1
"Houston County, MN",2016-2017,18719,18660,-59,-0.315,19,-78,27,55,H1
"Hubbard County, MN",2000-2001,18401,18533,132,0.717,5,127,27,57,H1
"Hubbard County, MN",2001-2002,18533,18820,287,1.549,2,285,27,57,H1
"Hubbard County, MN",2002-2003,18820,19049,229,1.217,32,197,27,57,H1
"Hubbard County, MN",2003-2004,19049,19453,404,2.121,51,353,27,57,H1
"Hubbard County, MN",2004-2005,19453,19652,199,1.023,51,148,27,57,H1
"Hubbard County, MN",2005-2006,19652,19783,131,0.667,44,87,27,57,H1
"Hubbard County, MN",2006-2007,19783,20123,340,1.719,74,266,27,57,H1
"Hubbard County, MN",2007-2008,20123,20346,223,1.108,48,175,27,57,H1
"Hubbard County, MN",2008-2009,20346,20389,43,0.211,55,-12,27,57,H1
"Hubbard County, MN",2009-2010,20389,20416,27,0.132,-8,35,27,57,H1
"Hubbard County, MN",2010-2011,20416,20487,71,0.348,55,16,27,57,H1
"Hubbard County, MN",2011-2012,20487,20436,-51,-0.249,15,-66,27,57,H1
"Hubbard County, MN",2012-2013,20436,20680,244,1.194,8,236,27,57,H1
"Hubbard County, MN",2013-2014,20680,20573,-107,-0.517,25,-132,27,57,H1
"Hubbard County, MN",2014-2015,20586,20655,69,0.335,29,40,27,57,H1
"Hubbard County, MN",2015-2016,20655,20719,64,0.31,33,31,27,57,H1
"Hubbard County, MN",2016-2017,20719,21018,299,1.443,19,280,27,57,H1
"Isanti County, MN",2000-2001,31459,32428,969,3.08,174,795,27,59,H1
"Isanti County, MN",2001-2002,32428,33410,982,3.028,168,814,27,59,H1
"Isanti County, MN",2002-2003,33410,34753,1343,4.02,232,1111,27,59,H1
"Isanti County, MN",2003-2004,34753,35592,839,2.414,189,650,27,59,H1
"Isanti County, MN",2004-2005,35592,36400,808,2.27,213,595,27,59,H1
"Isanti County, MN",2005-2006,36400,37183,783,2.151,228,555,27,59,H1
"Isanti County, MN",2006-2007,37183,37711,528,1.42,311,217,27,59,H1
"Isanti County, MN",2007-2008,37711,37851,140,0.371,230,-90,27,59,H1
"Isanti County, MN",2008-2009,37851,37809,-42,-0.111,263,-305,27,59,H1
"Isanti County, MN",2009-2010,37809,37876,67,0.177,164,-97,27,59,H1
"Isanti County, MN",2010-2011,37876,38242,366,0.966,234,132,27,59,H1
"Isanti County, MN",2011-2012,38242,38245,3,0.008,137,-134,27,59,H1
"Isanti County, MN",2012-2013,38245,38174,-71,-0.186,135,-206,27,59,H1
"Isanti County, MN",2013-2014,38174,38413,239,0.626,138,101,27,59,H1
"Isanti County, MN",2014-2015,38394,38429,35,0.091,146,-111,27,59,H1
"Isanti County, MN",2015-2016,38429,38764,335,0.872,156,179,27,59,H1
"Isanti County, MN",2016-2017,38764,39582,818,2.11,131,687,27,59,H1
"Itasca County, MN",2000-2001,43927,43810,-117,-0.266,-26,-91,27,61,H1
"Itasca County, MN",2001-2002,43810,43882,72,0.164,-28,100,27,61,H1
"Itasca County, MN",2002-2003,43882,44212,330,0.752,5,325,27,61,H1
"Itasca County, MN",2003-2004,44212,44221,9,0.02,-8,17,27,61,H1
"Itasca County, MN",2004-2005,44221,44338,117,0.265,38,79,27,61,H1
"Itasca County, MN",2005-2006,44338,44405,67,0.151,-28,95,27,61,H1
"Itasca County, MN",2006-2007,44405,44809,404,0.91,76,328,27,61,H1
"Itasca County, MN",2007-2008,44809,44852,43,0.096,76,-33,27,61,H1
"Itasca County, MN",2008-2009,44852,45066,214,0.477,66,148,27,61,H1
"Itasca County, MN",2009-2010,45066,45032,-34,-0.075,-13,-21,27,61,H1
"Itasca County, MN",2010-2011,45032,45137,105,0.233,-38,143,27,61,H1
"Itasca County, MN",2011-2012,45137,45252,115,0.255,-24,139,27,61,H1
"Itasca County, MN",2012-2013,45252,45506,254,0.561,-19,273,27,61,H1
"Itasca County, MN",2013-2014,45506,45589,83,0.182,22,61,27,61,H1
"Itasca County, MN",2014-2015,45516,45435,-81,-0.178,-52,-29,27,61,H1
"Itasca County, MN",2015-2016,45435,45149,-286,-0.629,-44,-242,27,61,H1
"Itasca County, MN",2016-2017,45149,45137,-12,-0.027,-12,0,27,61,H1
"Jackson County, MN",2000-2001,11186,10952,-234,-2.092,-4,-230,27,63,H1
"Jackson County, MN",2001-2002,10952,10945,-7,-0.064,-35,28,27,63,H1
"Jackson County, MN",2002-2003,10945,10794,-151,-1.38,-21,-130,27,63,H1
"Jackson County, MN",2003-2004,10794,10693,-101,-0.936,-30,-71,27,63,H1
"Jackson County, MN",2004-2005,10693,10595,-98,-0.916,-17,-81,27,63,H1
"Jackson County, MN",2005-2006,10595,10583,-12,-0.113,25,-37,27,63,H1
"Jackson County, MN",2006-2007,10583,10523,-60,-0.567,21,-81,27,63,H1
"Jackson County, MN",2007-2008,10523,10364,-159,-1.511,7,-166,27,63,H1
"Jackson County, MN",2008-2009,10364,10276,-88,-0.849,-26,-62,27,63,H1
"Jackson County, MN",2009-2010,10276,10268,-8,-0.078,-30,22,27,63,H1
"Jackson County, MN",2010-2011,10268,10195,-73,-0.711,-35,-38,27,63,H1
"Jackson County, MN",2011-2012,10195,10298,103,1.01,4,99,27,63,H1
"Jackson County, MN",2012-2013,10298,10268,-30,-0.291,33,-63,27,63,H1
"Jackson County, MN",2013-2014,10268,10269,1,0.01,6,-5,27,63,H1
"Jackson County, MN",2014-2015,10247,10079,-168,-1.64,7,-175,27,63,H1
"Jackson County, MN",2015-2016,10079,9942,-137,-1.359,10,-147,27,63,H1
"Jackson County, MN",2016-2017,9942,9946,4,0.04,1,3,27,63,H1
"Kanabec County, MN",2000-2001,15041,15266,225,1.496,68,157,27,65,H1
"Kanabec County, MN",2001-2002,15266,15449,183,1.199,44,139,27,65,H1
"Kanabec County, MN",2002-2003,15449,15877,428,2.77,41,387,27,65,H1
"Kanabec County, MN",2003-2004,15877,16080,203,1.279,77,126,27,65,H1
"Kanabec County, MN",2004-2005,16080,16259,179,1.113,48,131,27,65,H1
"Kanabec County, MN",2005-2006,16259,16360,101,0.621,54,47,27,65,H1
"Kanabec County, MN",2006-2007,16360,16495,135,0.825,104,31,27,65,H1
"Kanabec County, MN",2007-2008,16495,16535,40,0.242,60,-20,27,65,H1
"Kanabec County, MN",2008-2009,16535,16294,-241,-1.458,44,-285,27,65,H1
"Kanabec County, MN",2009-2010,16294,16235,-59,-0.362,10,-69,27,65,H1
"Kanabec County, MN",2010-2011,16235,16244,9,0.055,12,-3,27,65,H1
"Kanabec County, MN",2011-2012,16244,15999,-245,-1.508,-18,-227,27,65,H1
"Kanabec County, MN",2012-2013,15999,16010,11,0.069,2,9,27,65,H1
"Kanabec County, MN",2013-2014,16010,15930,-80,-0.5,-9,-71,27,65,H1
"Kanabec County, MN",2014-2015,15939,15837,-102,-0.64,14,-116,27,65,H1
"Kanabec County, MN",2015-2016,15837,15882,45,0.284,-14,59,27,65,H1
"Kanabec County, MN",2016-2017,15882,16024,142,0.894,-6,148,27,65,H1
"Kandiyohi County, MN",2000-2001,41141,41272,131,0.318,136,-5,27,67,H1
"Kandiyohi County, MN",2001-2002,41272,41069,-203,-0.492,198,-401,27,67,H1
"Kandiyohi County, MN",2002-2003,41069,41364,295,0.718,200,95,27,67,H1
"Kandiyohi County, MN",2003-2004,41364,41456,92,0.222,191,-99,27,67,H1
"Kandiyohi County, MN",2004-2005,41456,41487,31,0.075,209,-178,27,67,H1
"Kandiyohi County, MN",2005-2006,41487,41537,50,0.121,230,-180,27,67,H1
"Kandiyohi County, MN",2006-2007,41537,41639,102,0.246,295,-193,27,67,H1
"Kandiyohi County, MN",2007-2008,41639,41840,201,0.483,247,-46,27,67,H1
"Kandiyohi County, MN",2008-2009,41840,42058,218,0.521,260,-42,27,67,H1
"Kandiyohi County, MN",2009-2010,42058,42245,187,0.445,251,-64,27,67,H1
"Kandiyohi County, MN",2010-2011,42245,42248,3,0.007,190,-187,27,67,H1
"Kandiyohi County, MN",2011-2012,42248,42399,151,0.357,168,-17,27,67,H1
"Kandiyohi County, MN",2012-2013,42399,42403,4,0.009,166,-162,27,67,H1
"Kandiyohi County, MN",2013-2014,42403,42285,-118,-0.278,207,-325,27,67,H1
"Kandiyohi County, MN",2014-2015,42465,42542,77,0.181,236,-159,27,67,H1
"Kandiyohi County, MN",2015-2016,42542,42622,80,0.188,246,-166,27,67,H1
"Kandiyohi County, MN",2016-2017,42622,42743,121,0.284,241,-120,27,67,H1
"Kittson County, MN",2000-2001,5260,5188,-72,-1.369,-26,-46,27,69,H1
"Kittson County, MN",2001-2002,5188,5075,-113,-2.178,-23,-90,27,69,H1
"Kittson County, MN",2002-2003,5075,4974,-101,-1.99,-40,-61,27,69,H1
"Kittson County, MN",2003-2004,4974,4898,-76,-1.528,-27,-49,27,69,H1
"Kittson County, MN",2004-2005,4898,4846,-52,-1.062,-37,-15,27,69,H1
"Kittson County, MN",2005-2006,4846,4746,-100,-2.064,-26,-74,27,69,H1
"Kittson County, MN",2006-2007,4746,4640,-106,-2.233,-27,-79,27,69,H1
"Kittson County, MN",2007-2008,4640,4614,-26,-0.56,-22,-4,27,69,H1
"Kittson County, MN",2008-2009,4614,4561,-53,-1.149,-18,-35,27,69,H1
"Kittson County, MN",2009-2010,4561,4541,-20,-0.439,-14,-6,27,69,H1
"Kittson County, MN",2010-2011,4541,4535,-6,-0.132,0,-6,27,69,H1
"Kittson County, MN",2011-2012,4535,4505,-30,-0.662,-29,-1,27,69,H1
"Kittson County, MN",2012-2013,4505,4489,-16,-0.355,-23,7,27,69,H1
"Kittson County, MN",2013-2014,4489,4435,-54,-1.203,-18,-36,27,69,H1
"Kittson County, MN",2014-2015,4442,4424,-18,-0.405,-10,-8,27,69,H1
"Kittson County, MN",2015-2016,4424,4318,-106,-2.396,-21,-85,27,69,H1
"Kittson County, MN",2016-2017,4318,4250,-68,-1.575,-20,-48,27,69,H1
"Koochiching County, MN",2000-2001,14288,14124,-164,-1.148,-10,-154,27,71,H1
"Koochiching County, MN",2001-2002,14124,14001,-123,-0.871,-20,-103,27,71,H1
"Koochiching County, MN",2002-2003,14001,13965,-36,-0.257,-45,9,27,71,H1
"Koochiching County, MN",2003-2004,13965,13919,-46,-0.329,-17,-29,27,71,H1
"Koochiching County, MN",2004-2005,13919,13851,-68,-0.489,-40,-28,27,71,H1
"Koochiching County, MN",2005-2006,13851,13705,-146,-1.054,-36,-110,27,71,H1
"Koochiching County, MN",2006-2007,13705,13577,-128,-0.934,-48,-80,27,71,H1
"Koochiching County, MN",2007-2008,13577,13432,-145,-1.068,-14,-131,27,71,H1
"Koochiching County, MN",2008-2009,13432,13276,-156,-1.161,-21,-135,27,71,H1
"Koochiching County, MN",2009-2010,13276,13301,25,0.188,-45,70,27,71,H1
"Koochiching County, MN",2010-2011,13301,13236,-65,-0.489,-39,-26,27,71,H1
"Koochiching County, MN",2011-2012,13236,13180,-56,-0.423,-46,-10,27,71,H1
"Koochiching County, MN",2012-2013,13180,13117,-63,-0.478,-37,-26,27,71,H1
"Koochiching County, MN",2013-2014,13117,12856,-261,-1.99,-46,-215,27,71,H1
"Koochiching County, MN",2014-2015,12883,12841,-42,-0.326,-20,-22,27,71,H1
"Koochiching County, MN",2015-2016,12841,12618,-223,-1.737,-58,-165,27,71,H1
"Koochiching County, MN",2016-2017,12618,12528,-90,-0.713,-48,-42,27,71,H1
"Lac qui Parle County, MN",2000-2001,8057,7914,-143,-1.775,-35,-108,27,73,H1
"Lac qui Parle County, MN",2001-2002,7914,7891,-23,-0.291,-40,17,27,73,H1
"Lac qui Parle County, MN",2002-2003,7891,7793,-98,-1.242,-53,-45,27,73,H1
"Lac qui Parle County, MN",2003-2004,7793,7674,-119,-1.527,-48,-71,27,73,H1
"Lac qui Parle County, MN",2004-2005,7674,7574,-100,-1.303,-23,-77,27,73,H1
"Lac qui Parle County, MN",2005-2006,7574,7415,-159,-2.099,-33,-126,27,73,H1
"Lac qui Parle County, MN",2006-2007,7415,7419,4,0.054,-19,23,27,73,H1
"Lac qui Parle County, MN",2007-2008,7419,7342,-77,-1.038,-18,-59,27,73,H1
"Lac qui Parle County, MN",2008-2009,7342,7302,-40,-0.545,-24,-16,27,73,H1
"Lac qui Parle County, MN",2009-2010,7302,7233,-69,-0.945,-24,-45,27,73,H1
"Lac qui Parle County, MN",2010-2011,7233,7231,-2,-0.028,-28,26,27,73,H1
"Lac qui Parle County, MN",2011-2012,7231,7116,-115,-1.59,-40,-75,27,73,H1
"Lac qui Parle County, MN",2012-2013,7116,7010,-106,-1.49,-12,-94,27,73,H1
"Lac qui Parle County, MN",2013-2014,7010,6891,-119,-1.698,-31,-88,27,73,H1
"Lac qui Parle County, MN",2014-2015,6895,6856,-39,-0.566,-27,-12,27,73,H1
"Lac qui Parle County, MN",2015-2016,6856,6743,-113,-1.648,-17,-96,27,73,H1
"Lac qui Parle County, MN",2016-2017,6743,6685,-58,-0.86,-33,-25,27,73,H1
"Lake County, MN",2000-2001,11083,11145,62,0.559,-15,77,27,75,H1
"Lake County, MN",2001-2002,11145,11128,-17,-0.153,-41,24,27,75,H1
"Lake County, MN",2002-2003,11128,11162,34,0.306,-40,74,27,75,H1
"Lake County, MN",2003-2004,11162,11100,-62,-0.555,-54,-8,27,75,H1
"Lake County, MN",2004-2005,11100,11014,-86,-0.775,-54,-32,27,75,H1
"Lake County, MN",2005-2006,11014,10962,-52,-0.472,-53,1,27,75,H1
"Lake County, MN",2006-2007,10962,10938,-24,-0.219,-26,2,27,75,H1
"Lake County, MN",2007-2008,10938,10872,-66,-0.603,-55,-11,27,75,H1
"Lake County, MN",2008-2009,10872,10872,0,0,-33,33,27,75,H1
"Lake County, MN",2009-2010,10872,10863,-9,-0.083,-48,39,27,75,H1
"Lake County, MN",2010-2011,10863,10805,-58,-0.534,-29,-29,27,75,H1
"Lake County, MN",2011-2012,10805,10830,25,0.231,-3,28,27,75,H1
"Lake County, MN",2012-2013,10830,10778,-52,-0.48,-42,-10,27,75,H1
"Lake County, MN",2013-2014,10778,10680,-98,-0.909,-30,-68,27,75,H1
"Lake County, MN",2014-2015,10681,10631,-50,-0.468,-28,-22,27,75,H1
"Lake County, MN",2015-2016,10631,10516,-115,-1.082,-38,-77,27,75,H1
"Lake County, MN",2016-2017,10516,10524,8,0.076,-30,38,27,75,H1
"Lake of the Woods County, MN",2000-2001,4488,4452,-36,-0.802,-8,-28,27,77,H1
"Lake of the Woods County, MN",2001-2002,4452,4326,-126,-2.83,-31,-95,27,77,H1
"Lake of the Woods County, MN",2002-2003,4326,4371,45,1.04,13,32,27,77,H1
"Lake of the Woods County, MN",2003-2004,4371,4401,30,0.686,0,30,27,77,H1
"Lake of the Woods County, MN",2004-2005,4401,4374,-27,-0.613,-7,-20,27,77,H1
"Lake of the Woods County, MN",2005-2006,4374,4321,-53,-1.212,-7,-46,27,77,H1
"Lake of the Woods County, MN",2006-2007,4321,4205,-116,-2.685,-3,-113,27,77,H1
"Lake of the Woods County, MN",2007-2008,4205,4128,-77,-1.831,8,-85,27,77,H1
"Lake of the Woods County, MN",2008-2009,4128,4043,-85,-2.059,-4,-81,27,77,H1
"Lake of the Woods County, MN",2009-2010,4043,4041,-2,-0.049,-14,12,27,77,H1
"Lake of the Woods County, MN",2010-2011,4041,4023,-18,-0.445,-15,-3,27,77,H1
"Lake of the Woods County, MN",2011-2012,4023,3968,-55,-1.367,-22,-33,27,77,H1
"Lake of the Woods County, MN",2012-2013,3968,3931,-37,-0.932,-6,-31,27,77,H1
"Lake of the Woods County, MN",2013-2014,3931,3918,-13,-0.331,-14,1,27,77,H1
"Lake of the Woods County, MN",2014-2015,3917,3923,6,0.153,-1,7,27,77,H1
"Lake of the Woods County, MN",2015-2016,3923,3796,-127,-3.237,3,-130,27,77,H1
"Lake of the Woods County, MN",2016-2017,3796,3744,-52,-1.37,0,-52,27,77,H1
"Le Sueur County, MN",2000-2001,25459,25654,195,0.766,113,82,27,79,H1
"Le Sueur County, MN",2001-2002,25654,25909,255,0.994,99,156,27,79,H1
"Le Sueur County, MN",2002-2003,25909,26395,486,1.876,103,383,27,79,H1
"Le Sueur County, MN",2003-2004,26395,26811,416,1.576,150,266,27,79,H1
"Le Sueur County, MN",2004-2005,26811,27016,205,0.765,135,70,27,79,H1
"Le Sueur County, MN",2005-2006,27016,27480,464,1.718,217,247,27,79,H1
"Le Sueur County, MN",2006-2007,27480,27870,390,1.419,157,233,27,79,H1
"Le Sueur County, MN",2007-2008,27870,27816,-54,-0.194,182,-236,27,79,H1
"Le Sueur County, MN",2008-2009,27816,27730,-86,-0.309,153,-239,27,79,H1
"Le Sueur County, MN",2009-2010,27730,27690,-40,-0.144,110,-150,27,79,H1
"Le Sueur County, MN",2010-2011,27690,27802,112,0.404,128,-16,27,79,H1
"Le Sueur County, MN",2011-2012,27802,27647,-155,-0.558,116,-271,27,79,H1
"Le Sueur County, MN",2012-2013,27647,27678,31,0.112,79,-48,27,79,H1
"Le Sueur County, MN",2013-2014,27678,27770,92,0.332,75,17,27,79,H1
"Le Sueur County, MN",2014-2015,27748,27663,-85,-0.306,88,-173,27,79,H1
"Le Sueur County, MN",2015-2016,27663,27714,51,0.184,84,-33,27,79,H1
"Le Sueur County, MN",2016-2017,27714,28111,397,1.432,92,305,27,79,H1
"Lincoln County, MN",2000-2001,6403,6335,-68,-1.062,-34,-34,27,81,H1
"Lincoln County, MN",2001-2002,6335,6248,-87,-1.373,-43,-44,27,81,H1
"Lincoln County, MN",2002-2003,6248,6222,-26,-0.416,-29,3,27,81,H1
"Lincoln County, MN",2003-2004,6222,6138,-84,-1.35,-30,-54,27,81,H1
"Lincoln County, MN",2004-2005,6138,6074,-64,-1.043,-50,-14,27,81,H1
"Lincoln County, MN",2005-2006,6074,6003,-71,-1.169,-16,-55,27,81,H1
"Lincoln County, MN",2006-2007,6003,5949,-54,-0.9,4,-58,27,81,H1
"Lincoln County, MN",2007-2008,5949,5937,-12,-0.202,-17,5,27,81,H1
"Lincoln County, MN",2008-2009,5937,5892,-45,-0.758,-17,-28,27,81,H1
"Lincoln County, MN",2009-2010,5892,5877,-15,-0.255,-28,13,27,81,H1
"Lincoln County, MN",2010-2011,5877,5846,-31,-0.527,-34,3,27,81,H1
"Lincoln County, MN",2011-2012,5846,5800,-46,-0.787,-5,-41,27,81,H1
"Lincoln County, MN",2012-2013,5800,5792,-8,-0.138,-1,-7,27,81,H1
"Lincoln County, MN",2013-2014,5792,5788,-4,-0.069,-17,13,27,81,H1
"Lincoln County, MN",2014-2015,5804,5771,-33,-0.569,-7,-26,27,81,H1
"Lincoln County, MN",2015-2016,5771,5708,-63,-1.092,6,-69,27,81,H1
"Lincoln County, MN",2016-2017,5708,5678,-30,-0.526,-10,-20,27,81,H1
"Lyon County, MN",2000-2001,25465,25474,9,0.035,128,-119,27,83,H1
"Lyon County, MN",2001-2002,25474,25191,-283,-1.111,98,-381,27,83,H1
"Lyon County, MN",2002-2003,25191,25091,-100,-0.397,107,-207,27,83,H1
"Lyon County, MN",2003-2004,25091,24981,-110,-0.438,40,-150,27,83,H1
"Lyon County, MN",2004-2005,24981,25178,197,0.789,88,109,27,83,H1
"Lyon County, MN",2005-2006,25178,25347,169,0.671,120,49,27,83,H1
"Lyon County, MN",2006-2007,25347,25403,56,0.221,171,-115,27,83,H1
"Lyon County, MN",2007-2008,25403,25646,243,0.957,128,115,27,83,H1
"Lyon County, MN",2008-2009,25646,25768,122,0.476,123,-1,27,83,H1
"Lyon County, MN",2009-2010,25768,25856,88,0.342,100,-12,27,83,H1
"Lyon County, MN",2010-2011,25856,25808,-48,-0.186,174,-222,27,83,H1
"Lyon County, MN",2011-2012,25808,25618,-190,-0.736,134,-324,27,83,H1
"Lyon County, MN",2012-2013,25618,25674,56,0.219,145,-89,27,83,H1
"Lyon County, MN",2013-2014,25674,25665,-9,-0.035,119,-128,27,83,H1
"Lyon County, MN",2014-2015,25713,25673,-40,-0.156,148,-188,27,83,H1
"Lyon County, MN",2015-2016,25673,25861,188,0.732,148,40,27,83,H1
"Lyon County, MN",2016-2017,25861,25831,-30,-0.116,146,-176,27,83,H1
"McLeod County, MN",2000-2001,34854,35144,290,0.832,237,53,27,85,H1
"McLeod County, MN",2001-2002,35144,35408,264,0.751,210,54,27,85,H1
"McLeod County, MN",2002-2003,35408,35541,133,0.376,197,-64,27,85,H1
"McLeod County, MN",2003-2004,35541,35923,382,1.075,247,135,27,85,H1
"McLeod County, MN",2004-2005,35923,36250,327,0.91,240,87,27,85,H1
"McLeod County, MN",2005-2006,36250,36749,499,1.377,212,287,27,85,H1
"McLeod County, MN",2006-2007,36749,36961,212,0.577,271,-59,27,85,H1
"McLeod County, MN",2007-2008,36961,36917,-44,-0.119,237,-281,27,85,H1
"McLeod County, MN",2008-2009,36917,36662,-255,-0.691,253,-508,27,85,H1
"McLeod County, MN",2009-2010,36662,36608,-54,-0.147,204,-258,27,85,H1
"McLeod County, MN",2010-2011,36608,36408,-200,-0.546,139,-339,27,85,H1
"McLeod County, MN",2011-2012,36408,36011,-397,-1.09,71,-468,27,85,H1
"McLeod County, MN",2012-2013,36011,35953,-58,-0.161,118,-176,27,85,H1
"McLeod County, MN",2013-2014,35953,35882,-71,-0.197,98,-169,27,85,H1
"McLeod County, MN",2014-2015,35891,35932,41,0.114,104,-63,27,85,H1
"McLeod County, MN",2015-2016,35932,35748,-184,-0.512,64,-248,27,85,H1
"McLeod County, MN",2016-2017,35748,35884,136,0.38,77,59,27,85,H1
"Mahnomen County, MN",2000-2001,5167,5211,44,0.852,22,22,27,87,H1
"Mahnomen County, MN",2001-2002,5211,5220,9,0.173,21,-12,27,87,H1
"Mahnomen County, MN",2002-2003,5220,5214,-6,-0.115,32,-38,27,87,H1
"Mahnomen County, MN",2003-2004,5214,5215,1,0.019,33,-32,27,87,H1
"Mahnomen County, MN",2004-2005,5215,5283,68,1.304,50,18,27,87,H1
"Mahnomen County, MN",2005-2006,5283,5277,-6,-0.114,27,-33,27,87,H1
"Mahnomen County, MN",2006-2007,5277,5352,75,1.421,39,36,27,87,H1
"Mahnomen County, MN",2007-2008,5352,5386,34,0.635,44,-10,27,87,H1
"Mahnomen County, MN",2008-2009,5386,5357,-29,-0.538,60,-89,27,87,H1
"Mahnomen County, MN",2009-2010,5357,5424,67,1.251,61,6,27,87,H1
"Mahnomen County, MN",2010-2011,5424,5495,71,1.309,55,16,27,87,H1
"Mahnomen County, MN",2011-2012,5495,5521,26,0.473,46,-20,27,87,H1
"Mahnomen County, MN",2012-2013,5521,5485,-36,-0.652,27,-63,27,87,H1
"Mahnomen County, MN",2013-2014,5485,5505,20,0.365,23,-3,27,87,H1
"Mahnomen County, MN",2014-2015,5525,5457,-68,-1.231,45,-113,27,87,H1
"Mahnomen County, MN",2015-2016,5457,5494,37,0.678,49,-12,27,87,H1
"Mahnomen County, MN",2016-2017,5494,5596,102,1.857,51,51,27,87,H1
"Marshall County, MN",2000-2001,10119,9948,-171,-1.69,-11,-160,27,89,H1
"Marshall County, MN",2001-2002,9948,9919,-29,-0.292,12,-41,27,89,H1
"Marshall County, MN",2002-2003,9919,9962,43,0.434,12,31,27,89,H1
"Marshall County, MN",2003-2004,9962,9938,-24,-0.241,32,-56,27,89,H1
"Marshall County, MN",2004-2005,9938,9889,-49,-0.493,25,-74,27,89,H1
"Marshall County, MN",2005-2006,9889,9802,-87,-0.88,22,-109,27,89,H1
"Marshall County, MN",2006-2007,9802,9651,-151,-1.541,-8,-143,27,89,H1
"Marshall County, MN",2007-2008,9651,9551,-100,-1.036,45,-145,27,89,H1
"Marshall County, MN",2008-2009,9551,9478,-73,-0.764,35,-108,27,89,H1
"Marshall County, MN",2009-2010,9478,9429,-49,-0.517,28,-77,27,89,H1
"Marshall County, MN",2010-2011,9429,9476,47,0.498,11,36,27,89,H1
"Marshall County, MN",2011-2012,9476,9471,-5,-0.053,39,-44,27,89,H1
"Marshall County, MN",2012-2013,9471,9443,-28,-0.296,16,-44,27,89,H1
"Marshall County, MN",2013-2014,9443,9417,-26,-0.275,25,-51,27,89,H1
"Marshall County, MN",2014-2015,9434,9423,-11,-0.117,34,-45,27,89,H1
"Marshall County, MN",2015-2016,9423,9371,-52,-0.552,42,-94,27,89,H1
"Marshall County, MN",2016-2017,9371,9356,-15,-0.16,29,-44,27,89,H1
"Martin County, MN",2000-2001,21786,21500,-286,-1.313,4,-290,27,91,H1
"Martin County, MN",2001-2002,21500,21341,-159,-0.74,-41,-118,27,91,H1
"Martin County, MN",2002-2003,21341,21209,-132,-0.619,-45,-87,27,91,H1
"Martin County, MN",2003-2004,21209,21126,-83,-0.391,35,-118,27,91,H1
"Martin County, MN",2004-2005,21126,21063,-63,-0.298,0,-63,27,91,H1
"Martin County, MN",2005-2006,21063,20901,-162,-0.769,-15,-147,27,91,H1
"Martin County, MN",2006-2007,20901,20878,-23,-0.11,9,-32,27,91,H1
"Martin County, MN",2007-2008,20878,20914,36,0.172,13,23,27,91,H1
"Martin County, MN",2008-2009,20914,20790,-124,-0.593,-5,-119,27,91,H1
"Martin County, MN",2009-2010,20790,20825,35,0.168,-7,42,27,91,H1
"Martin County, MN",2010-2011,20825,20631,-194,-0.932,-31,-163,27,91,H1
"Martin County, MN",2011-2012,20631,20482,-149,-0.722,-22,-127,27,91,H1
"Martin County, MN",2012-2013,20482,20418,-64,-0.312,-5,-59,27,91,H1
"Martin County, MN",2013-2014,20418,20220,-198,-0.97,-1,-197,27,91,H1
"Martin County, MN",2014-2015,20206,20022,-184,-0.911,-1,-183,27,91,H1
"Martin County, MN",2015-2016,20022,19890,-132,-0.659,-16,-116,27,91,H1
"Martin County, MN",2016-2017,19890,19850,-40,-0.201,7,-47,27,91,H1
"Meeker County, MN",2000-2001,22766,22862,96,0.422,58,38,27,93,H1
"Meeker County, MN",2001-2002,22862,22991,129,0.564,77,52,27,93,H1
"Meeker County, MN",2002-2003,22991,23092,101,0.439,46,55,27,93,H1
"Meeker County, MN",2003-2004,23092,23200,108,0.468,60,48,27,93,H1
"Meeker County, MN",2004-2005,23200,23213,13,0.056,108,-95,27,93,H1
"Meeker County, MN",2005-2006,23213,23402,189,0.814,72,117,27,93,H1
"Meeker County, MN",2006-2007,23402,23407,5,0.021,111,-106,27,93,H1
"Meeker County, MN",2007-2008,23407,23454,47,0.201,119,-72,27,93,H1
"Meeker County, MN",2008-2009,23454,23298,-156,-0.665,100,-256,27,93,H1
"Meeker County, MN",2009-2010,23298,23307,9,0.039,41,-32,27,93,H1
"Meeker County, MN",2010-2011,23307,23200,-107,-0.459,70,-177,27,93,H1
"Meeker County, MN",2011-2012,23200,23044,-156,-0.672,71,-227,27,93,H1
"Meeker County, MN",2012-2013,23044,23079,35,0.152,50,-15,27,93,H1
"Meeker County, MN",2013-2014,23079,23107,28,0.121,86,-58,27,93,H1
"Meeker County, MN",2014-2015,23148,23102,-46,-0.199,70,-116,27,93,H1
"Meeker County, MN",2015-2016,23102,23099,-3,-0.013,71,-74,27,93,H1
"Meeker County, MN",2016-2017,23099,23131,32,0.139,68,-36,27,93,H1
"Mille Lacs County, MN",2000-2001,22422,22865,443,1.976,12,431,27,95,H1
"Mille Lacs County, MN",2001-2002,22865,23580,715,3.127,24,691,27,95,H1
"Mille Lacs County, MN",2002-2003,23580,24234,654,2.774,84,570,27,95,H1
"Mille Lacs County, MN",2003-2004,24234,24716,482,1.989,68,414,27,95,H1
"Mille Lacs County, MN",2004-2005,24716,25414,698,2.824,156,542,27,95,H1
"Mille Lacs County, MN",2005-2006,25414,25882,468,1.842,130,338,27,95,H1
"Mille Lacs County, MN",2006-2007,25882,26108,226,0.873,102,124,27,95,H1
"Mille Lacs County, MN",2007-2008,26108,26171,63,0.241,141,-78,27,95,H1
"Mille Lacs County, MN",2008-2009,26171,26127,-44,-0.168,129,-173,27,95,H1
"Mille Lacs County, MN",2009-2010,26127,26083,-44,-0.168,59,-103,27,95,H1
"Mille Lacs County, MN",2010-2011,26083,25875,-208,-0.797,17,-225,27,95,H1
"Mille Lacs County, MN",2011-2012,25875,25728,-147,-0.568,59,-206,27,95,H1
"Mille Lacs County, MN",2012-2013,25728,25884,156,0.606,111,45,27,95,H1
"Mille Lacs County, MN",2013-2014,25884,25884,0,0,105,-105,27,95,H1
"Mille Lacs County, MN",2014-2015,25794,25788,-6,-0.023,55,-61,27,95,H1
"Mille Lacs County, MN",2015-2016,25788,25614,-174,-0.675,43,-217,27,95,H1
"Mille Lacs County, MN",2016-2017,25614,25872,258,1.007,23,235,27,95,H1
"Morrison County, MN",2000-2001,31819,32102,283,0.889,131,152,27,97,H1
"Morrison County, MN",2001-2002,32102,32373,271,0.844,93,178,27,97,H1
"Morrison County, MN",2002-2003,32373,32434,61,0.188,75,-14,27,97,H1
"Morrison County, MN",2003-2004,32434,32489,55,0.17,142,-87,27,97,H1
"Morrison County, MN",2004-2005,32489,32669,180,0.554,134,46,27,97,H1
"Morrison County, MN",2005-2006,32669,32813,144,0.441,151,-7,27,97,H1
"Morrison County, MN",2006-2007,32813,33024,211,0.643,120,91,27,97,H1
"Morrison County, MN",2007-2008,33024,33267,243,0.736,147,96,27,97,H1
"Morrison County, MN",2008-2009,33267,33156,-111,-0.334,153,-264,27,97,H1
"Morrison County, MN",2009-2010,33156,33230,74,0.223,111,-37,27,97,H1
"Morrison County, MN",2010-2011,33230,33248,18,0.054,102,-84,27,97,H1
"Morrison County, MN",2011-2012,33248,33097,-151,-0.454,49,-200,27,97,H1
"Morrison County, MN",2012-2013,33097,32884,-213,-0.644,16,-229,27,97,H1
"Morrison County, MN",2013-2014,32884,32810,-74,-0.225,20,-94,27,97,H1
"Morrison County, MN",2014-2015,32844,32775,-69,-0.21,54,-123,27,97,H1
"Morrison County, MN",2015-2016,32775,32920,145,0.442,98,47,27,97,H1
"Morrison County, MN",2016-2017,32920,33064,144,0.437,61,83,27,97,H1
"Mower County, MN",2000-2001,38669,38755,86,0.222,141,-55,27,99,H1
"Mower County, MN",2001-2002,38755,38663,-92,-0.237,121,-213,27,99,H1
"Mower County, MN",2002-2003,38663,38735,72,0.186,142,-70,27,99,H1
"Mower County, MN",2003-2004,38735,38900,165,0.426,142,23,27,99,H1
"Mower County, MN",2004-2005,38900,38659,-241,-0.62,120,-361,27,99,H1
"Mower County, MN",2005-2006,38659,38697,38,0.098,125,-87,27,99,H1
"Mower County, MN",2006-2007,38697,38672,-25,-0.065,187,-212,27,99,H1
"Mower County, MN",2007-2008,38672,38695,23,0.059,176,-153,27,99,H1
"Mower County, MN",2008-2009,38695,39023,328,0.848,153,175,27,99,H1
"Mower County, MN",2009-2010,39023,39219,196,0.502,156,40,27,99,H1
"Mower County, MN",2010-2011,39219,39322,103,0.263,131,-28,27,99,H1
"Mower County, MN",2011-2012,39322,39377,55,0.14,144,-89,27,99,H1
"Mower County, MN",2012-2013,39377,39318,-59,-0.15,127,-186,27,99,H1
"Mower County, MN",2013-2014,39318,39323,5,0.013,131,-126,27,99,H1
"Mower County, MN",2014-2015,39218,39116,-102,-0.26,160,-262,27,99,H1
"Mower County, MN",2015-2016,39116,39329,213,0.545,114,99,27,99,H1
"Mower County, MN",2016-2017,39329,39566,237,0.603,139,98,27,99,H1
"Murray County, MN",2000-2001,9153,9111,-42,-0.459,-14,-28,27,101,H1
"Murray County, MN",2001-2002,9111,9066,-45,-0.494,-6,-39,27,101,H1
"Murray County, MN",2002-2003,9066,9041,-25,-0.276,7,-32,27,101,H1
"Murray County, MN",2003-2004,9041,8989,-52,-0.575,-20,-32,27,101,H1
"Murray County, MN",2004-2005,8989,8919,-70,-0.779,-4,-66,27,101,H1
"Murray County, MN",2005-2006,8919,8884,-35,-0.392,3,-38,27,101,H1
"Murray County, MN",2006-2007,8884,8788,-96,-1.081,-18,-78,27,101,H1
"Murray County, MN",2007-2008,8788,8755,-33,-0.376,12,-45,27,101,H1
"Murray County, MN",2008-2009,8755,8771,16,0.183,11,5,27,101,H1
"Murray County, MN",2009-2010,8771,8685,-86,-0.981,3,-89,27,101,H1
"Murray County, MN",2010-2011,8685,8648,-37,-0.426,-16,-21,27,101,H1
"Murray County, MN",2011-2012,8648,8574,-74,-0.856,-32,-42,27,101,H1
"Murray County, MN",2012-2013,8574,8554,-20,-0.233,8,-28,27,101,H1
"Murray County, MN",2013-2014,8554,8470,-84,-0.982,-4,-80,27,101,H1
"Murray County, MN",2014-2015,8447,8413,-34,-0.403,-10,-24,27,101,H1
"Murray County, MN",2015-2016,8413,8300,-113,-1.343,-2,-111,27,101,H1
"Murray County, MN",2016-2017,8300,8346,46,0.554,3,43,27,101,H1
"Nicollet County, MN",2000-2001,29904,30297,393,1.314,212,181,27,103,H1
"Nicollet County, MN",2001-2002,30297,30565,268,0.885,199,69,27,103,H1
"Nicollet County, MN",2002-2003,30565,30782,217,0.71,173,44,27,103,H1
"Nicollet County, MN",2003-2004,30782,31036,254,0.825,199,55,27,103,H1
"Nicollet County, MN",2004-2005,31036,31193,157,0.506,211,-54,27,103,H1
"Nicollet County, MN",2005-2006,31193,31779,586,1.879,180,406,27,103,H1
"Nicollet County, MN",2006-2007,31779,31989,210,0.661,214,-4,27,103,H1
"Nicollet County, MN",2007-2008,31989,32261,272,0.85,215,57,27,103,H1
"Nicollet County, MN",2008-2009,32261,32546,285,0.883,181,104,27,103,H1
"Nicollet County, MN",2009-2010,32546,32740,194,0.596,213,-19,27,103,H1
"Nicollet County, MN",2010-2011,32740,32963,223,0.681,218,5,27,103,H1
"Nicollet County, MN",2011-2012,32963,32936,-27,-0.082,180,-207,27,103,H1
"Nicollet County, MN",2012-2013,32936,32883,-53,-0.161,137,-190,27,103,H1
"Nicollet County, MN",2013-2014,32883,33093,210,0.639,119,91,27,103,H1
"Nicollet County, MN",2014-2015,33257,33347,90,0.271,174,-84,27,103,H1
"Nicollet County, MN",2015-2016,33347,33656,309,0.927,174,135,27,103,H1
"Nicollet County, MN",2016-2017,33656,33966,310,0.921,124,186,27,103,H1
"Nobles County, MN",2000-2001,20791,20847,56,0.269,113,-57,27,105,H1
"Nobles County, MN",2001-2002,20847,20665,-182,-0.873,124,-306,27,105,H1
"Nobles County, MN",2002-2003,20665,20667,2,0.01,116,-114,27,105,H1
"Nobles County, MN",2003-2004,20667,20629,-38,-0.184,141,-179,27,105,H1
"Nobles County, MN",2004-2005,20629,20709,80,0.388,157,-77,27,105,H1
"Nobles County, MN",2005-2006,20709,20608,-101,-0.488,150,-251,27,105,H1
"Nobles County, MN",2006-2007,20608,20723,115,0.558,140,-25,27,105,H1
"Nobles County, MN",2007-2008,20723,21126,403,1.945,201,202,27,105,H1
"Nobles County, MN",2008-2009,21126,21318,192,0.909,172,20,27,105,H1
"Nobles County, MN",2009-2010,21318,21394,76,0.357,171,-95,27,105,H1
"Nobles County, MN",2010-2011,21394,21568,174,0.813,211,-37,27,105,H1
"Nobles County, MN",2011-2012,21568,21674,106,0.491,158,-52,27,105,H1
"Nobles County, MN",2012-2013,21674,21719,45,0.208,149,-104,27,105,H1
"Nobles County, MN",2013-2014,21719,21590,-129,-0.594,160,-289,27,105,H1
"Nobles County, MN",2014-2015,21653,21770,117,0.54,190,-73,27,105,H1
"Nobles County, MN",2015-2016,21770,22016,246,1.13,233,13,27,105,H1
"Nobles County, MN",2016-2017,22016,21944,-72,-0.327,212,-284,27,105,H1
"Norman County, MN",2000-2001,7431,7328,-103,-1.386,-28,-75,27,107,H1
"Norman County, MN",2001-2002,7328,7312,-16,-0.218,-29,13,27,107,H1
"Norman County, MN",2002-2003,7312,7188,-124,-1.696,-46,-78,27,107,H1
"Norman County, MN",2003-2004,7188,7120,-68,-0.946,-27,-41,27,107,H1
"Norman County, MN",2004-2005,7120,7047,-73,-1.025,-37,-36,27,107,H1
"Norman County, MN",2005-2006,7047,6952,-95,-1.348,-4,-91,27,107,H1
"Norman County, MN",2006-2007,6952,6860,-92,-1.323,-69,-23,27,107,H1
"Norman County, MN",2007-2008,6860,6842,-18,-0.262,3,-21,27,107,H1
"Norman County, MN",2008-2009,6842,6815,-27,-0.395,-18,-9,27,107,H1
"Norman County, MN",2009-2010,6815,6847,32,0.47,-16,48,27,107,H1
"Norman County, MN",2010-2011,6847,6840,-7,-0.102,-37,30,27,107,H1
"Norman County, MN",2011-2012,6840,6637,-203,-2.968,-34,-169,27,107,H1
"Norman County, MN",2012-2013,6637,6662,25,0.377,-5,30,27,107,H1
"Norman County, MN",2013-2014,6662,6639,-23,-0.345,-10,-13,27,107,H1
"Norman County, MN",2014-2015,6643,6678,35,0.527,-11,46,27,107,H1
"Norman County, MN",2015-2016,6678,6538,-140,-2.096,-20,-120,27,107,H1
"Norman County, MN",2016-2017,6538,6597,59,0.902,-20,79,27,107,H1
"Olmsted County, MN",2000-2001,124930,126737,1807,1.446,1113,694,27,109,H1
"Olmsted County, MN",2001-2002,126737,129132,2395,1.89,1181,1214,27,109,H1
"Olmsted County, MN",2002-2003,129132,131196,2064,1.598,1207,857,27,109,H1
"Olmsted County, MN",2003-2004,131196,133195,1999,1.524,1323,676,27,109,H1
"Olmsted County, MN",2004-2005,133195,134953,1758,1.32,1352,406,27,109,H1
"Olmsted County, MN",2005-2006,134953,137293,2340,1.734,1405,935,27,109,H1
"Olmsted County, MN",2006-2007,137293,139369,2076,1.512,1386,690,27,109,H1
"Olmsted County, MN",2007-2008,139369,141527,2158,1.548,1480,678,27,109,H1
"Olmsted County, MN",2008-2009,141527,143521,1994,1.409,1373,621,27,109,H1
"Olmsted County, MN",2009-2010,143521,144500,979,0.682,1479,-500,27,109,H1
"Olmsted County, MN",2010-2011,144500,145981,1481,1.025,1243,238,27,109,H1
"Olmsted County, MN",2011-2012,145981,147156,1175,0.805,1166,9,27,109,H1
"Olmsted County, MN",2012-2013,147156,149232,2076,1.411,1184,892,27,109,H1
"Olmsted County, MN",2013-2014,149232,150287,1055,0.707,1150,-95,27,109,H1
"Olmsted County, MN",2014-2015,150199,151436,1237,0.824,1228,9,27,109,H1
"Olmsted County, MN",2015-2016,151436,153183,1747,1.154,1087,660,27,109,H1
"Olmsted County, MN",2016-2017,153183,154930,1747,1.14,1113,634,27,109,H1
"Otter Tail County, MN",2000-2001,57073,57076,3,0.005,-80,83,27,111,H1
"Otter Tail County, MN",2001-2002,57076,57245,169,0.296,-80,249,27,111,H1
"Otter Tail County, MN",2002-2003,57245,57515,270,0.472,-81,351,27,111,H1
"Otter Tail County, MN",2003-2004,57515,57576,61,0.106,-50,111,27,111,H1
"Otter Tail County, MN",2004-2005,57576,57420,-156,-0.271,-23,-133,27,111,H1
"Otter Tail County, MN",2005-2006,57420,57732,312,0.543,-22,334,27,111,H1
"Otter Tail County, MN",2006-2007,57732,57677,-55,-0.095,51,-106,27,111,H1
"Otter Tail County, MN",2007-2008,57677,57691,14,0.024,24,-10,27,111,H1
"Otter Tail County, MN",2008-2009,57691,57333,-358,-0.621,-8,-350,27,111,H1
"Otter Tail County, MN",2009-2010,57333,57260,-73,-0.127,-96,23,27,111,H1
"Otter Tail County, MN",2010-2011,57260,57307,47,0.082,-118,165,27,111,H1
"Otter Tail County, MN",2011-2012,57307,57292,-15,-0.026,-68,53,27,111,H1
"Otter Tail County, MN",2012-2013,57292,57591,299,0.522,-17,316,27,111,H1
"Otter Tail County, MN",2013-2014,57591,57635,44,0.076,-33,77,27,111,H1
"Otter Tail County, MN",2014-2015,57622,57716,94,0.163,-28,122,27,111,H1
"Otter Tail County, MN",2015-2016,57716,57981,265,0.459,46,219,27,111,H1
"Otter Tail County, MN",2016-2017,57981,58345,364,0.628,10,354,27,111,H1
"Pennington County, MN",2000-2001,13545,13373,-172,-1.27,12,-184,27,113,H1
"Pennington County, MN",2001-2002,13373,13607,234,1.75,34,200,27,113,H1
"Pennington County, MN",2002-2003,13607,13604,-3,-0.022,27,-30,27,113,H1
"Pennington County, MN",2003-2004,13604,13640,36,0.265,26,10,27,113,H1
"Pennington County, MN",2004-2005,13640,13639,-1,-0.007,52,-53,27,113,H1
"Pennington County, MN",2005-2006,13639,13810,171,1.254,48,123,27,113,H1
"Pennington County, MN",2006-2007,13810,13840,30,0.217,63,-33,27,113,H1
"Pennington County, MN",2007-2008,13840,13842,2,0.014,79,-77,27,113,H1
"Pennington County, MN",2008-2009,13842,13873,31,0.224,61,-30,27,113,H1
"Pennington County, MN",2009-2010,13873,13946,73,0.526,52,21,27,113,H1
"Pennington County, MN",2010-2011,13946,14023,77,0.552,20,57,27,113,H1
"Pennington County, MN",2011-2012,14023,14071,48,0.342,44,4,27,113,H1
"Pennington County, MN",2012-2013,14071,14105,34,0.242,60,-26,27,113,H1
"Pennington County, MN",2013-2014,14105,14058,-47,-0.333,53,-100,27,113,H1
"Pennington County, MN",2014-2015,14079,14219,140,0.994,58,82,27,113,H1
"Pennington County, MN",2015-2016,14219,14251,32,0.225,75,-43,27,113,H1
"Pennington County, MN",2016-2017,14251,14238,-13,-0.091,41,-54,27,113,H1
"Pine County, MN",2000-2001,26607,27125,518,1.947,75,443,27,115,H1
"Pine County, MN",2001-2002,27125,27627,502,1.851,42,460,27,115,H1
"Pine County, MN",2002-2003,27627,27946,319,1.155,75,244,27,115,H1
"Pine County, MN",2003-2004,27946,28323,377,1.349,75,302,27,115,H1
"Pine County, MN",2004-2005,28323,28616,293,1.034,75,218,27,115,H1
"Pine County, MN",2005-2006,28616,28860,244,0.853,93,151,27,115,H1
"Pine County, MN",2006-2007,28860,29210,350,1.213,85,265,27,115,H1
"Pine County, MN",2007-2008,29210,29614,404,1.383,80,324,27,115,H1
"Pine County, MN",2008-2009,29614,29655,41,0.138,82,-41,27,115,H1
"Pine County, MN",2009-2010,29655,29718,63,0.212,8,55,27,115,H1
"Pine County, MN",2010-2011,29718,29617,-101,-0.34,81,-182,27,115,H1
"Pine County, MN",2011-2012,29617,29223,-394,-1.33,51,-445,27,115,H1
"Pine County, MN",2012-2013,29223,29083,-140,-0.479,-9,-131,27,115,H1
"Pine County, MN",2013-2014,29083,29095,12,0.041,11,1,27,115,H1
"Pine County, MN",2014-2015,29109,29069,-40,-0.137,41,-81,27,115,H1
"Pine County, MN",2015-2016,29069,28877,-192,-0.66,-38,-154,27,115,H1
"Pine County, MN",2016-2017,28877,29203,326,1.129,-21,347,27,115,H1
"Pipestone County, MN",2000-2001,9858,9854,-4,-0.041,-6,2,27,117,H1
"Pipestone County, MN",2001-2002,9854,9727,-127,-1.289,-35,-92,27,117,H1
"Pipestone County, MN",2002-2003,9727,9662,-65,-0.668,-24,-41,27,117,H1
"Pipestone County, MN",2003-2004,9662,9598,-64,-0.662,8,-72,27,117,H1
"Pipestone County, MN",2004-2005,9598,9453,-145,-1.511,-11,-134,27,117,H1
"Pipestone County, MN",2005-2006,9453,9496,43,0.455,4,39,27,117,H1
"Pipestone County, MN",2006-2007,9496,9520,24,0.253,7,17,27,117,H1
"Pipestone County, MN",2007-2008,9520,9631,111,1.166,23,88,27,117,H1
"Pipestone County, MN",2008-2009,9631,9624,-7,-0.073,19,-26,27,117,H1
"Pipestone County, MN",2009-2010,9624,9581,-43,-0.447,3,-46,27,117,H1
"Pipestone County, MN",2010-2011,9581,9516,-65,-0.678,13,-78,27,117,H1
"Pipestone County, MN",2011-2012,9516,9373,-143,-1.503,-1,-142,27,117,H1
"Pipestone County, MN",2012-2013,9373,9282,-91,-0.971,6,-97,27,117,H1
"Pipestone County, MN",2013-2014,9282,9281,-1,-0.011,2,-3,27,117,H1
"Pipestone County, MN",2014-2015,9301,9271,-30,-0.323,17,-47,27,117,H1
"Pipestone County, MN",2015-2016,9271,9193,-78,-0.841,5,-83,27,117,H1
"Pipestone County, MN",2016-2017,9193,9087,-106,-1.153,6,-112,27,117,H1
"Polk County, MN",2000-2001,31384,31096,-288,-0.918,-69,-219,27,119,H1
"Polk County, MN",2001-2002,31096,30958,-138,-0.444,-64,-74,27,119,H1
"Polk County, MN",2002-2003,30958,30980,22,0.071,-33,55,27,119,H1
"Polk County, MN",2003-2004,30980,31093,113,0.365,37,76,27,119,H1
"Polk County, MN",2004-2005,31093,31148,55,0.177,44,11,27,119,H1
"Polk County, MN",2005-2006,31148,31170,22,0.071,59,-37,27,119,H1
"Polk County, MN",2006-2007,31170,31273,103,0.33,33,70,27,119,H1
"Polk County, MN",2007-2008,31273,31175,-98,-0.313,41,-139,27,119,H1
"Polk County, MN",2008-2009,31175,31423,248,0.796,76,172,27,119,H1
"Polk County, MN",2009-2010,31423,31662,239,0.761,41,198,27,119,H1
"Polk County, MN",2010-2011,31662,31569,-93,-0.294,28,-121,27,119,H1
"Polk County, MN",2011-2012,31569,31513,-56,-0.177,49,-105,27,119,H1
"Polk County, MN",2012-2013,31513,31703,190,0.603,94,96,27,119,H1
"Polk County, MN",2013-2014,31703,31704,1,0.003,92,-91,27,119,H1
"Polk County, MN",2014-2015,31517,31533,16,0.051,74,-58,27,119,H1
"Polk County, MN",2015-2016,31533,31635,102,0.323,98,4,27,119,H1
"Polk County, MN",2016-2017,31635,31619,-16,-0.051,101,-117,27,119,H1
"Pope County, MN",2000-2001,11231,11153,-78,-0.695,-43,-35,27,121,H1
"Pope County, MN",2001-2002,11153,11206,53,0.475,-39,92,27,121,H1
"Pope County, MN",2002-2003,11206,11171,-35,-0.312,-8,-27,27,121,H1
"Pope County, MN",2003-2004,11171,11183,12,0.107,-36,48,27,121,H1
"Pope County, MN",2004-2005,11183,11142,-41,-0.367,-26,-15,27,121,H1
"Pope County, MN",2005-2006,11142,11138,-4,-0.036,-28,24,27,121,H1
"Pope County, MN",2006-2007,11138,11087,-51,-0.458,-3,-48,27,121,H1
"Pope County, MN",2007-2008,11087,11084,-3,-0.027,-19,16,27,121,H1
"Pope County, MN",2008-2009,11084,11034,-50,-0.451,-6,-44,27,121,H1
"Pope County, MN",2009-2010,11034,10969,-65,-0.589,-15,-50,27,121,H1
"Pope County, MN",2010-2011,10969,10927,-42,-0.383,-20,-22,27,121,H1
"Pope County, MN",2011-2012,10927,10918,-9,-0.082,7,-16,27,121,H1
"Pope County, MN",2012-2013,10918,10932,14,0.128,6,8,27,121,H1
"Pope County, MN",2013-2014,10932,10984,52,0.476,14,38,27,121,H1
"Pope County, MN",2014-2015,10952,11041,89,0.813,10,79,27,121,H1
"Pope County, MN",2015-2016,11041,10961,-80,-0.725,-8,-72,27,121,H1
"Pope County, MN",2016-2017,10961,10970,9,0.082,1,8,27,121,H1
"Ramsey County, MN",2000-2001,511520,512926,1406,0.275,3525,-2119,27,123,H1
"Ramsey County, MN",2001-2002,512926,510581,-2345,-0.457,3257,-5602,27,123,H1
"Ramsey County, MN",2002-2003,510581,505958,-4623,-0.905,3715,-8338,27,123,H1
"Ramsey County, MN",2003-2004,505958,501104,-4854,-0.959,3490,-8344,27,123,H1
"Ramsey County, MN",2004-2005,501104,497560,-3544,-0.707,3402,-6946,27,123,H1
"Ramsey County, MN",2005-2006,497560,497158,-402,-0.081,3803,-4205,27,123,H1
"Ramsey County, MN",2006-2007,497158,499605,2447,0.492,3886,-1439,27,123,H1
"Ramsey County, MN",2007-2008,499605,502890,3285,0.658,3413,-128,27,123,H1
"Ramsey County, MN",2008-2009,502890,506590,3700,0.736,3080,620,27,123,H1
"Ramsey County, MN",2009-2010,506590,509372,2782,0.549,3500,-718,27,123,H1
"Ramsey County, MN",2010-2011,509372,515710,6338,1.244,3558,2780,27,123,H1
"Ramsey County, MN",2011-2012,515710,520919,5209,1.01,3714,1495,27,123,H1
"Ramsey County, MN",2012-2013,520919,527667,6748,1.295,3973,2775,27,123,H1
"Ramsey County, MN",2013-2014,527667,532655,4988,0.945,3938,1050,27,123,H1
"Ramsey County, MN",2014-2015,533634,538133,4499,0.843,3955,544,27,123,H1
"Ramsey County, MN",2015-2016,538133,542812,4679,0.869,3685,994,27,123,H1
"Ramsey County, MN",2016-2017,542812,547974,5162,0.951,3667,1495,27,123,H1
"Red Lake County, MN",2000-2001,4279,4273,-6,-0.14,8,-14,27,125,H1
"Red Lake County, MN",2001-2002,4273,4224,-49,-1.147,-8,-41,27,125,H1
"Red Lake County, MN",2002-2003,4224,4239,15,0.355,7,8,27,125,H1
"Red Lake County, MN",2003-2004,4239,4259,20,0.472,7,13,27,125,H1
"Red Lake County, MN",2004-2005,4259,4191,-68,-1.597,10,-78,27,125,H1
"Red Lake County, MN",2005-2006,4191,4077,-114,-2.72,-12,-102,27,125,H1
"Red Lake County, MN",2006-2007,4077,4093,16,0.392,-12,28,27,125,H1
"Red Lake County, MN",2007-2008,4093,4097,4,0.098,25,-21,27,125,H1
"Red Lake County, MN",2008-2009,4097,4130,33,0.805,14,19,27,125,H1
"Red Lake County, MN",2009-2010,4130,4074,-56,-1.356,10,-66,27,125,H1
"Red Lake County, MN",2010-2011,4074,4102,28,0.687,0,28,27,125,H1
"Red Lake County, MN",2011-2012,4102,4075,-27,-0.658,23,-50,27,125,H1
"Red Lake County, MN",2012-2013,4075,4063,-12,-0.294,34,-46,27,125,H1
"Red Lake County, MN",2013-2014,4063,4043,-20,-0.492,36,-56,27,125,H1
"Red Lake County, MN",2014-2015,4019,4055,36,0.896,31,5,27,125,H1
"Red Lake County, MN",2015-2016,4055,3996,-59,-1.455,23,-82,27,125,H1
"Red Lake County, MN",2016-2017,3996,4030,34,0.851,22,12,27,125,H1
"Redwood County, MN",2000-2001,16767,16666,-101,-0.602,-31,-70,27,127,H1
"Redwood County, MN",2001-2002,16666,16487,-179,-1.074,0,-179,27,127,H1
"Redwood County, MN",2002-2003,16487,16372,-115,-0.698,17,-132,27,127,H1
"Redwood County, MN",2003-2004,16372,16320,-52,-0.318,7,-59,27,127,H1
"Redwood County, MN",2004-2005,16320,16100,-220,-1.348,-58,-162,27,127,H1
"Redwood County, MN",2005-2006,16100,16119,19,0.118,14,5,27,127,H1
"Redwood County, MN",2006-2007,16119,16053,-66,-0.409,14,-80,27,127,H1
"Redwood County, MN",2007-2008,16053,16103,50,0.311,24,26,27,127,H1
"Redwood County, MN",2008-2009,16103,16011,-92,-0.571,14,-106,27,127,H1
"Redwood County, MN",2009-2010,16011,16033,22,0.137,17,5,27,127,H1
"Redwood County, MN",2010-2011,16033,16055,22,0.137,-3,25,27,127,H1
"Redwood County, MN",2011-2012,16055,15853,-202,-1.258,-8,-194,27,127,H1
"Redwood County, MN",2012-2013,15853,15712,-141,-0.889,4,-145,27,127,H1
"Redwood County, MN",2013-2014,15712,15515,-197,-1.254,6,-203,27,127,H1
"Redwood County, MN",2014-2015,15509,15471,-38,-0.245,10,-48,27,127,H1
"Redwood County, MN",2015-2016,15471,15236,-235,-1.519,18,-253,27,127,H1
"Redwood County, MN",2016-2017,15236,15272,36,0.236,18,18,27,127,H1
"Renville County, MN",2000-2001,17125,16880,-245,-1.431,-53,-192,27,129,H1
"Renville County, MN",2001-2002,16880,16869,-11,-0.065,-2,-9,27,129,H1
"Renville County, MN",2002-2003,16869,16757,-112,-0.664,10,-122,27,129,H1
"Renville County, MN",2003-2004,16757,16609,-148,-0.883,-29,-119,27,129,H1
"Renville County, MN",2004-2005,16609,16565,-44,-0.265,-14,-30,27,129,H1
"Renville County, MN",2005-2006,16565,16374,-191,-1.153,29,-220,27,129,H1
"Renville County, MN",2006-2007,16374,16227,-147,-0.898,-26,-121,27,129,H1
"Renville County, MN",2007-2008,16227,15911,-316,-1.947,6,-322,27,129,H1
"Renville County, MN",2008-2009,15911,15832,-79,-0.497,7,-86,27,129,H1
"Renville County, MN",2009-2010,15832,15674,-158,-0.998,31,-189,27,129,H1
"Renville County, MN",2010-2011,15674,15452,-222,-1.416,-24,-198,27,129,H1
"Renville County, MN",2011-2012,15452,15343,-109,-0.705,-1,-108,27,129,H1
"Renville County, MN",2012-2013,15343,15134,-209,-1.362,-3,-206,27,129,H1
"Renville County, MN",2013-2014,15134,15025,-109,-0.72,-3,-106,27,129,H1
"Renville County, MN",2014-2015,15003,14892,-111,-0.74,-18,-93,27,129,H1
"Renville County, MN",2015-2016,14892,14580,-312,-2.095,-26,-286,27,129,H1
"Renville County, MN",2016-2017,14580,14645,65,0.446,-4,69,27,129,H1
"Rice County, MN",2000-2001,56811,57731,920,1.619,254,666,27,131,H1
"Rice County, MN",2001-2002,57731,58452,721,1.249,275,446,27,131,H1
"Rice County, MN",2002-2003,58452,59395,943,1.613,264,679,27,131,H1
"Rice County, MN",2003-2004,59395,60146,751,1.264,293,458,27,131,H1
"Rice County, MN",2004-2005,60146,60832,686,1.141,361,325,27,131,H1
"Rice County, MN",2005-2006,60832,61899,1067,1.754,432,635,27,131,H1
"Rice County, MN",2006-2007,61899,62387,488,0.788,402,86,27,131,H1
"Rice County, MN",2007-2008,62387,63061,674,1.08,364,310,27,131,H1
"Rice County, MN",2008-2009,63061,63859,798,1.265,390,408,27,131,H1
"Rice County, MN",2009-2010,63859,64297,438,0.686,259,179,27,131,H1
"Rice County, MN",2010-2011,64297,64937,640,0.995,321,319,27,131,H1
"Rice County, MN",2011-2012,64937,64904,-33,-0.051,244,-277,27,131,H1
"Rice County, MN",2012-2013,64904,64854,-50,-0.077,282,-332,27,131,H1
"Rice County, MN",2013-2014,64854,65151,297,0.458,280,17,27,131,H1
"Rice County, MN",2014-2015,65143,65400,257,0.395,241,16,27,131,H1
"Rice County, MN",2015-2016,65400,65588,188,0.287,314,-126,27,131,H1
"Rice County, MN",2016-2017,65588,65968,380,0.579,282,98,27,131,H1
"Rock County, MN",2000-2001,9703,9696,-7,-0.072,-23,16,27,133,H1
"Rock County, MN",2001-2002,9696,9688,-8,-0.083,-14,6,27,133,H1
"Rock County, MN",2002-2003,9688,9631,-57,-0.588,-5,-52,27,133,H1
"Rock County, MN",2003-2004,9631,9501,-130,-1.35,2,-132,27,133,H1
"Rock County, MN",2004-2005,9501,9520,19,0.2,14,5,27,133,H1
"Rock County, MN",2005-2006,9520,9502,-18,-0.189,25,-43,27,133,H1
"Rock County, MN",2006-2007,9502,9588,86,0.905,-4,90,27,133,H1
"Rock County, MN",2007-2008,9588,9597,9,0.094,25,-16,27,133,H1
"Rock County, MN",2008-2009,9597,9652,55,0.573,15,40,27,133,H1
"Rock County, MN",2009-2010,9652,9659,7,0.073,11,-4,27,133,H1
"Rock County, MN",2010-2011,9659,9625,-34,-0.352,-33,-1,27,133,H1
"Rock County, MN",2011-2012,9625,9551,-74,-0.769,-10,-64,27,133,H1
"Rock County, MN",2012-2013,9551,9547,-4,-0.042,21,-25,27,133,H1
"Rock County, MN",2013-2014,9547,9553,6,0.063,7,-1,27,133,H1
"Rock County, MN",2014-2015,9516,9600,84,0.883,6,78,27,133,H1
"Rock County, MN",2015-2016,9600,9413,-187,-1.948,3,-190,27,133,H1
"Rock County, MN",2016-2017,9413,9490,77,0.818,5,72,27,133,H1
"Roseau County, MN",2000-2001,16309,16164,-145,-0.889,57,-202,27,135,H1
"Roseau County, MN",2001-2002,16164,16101,-63,-0.39,75,-138,27,135,H1
"Roseau County, MN",2002-2003,16101,16168,67,0.416,83,-16,27,135,H1
"Roseau County, MN",2003-2004,16168,16150,-18,-0.111,79,-97,27,135,H1
"Roseau County, MN",2004-2005,16150,16212,62,0.384,66,-4,27,135,H1
"Roseau County, MN",2005-2006,16212,16031,-181,-1.116,80,-261,27,135,H1
"Roseau County, MN",2006-2007,16031,15959,-72,-0.449,95,-167,27,135,H1
"Roseau County, MN",2007-2008,15959,15935,-24,-0.15,71,-95,27,135,H1
"Roseau County, MN",2008-2009,15935,15836,-99,-0.621,88,-187,27,135,H1
"Roseau County, MN",2009-2010,15836,15557,-279,-1.762,63,-342,27,135,H1
"Roseau County, MN",2010-2011,15557,15504,-53,-0.341,50,-103,27,135,H1
"Roseau County, MN",2011-2012,15504,15487,-17,-0.11,39,-56,27,135,H1
"Roseau County, MN",2012-2013,15487,15497,10,0.065,69,-59,27,135,H1
"Roseau County, MN",2013-2014,15497,15679,182,1.174,62,120,27,135,H1
"Roseau County, MN",2014-2015,15740,15770,30,0.191,98,-68,27,135,H1
"Roseau County, MN",2015-2016,15770,15559,-211,-1.338,48,-259,27,135,H1
"Roseau County, MN",2016-2017,15559,15327,-232,-1.491,51,-283,27,135,H1
"St. Louis County, MN",2000-2001,200626,201307,681,0.339,-250,931,27,137,H1
"St. Louis County, MN",2001-2002,201307,200519,-788,-0.391,-174,-614,27,137,H1
"St. Louis County, MN",2002-2003,200519,200076,-443,-0.221,-228,-215,27,137,H1
"St. Louis County, MN",2003-2004,200076,199304,-772,-0.386,23,-795,27,137,H1
"St. Louis County, MN",2004-2005,199304,198443,-861,-0.432,-10,-851,27,137,H1
"St. Louis County, MN",2005-2006,198443,198357,-86,-0.043,109,-195,27,137,H1
"St. Louis County, MN",2006-2007,198357,198903,546,0.275,31,515,27,137,H1
"St. Louis County, MN",2007-2008,198903,199745,842,0.423,126,716,27,137,H1
"St. Louis County, MN",2008-2009,199745,200198,453,0.227,238,215,27,137,H1
"St. Louis County, MN",2009-2010,200198,200198,0,0,136,-136,27,137,H1
"St. Louis County, MN",2010-2011,200198,200418,220,0.11,-60,280,27,137,H1
"St. Louis County, MN",2011-2012,200418,200487,69,0.034,-48,117,27,137,H1
"St. Louis County, MN",2012-2013,200487,200763,276,0.138,36,240,27,137,H1
"St. Louis County, MN",2013-2014,200763,200949,186,0.093,53,133,27,137,H1
"St. Louis County, MN",2014-2015,200780,200431,-349,-0.174,47,-396,27,137,H1
"St. Louis County, MN",2015-2016,200431,200018,-413,-0.206,-144,-269,27,137,H1
"St. Louis County, MN",2016-2017,200018,2.00E+05,-18,-0.009,-92,74,27,137,H1
"Scott County, MN",2000-2001,91031,96903,5872,6.451,1297,4575,27,139,H1
"Scott County, MN",2001-2002,96903,102623,5720,5.903,1423,4297,27,139,H1
"Scott County, MN",2002-2003,102623,107204,4581,4.464,1619,2962,27,139,H1
"Scott County, MN",2003-2004,107204,112605,5401,5.038,1670,3731,27,139,H1
"Scott County, MN",2004-2005,112605,117111,4506,4.002,1639,2867,27,139,H1
"Scott County, MN",2005-2006,117111,121013,3902,3.332,1699,2203,27,139,H1
"Scott County, MN",2006-2007,121013,124050,3037,2.51,1667,1370,27,139,H1
"Scott County, MN",2007-2008,124050,126613,2563,2.066,1733,830,27,139,H1
"Scott County, MN",2008-2009,126613,128530,1917,1.514,1770,147,27,139,H1
"Scott County, MN",2009-2010,128530,130480,1950,1.517,1494,456,27,139,H1
"Scott County, MN",2010-2011,130480,132638,2158,1.654,1358,800,27,139,H1
"Scott County, MN",2011-2012,132638,135254,2616,1.972,1407,1209,27,139,H1
"Scott County, MN",2012-2013,135254,137603,2349,1.737,1408,941,27,139,H1
"Scott County, MN",2013-2014,137603,139672,2069,1.504,1419,650,27,139,H1
"Scott County, MN",2014-2015,139470,141660,2190,1.57,1277,913,27,139,H1
"Scott County, MN",2015-2016,141660,143438,1778,1.255,1140,638,27,139,H1
"Scott County, MN",2016-2017,143438,145827,2389,1.666,1177,1212,27,139,H1
"Sherburne County, MN",2000-2001,65361,68220,2859,4.374,845,2014,27,141,H1
"Sherburne County, MN",2001-2002,68220,71867,3647,5.346,762,2885,27,141,H1
"Sherburne County, MN",2002-2003,71867,74771,2904,4.041,848,2056,27,141,H1
"Sherburne County, MN",2003-2004,74771,78091,3320,4.44,775,2545,27,141,H1
"Sherburne County, MN",2004-2005,78091,81179,3088,3.954,905,2183,27,141,H1
"Sherburne County, MN",2005-2006,81179,84079,2900,3.572,985,1915,27,141,H1
"Sherburne County, MN",2006-2007,84079,85968,1889,2.247,949,940,27,141,H1
"Sherburne County, MN",2007-2008,85968,87495,1527,1.776,991,536,27,141,H1
"Sherburne County, MN",2008-2009,87495,87880,385,0.44,1002,-617,27,141,H1
"Sherburne County, MN",2009-2010,87880,88788,908,1.033,729,179,27,141,H1
"Sherburne County, MN",2010-2011,88788,89251,463,0.521,671,-208,27,141,H1
"Sherburne County, MN",2011-2012,89251,89488,237,0.266,705,-468,27,141,H1
"Sherburne County, MN",2012-2013,89488,90197,709,0.792,746,-37,27,141,H1
"Sherburne County, MN",2013-2014,90197,91126,929,1.03,674,255,27,141,H1
"Sherburne County, MN",2014-2015,91208,91705,497,0.545,667,-170,27,141,H1
"Sherburne County, MN",2015-2016,91705,93236,1531,1.669,687,844,27,141,H1
"Sherburne County, MN",2016-2017,93236,94570,1334,1.431,711,623,27,141,H1
"Sibley County, MN",2000-2001,15361,15395,34,0.221,9,25,27,143,H1
"Sibley County, MN",2001-2002,15395,15345,-50,-0.325,41,-91,27,143,H1
"Sibley County, MN",2002-2003,15345,15254,-91,-0.593,45,-136,27,143,H1
"Sibley County, MN",2003-2004,15254,15202,-52,-0.341,73,-125,27,143,H1
"Sibley County, MN",2004-2005,15202,15126,-76,-0.5,66,-142,27,143,H1
"Sibley County, MN",2005-2006,15126,15164,38,0.251,64,-26,27,143,H1
"Sibley County, MN",2006-2007,15164,15263,99,0.653,91,8,27,143,H1
"Sibley County, MN",2007-2008,15263,15283,20,0.131,71,-51,27,143,H1
"Sibley County, MN",2008-2009,15283,15140,-143,-0.936,91,-234,27,143,H1
"Sibley County, MN",2009-2010,15140,15231,91,0.601,78,13,27,143,H1
"Sibley County, MN",2010-2011,15231,15175,-56,-0.368,26,-82,27,143,H1
"Sibley County, MN",2011-2012,15175,15100,-75,-0.494,38,-113,27,143,H1
"Sibley County, MN",2012-2013,15100,15058,-42,-0.278,53,-95,27,143,H1
"Sibley County, MN",2013-2014,15058,14918,-140,-0.93,53,-193,27,143,H1
"Sibley County, MN",2014-2015,14897,14875,-22,-0.148,35,-57,27,143,H1
"Sibley County, MN",2015-2016,14875,14792,-83,-0.558,-11,-72,27,143,H1
"Sibley County, MN",2016-2017,14792,14869,77,0.521,6,71,27,143,H1
"Stearns County, MN",2000-2001,133669,135241,1572,1.176,940,632,27,145,H1
"Stearns County, MN",2001-2002,135241,137006,1765,1.305,981,784,27,145,H1
"Stearns County, MN",2002-2003,137006,138401,1395,1.018,1005,390,27,145,H1
"Stearns County, MN",2003-2004,138401,139788,1387,1.002,1073,314,27,145,H1
"Stearns County, MN",2004-2005,139788,141813,2025,1.449,1086,939,27,145,H1
"Stearns County, MN",2005-2006,141813,144256,2443,1.723,1207,1236,27,145,H1
"Stearns County, MN",2006-2007,144256,146591,2335,1.619,1192,1143,27,145,H1
"Stearns County, MN",2007-2008,146591,148307,1716,1.171,1175,541,27,145,H1
"Stearns County, MN",2008-2009,148307,149696,1389,0.937,1173,216,27,145,H1
"Stearns County, MN",2009-2010,149696,150733,1037,0.693,1065,-28,27,145,H1
"Stearns County, MN",2010-2011,150733,151249,516,0.342,1025,-509,27,145,H1
"Stearns County, MN",2011-2012,151249,151646,397,0.262,870,-473,27,145,H1
"Stearns County, MN",2012-2013,151646,152098,452,0.298,955,-503,27,145,H1
"Stearns County, MN",2013-2014,152098,152912,814,0.535,913,-99,27,145,H1
"Stearns County, MN",2014-2015,153140,154708,1568,1.024,1075,493,27,145,H1
"Stearns County, MN",2015-2016,154708,156571,1863,1.204,955,908,27,145,H1
"Stearns County, MN",2016-2017,156571,157822,1251,0.799,1004,247,27,145,H1
"Steele County, MN",2000-2001,33793,34154,361,1.068,217,144,27,147,H1
"Steele County, MN",2001-2002,34154,34318,164,0.48,159,5,27,147,H1
"Steele County, MN",2002-2003,34318,34669,351,1.023,206,145,27,147,H1
"Steele County, MN",2003-2004,34669,35090,421,1.214,253,168,27,147,H1
"Steele County, MN",2004-2005,35090,35568,478,1.362,260,218,27,147,H1
"Steele County, MN",2005-2006,35568,36040,472,1.327,338,134,27,147,H1
"Steele County, MN",2006-2007,36040,36342,302,0.838,274,28,27,147,H1
"Steele County, MN",2007-2008,36342,36558,216,0.594,259,-43,27,147,H1
"Steele County, MN",2008-2009,36558,36684,126,0.345,285,-159,27,147,H1
"Steele County, MN",2009-2010,36684,36506,-178,-0.485,261,-439,27,147,H1
"Steele County, MN",2010-2011,36506,36551,45,0.123,224,-179,27,147,H1
"Steele County, MN",2011-2012,36551,36301,-250,-0.684,143,-393,27,147,H1
"Steele County, MN",2012-2013,36301,36429,128,0.353,176,-48,27,147,H1
"Steele County, MN",2013-2014,36429,36573,144,0.395,151,-7,27,147,H1
"Steele County, MN",2014-2015,36600,36755,155,0.423,188,-33,27,147,H1
"Steele County, MN",2015-2016,36755,36703,-52,-0.141,148,-200,27,147,H1
"Steele County, MN",2016-2017,36703,36887,184,0.501,138,46,27,147,H1
"Stevens County, MN",2000-2001,10021,9988,-33,-0.329,16,-49,27,149,H1
"Stevens County, MN",2001-2002,9988,9942,-46,-0.461,16,-62,27,149,H1
"Stevens County, MN",2002-2003,9942,9945,3,0.03,0,3,27,149,H1
"Stevens County, MN",2003-2004,9945,9857,-88,-0.885,34,-122,27,149,H1
"Stevens County, MN",2004-2005,9857,9807,-50,-0.507,40,-90,27,149,H1
"Stevens County, MN",2005-2006,9807,9729,-78,-0.795,47,-125,27,149,H1
"Stevens County, MN",2006-2007,9729,9660,-69,-0.709,19,-88,27,149,H1
"Stevens County, MN",2007-2008,9660,9711,51,0.528,54,-3,27,149,H1
"Stevens County, MN",2008-2009,9711,9735,24,0.247,33,-9,27,149,H1
"Stevens County, MN",2009-2010,9735,9710,-25,-0.257,37,-62,27,149,H1
"Stevens County, MN",2010-2011,9710,9725,15,0.154,9,6,27,149,H1
"Stevens County, MN",2011-2012,9725,9745,20,0.206,54,-34,27,149,H1
"Stevens County, MN",2012-2013,9745,9761,16,0.164,24,-8,27,149,H1
"Stevens County, MN",2013-2014,9761,9800,39,0.4,34,5,27,149,H1
"Stevens County, MN",2014-2015,9838,9796,-42,-0.427,47,-89,27,149,H1
"Stevens County, MN",2015-2016,9796,9747,-49,-0.5,34,-83,27,149,H1
"Stevens County, MN",2016-2017,9747,9634,-113,-1.159,31,-144,27,149,H1
"Swift County, MN",2000-2001,11834,11220,-614,-5.188,-19,-595,27,151,H1
"Swift County, MN",2001-2002,11220,10981,-239,-2.13,-9,-230,27,151,H1
"Swift County, MN",2002-2003,10981,10811,-170,-1.548,-3,-167,27,151,H1
"Swift County, MN",2003-2004,10811,10551,-260,-2.405,22,-282,27,151,H1
"Swift County, MN",2004-2005,10551,10232,-319,-3.023,-29,-290,27,151,H1
"Swift County, MN",2005-2006,10232,10119,-113,-1.104,2,-115,27,151,H1
"Swift County, MN",2006-2007,10119,10058,-61,-0.603,8,-69,27,151,H1
"Swift County, MN",2007-2008,10058,9966,-92,-0.915,-20,-72,27,151,H1
"Swift County, MN",2008-2009,9966,9827,-139,-1.395,4,-143,27,151,H1
"Swift County, MN",2009-2010,9827,9752,-75,-0.763,10,-85,27,151,H1
"Swift County, MN",2010-2011,9752,9679,-73,-0.749,0,-73,27,151,H1
"Swift County, MN",2011-2012,9679,9606,-73,-0.754,11,-84,27,151,H1
"Swift County, MN",2012-2013,9606,9535,-71,-0.739,4,-75,27,151,H1
"Swift County, MN",2013-2014,9535,9436,-99,-1.038,7,-106,27,151,H1
"Swift County, MN",2014-2015,9446,9340,-106,-1.122,16,-122,27,151,H1
"Swift County, MN",2015-2016,9340,9444,104,1.113,8,96,27,151,H1
"Swift County, MN",2016-2017,9444,9407,-37,-0.392,16,-53,27,151,H1
"Todd County, MN",2000-2001,24407,24567,160,0.656,37,123,27,153,H1
"Todd County, MN",2001-2002,24567,24463,-104,-0.423,30,-134,27,153,H1
"Todd County, MN",2002-2003,24463,24467,4,0.016,74,-70,27,153,H1
"Todd County, MN",2003-2004,24467,24633,166,0.678,84,82,27,153,H1
"Todd County, MN",2004-2005,24633,24608,-25,-0.101,76,-101,27,153,H1
"Todd County, MN",2005-2006,24608,24620,12,0.049,86,-74,27,153,H1
"Todd County, MN",2006-2007,24620,24819,199,0.808,118,81,27,153,H1
"Todd County, MN",2007-2008,24819,24859,40,0.161,124,-84,27,153,H1
"Todd County, MN",2008-2009,24859,24839,-20,-0.08,106,-126,27,153,H1
"Todd County, MN",2009-2010,24839,24880,41,0.165,68,-27,27,153,H1
"Todd County, MN",2010-2011,24880,24834,-46,-0.185,103,-149,27,153,H1
"Todd County, MN",2011-2012,24834,24546,-288,-1.16,143,-431,27,153,H1
"Todd County, MN",2012-2013,24546,24417,-129,-0.526,141,-270,27,153,H1
"Todd County, MN",2013-2014,24417,24264,-153,-0.627,132,-285,27,153,H1
"Todd County, MN",2014-2015,24269,24257,-12,-0.049,120,-132,27,153,H1
"Todd County, MN",2015-2016,24257,24404,147,0.606,100,47,27,153,H1
"Todd County, MN",2016-2017,24404,24515,111,0.455,117,-6,27,153,H1
"Traverse County, MN",2000-2001,4123,3978,-145,-3.517,-27,-118,27,155,H1
"Traverse County, MN",2001-2002,3978,3929,-49,-1.232,-20,-29,27,155,H1
"Traverse County, MN",2002-2003,3929,3883,-46,-1.171,-21,-25,27,155,H1
"Traverse County, MN",2003-2004,3883,3871,-12,-0.309,-25,13,27,155,H1
"Traverse County, MN",2004-2005,3871,3838,-33,-0.852,-18,-15,27,155,H1
"Traverse County, MN",2005-2006,3838,3795,-43,-1.12,-9,-34,27,155,H1
"Traverse County, MN",2006-2007,3795,3709,-86,-2.266,-8,-78,27,155,H1
"Traverse County, MN",2007-2008,3709,3637,-72,-1.941,-20,-52,27,155,H1
"Traverse County, MN",2008-2009,3637,3600,-37,-1.017,-8,-29,27,155,H1
"Traverse County, MN",2009-2010,3600,3539,-61,-1.694,-7,-54,27,155,H1
"Traverse County, MN",2010-2011,3539,3513,-26,-0.735,-36,10,27,155,H1
"Traverse County, MN",2011-2012,3513,3426,-87,-2.477,-25,-62,27,155,H1
"Traverse County, MN",2012-2013,3426,3410,-16,-0.467,-9,-7,27,155,H1
"Traverse County, MN",2013-2014,3410,3387,-23,-0.674,1,-24,27,155,H1
"Traverse County, MN",2014-2015,3391,3401,10,0.295,4,6,27,155,H1
"Traverse County, MN",2015-2016,3401,3322,-79,-2.323,-11,-68,27,155,H1
"Traverse County, MN",2016-2017,3322,3319,-3,-0.09,5,-8,27,155,H1
"Wabasha County, MN",2000-2001,21644,21764,120,0.554,83,37,27,157,H1
"Wabasha County, MN",2001-2002,21764,21752,-12,-0.055,73,-85,27,157,H1
"Wabasha County, MN",2002-2003,21752,21821,69,0.317,59,10,27,157,H1
"Wabasha County, MN",2003-2004,21821,21755,-66,-0.302,56,-122,27,157,H1
"Wabasha County, MN",2004-2005,21755,21706,-49,-0.225,93,-142,27,157,H1
"Wabasha County, MN",2005-2006,21706,21826,120,0.553,98,22,27,157,H1
"Wabasha County, MN",2006-2007,21826,21708,-118,-0.541,65,-183,27,157,H1
"Wabasha County, MN",2007-2008,21708,21787,79,0.364,80,-1,27,157,H1
"Wabasha County, MN",2008-2009,21787,21734,-53,-0.243,85,-138,27,157,H1
"Wabasha County, MN",2009-2010,21734,21658,-76,-0.35,50,-126,27,157,H1
"Wabasha County, MN",2010-2011,21658,21522,-136,-0.628,70,-206,27,157,H1
"Wabasha County, MN",2011-2012,21522,21422,-100,-0.465,54,-154,27,157,H1
"Wabasha County, MN",2012-2013,21422,21462,40,0.187,80,-40,27,157,H1
"Wabasha County, MN",2013-2014,21462,21362,-100,-0.466,66,-166,27,157,H1
"Wabasha County, MN",2014-2015,21314,21239,-75,-0.352,59,-134,27,157,H1
"Wabasha County, MN",2015-2016,21239,21447,208,0.979,69,139,27,157,H1
"Wabasha County, MN",2016-2017,21447,21608,161,0.751,71,90,27,157,H1
"Wadena County, MN",2000-2001,13745,13737,-8,-0.058,-28,20,27,159,H1
"Wadena County, MN",2001-2002,13737,13789,52,0.379,-48,100,27,159,H1
"Wadena County, MN",2002-2003,13789,13682,-107,-0.776,-26,-81,27,159,H1
"Wadena County, MN",2003-2004,13682,13682,0,0,-16,16,27,159,H1
"Wadena County, MN",2004-2005,13682,13799,117,0.855,-30,147,27,159,H1
"Wadena County, MN",2005-2006,13799,13705,-94,-0.681,6,-100,27,159,H1
"Wadena County, MN",2006-2007,13705,13840,135,0.985,-6,141,27,159,H1
"Wadena County, MN",2007-2008,13840,13844,4,0.029,-2,6,27,159,H1
"Wadena County, MN",2008-2009,13844,13825,-19,-0.137,-13,-6,27,159,H1
"Wadena County, MN",2009-2010,13825,13835,10,0.072,-33,43,27,159,H1
"Wadena County, MN",2010-2011,13835,13706,-129,-0.932,-15,-114,27,159,H1
"Wadena County, MN",2011-2012,13706,13689,-17,-0.124,3,-20,27,159,H1
"Wadena County, MN",2012-2013,13689,13782,93,0.679,-7,100,27,159,H1
"Wadena County, MN",2013-2014,13782,13757,-25,-0.181,11,-36,27,159,H1
"Wadena County, MN",2014-2015,13740,13875,135,0.983,29,106,27,159,H1
"Wadena County, MN",2015-2016,13875,13566,-309,-2.227,-29,-280,27,159,H1
"Wadena County, MN",2016-2017,13566,13669,103,0.759,-1,104,27,159,H1
"Waseca County, MN",2000-2001,19522,19486,-36,-0.184,72,-108,27,161,H1
"Waseca County, MN",2001-2002,19486,19483,-3,-0.015,51,-54,27,161,H1
"Waseca County, MN",2002-2003,19483,19416,-67,-0.344,94,-161,27,161,H1
"Waseca County, MN",2003-2004,19416,19245,-171,-0.881,70,-241,27,161,H1
"Waseca County, MN",2004-2005,19245,19288,43,0.223,100,-57,27,161,H1
"Waseca County, MN",2005-2006,19288,19348,60,0.311,104,-44,27,161,H1
"Waseca County, MN",2006-2007,19348,19407,59,0.305,100,-41,27,161,H1
"Waseca County, MN",2007-2008,19407,19311,-96,-0.495,117,-213,27,161,H1
"Waseca County, MN",2008-2009,19311,18639,-672,-3.48,114,-786,27,161,H1
"Waseca County, MN",2009-2010,18639,19138,499,2.677,114,385,27,161,H1
"Waseca County, MN",2010-2011,19138,19175,37,0.193,66,-29,27,161,H1
"Waseca County, MN",2011-2012,19175,19194,19,0.099,43,-24,27,161,H1
"Waseca County, MN",2012-2013,19194,19101,-93,-0.485,80,-173,27,161,H1
"Waseca County, MN",2013-2014,19101,19025,-76,-0.398,86,-162,27,161,H1
"Waseca County, MN",2014-2015,18965,18989,24,0.127,71,-47,27,161,H1
"Waseca County, MN",2015-2016,18989,18828,-161,-0.848,55,-216,27,161,H1
"Waseca County, MN",2016-2017,18828,18787,-41,-0.218,65,-106,27,161,H1
"Washington County, MN",2000-2001,202686,207206,4520,2.23,1828,2692,27,163,H1
"Washington County, MN",2001-2002,207206,210181,2975,1.436,1746,1229,27,163,H1
"Washington County, MN",2002-2003,210181,213909,3728,1.774,1924,1804,27,163,H1
"Washington County, MN",2003-2004,213909,215937,2028,0.948,1763,265,27,163,H1
"Washington County, MN",2004-2005,215937,219972,4035,1.869,1793,2242,27,163,H1
"Washington County, MN",2005-2006,219972,225091,5119,2.327,1849,3270,27,163,H1
"Washington County, MN",2006-2007,225091,229756,4665,2.072,1855,2810,27,163,H1
"Washington County, MN",2007-2008,229756,233306,3550,1.545,1874,1676,27,163,H1
"Washington County, MN",2008-2009,233306,235684,2378,1.019,1997,381,27,163,H1
"Washington County, MN",2009-2010,235684,238897,3213,1.363,1589,1624,27,163,H1
"Washington County, MN",2010-2011,238897,241539,2642,1.106,1560,1082,27,163,H1
"Washington County, MN",2011-2012,241539,244112,2573,1.065,1386,1187,27,163,H1
"Washington County, MN",2012-2013,244112,246683,2571,1.053,1419,1152,27,163,H1
"Washington County, MN",2013-2014,246683,249283,2600,1.054,1357,1243,27,163,H1
"Washington County, MN",2014-2015,249320,251597,2277,0.913,1414,863,27,163,H1
"Washington County, MN",2015-2016,251597,252976,1379,0.548,1207,172,27,163,H1
"Washington County, MN",2016-2017,252976,256348,3372,1.333,1206,2166,27,163,H1
"Watonwan County, MN",2000-2001,11826,11856,30,0.254,67,-37,27,165,H1
"Watonwan County, MN",2001-2002,11856,11807,-49,-0.413,11,-60,27,165,H1
"Watonwan County, MN",2002-2003,11807,11664,-143,-1.211,32,-175,27,165,H1
"Watonwan County, MN",2003-2004,11664,11504,-160,-1.372,39,-199,27,165,H1
"Watonwan County, MN",2004-2005,11504,11377,-127,-1.104,10,-137,27,165,H1
"Watonwan County, MN",2005-2006,11377,11323,-54,-0.475,45,-99,27,165,H1
"Watonwan County, MN",2006-2007,11323,11231,-92,-0.813,38,-130,27,165,H1
"Watonwan County, MN",2007-2008,11231,11120,-111,-0.988,67,-178,27,165,H1
"Watonwan County, MN",2008-2009,11120,11171,51,0.459,53,-2,27,165,H1
"Watonwan County, MN",2009-2010,11171,11213,42,0.376,49,-7,27,165,H1
"Watonwan County, MN",2010-2011,11213,11182,-31,-0.276,34,-65,27,165,H1
"Watonwan County, MN",2011-2012,11182,11155,-27,-0.241,43,-70,27,165,H1
"Watonwan County, MN",2012-2013,11155,11123,-32,-0.287,36,-68,27,165,H1
"Watonwan County, MN",2013-2014,11123,11083,-40,-0.36,58,-98,27,165,H1
"Watonwan County, MN",2014-2015,10969,10952,-17,-0.155,41,-58,27,165,H1
"Watonwan County, MN",2015-2016,10952,10911,-41,-0.374,56,-97,27,165,H1
"Watonwan County, MN",2016-2017,10911,10840,-71,-0.651,50,-121,27,165,H1
"Wilkin County, MN",2000-2001,7116,6989,-127,-1.785,4,-131,27,167,H1
"Wilkin County, MN",2001-2002,6989,6982,-7,-0.1,-5,-2,27,167,H1
"Wilkin County, MN",2002-2003,6982,6964,-18,-0.258,-10,-8,27,167,H1
"Wilkin County, MN",2003-2004,6964,6860,-104,-1.493,14,-118,27,167,H1
"Wilkin County, MN",2004-2005,6860,6801,-59,-0.86,-6,-53,27,167,H1
"Wilkin County, MN",2005-2006,6801,6709,-92,-1.353,3,-95,27,167,H1
"Wilkin County, MN",2006-2007,6709,6715,6,0.089,18,-12,27,167,H1
"Wilkin County, MN",2007-2008,6715,6622,-93,-1.385,28,-121,27,167,H1
"Wilkin County, MN",2008-2009,6622,6563,-59,-0.891,5,-64,27,167,H1
"Wilkin County, MN",2009-2010,6563,6573,10,0.152,3,7,27,167,H1
"Wilkin County, MN",2010-2011,6573,6579,6,0.091,-10,16,27,167,H1
"Wilkin County, MN",2011-2012,6579,6608,29,0.441,-4,33,27,167,H1
"Wilkin County, MN",2012-2013,6608,6550,-58,-0.878,-17,-41,27,167,H1
"Wilkin County, MN",2013-2014,6550,6495,-55,-0.84,-17,-38,27,167,H1
"Wilkin County, MN",2014-2015,6494,6396,-98,-1.509,-4,-94,27,167,H1
"Wilkin County, MN",2015-2016,6396,6345,-51,-0.797,2,-53,27,167,H1
"Wilkin County, MN",2016-2017,6345,6324,-21,-0.331,-9,-12,27,167,H1
"Winona County, MN",2000-2001,50081,50072,-9,-0.018,125,-134,27,169,H1
"Winona County, MN",2001-2002,50072,49977,-95,-0.19,71,-166,27,169,H1
"Winona County, MN",2002-2003,49977,50200,223,0.446,92,131,27,169,H1
"Winona County, MN",2003-2004,50200,50257,57,0.114,171,-114,27,169,H1
"Winona County, MN",2004-2005,50257,50756,499,0.993,164,335,27,169,H1
"Winona County, MN",2005-2006,50756,50904,148,0.292,99,49,27,169,H1
"Winona County, MN",2006-2007,50904,51316,412,0.809,176,236,27,169,H1
"Winona County, MN",2007-2008,51316,51457,141,0.275,178,-37,27,169,H1
"Winona County, MN",2008-2009,51457,51422,-35,-0.068,188,-223,27,169,H1
"Winona County, MN",2009-2010,51422,51393,-29,-0.056,131,-160,27,169,H1
"Winona County, MN",2010-2011,51393,51347,-46,-0.09,36,-82,27,169,H1
"Winona County, MN",2011-2012,51347,51326,-21,-0.041,77,-98,27,169,H1
"Winona County, MN",2012-2013,51326,51262,-64,-0.125,61,-125,27,169,H1
"Winona County, MN",2013-2014,51262,51097,-165,-0.322,45,-210,27,169,H1
"Winona County, MN",2014-2015,51107,50885,-222,-0.434,72,-294,27,169,H1
"Winona County, MN",2015-2016,50885,50872,-13,-0.026,57,-70,27,169,H1
"Winona County, MN",2016-2017,50872,50873,1,0.002,46,-45,27,169,H1
"Wright County, MN",2000-2001,90786,93922,3136,3.454,908,2228,27,171,H1
"Wright County, MN",2001-2002,93922,98434,4512,4.804,1018,3494,27,171,H1
"Wright County, MN",2002-2003,98434,102856,4422,4.492,1243,3179,27,171,H1
"Wright County, MN",2003-2004,102856,106998,4142,4.027,1307,2835,27,171,H1
"Wright County, MN",2004-2005,106998,110674,3676,3.436,1398,2278,27,171,H1
"Wright County, MN",2005-2006,110674,115192,4518,4.082,1490,3028,27,171,H1
"Wright County, MN",2006-2007,115192,118635,3443,2.989,1562,1881,27,171,H1
"Wright County, MN",2007-2008,118635,121553,2918,2.46,1581,1337,27,171,H1
"Wright County, MN",2008-2009,121553,123320,1767,1.454,1617,150,27,171,H1
"Wright County, MN",2009-2010,123320,125102,1782,1.445,1284,498,27,171,H1
"Wright County, MN",2010-2011,125102,126298,1196,0.956,1175,21,27,171,H1
"Wright County, MN",2011-2012,126298,127316,1018,0.806,1192,-174,27,171,H1
"Wright County, MN",2012-2013,127316,128298,982,0.771,1084,-102,27,171,H1
"Wright County, MN",2013-2014,128298,129918,1620,1.263,1051,569,27,171,H1
"Wright County, MN",2014-2015,130026,131311,1285,0.988,1054,231,27,171,H1
"Wright County, MN",2015-2016,131311,132387,1076,0.819,1020,56,27,171,H1
"Wright County, MN",2016-2017,132387,134286,1899,1.434,920,979,27,171,H1
"Yellow Medicine County, MN",2000-2001,11208,11136,-72,-0.642,1,-73,27,173,H1
"Yellow Medicine County, MN",2001-2002,11136,11002,-134,-1.203,0,-134,27,173,H1
"Yellow Medicine County, MN",2002-2003,11002,10924,-78,-0.709,-32,-46,27,173,H1
"Yellow Medicine County, MN",2003-2004,10924,10795,-129,-1.181,-11,-118,27,173,H1
"Yellow Medicine County, MN",2004-2005,10795,10691,-104,-0.963,-16,-88,27,173,H1
"Yellow Medicine County, MN",2005-2006,10691,10663,-28,-0.262,12,-40,27,173,H1
"Yellow Medicine County, MN",2006-2007,10663,10574,-89,-0.835,-8,-81,27,173,H1
"Yellow Medicine County, MN",2007-2008,10574,10473,-101,-0.955,-1,-100,27,173,H1
"Yellow Medicine County, MN",2008-2009,10473,10437,-36,-0.344,-17,-19,27,173,H1
"Yellow Medicine County, MN",2009-2010,10437,10436,-1,-0.01,1,-2,27,173,H1
"Yellow Medicine County, MN",2010-2011,10436,10289,-147,-1.409,-20,-127,27,173,H1
"Yellow Medicine County, MN",2011-2012,10289,10168,-121,-1.176,-7,-114,27,173,H1
"Yellow Medicine County, MN",2012-2013,10168,10163,-5,-0.049,44,-49,27,173,H1
"Yellow Medicine County, MN",2013-2014,10163,10109,-54,-0.531,34,-88,27,173,H1
"Yellow Medicine County, MN",2014-2015,10033,9875,-158,-1.575,-6,-152,27,173,H1
"Yellow Medicine County, MN",2015-2016,9875,9892,17,0.172,17,0,27,173,H1
"Yellow Medicine County, MN",2016-2017,9892,9867,-25,-0.253,13,-38,27,173,H1
Mississippi,2000-2001,2848353,2852994,4641,0.163,14734,-10093,28,0,STATE
Mississippi,2001-2002,2852994,2858681,5687,0.199,13419,-7732,28,0,STATE
Mississippi,2002-2003,2858681,2868312,9631,0.337,13366,-3735,28,0,STATE
Mississippi,2003-2004,2868312,2889010,20698,0.722,14356,6342,28,0,STATE
Mississippi,2004-2005,2889010,2905943,16933,0.586,14163,2770,28,0,STATE
Mississippi,2005-2006,2905943,2904978,-965,-0.033,14852,-15817,28,0,STATE
Mississippi,2006-2007,2904978,2928350,23372,0.805,18471,4901,28,0,STATE
Mississippi,2007-2008,2928350,2947806,19456,0.664,17686,1770,28,0,STATE
Mississippi,2008-2009,2947806,2958774,10968,0.372,15191,-4223,28,0,STATE
Mississippi,2009-2010,2958774,2970316,11542,0.39,14158,-2616,28,0,STATE
Mississippi,2010-2011,2970316,2977999,7683,0.259,10612,-2929,28,0,STATE
Mississippi,2011-2012,2977999,2985660,7661,0.257,10402,-2741,28,0,STATE
Mississippi,2012-2013,2985660,2990976,5316,0.178,7853,-2537,28,0,STATE
Mississippi,2013-2014,2990976,2993443,2467,0.082,8640,-6173,28,0,STATE
Mississippi,2014-2015,2993443,2992333,-1110,-0.037,8746,-9856,28,0,STATE
Mississippi,2015-2016,2992333,2985415,-6918,-0.231,7140,-14058,28,0,STATE
Mississippi,2016-2017,2985415,2984100,-1315,-0.044,6498,-7813,28,0,STATE
"Adams County, MS",2000-2001,34246,33945,-301,-0.879,33,-334,28,1,H1
"Adams County, MS",2001-2002,33945,33730,-215,-0.633,55,-270,28,1,H1
"Adams County, MS",2002-2003,33730,33482,-248,-0.735,44,-292,28,1,H1
"Adams County, MS",2003-2004,33482,32785,-697,-2.082,-18,-679,28,1,H1
"Adams County, MS",2004-2005,32785,32674,-111,-0.339,46,-157,28,1,H1
"Adams County, MS",2005-2006,32674,33220,546,1.671,44,502,28,1,H1
"Adams County, MS",2006-2007,33220,32889,-331,-0.996,42,-373,28,1,H1
"Adams County, MS",2007-2008,32889,32629,-260,-0.791,5,-265,28,1,H1
"Adams County, MS",2008-2009,32629,32305,-324,-0.993,7,-331,28,1,H1
"Adams County, MS",2009-2010,32305,32596,291,0.901,46,245,28,1,H1
"Adams County, MS",2010-2011,32596,32427,-169,-0.518,-9,-160,28,1,H1
"Adams County, MS",2011-2012,32427,32141,-286,-0.882,-4,-282,28,1,H1
"Adams County, MS",2012-2013,32141,32043,-98,-0.305,-90,-8,28,1,H1
"Adams County, MS",2013-2014,32043,31737,-306,-0.955,-70,-236,28,1,H1
"Adams County, MS",2014-2015,31935,31254,-681,-2.132,-47,-634,28,1,H1
"Adams County, MS",2015-2016,31254,31440,186,0.595,-26,212,28,1,H1
"Adams County, MS",2016-2017,31440,31003,-437,-1.39,-47,-390,28,1,H1
"Alcorn County, MS",2000-2001,34600,34746,146,0.422,-10,156,28,3,H1
"Alcorn County, MS",2001-2002,34746,34946,200,0.576,76,124,28,3,H1
"Alcorn County, MS",2002-2003,34946,35045,99,0.283,30,69,28,3,H1
"Alcorn County, MS",2003-2004,35045,35448,403,1.15,30,373,28,3,H1
"Alcorn County, MS",2004-2005,35448,35688,240,0.677,53,187,28,3,H1
"Alcorn County, MS",2005-2006,35688,36183,495,1.387,67,428,28,3,H1
"Alcorn County, MS",2006-2007,36183,36608,425,1.175,110,315,28,3,H1
"Alcorn County, MS",2007-2008,36608,36793,185,0.505,44,141,28,3,H1
"Alcorn County, MS",2008-2009,36793,36868,75,0.204,3,72,28,3,H1
"Alcorn County, MS",2009-2010,36868,37111,243,0.659,33,210,28,3,H1
"Alcorn County, MS",2010-2011,37111,37303,192,0.517,3,189,28,3,H1
"Alcorn County, MS",2011-2012,37303,37237,-66,-0.177,-9,-57,28,3,H1
"Alcorn County, MS",2012-2013,37237,37364,127,0.341,13,114,28,3,H1
"Alcorn County, MS",2013-2014,37364,37380,16,0.043,15,1,28,3,H1
"Alcorn County, MS",2014-2015,37346,37388,42,0.112,18,24,28,3,H1
"Alcorn County, MS",2015-2016,37388,37240,-148,-0.396,-32,-116,28,3,H1
"Alcorn County, MS",2016-2017,37240,37210,-30,-0.081,-2,-28,28,3,H1
"Amite County, MS",2000-2001,13546,13471,-75,-0.554,28,-103,28,5,H1
"Amite County, MS",2001-2002,13471,13401,-70,-0.52,17,-87,28,5,H1
"Amite County, MS",2002-2003,13401,13415,14,0.104,-4,18,28,5,H1
"Amite County, MS",2003-2004,13415,13337,-78,-0.581,8,-86,28,5,H1
"Amite County, MS",2004-2005,13337,13396,59,0.442,28,31,28,5,H1
"Amite County, MS",2005-2006,13396,13586,190,1.418,15,175,28,5,H1
"Amite County, MS",2006-2007,13586,13400,-186,-1.369,13,-199,28,5,H1
"Amite County, MS",2007-2008,13400,13324,-76,-0.567,24,-100,28,5,H1
"Amite County, MS",2008-2009,13324,13171,-153,-1.148,5,-158,28,5,H1
"Amite County, MS",2009-2010,13171,13112,-59,-0.448,27,-86,28,5,H1
"Amite County, MS",2010-2011,13112,13177,65,0.496,11,54,28,5,H1
"Amite County, MS",2011-2012,13177,12972,-205,-1.556,7,-212,28,5,H1
"Amite County, MS",2012-2013,12972,12895,-77,-0.594,-16,-61,28,5,H1
"Amite County, MS",2013-2014,12895,12629,-266,-2.063,-25,-241,28,5,H1
"Amite County, MS",2014-2015,12612,12574,-38,-0.301,-25,-13,28,5,H1
"Amite County, MS",2015-2016,12574,12430,-144,-1.145,-48,-96,28,5,H1
"Amite County, MS",2016-2017,12430,12447,17,0.137,-38,55,28,5,H1
"Attala County, MS",2000-2001,19620,19595,-25,-0.127,42,-67,28,7,H1
"Attala County, MS",2001-2002,19595,19549,-46,-0.235,-2,-44,28,7,H1
"Attala County, MS",2002-2003,19549,19469,-80,-0.409,6,-86,28,7,H1
"Attala County, MS",2003-2004,19469,19330,-139,-0.714,-39,-100,28,7,H1
"Attala County, MS",2004-2005,19330,19265,-65,-0.336,15,-80,28,7,H1
"Attala County, MS",2005-2006,19265,19431,166,0.862,52,114,28,7,H1
"Attala County, MS",2006-2007,19431,19511,80,0.412,30,50,28,7,H1
"Attala County, MS",2007-2008,19511,19622,111,0.569,54,57,28,7,H1
"Attala County, MS",2008-2009,19622,19611,-11,-0.056,35,-46,28,7,H1
"Attala County, MS",2009-2010,19611,19559,-52,-0.265,51,-103,28,7,H1
"Attala County, MS",2010-2011,19559,19332,-227,-1.161,13,-240,28,7,H1
"Attala County, MS",2011-2012,19332,19123,-209,-1.081,-17,-192,28,7,H1
"Attala County, MS",2012-2013,19123,19338,215,1.124,-13,228,28,7,H1
"Attala County, MS",2013-2014,19338,19163,-175,-0.905,-3,-172,28,7,H1
"Attala County, MS",2014-2015,19112,19043,-69,-0.361,-16,-53,28,7,H1
"Attala County, MS",2015-2016,19043,18566,-477,-2.505,-54,-423,28,7,H1
"Attala County, MS",2016-2017,18566,18477,-89,-0.479,-24,-65,28,7,H1
"Benton County, MS",2000-2001,8034,8006,-28,-0.349,37,-65,28,9,H1
"Benton County, MS",2001-2002,8006,8004,-2,-0.025,19,-21,28,9,H1
"Benton County, MS",2002-2003,8004,8073,69,0.862,34,35,28,9,H1
"Benton County, MS",2003-2004,8073,8146,73,0.904,13,60,28,9,H1
"Benton County, MS",2004-2005,8146,8307,161,1.976,45,116,28,9,H1
"Benton County, MS",2005-2006,8307,8479,172,2.071,38,134,28,9,H1
"Benton County, MS",2006-2007,8479,8603,124,1.462,8,116,28,9,H1
"Benton County, MS",2007-2008,8603,8769,166,1.93,48,118,28,9,H1
"Benton County, MS",2008-2009,8769,8689,-80,-0.912,38,-118,28,9,H1
"Benton County, MS",2009-2010,8689,8699,10,0.115,32,-22,28,9,H1
"Benton County, MS",2010-2011,8699,8711,12,0.138,7,5,28,9,H1
"Benton County, MS",2011-2012,8711,8652,-59,-0.677,-7,-52,28,9,H1
"Benton County, MS",2012-2013,8652,8506,-146,-1.687,5,-151,28,9,H1
"Benton County, MS",2013-2014,8506,8296,-210,-2.469,-13,-197,28,9,H1
"Benton County, MS",2014-2015,8312,8182,-130,-1.564,5,-135,28,9,H1
"Benton County, MS",2015-2016,8182,8265,83,1.014,0,83,28,9,H1
"Benton County, MS",2016-2017,8265,8312,47,0.569,4,43,28,9,H1
"Bolivar County, MS",2000-2001,40381,39723,-658,-1.629,195,-853,28,11,H1
"Bolivar County, MS",2001-2002,39723,38634,-1089,-2.741,212,-1301,28,11,H1
"Bolivar County, MS",2002-2003,38634,38027,-607,-1.571,197,-804,28,11,H1
"Bolivar County, MS",2003-2004,38027,37211,-816,-2.146,211,-1027,28,11,H1
"Bolivar County, MS",2004-2005,37211,36305,-906,-2.435,189,-1095,28,11,H1
"Bolivar County, MS",2005-2006,36305,36102,-203,-0.559,197,-400,28,11,H1
"Bolivar County, MS",2006-2007,36102,35628,-474,-1.313,165,-639,28,11,H1
"Bolivar County, MS",2007-2008,35628,35032,-596,-1.673,223,-819,28,11,H1
"Bolivar County, MS",2008-2009,35032,34450,-582,-1.661,198,-780,28,11,H1
"Bolivar County, MS",2009-2010,34450,34121,-329,-0.955,186,-515,28,11,H1
"Bolivar County, MS",2010-2011,34121,33838,-283,-0.829,187,-470,28,11,H1
"Bolivar County, MS",2011-2012,33838,34061,223,0.659,146,77,28,11,H1
"Bolivar County, MS",2012-2013,34061,34019,-42,-0.123,110,-152,28,11,H1
"Bolivar County, MS",2013-2014,34019,33768,-251,-0.738,133,-384,28,11,H1
"Bolivar County, MS",2014-2015,33835,33322,-513,-1.516,85,-598,28,11,H1
"Bolivar County, MS",2015-2016,33322,32634,-688,-2.065,26,-714,28,11,H1
"Bolivar County, MS",2016-2017,32634,31945,-689,-2.111,34,-723,28,11,H1
"Calhoun County, MS",2000-2001,15044,14991,-53,-0.352,24,-77,28,13,H1
"Calhoun County, MS",2001-2002,14991,14906,-85,-0.567,23,-108,28,13,H1
"Calhoun County, MS",2002-2003,14906,14887,-19,-0.127,29,-48,28,13,H1
"Calhoun County, MS",2003-2004,14887,14857,-30,-0.202,25,-55,28,13,H1
"Calhoun County, MS",2004-2005,14857,14803,-54,-0.363,20,-74,28,13,H1
"Calhoun County, MS",2005-2006,14803,14947,144,0.973,31,113,28,13,H1
"Calhoun County, MS",2006-2007,14947,14967,20,0.134,55,-35,28,13,H1
"Calhoun County, MS",2007-2008,14967,14912,-55,-0.367,33,-88,28,13,H1
"Calhoun County, MS",2008-2009,14912,14940,28,0.188,35,-7,28,13,H1
"Calhoun County, MS",2009-2010,14940,14957,17,0.114,51,-34,28,13,H1
"Calhoun County, MS",2010-2011,14957,14914,-43,-0.287,-10,-33,28,13,H1
"Calhoun County, MS",2011-2012,14914,14848,-66,-0.443,-19,-47,28,13,H1
"Calhoun County, MS",2012-2013,14848,14739,-109,-0.734,4,-113,28,13,H1
"Calhoun County, MS",2013-2014,14739,14745,6,0.041,-15,21,28,13,H1
"Calhoun County, MS",2014-2015,14745,14717,-28,-0.19,17,-45,28,13,H1
"Calhoun County, MS",2015-2016,14717,14563,-154,-1.046,13,-167,28,13,H1
"Calhoun County, MS",2016-2017,14563,14492,-71,-0.488,-3,-68,28,13,H1
"Carroll County, MS",2000-2001,10764,10699,-65,-0.604,10,-75,28,15,H1
"Carroll County, MS",2001-2002,10699,10567,-132,-1.234,18,-150,28,15,H1
"Carroll County, MS",2002-2003,10567,10565,-2,-0.019,9,-11,28,15,H1
"Carroll County, MS",2003-2004,10565,10544,-21,-0.199,6,-27,28,15,H1
"Carroll County, MS",2004-2005,10544,10473,-71,-0.673,-23,-48,28,15,H1
"Carroll County, MS",2005-2006,10473,10534,61,0.582,-3,64,28,15,H1
"Carroll County, MS",2006-2007,10534,10630,96,0.911,30,66,28,15,H1
"Carroll County, MS",2007-2008,10630,10694,64,0.602,76,-12,28,15,H1
"Carroll County, MS",2008-2009,10694,10604,-90,-0.842,29,-119,28,15,H1
"Carroll County, MS",2009-2010,10604,10597,-7,-0.066,-3,-4,28,15,H1
"Carroll County, MS",2010-2011,10597,10471,-126,-1.189,1,-127,28,15,H1
"Carroll County, MS",2011-2012,10471,10413,-58,-0.554,-31,-27,28,15,H1
"Carroll County, MS",2012-2013,10413,10353,-60,-0.576,-19,-41,28,15,H1
"Carroll County, MS",2013-2014,10353,10254,-99,-0.956,-27,-72,28,15,H1
"Carroll County, MS",2014-2015,10255,10243,-12,-0.117,-12,0,28,15,H1
"Carroll County, MS",2015-2016,10243,10211,-32,-0.312,-5,-27,28,15,H1
"Carroll County, MS",2016-2017,10211,10139,-72,-0.705,-20,-52,28,15,H1
"Chickasaw County, MS",2000-2001,19372,19266,-106,-0.547,94,-200,28,17,H1
"Chickasaw County, MS",2001-2002,19266,18976,-290,-1.505,79,-369,28,17,H1
"Chickasaw County, MS",2002-2003,18976,18811,-165,-0.87,118,-283,28,17,H1
"Chickasaw County, MS",2003-2004,18811,18642,-169,-0.898,144,-313,28,17,H1
"Chickasaw County, MS",2004-2005,18642,18369,-273,-1.464,80,-353,28,17,H1
"Chickasaw County, MS",2005-2006,18369,18074,-295,-1.606,110,-405,28,17,H1
"Chickasaw County, MS",2006-2007,18074,17884,-190,-1.051,120,-310,28,17,H1
"Chickasaw County, MS",2007-2008,17884,17639,-245,-1.37,126,-371,28,17,H1
"Chickasaw County, MS",2008-2009,17639,17439,-200,-1.134,96,-296,28,17,H1
"Chickasaw County, MS",2009-2010,17439,17398,-41,-0.235,112,-153,28,17,H1
"Chickasaw County, MS",2010-2011,17398,17446,48,0.276,58,-10,28,17,H1
"Chickasaw County, MS",2011-2012,17446,17406,-40,-0.229,87,-127,28,17,H1
"Chickasaw County, MS",2012-2013,17406,17317,-89,-0.511,101,-190,28,17,H1
"Chickasaw County, MS",2013-2014,17317,17313,-4,-0.023,57,-61,28,17,H1
"Chickasaw County, MS",2014-2015,17375,17328,-47,-0.271,61,-108,28,17,H1
"Chickasaw County, MS",2015-2016,17328,17234,-94,-0.542,43,-137,28,17,H1
"Chickasaw County, MS",2016-2017,17234,17146,-88,-0.511,28,-116,28,17,H1
"Choctaw County, MS",2000-2001,9742,9545,-197,-2.022,12,-209,28,19,H1
"Choctaw County, MS",2001-2002,9545,9468,-77,-0.807,10,-87,28,19,H1
"Choctaw County, MS",2002-2003,9468,9358,-110,-1.162,26,-136,28,19,H1
"Choctaw County, MS",2003-2004,9358,9132,-226,-2.415,13,-239,28,19,H1
"Choctaw County, MS",2004-2005,9132,9026,-106,-1.161,-1,-105,28,19,H1
"Choctaw County, MS",2005-2006,9026,8894,-132,-1.462,4,-136,28,19,H1
"Choctaw County, MS",2006-2007,8894,8680,-214,-2.406,39,-253,28,19,H1
"Choctaw County, MS",2007-2008,8680,8703,23,0.265,38,-15,28,19,H1
"Choctaw County, MS",2008-2009,8703,8576,-127,-1.459,29,-156,28,19,H1
"Choctaw County, MS",2009-2010,8576,8558,-18,-0.21,23,-41,28,19,H1
"Choctaw County, MS",2010-2011,8558,8398,-160,-1.87,10,-170,28,19,H1
"Choctaw County, MS",2011-2012,8398,8355,-43,-0.512,6,-49,28,19,H1
"Choctaw County, MS",2012-2013,8355,8390,35,0.419,-15,50,28,19,H1
"Choctaw County, MS",2013-2014,8390,8294,-96,-1.144,-20,-76,28,19,H1
"Choctaw County, MS",2014-2015,8310,8299,-11,-0.132,-6,-5,28,19,H1
"Choctaw County, MS",2015-2016,8299,8316,17,0.205,-2,19,28,19,H1
"Choctaw County, MS",2016-2017,8316,8278,-38,-0.457,-23,-15,28,19,H1
"Claiborne County, MS",2000-2001,11792,11519,-273,-2.315,52,-325,28,21,H1
"Claiborne County, MS",2001-2002,11519,11277,-242,-2.101,57,-299,28,21,H1
"Claiborne County, MS",2002-2003,11277,10889,-388,-3.441,53,-441,28,21,H1
"Claiborne County, MS",2003-2004,10889,10772,-117,-1.074,54,-171,28,21,H1
"Claiborne County, MS",2004-2005,10772,10646,-126,-1.17,44,-170,28,21,H1
"Claiborne County, MS",2005-2006,10646,10358,-288,-2.705,29,-317,28,21,H1
"Claiborne County, MS",2006-2007,10358,9962,-396,-3.823,61,-457,28,21,H1
"Claiborne County, MS",2007-2008,9962,9940,-22,-0.221,58,-80,28,21,H1
"Claiborne County, MS",2008-2009,9940,9822,-118,-1.187,45,-163,28,21,H1
"Claiborne County, MS",2009-2010,9822,9570,-252,-2.566,30,-282,28,21,H1
"Claiborne County, MS",2010-2011,9570,9779,209,2.184,31,178,28,21,H1
"Claiborne County, MS",2011-2012,9779,9376,-403,-4.121,18,-421,28,21,H1
"Claiborne County, MS",2012-2013,9376,9177,-199,-2.122,8,-207,28,21,H1
"Claiborne County, MS",2013-2014,9177,9080,-97,-1.057,6,-103,28,21,H1
"Claiborne County, MS",2014-2015,9177,9150,-27,-0.294,26,-53,28,21,H1
"Claiborne County, MS",2015-2016,9150,9129,-21,-0.23,30,-51,28,21,H1
"Claiborne County, MS",2016-2017,9129,8950,-179,-1.961,11,-190,28,21,H1
"Clarke County, MS",2000-2001,17749,17556,-193,-1.087,41,-234,28,23,H1
"Clarke County, MS",2001-2002,17556,17402,-154,-0.877,43,-197,28,23,H1
"Clarke County, MS",2002-2003,17402,17235,-167,-0.96,65,-232,28,23,H1
"Clarke County, MS",2003-2004,17235,17133,-102,-0.592,45,-147,28,23,H1
"Clarke County, MS",2004-2005,17133,16905,-228,-1.331,18,-246,28,23,H1
"Clarke County, MS",2005-2006,16905,16976,71,0.42,50,21,28,23,H1
"Clarke County, MS",2006-2007,16976,16857,-119,-0.701,75,-194,28,23,H1
"Clarke County, MS",2007-2008,16857,16772,-85,-0.504,7,-92,28,23,H1
"Clarke County, MS",2008-2009,16772,16671,-101,-0.602,24,-125,28,23,H1
"Clarke County, MS",2009-2010,16671,16704,33,0.198,67,-34,28,23,H1
"Clarke County, MS",2010-2011,16704,16658,-46,-0.275,-24,-22,28,23,H1
"Clarke County, MS",2011-2012,16658,16495,-163,-0.979,-4,-159,28,23,H1
"Clarke County, MS",2012-2013,16495,16389,-106,-0.643,3,-109,28,23,H1
"Clarke County, MS",2013-2014,16389,16299,-90,-0.549,5,-95,28,23,H1
"Clarke County, MS",2014-2015,16269,16006,-263,-1.617,-19,-244,28,23,H1
"Clarke County, MS",2015-2016,16006,15896,-110,-0.687,-50,-60,28,23,H1
"Clarke County, MS",2016-2017,15896,15828,-68,-0.428,-10,-58,28,23,H1
"Clay County, MS",2000-2001,21984,21811,-173,-0.787,95,-268,28,25,H1
"Clay County, MS",2001-2002,21811,21845,34,0.156,97,-63,28,25,H1
"Clay County, MS",2002-2003,21845,21484,-361,-1.653,69,-430,28,25,H1
"Clay County, MS",2003-2004,21484,21531,47,0.219,56,-9,28,25,H1
"Clay County, MS",2004-2005,21531,21245,-286,-1.328,118,-404,28,25,H1
"Clay County, MS",2005-2006,21245,21139,-106,-0.499,101,-207,28,25,H1
"Clay County, MS",2006-2007,21139,21017,-122,-0.577,106,-228,28,25,H1
"Clay County, MS",2007-2008,21017,20878,-139,-0.661,73,-212,28,25,H1
"Clay County, MS",2008-2009,20878,20804,-74,-0.354,70,-144,28,25,H1
"Clay County, MS",2009-2010,20804,20557,-247,-1.187,36,-283,28,25,H1
"Clay County, MS",2010-2011,20557,20500,-57,-0.277,60,-117,28,25,H1
"Clay County, MS",2011-2012,20500,20395,-105,-0.512,2,-107,28,25,H1
"Clay County, MS",2012-2013,20395,20395,0,0,45,-45,28,25,H1
"Clay County, MS",2013-2014,20395,20225,-170,-0.834,10,-180,28,25,H1
"Clay County, MS",2014-2015,20143,20048,-95,-0.472,-13,-82,28,25,H1
"Clay County, MS",2015-2016,20048,19840,-208,-1.038,-5,-203,28,25,H1
"Clay County, MS",2016-2017,19840,19640,-200,-1.008,-5,-195,28,25,H1
"Coahoma County, MS",2000-2001,30526,30172,-354,-1.16,247,-601,28,27,H1
"Coahoma County, MS",2001-2002,30172,29662,-510,-1.69,184,-694,28,27,H1
"Coahoma County, MS",2002-2003,29662,29055,-607,-2.046,168,-775,28,27,H1
"Coahoma County, MS",2003-2004,29055,28508,-547,-1.883,209,-756,28,27,H1
"Coahoma County, MS",2004-2005,28508,27875,-633,-2.22,131,-764,28,27,H1
"Coahoma County, MS",2005-2006,27875,27441,-434,-1.557,215,-649,28,27,H1
"Coahoma County, MS",2006-2007,27441,27025,-416,-1.516,201,-617,28,27,H1
"Coahoma County, MS",2007-2008,27025,26549,-476,-1.761,213,-689,28,27,H1
"Coahoma County, MS",2008-2009,26549,26257,-292,-1.1,180,-472,28,27,H1
"Coahoma County, MS",2009-2010,26257,26114,-143,-0.545,197,-340,28,27,H1
"Coahoma County, MS",2010-2011,26114,25862,-252,-0.965,149,-401,28,27,H1
"Coahoma County, MS",2011-2012,25862,25685,-177,-0.684,146,-323,28,27,H1
"Coahoma County, MS",2012-2013,25685,25165,-520,-2.025,113,-633,28,27,H1
"Coahoma County, MS",2013-2014,25165,24807,-358,-1.423,105,-463,28,27,H1
"Coahoma County, MS",2014-2015,24909,24620,-289,-1.16,163,-452,28,27,H1
"Coahoma County, MS",2015-2016,24620,23820,-800,-3.249,102,-902,28,27,H1
"Coahoma County, MS",2016-2017,23820,23154,-666,-2.796,94,-760,28,27,H1
"Copiah County, MS",2000-2001,28761,28857,96,0.334,140,-44,28,29,H1
"Copiah County, MS",2001-2002,28857,28762,-95,-0.329,154,-249,28,29,H1
"Copiah County, MS",2002-2003,28762,29058,296,1.029,132,164,28,29,H1
"Copiah County, MS",2003-2004,29058,29157,99,0.341,158,-59,28,29,H1
"Copiah County, MS",2004-2005,29157,29134,-23,-0.079,123,-146,28,29,H1
"Copiah County, MS",2005-2006,29134,29540,406,1.394,251,155,28,29,H1
"Copiah County, MS",2006-2007,29540,29565,25,0.085,217,-192,28,29,H1
"Copiah County, MS",2007-2008,29565,29584,19,0.064,149,-130,28,29,H1
"Copiah County, MS",2008-2009,29584,29484,-100,-0.338,165,-265,28,29,H1
"Copiah County, MS",2009-2010,29484,29418,-66,-0.224,159,-225,28,29,H1
"Copiah County, MS",2010-2011,29418,29230,-188,-0.639,103,-291,28,29,H1
"Copiah County, MS",2011-2012,29230,28902,-328,-1.122,64,-392,28,29,H1
"Copiah County, MS",2012-2013,28902,28795,-107,-0.37,35,-142,28,29,H1
"Copiah County, MS",2013-2014,28795,28797,2,0.007,40,-38,28,29,H1
"Copiah County, MS",2014-2015,28864,28773,-91,-0.315,63,-154,28,29,H1
"Copiah County, MS",2015-2016,28773,28605,-168,-0.584,17,-185,28,29,H1
"Copiah County, MS",2016-2017,28605,28516,-89,-0.311,21,-110,28,29,H1
"Covington County, MS",2000-2001,19426,19332,-94,-0.484,122,-216,28,31,H1
"Covington County, MS",2001-2002,19332,19458,126,0.652,31,95,28,31,H1
"Covington County, MS",2002-2003,19458,19660,202,1.038,70,132,28,31,H1
"Covington County, MS",2003-2004,19660,19621,-39,-0.198,45,-84,28,31,H1
"Covington County, MS",2004-2005,19621,19480,-141,-0.719,88,-229,28,31,H1
"Covington County, MS",2005-2006,19480,19555,75,0.385,77,-2,28,31,H1
"Covington County, MS",2006-2007,19555,19510,-45,-0.23,69,-114,28,31,H1
"Covington County, MS",2007-2008,19510,19594,84,0.431,90,-6,28,31,H1
"Covington County, MS",2008-2009,19594,19516,-78,-0.398,77,-155,28,31,H1
"Covington County, MS",2009-2010,19516,19585,69,0.354,78,-9,28,31,H1
"Covington County, MS",2010-2011,19585,19497,-88,-0.449,14,-102,28,31,H1
"Covington County, MS",2011-2012,19497,19523,26,0.133,23,3,28,31,H1
"Covington County, MS",2012-2013,19523,19426,-97,-0.497,63,-160,28,31,H1
"Covington County, MS",2013-2014,19426,19442,16,0.082,62,-46,28,31,H1
"Covington County, MS",2014-2015,19378,19543,165,0.851,40,125,28,31,H1
"Covington County, MS",2015-2016,19543,19188,-355,-1.817,-7,-348,28,31,H1
"Covington County, MS",2016-2017,19188,19079,-109,-0.568,20,-129,28,31,H1
"DeSoto County, MS",2000-2001,108714,113401,4687,4.311,978,3709,28,33,H1
"DeSoto County, MS",2001-2002,113401,118603,5202,4.587,973,4229,28,33,H1
"DeSoto County, MS",2002-2003,118603,124347,5744,4.843,986,4758,28,33,H1
"DeSoto County, MS",2003-2004,124347,130767,6420,5.163,1039,5381,28,33,H1
"DeSoto County, MS",2004-2005,130767,136915,6148,4.701,1066,5082,28,33,H1
"DeSoto County, MS",2005-2006,136915,145220,8305,6.066,1164,7141,28,33,H1
"DeSoto County, MS",2006-2007,145220,150688,5468,3.765,1330,4138,28,33,H1
"DeSoto County, MS",2007-2008,150688,156214,5526,3.667,1321,4205,28,33,H1
"DeSoto County, MS",2008-2009,156214,159706,3492,2.235,1316,2176,28,33,H1
"DeSoto County, MS",2009-2010,159706,161791,2085,1.306,1058,1027,28,33,H1
"DeSoto County, MS",2010-2011,161791,163905,2114,1.307,924,1190,28,33,H1
"DeSoto County, MS",2011-2012,163905,166355,2450,1.495,906,1544,28,33,H1
"DeSoto County, MS",2012-2013,166355,168364,2009,1.208,832,1177,28,33,H1
"DeSoto County, MS",2013-2014,168364,170913,2549,1.514,849,1700,28,33,H1
"DeSoto County, MS",2014-2015,170886,173323,2437,1.426,813,1624,28,33,H1
"DeSoto County, MS",2015-2016,173323,175545,2222,1.282,771,1451,28,33,H1
"DeSoto County, MS",2016-2017,175545,178751,3206,1.826,809,2397,28,33,H1
"Forrest County, MS",2000-2001,71982,71846,-136,-0.189,379,-515,28,35,H1
"Forrest County, MS",2001-2002,71846,71584,-262,-0.365,334,-596,28,35,H1
"Forrest County, MS",2002-2003,71584,71747,163,0.228,380,-217,28,35,H1
"Forrest County, MS",2003-2004,71747,71732,-15,-0.021,386,-401,28,35,H1
"Forrest County, MS",2004-2005,71732,72043,311,0.434,432,-121,28,35,H1
"Forrest County, MS",2005-2006,72043,73219,1176,1.632,457,719,28,35,H1
"Forrest County, MS",2006-2007,73219,74057,838,1.145,582,256,28,35,H1
"Forrest County, MS",2007-2008,74057,74196,139,0.188,600,-461,28,35,H1
"Forrest County, MS",2008-2009,74196,74863,667,0.899,488,179,28,35,H1
"Forrest County, MS",2009-2010,74863,75034,171,0.228,475,-304,28,35,H1
"Forrest County, MS",2010-2011,75034,75918,884,1.178,466,418,28,35,H1
"Forrest County, MS",2011-2012,75918,76769,851,1.121,317,534,28,35,H1
"Forrest County, MS",2012-2013,76769,76745,-24,-0.031,316,-340,28,35,H1
"Forrest County, MS",2013-2014,76745,76330,-415,-0.541,321,-736,28,35,H1
"Forrest County, MS",2014-2015,76014,75944,-70,-0.092,340,-410,28,35,H1
"Forrest County, MS",2015-2016,75944,75637,-307,-0.404,262,-569,28,35,H1
"Forrest County, MS",2016-2017,75637,75471,-166,-0.219,282,-448,28,35,H1
"Franklin County, MS",2000-2001,8414,8286,-128,-1.521,12,-140,28,37,H1
"Franklin County, MS",2001-2002,8286,8130,-156,-1.883,-4,-152,28,37,H1
"Franklin County, MS",2002-2003,8130,8150,20,0.246,14,6,28,37,H1
"Franklin County, MS",2003-2004,8150,8196,46,0.564,38,8,28,37,H1
"Franklin County, MS",2004-2005,8196,8076,-120,-1.464,-9,-111,28,37,H1
"Franklin County, MS",2005-2006,8076,8111,35,0.433,46,-11,28,37,H1
"Franklin County, MS",2006-2007,8111,8165,54,0.666,44,10,28,37,H1
"Franklin County, MS",2007-2008,8165,8136,-29,-0.355,60,-89,28,37,H1
"Franklin County, MS",2008-2009,8136,8112,-24,-0.295,35,-59,28,37,H1
"Franklin County, MS",2009-2010,8112,8117,5,0.062,21,-16,28,37,H1
"Franklin County, MS",2010-2011,8117,7984,-133,-1.639,4,-137,28,37,H1
"Franklin County, MS",2011-2012,7984,7887,-97,-1.215,-23,-74,28,37,H1
"Franklin County, MS",2012-2013,7887,7901,14,0.178,27,-13,28,37,H1
"Franklin County, MS",2013-2014,7901,7833,-68,-0.861,21,-89,28,37,H1
"Franklin County, MS",2014-2015,7786,7743,-43,-0.552,1,-44,28,37,H1
"Franklin County, MS",2015-2016,7743,7724,-19,-0.245,14,-33,28,37,H1
"Franklin County, MS",2016-2017,7724,7765,41,0.531,3,38,28,37,H1
"George County, MS",2000-2001,19257,19459,202,1.049,123,79,28,39,H1
"George County, MS",2001-2002,19459,19811,352,1.809,165,187,28,39,H1
"George County, MS",2002-2003,19811,20166,355,1.792,131,224,28,39,H1
"George County, MS",2003-2004,20166,20326,160,0.793,81,79,28,39,H1
"George County, MS",2004-2005,20326,20699,373,1.835,112,261,28,39,H1
"George County, MS",2005-2006,20699,21382,683,3.3,145,538,28,39,H1
"George County, MS",2006-2007,21382,21764,382,1.787,210,172,28,39,H1
"George County, MS",2007-2008,21764,22193,429,1.971,148,281,28,39,H1
"George County, MS",2008-2009,22193,22280,87,0.392,158,-71,28,39,H1
"George County, MS",2009-2010,22280,22654,374,1.679,142,232,28,39,H1
"George County, MS",2010-2011,22654,22816,162,0.715,135,27,28,39,H1
"George County, MS",2011-2012,22816,22872,56,0.245,130,-74,28,39,H1
"George County, MS",2012-2013,22872,23154,282,1.233,123,159,28,39,H1
"George County, MS",2013-2014,23154,23303,149,0.644,133,16,28,39,H1
"George County, MS",2014-2015,23271,23373,102,0.438,109,-7,28,39,H1
"George County, MS",2015-2016,23373,23715,342,1.463,129,213,28,39,H1
"George County, MS",2016-2017,23715,24094,379,1.598,139,240,28,39,H1
"Greene County, MS",2000-2001,13295,13231,-64,-0.481,42,-106,28,41,H1
"Greene County, MS",2001-2002,13231,13258,27,0.204,36,-9,28,41,H1
"Greene County, MS",2002-2003,13258,13323,65,0.49,19,46,28,41,H1
"Greene County, MS",2003-2004,13323,13155,-168,-1.261,24,-192,28,41,H1
"Greene County, MS",2004-2005,13155,13201,46,0.35,29,17,28,41,H1
"Greene County, MS",2005-2006,13201,13135,-66,-0.5,26,-92,28,41,H1
"Greene County, MS",2006-2007,13135,13776,641,4.88,22,619,28,41,H1
"Greene County, MS",2007-2008,13776,14293,517,3.753,52,465,28,41,H1
"Greene County, MS",2008-2009,14293,14449,156,1.091,52,104,28,41,H1
"Greene County, MS",2009-2010,14449,14402,-47,-0.325,50,-97,28,41,H1
"Greene County, MS",2010-2011,14402,14285,-117,-0.812,1,-118,28,41,H1
"Greene County, MS",2011-2012,14285,14286,1,0.007,2,-1,28,41,H1
"Greene County, MS",2012-2013,14286,14241,-45,-0.315,18,-63,28,41,H1
"Greene County, MS",2013-2014,14241,14326,85,0.597,14,71,28,41,H1
"Greene County, MS",2014-2015,14312,13522,-790,-5.52,19,-809,28,41,H1
"Greene County, MS",2015-2016,13522,13482,-40,-0.296,-9,-31,28,41,H1
"Greene County, MS",2016-2017,13482,13345,-137,-1.016,-19,-118,28,41,H1
"Grenada County, MS",2000-2001,23160,22898,-262,-1.131,23,-285,28,43,H1
"Grenada County, MS",2001-2002,22898,22684,-214,-0.935,-36,-178,28,43,H1
"Grenada County, MS",2002-2003,22684,22410,-274,-1.208,-33,-241,28,43,H1
"Grenada County, MS",2003-2004,22410,22222,-188,-0.839,-24,-164,28,43,H1
"Grenada County, MS",2004-2005,22222,22173,-49,-0.221,27,-76,28,43,H1
"Grenada County, MS",2005-2006,22173,22388,215,0.97,65,150,28,43,H1
"Grenada County, MS",2006-2007,22388,22335,-53,-0.237,64,-117,28,43,H1
"Grenada County, MS",2007-2008,22335,22194,-141,-0.631,69,-210,28,43,H1
"Grenada County, MS",2008-2009,22194,22036,-158,-0.712,41,-199,28,43,H1
"Grenada County, MS",2009-2010,22036,21872,-164,-0.744,10,-174,28,43,H1
"Grenada County, MS",2010-2011,21872,21593,-279,-1.276,5,-284,28,43,H1
"Grenada County, MS",2011-2012,21593,21616,23,0.107,7,16,28,43,H1
"Grenada County, MS",2012-2013,21616,21552,-64,-0.296,-26,-38,28,43,H1
"Grenada County, MS",2013-2014,21552,21666,114,0.529,2,112,28,43,H1
"Grenada County, MS",2014-2015,21656,21578,-78,-0.36,43,-121,28,43,H1
"Grenada County, MS",2015-2016,21578,21219,-359,-1.664,-25,-334,28,43,H1
"Grenada County, MS",2016-2017,21219,21087,-132,-0.622,17,-149,28,43,H1
"Hancock County, MS",2000-2001,43307,44172,865,1.997,87,778,28,45,H1
"Hancock County, MS",2001-2002,44172,45058,886,2.006,71,815,28,45,H1
"Hancock County, MS",2002-2003,45058,45772,714,1.585,113,601,28,45,H1
"Hancock County, MS",2003-2004,45772,46717,945,2.065,79,866,28,45,H1
"Hancock County, MS",2004-2005,46717,47715,998,2.136,90,908,28,45,H1
"Hancock County, MS",2005-2006,47715,40087,-7628,-15.987,6,-7634,28,45,H1
"Hancock County, MS",2006-2007,40087,41707,1620,4.041,206,1414,28,45,H1
"Hancock County, MS",2007-2008,41707,42764,1057,2.534,151,906,28,45,H1
"Hancock County, MS",2008-2009,42764,43471,707,1.653,98,609,28,45,H1
"Hancock County, MS",2009-2010,43471,44089,618,1.422,96,522,28,45,H1
"Hancock County, MS",2010-2011,44089,44743,654,1.483,11,643,28,45,H1
"Hancock County, MS",2011-2012,44743,45310,567,1.267,88,479,28,45,H1
"Hancock County, MS",2012-2013,45310,45587,277,0.611,36,241,28,45,H1
"Hancock County, MS",2013-2014,45587,45949,362,0.794,48,314,28,45,H1
"Hancock County, MS",2014-2015,46035,46420,385,0.836,111,274,28,45,H1
"Hancock County, MS",2015-2016,46420,46647,227,0.489,-5,232,28,45,H1
"Hancock County, MS",2016-2017,46647,47053,406,0.87,-11,417,28,45,H1
"Harrison County, MS",2000-2001,190071,190922,851,0.448,1193,-342,28,47,H1
"Harrison County, MS",2001-2002,190922,192145,1223,0.641,1133,90,28,47,H1
"Harrison County, MS",2002-2003,192145,191290,-855,-0.445,1118,-1973,28,47,H1
"Harrison County, MS",2003-2004,191290,195971,4681,2.447,1141,3540,28,47,H1
"Harrison County, MS",2004-2005,195971,197784,1813,0.925,1153,660,28,47,H1
"Harrison County, MS",2005-2006,197784,174449,-23335,-11.798,792,-24127,28,47,H1
"Harrison County, MS",2006-2007,174449,179054,4605,2.64,1371,3234,28,47,H1
"Harrison County, MS",2007-2008,179054,182735,3681,2.056,1346,2335,28,47,H1
"Harrison County, MS",2008-2009,182735,184930,2195,1.201,1118,1077,28,47,H1
"Harrison County, MS",2009-2010,184930,187917,2987,1.615,1157,1830,28,47,H1
"Harrison County, MS",2010-2011,187917,190946,3029,1.612,1102,1927,28,47,H1
"Harrison County, MS",2011-2012,190946,193691,2745,1.438,1042,1703,28,47,H1
"Harrison County, MS",2012-2013,193691,196597,2906,1.5,938,1968,28,47,H1
"Harrison County, MS",2013-2014,196597,199058,2461,1.252,1065,1396,28,47,H1
"Harrison County, MS",2014-2015,198758,201410,2652,1.334,1007,1645,28,47,H1
"Harrison County, MS",2015-2016,201410,202639,1229,0.61,845,384,28,47,H1
"Harrison County, MS",2016-2017,202639,205027,2388,1.178,830,1558,28,47,H1
"Hinds County, MS",2000-2001,250474,248941,-1533,-0.612,1846,-3379,28,49,H1
"Hinds County, MS",2001-2002,248941,247857,-1084,-0.435,1790,-2874,28,49,H1
"Hinds County, MS",2002-2003,247857,247449,-408,-0.165,1759,-2167,28,49,H1
"Hinds County, MS",2003-2004,247449,248147,698,0.282,1876,-1178,28,49,H1
"Hinds County, MS",2004-2005,248147,247370,-777,-0.313,1861,-2638,28,49,H1
"Hinds County, MS",2005-2006,247370,248989,1619,0.654,1990,-371,28,49,H1
"Hinds County, MS",2006-2007,248989,246546,-2443,-0.981,2105,-4548,28,49,H1
"Hinds County, MS",2007-2008,246546,244695,-1851,-0.751,1976,-3827,28,49,H1
"Hinds County, MS",2008-2009,244695,244474,-221,-0.09,1874,-2095,28,49,H1
"Hinds County, MS",2009-2010,244474,245766,1292,0.528,1863,-571,28,49,H1
"Hinds County, MS",2010-2011,245766,248409,2643,1.075,1458,1185,28,49,H1
"Hinds County, MS",2011-2012,248409,248298,-111,-0.045,1429,-1540,28,49,H1
"Hinds County, MS",2012-2013,248298,245616,-2682,-1.08,1243,-3925,28,49,H1
"Hinds County, MS",2013-2014,245616,243729,-1887,-0.768,1175,-3062,28,49,H1
"Hinds County, MS",2014-2015,244406,242891,-1515,-0.62,1213,-2728,28,49,H1
"Hinds County, MS",2015-2016,242891,241818,-1073,-0.442,1028,-2101,28,49,H1
"Hinds County, MS",2016-2017,241818,239497,-2321,-0.96,987,-3308,28,49,H1
"Holmes County, MS",2000-2001,21564,21091,-473,-2.193,130,-603,28,51,H1
"Holmes County, MS",2001-2002,21091,20837,-254,-1.204,97,-351,28,51,H1
"Holmes County, MS",2002-2003,20837,20399,-438,-2.102,106,-544,28,51,H1
"Holmes County, MS",2003-2004,20399,20257,-142,-0.696,117,-259,28,51,H1
"Holmes County, MS",2004-2005,20257,20052,-205,-1.012,119,-324,28,51,H1
"Holmes County, MS",2005-2006,20052,19932,-120,-0.598,160,-280,28,51,H1
"Holmes County, MS",2006-2007,19932,19710,-222,-1.114,218,-440,28,51,H1
"Holmes County, MS",2007-2008,19710,19755,45,0.228,170,-125,28,51,H1
"Holmes County, MS",2008-2009,19755,19461,-294,-1.488,143,-437,28,51,H1
"Holmes County, MS",2009-2010,19461,19393,-68,-0.349,100,-168,28,51,H1
"Holmes County, MS",2010-2011,19393,19187,-206,-1.062,89,-295,28,51,H1
"Holmes County, MS",2011-2012,19187,19040,-147,-0.766,89,-236,28,51,H1
"Holmes County, MS",2012-2013,19040,18746,-294,-1.544,53,-347,28,51,H1
"Holmes County, MS",2013-2014,18746,18459,-287,-1.531,19,-306,28,51,H1
"Holmes County, MS",2014-2015,18508,18340,-168,-0.908,12,-180,28,51,H1
"Holmes County, MS",2015-2016,18340,17960,-380,-2.072,25,-405,28,51,H1
"Holmes County, MS",2016-2017,17960,17739,-221,-1.231,3,-224,28,51,H1
"Humphreys County, MS",2000-2001,11106,10969,-137,-1.234,93,-230,28,53,H1
"Humphreys County, MS",2001-2002,10969,10582,-387,-3.528,79,-466,28,53,H1
"Humphreys County, MS",2002-2003,10582,10351,-231,-2.183,70,-301,28,53,H1
"Humphreys County, MS",2003-2004,10351,10204,-147,-1.42,80,-227,28,53,H1
"Humphreys County, MS",2004-2005,10204,9974,-230,-2.254,77,-307,28,53,H1
"Humphreys County, MS",2005-2006,9974,9840,-134,-1.343,82,-216,28,53,H1
"Humphreys County, MS",2006-2007,9840,9666,-174,-1.768,122,-296,28,53,H1
"Humphreys County, MS",2007-2008,9666,9691,25,0.259,134,-109,28,53,H1
"Humphreys County, MS",2008-2009,9691,9517,-174,-1.795,65,-239,28,53,H1
"Humphreys County, MS",2009-2010,9517,9336,-181,-1.902,71,-252,28,53,H1
"Humphreys County, MS",2010-2011,9336,9328,-8,-0.086,46,-54,28,53,H1
"Humphreys County, MS",2011-2012,9328,9208,-120,-1.286,56,-176,28,53,H1
"Humphreys County, MS",2012-2013,9208,8918,-290,-3.149,7,-297,28,53,H1
"Humphreys County, MS",2013-2014,8918,8741,-177,-1.985,4,-181,28,53,H1
"Humphreys County, MS",2014-2015,8772,8669,-103,-1.174,17,-120,28,53,H1
"Humphreys County, MS",2015-2016,8669,8594,-75,-0.865,20,-95,28,53,H1
"Humphreys County, MS",2016-2017,8594,8342,-252,-2.932,0,-252,28,53,H1
"Issaquena County, MS",2000-2001,2258,2157,-101,-4.473,7,-108,28,55,H1
"Issaquena County, MS",2001-2002,2157,2012,-145,-6.722,8,-153,28,55,H1
"Issaquena County, MS",2002-2003,2012,1959,-53,-2.634,1,-54,28,55,H1
"Issaquena County, MS",2003-2004,1959,1813,-146,-7.453,9,-155,28,55,H1
"Issaquena County, MS",2004-2005,1813,1720,-93,-5.13,0,-93,28,55,H1
"Issaquena County, MS",2005-2006,1720,1649,-71,-4.128,7,-78,28,55,H1
"Issaquena County, MS",2006-2007,1649,1552,-97,-5.882,6,-103,28,55,H1
"Issaquena County, MS",2007-2008,1552,1521,-31,-1.997,5,-36,28,55,H1
"Issaquena County, MS",2008-2009,1521,1443,-78,-5.128,9,-87,28,55,H1
"Issaquena County, MS",2009-2010,1443,1398,-45,-3.119,9,-54,28,55,H1
"Issaquena County, MS",2010-2011,1398,1395,-3,-0.215,5,-8,28,55,H1
"Issaquena County, MS",2011-2012,1395,1410,15,1.075,2,13,28,55,H1
"Issaquena County, MS",2012-2013,1410,1416,6,0.426,6,0,28,55,H1
"Issaquena County, MS",2013-2014,1416,1397,-19,-1.342,5,-24,28,55,H1
"Issaquena County, MS",2014-2015,1386,1337,-49,-3.535,6,-55,28,55,H1
"Issaquena County, MS",2015-2016,1337,1322,-15,-1.122,4,-19,28,55,H1
"Issaquena County, MS",2016-2017,1322,1339,17,1.286,8,9,28,55,H1
"Itawamba County, MS",2000-2001,22853,22869,16,0.07,-24,40,28,57,H1
"Itawamba County, MS",2001-2002,22869,22859,-10,-0.044,-17,7,28,57,H1
"Itawamba County, MS",2002-2003,22859,23075,216,0.945,-7,223,28,57,H1
"Itawamba County, MS",2003-2004,23075,23085,10,0.043,-12,22,28,57,H1
"Itawamba County, MS",2004-2005,23085,23254,169,0.732,8,161,28,57,H1
"Itawamba County, MS",2005-2006,23254,23217,-37,-0.159,5,-42,28,57,H1
"Itawamba County, MS",2006-2007,23217,23271,54,0.233,63,-9,28,57,H1
"Itawamba County, MS",2007-2008,23271,23412,141,0.606,30,111,28,57,H1
"Itawamba County, MS",2008-2009,23412,23329,-83,-0.355,19,-102,28,57,H1
"Itawamba County, MS",2009-2010,23329,23397,68,0.291,30,38,28,57,H1
"Itawamba County, MS",2010-2011,23397,23320,-77,-0.329,-32,-45,28,57,H1
"Itawamba County, MS",2011-2012,23320,23371,51,0.219,73,-22,28,57,H1
"Itawamba County, MS",2012-2013,23371,23461,90,0.385,26,64,28,57,H1
"Itawamba County, MS",2013-2014,23461,23527,66,0.281,59,7,28,57,H1
"Itawamba County, MS",2014-2015,23474,23609,135,0.575,-4,139,28,57,H1
"Itawamba County, MS",2015-2016,23609,23403,-206,-0.873,-37,-169,28,57,H1
"Itawamba County, MS",2016-2017,23403,23508,105,0.449,-8,113,28,57,H1
"Jackson County, MS",2000-2001,132019,133069,1050,0.795,743,307,28,59,H1
"Jackson County, MS",2001-2002,133069,133688,619,0.465,716,-97,28,59,H1
"Jackson County, MS",2002-2003,133688,134234,546,0.408,609,-63,28,59,H1
"Jackson County, MS",2003-2004,134234,136565,2331,1.737,699,1632,28,59,H1
"Jackson County, MS",2004-2005,136565,137913,1348,0.987,618,730,28,59,H1
"Jackson County, MS",2005-2006,137913,132717,-5196,-3.768,476,-5672,28,59,H1
"Jackson County, MS",2006-2007,132717,136028,3311,2.495,844,2467,28,59,H1
"Jackson County, MS",2007-2008,136028,137791,1763,1.296,822,941,28,59,H1
"Jackson County, MS",2008-2009,137791,139176,1385,1.005,659,726,28,59,H1
"Jackson County, MS",2009-2010,139176,139518,342,0.246,570,-228,28,59,H1
"Jackson County, MS",2010-2011,139518,140073,555,0.398,404,151,28,59,H1
"Jackson County, MS",2011-2012,140073,139969,-104,-0.074,361,-465,28,59,H1
"Jackson County, MS",2012-2013,139969,140274,305,0.218,213,92,28,59,H1
"Jackson County, MS",2013-2014,140274,141137,863,0.615,215,648,28,59,H1
"Jackson County, MS",2014-2015,141504,141425,-79,-0.056,338,-417,28,59,H1
"Jackson County, MS",2015-2016,141425,141550,125,0.088,330,-205,28,59,H1
"Jackson County, MS",2016-2017,141550,142152,602,0.425,275,327,28,59,H1
"Jasper County, MS",2000-2001,18110,18230,120,0.663,97,23,28,61,H1
"Jasper County, MS",2001-2002,18230,18068,-162,-0.889,63,-225,28,61,H1
"Jasper County, MS",2002-2003,18068,17855,-213,-1.179,40,-253,28,61,H1
"Jasper County, MS",2003-2004,17855,17751,-104,-0.582,118,-222,28,61,H1
"Jasper County, MS",2004-2005,17751,17496,-255,-1.437,72,-327,28,61,H1
"Jasper County, MS",2005-2006,17496,17544,48,0.274,55,-7,28,61,H1
"Jasper County, MS",2006-2007,17544,17492,-52,-0.296,79,-131,28,61,H1
"Jasper County, MS",2007-2008,17492,17550,58,0.332,97,-39,28,61,H1
"Jasper County, MS",2008-2009,17550,17344,-206,-1.174,80,-286,28,61,H1
"Jasper County, MS",2009-2010,17344,16986,-358,-2.064,52,-410,28,61,H1
"Jasper County, MS",2010-2011,16986,16796,-190,-1.119,29,-219,28,61,H1
"Jasper County, MS",2011-2012,16796,16535,-261,-1.554,17,-278,28,61,H1
"Jasper County, MS",2012-2013,16535,16517,-18,-0.109,111,-129,28,61,H1
"Jasper County, MS",2013-2014,16517,16601,84,0.509,88,-4,28,61,H1
"Jasper County, MS",2014-2015,16546,16569,23,0.139,40,-17,28,61,H1
"Jasper County, MS",2015-2016,16569,16591,22,0.133,30,-8,28,61,H1
"Jasper County, MS",2016-2017,16591,16582,-9,-0.054,17,-26,28,61,H1
"Jefferson County, MS",2000-2001,9649,9436,-213,-2.207,64,-277,28,63,H1
"Jefferson County, MS",2001-2002,9436,9251,-185,-1.961,40,-225,28,63,H1
"Jefferson County, MS",2002-2003,9251,8929,-322,-3.481,31,-353,28,63,H1
"Jefferson County, MS",2003-2004,8929,8760,-169,-1.893,47,-216,28,63,H1
"Jefferson County, MS",2004-2005,8760,8461,-299,-3.413,42,-341,28,63,H1
"Jefferson County, MS",2005-2006,8461,8241,-220,-2.6,47,-267,28,63,H1
"Jefferson County, MS",2006-2007,8241,8127,-114,-1.383,59,-173,28,63,H1
"Jefferson County, MS",2007-2008,8127,7927,-200,-2.461,66,-266,28,63,H1
"Jefferson County, MS",2008-2009,7927,7842,-85,-1.072,43,-128,28,63,H1
"Jefferson County, MS",2009-2010,7842,7712,-130,-1.658,34,-164,28,63,H1
"Jefferson County, MS",2010-2011,7712,7576,-136,-1.763,17,-153,28,63,H1
"Jefferson County, MS",2011-2012,7576,7649,73,0.964,48,25,28,63,H1
"Jefferson County, MS",2012-2013,7649,7632,-17,-0.222,57,-74,28,63,H1
"Jefferson County, MS",2013-2014,7632,7599,-33,-0.432,52,-85,28,63,H1
"Jefferson County, MS",2014-2015,7574,7507,-67,-0.885,32,-99,28,63,H1
"Jefferson County, MS",2015-2016,7507,7322,-185,-2.464,15,-200,28,63,H1
"Jefferson County, MS",2016-2017,7322,7262,-60,-0.819,10,-70,28,63,H1
"Jefferson Davis County, MS",2000-2001,13853,13630,-223,-1.61,48,-271,28,65,H1
"Jefferson Davis County, MS",2001-2002,13630,13413,-217,-1.592,26,-243,28,65,H1
"Jefferson Davis County, MS",2002-2003,13413,13234,-179,-1.335,8,-187,28,65,H1
"Jefferson Davis County, MS",2003-2004,13234,12932,-302,-2.282,27,-329,28,65,H1
"Jefferson Davis County, MS",2004-2005,12932,12859,-73,-0.564,3,-76,28,65,H1
"Jefferson Davis County, MS",2005-2006,12859,12928,69,0.537,41,28,28,65,H1
"Jefferson Davis County, MS",2006-2007,12928,12749,-179,-1.385,46,-225,28,65,H1
"Jefferson Davis County, MS",2007-2008,12749,12636,-113,-0.886,61,-174,28,65,H1
"Jefferson Davis County, MS",2008-2009,12636,12553,-83,-0.657,35,-118,28,65,H1
"Jefferson Davis County, MS",2009-2010,12553,12456,-97,-0.773,8,-105,28,65,H1
"Jefferson Davis County, MS",2010-2011,12456,12188,-268,-2.152,-8,-260,28,65,H1
"Jefferson Davis County, MS",2011-2012,12188,12087,-101,-0.829,-16,-85,28,65,H1
"Jefferson Davis County, MS",2012-2013,12087,11948,-139,-1.15,-8,-131,28,65,H1
"Jefferson Davis County, MS",2013-2014,11948,11822,-126,-1.055,-15,-111,28,65,H1
"Jefferson Davis County, MS",2014-2015,11837,11665,-172,-1.453,10,-182,28,65,H1
"Jefferson Davis County, MS",2015-2016,11665,11464,-201,-1.723,-8,-193,28,65,H1
"Jefferson Davis County, MS",2016-2017,11464,11314,-150,-1.308,-32,-118,28,65,H1
"Jones County, MS",2000-2001,64993,64855,-138,-0.212,363,-501,28,67,H1
"Jones County, MS",2001-2002,64855,64916,61,0.094,292,-231,28,67,H1
"Jones County, MS",2002-2003,64916,64913,-3,-0.005,259,-262,28,67,H1
"Jones County, MS",2003-2004,64913,65296,383,0.59,290,93,28,67,H1
"Jones County, MS",2004-2005,65296,65871,575,0.881,338,237,28,67,H1
"Jones County, MS",2005-2006,65871,66330,459,0.697,366,93,28,67,H1
"Jones County, MS",2006-2007,66330,66760,430,0.648,417,13,28,67,H1
"Jones County, MS",2007-2008,66760,67318,558,0.836,446,112,28,67,H1
"Jones County, MS",2008-2009,67318,67443,125,0.186,396,-271,28,67,H1
"Jones County, MS",2009-2010,67443,67882,439,0.651,332,107,28,67,H1
"Jones County, MS",2010-2011,67882,67921,39,0.057,328,-289,28,67,H1
"Jones County, MS",2011-2012,67921,68385,464,0.683,277,187,28,67,H1
"Jones County, MS",2012-2013,68385,68886,501,0.733,246,255,28,67,H1
"Jones County, MS",2013-2014,68886,68290,-596,-0.865,184,-780,28,67,H1
"Jones County, MS",2014-2015,68235,68215,-20,-0.029,183,-203,28,67,H1
"Jones County, MS",2015-2016,68215,68181,-34,-0.05,217,-251,28,67,H1
"Jones County, MS",2016-2017,68181,67930,-251,-0.368,175,-426,28,67,H1
"Kemper County, MS",2000-2001,10443,10712,269,2.576,52,217,28,69,H1
"Kemper County, MS",2001-2002,10712,10635,-77,-0.719,-6,-71,28,69,H1
"Kemper County, MS",2002-2003,10635,10623,-12,-0.113,28,-40,28,69,H1
"Kemper County, MS",2003-2004,10623,10648,25,0.235,34,-9,28,69,H1
"Kemper County, MS",2004-2005,10648,10551,-97,-0.911,18,-115,28,69,H1
"Kemper County, MS",2005-2006,10551,10533,-18,-0.171,39,-57,28,69,H1
"Kemper County, MS",2006-2007,10533,10486,-47,-0.446,36,-83,28,69,H1
"Kemper County, MS",2007-2008,10486,10392,-94,-0.896,64,-158,28,69,H1
"Kemper County, MS",2008-2009,10392,10526,134,1.289,22,112,28,69,H1
"Kemper County, MS",2009-2010,10526,10474,-52,-0.494,23,-75,28,69,H1
"Kemper County, MS",2010-2011,10474,10270,-204,-1.948,-12,-192,28,69,H1
"Kemper County, MS",2011-2012,10270,10366,96,0.935,-13,109,28,69,H1
"Kemper County, MS",2012-2013,10366,10276,-90,-0.868,-10,-80,28,69,H1
"Kemper County, MS",2013-2014,10276,10163,-113,-1.1,-23,-90,28,69,H1
"Kemper County, MS",2014-2015,10213,9969,-244,-2.389,-6,-238,28,69,H1
"Kemper County, MS",2015-2016,9969,9954,-15,-0.15,2,-17,28,69,H1
"Kemper County, MS",2016-2017,9954,9883,-71,-0.713,-20,-51,28,69,H1
"Lafayette County, MS",2000-2001,38759,39292,533,1.375,116,417,28,71,H1
"Lafayette County, MS",2001-2002,39292,39914,622,1.583,125,497,28,71,H1
"Lafayette County, MS",2002-2003,39914,41241,1327,3.325,188,1139,28,71,H1
"Lafayette County, MS",2003-2004,41241,41840,599,1.452,192,407,28,71,H1
"Lafayette County, MS",2004-2005,41840,42526,686,1.64,156,530,28,71,H1
"Lafayette County, MS",2005-2006,42526,44281,1755,4.127,188,1567,28,71,H1
"Lafayette County, MS",2006-2007,44281,45027,746,1.685,187,559,28,71,H1
"Lafayette County, MS",2007-2008,45027,45781,754,1.675,160,594,28,71,H1
"Lafayette County, MS",2008-2009,45781,46712,931,2.034,156,775,28,71,H1
"Lafayette County, MS",2009-2010,46712,47535,823,1.762,142,681,28,71,H1
"Lafayette County, MS",2010-2011,47535,48404,869,1.828,172,697,28,71,H1
"Lafayette County, MS",2011-2012,48404,50416,2012,4.157,194,1818,28,71,H1
"Lafayette County, MS",2012-2013,50416,51993,1577,3.128,209,1368,28,71,H1
"Lafayette County, MS",2013-2014,51993,52930,937,1.802,211,726,28,71,H1
"Lafayette County, MS",2014-2015,52220,53154,934,1.789,134,800,28,71,H1
"Lafayette County, MS",2015-2016,53154,53479,325,0.611,220,105,28,71,H1
"Lafayette County, MS",2016-2017,53479,54374,895,1.674,192,703,28,71,H1
"Lamar County, MS",2000-2001,40211,41100,889,2.211,312,577,28,73,H1
"Lamar County, MS",2001-2002,41100,42377,1277,3.107,313,964,28,73,H1
"Lamar County, MS",2002-2003,42377,43379,1002,2.364,314,688,28,73,H1
"Lamar County, MS",2003-2004,43379,45001,1622,3.739,368,1254,28,73,H1
"Lamar County, MS",2004-2005,45001,46684,1683,3.74,372,1311,28,73,H1
"Lamar County, MS",2005-2006,46684,48850,2166,4.64,391,1775,28,73,H1
"Lamar County, MS",2006-2007,48850,50920,2070,4.237,489,1581,28,73,H1
"Lamar County, MS",2007-2008,50920,52772,1852,3.637,480,1372,28,73,H1
"Lamar County, MS",2008-2009,52772,54197,1425,2.7,467,958,28,73,H1
"Lamar County, MS",2009-2010,54197,56095,1898,3.502,452,1446,28,73,H1
"Lamar County, MS",2010-2011,56095,57148,1053,1.877,388,665,28,73,H1
"Lamar County, MS",2011-2012,57148,57864,716,1.253,411,305,28,73,H1
"Lamar County, MS",2012-2013,57864,58983,1119,1.934,495,624,28,73,H1
"Lamar County, MS",2013-2014,58983,60099,1116,1.892,513,603,28,73,H1
"Lamar County, MS",2014-2015,59935,60618,683,1.14,405,278,28,73,H1
"Lamar County, MS",2015-2016,60618,61230,612,1.01,357,255,28,73,H1
"Lamar County, MS",2016-2017,61230,61374,144,0.235,371,-227,28,73,H1
"Lauderdale County, MS",2000-2001,78195,77780,-415,-0.531,178,-593,28,75,H1
"Lauderdale County, MS",2001-2002,77780,77979,199,0.256,214,-15,28,75,H1
"Lauderdale County, MS",2002-2003,77979,78082,103,0.132,180,-77,28,75,H1
"Lauderdale County, MS",2003-2004,78082,78055,-27,-0.035,313,-340,28,75,H1
"Lauderdale County, MS",2004-2005,78055,78082,27,0.035,201,-174,28,75,H1
"Lauderdale County, MS",2005-2006,78082,78063,-19,-0.024,278,-297,28,75,H1
"Lauderdale County, MS",2006-2007,78063,78794,731,0.936,349,382,28,75,H1
"Lauderdale County, MS",2007-2008,78794,79665,871,1.105,326,545,28,75,H1
"Lauderdale County, MS",2008-2009,79665,80275,610,0.766,262,348,28,75,H1
"Lauderdale County, MS",2009-2010,80275,80370,95,0.118,241,-146,28,75,H1
"Lauderdale County, MS",2010-2011,80370,80591,221,0.275,176,45,28,75,H1
"Lauderdale County, MS",2011-2012,80591,80271,-320,-0.397,219,-539,28,75,H1
"Lauderdale County, MS",2012-2013,80271,80332,61,0.076,165,-104,28,75,H1
"Lauderdale County, MS",2013-2014,80332,79739,-593,-0.738,217,-810,28,75,H1
"Lauderdale County, MS",2014-2015,79413,78524,-889,-1.119,199,-1088,28,75,H1
"Lauderdale County, MS",2015-2016,78524,77228,-1296,-1.65,119,-1415,28,75,H1
"Lauderdale County, MS",2016-2017,77228,76155,-1073,-1.389,127,-1200,28,75,H1
"Lawrence County, MS",2000-2001,13215,13235,20,0.151,42,-22,28,77,H1
"Lawrence County, MS",2001-2002,13235,13137,-98,-0.74,35,-133,28,77,H1
"Lawrence County, MS",2002-2003,13137,13190,53,0.403,29,24,28,77,H1
"Lawrence County, MS",2003-2004,13190,13149,-41,-0.311,51,-92,28,77,H1
"Lawrence County, MS",2004-2005,13149,13097,-52,-0.395,31,-83,28,77,H1
"Lawrence County, MS",2005-2006,13097,13053,-44,-0.336,15,-59,28,77,H1
"Lawrence County, MS",2006-2007,13053,13043,-10,-0.077,85,-95,28,77,H1
"Lawrence County, MS",2007-2008,13043,13038,-5,-0.038,73,-78,28,77,H1
"Lawrence County, MS",2008-2009,13038,13054,16,0.123,56,-40,28,77,H1
"Lawrence County, MS",2009-2010,13054,12896,-158,-1.21,58,-216,28,77,H1
"Lawrence County, MS",2010-2011,12896,12668,-228,-1.768,35,-263,28,77,H1
"Lawrence County, MS",2011-2012,12668,12601,-67,-0.529,10,-77,28,77,H1
"Lawrence County, MS",2012-2013,12601,12512,-89,-0.706,2,-91,28,77,H1
"Lawrence County, MS",2013-2014,12512,12502,-10,-0.08,0,-10,28,77,H1
"Lawrence County, MS",2014-2015,12526,12622,96,0.766,24,72,28,77,H1
"Lawrence County, MS",2015-2016,12622,12803,181,1.434,27,154,28,77,H1
"Lawrence County, MS",2016-2017,12803,12643,-160,-1.25,17,-177,28,77,H1
"Leake County, MS",2000-2001,20964,21563,599,2.857,142,457,28,79,H1
"Leake County, MS",2001-2002,21563,21884,321,1.489,96,225,28,79,H1
"Leake County, MS",2002-2003,21884,22240,356,1.627,114,242,28,79,H1
"Leake County, MS",2003-2004,22240,22561,321,1.443,110,211,28,79,H1
"Leake County, MS",2004-2005,22561,22869,308,1.365,104,204,28,79,H1
"Leake County, MS",2005-2006,22869,23159,290,1.268,125,165,28,79,H1
"Leake County, MS",2006-2007,23159,23353,194,0.838,153,41,28,79,H1
"Leake County, MS",2007-2008,23353,23641,288,1.233,163,125,28,79,H1
"Leake County, MS",2008-2009,23641,23790,149,0.63,128,21,28,79,H1
"Leake County, MS",2009-2010,23790,23779,-11,-0.046,118,-129,28,79,H1
"Leake County, MS",2010-2011,23779,23305,-474,-1.993,79,-553,28,79,H1
"Leake County, MS",2011-2012,23305,23253,-52,-0.223,65,-117,28,79,H1
"Leake County, MS",2012-2013,23253,23309,56,0.241,10,46,28,79,H1
"Leake County, MS",2013-2014,23309,23193,-116,-0.498,-1,-115,28,79,H1
"Leake County, MS",2014-2015,23191,22763,-428,-1.846,46,-474,28,79,H1
"Leake County, MS",2015-2016,22763,22737,-26,-0.114,33,-59,28,79,H1
"Leake County, MS",2016-2017,22737,22715,-22,-0.097,30,-52,28,79,H1
"Lee County, MS",2000-2001,75876,76537,661,0.871,501,160,28,81,H1
"Lee County, MS",2001-2002,76537,76783,246,0.321,417,-171,28,81,H1
"Lee County, MS",2002-2003,76783,77480,697,0.908,425,272,28,81,H1
"Lee County, MS",2003-2004,77480,77937,457,0.59,517,-60,28,81,H1
"Lee County, MS",2004-2005,77937,78529,592,0.76,518,74,28,81,H1
"Lee County, MS",2005-2006,78529,79684,1155,1.471,393,762,28,81,H1
"Lee County, MS",2006-2007,79684,80561,877,1.101,333,544,28,81,H1
"Lee County, MS",2007-2008,80561,81501,940,1.167,309,631,28,81,H1
"Lee County, MS",2008-2009,81501,82436,935,1.147,447,488,28,81,H1
"Lee County, MS",2009-2010,82436,82931,495,0.6,489,6,28,81,H1
"Lee County, MS",2010-2011,82931,84208,1277,1.54,329,948,28,81,H1
"Lee County, MS",2011-2012,84208,85115,907,1.077,355,552,28,81,H1
"Lee County, MS",2012-2013,85115,85440,325,0.382,141,184,28,81,H1
"Lee County, MS",2013-2014,85440,85246,-194,-0.227,131,-325,28,81,H1
"Lee County, MS",2014-2015,85242,85300,58,0.068,165,-107,28,81,H1
"Lee County, MS",2015-2016,85300,84816,-484,-0.567,252,-736,28,81,H1
"Lee County, MS",2016-2017,84816,84933,117,0.138,154,-37,28,81,H1
"Leflore County, MS",2000-2001,37763,36775,-988,-2.616,141,-1129,28,83,H1
"Leflore County, MS",2001-2002,36775,35957,-818,-2.224,178,-996,28,83,H1
"Leflore County, MS",2002-2003,35957,34516,-1441,-4.008,195,-1636,28,83,H1
"Leflore County, MS",2003-2004,34516,34863,347,1.005,212,135,28,83,H1
"Leflore County, MS",2004-2005,34863,34178,-685,-1.965,153,-838,28,83,H1
"Leflore County, MS",2005-2006,34178,33862,-316,-0.925,236,-552,28,83,H1
"Leflore County, MS",2006-2007,33862,33540,-322,-0.951,261,-583,28,83,H1
"Leflore County, MS",2007-2008,33540,33329,-211,-0.629,247,-458,28,83,H1
"Leflore County, MS",2008-2009,33329,32508,-821,-2.463,234,-1055,28,83,H1
"Leflore County, MS",2009-2010,32508,32331,-177,-0.544,192,-369,28,83,H1
"Leflore County, MS",2010-2011,32331,31947,-384,-1.188,203,-587,28,83,H1
"Leflore County, MS",2011-2012,31947,31566,-381,-1.193,81,-462,28,83,H1
"Leflore County, MS",2012-2013,31566,31592,26,0.082,90,-64,28,83,H1
"Leflore County, MS",2013-2014,31592,31422,-170,-0.538,98,-268,28,83,H1
"Leflore County, MS",2014-2015,31526,30999,-527,-1.672,89,-616,28,83,H1
"Leflore County, MS",2015-2016,30999,29727,-1272,-4.103,90,-1362,28,83,H1
"Leflore County, MS",2016-2017,29727,29223,-504,-1.695,91,-595,28,83,H1
"Lincoln County, MS",2000-2001,33163,33188,25,0.075,104,-79,28,85,H1
"Lincoln County, MS",2001-2002,33188,33326,138,0.416,61,77,28,85,H1
"Lincoln County, MS",2002-2003,33326,33407,81,0.243,69,12,28,85,H1
"Lincoln County, MS",2003-2004,33407,33490,83,0.248,100,-17,28,85,H1
"Lincoln County, MS",2004-2005,33490,33748,258,0.77,122,136,28,85,H1
"Lincoln County, MS",2005-2006,33748,34248,500,1.482,68,432,28,85,H1
"Lincoln County, MS",2006-2007,34248,34398,150,0.438,179,-29,28,85,H1
"Lincoln County, MS",2007-2008,34398,34724,326,0.948,210,116,28,85,H1
"Lincoln County, MS",2008-2009,34724,34877,153,0.441,120,33,28,85,H1
"Lincoln County, MS",2009-2010,34877,34893,16,0.046,91,-75,28,85,H1
"Lincoln County, MS",2010-2011,34893,34855,-38,-0.109,33,-71,28,85,H1
"Lincoln County, MS",2011-2012,34855,34849,-6,-0.017,94,-100,28,85,H1
"Lincoln County, MS",2012-2013,34849,34750,-99,-0.284,60,-159,28,85,H1
"Lincoln County, MS",2013-2014,34750,34775,25,0.072,74,-49,28,85,H1
"Lincoln County, MS",2014-2015,34766,34649,-117,-0.337,89,-206,28,85,H1
"Lincoln County, MS",2015-2016,34649,34404,-245,-0.707,23,-268,28,85,H1
"Lincoln County, MS",2016-2017,34404,34347,-57,-0.166,5,-62,28,85,H1
"Lowndes County, MS",2000-2001,61529,60958,-571,-0.928,451,-1022,28,87,H1
"Lowndes County, MS",2001-2002,60958,60508,-450,-0.738,397,-847,28,87,H1
"Lowndes County, MS",2002-2003,60508,59919,-589,-0.973,323,-912,28,87,H1
"Lowndes County, MS",2003-2004,59919,59699,-220,-0.367,373,-593,28,87,H1
"Lowndes County, MS",2004-2005,59699,59237,-462,-0.774,281,-743,28,87,H1
"Lowndes County, MS",2005-2006,59237,59396,159,0.268,382,-223,28,87,H1
"Lowndes County, MS",2006-2007,59396,59355,-41,-0.069,374,-415,28,87,H1
"Lowndes County, MS",2007-2008,59355,59160,-195,-0.329,396,-591,28,87,H1
"Lowndes County, MS",2008-2009,59160,59663,503,0.85,294,209,28,87,H1
"Lowndes County, MS",2009-2010,59663,59820,157,0.263,298,-141,28,87,H1
"Lowndes County, MS",2010-2011,59820,59586,-234,-0.391,199,-433,28,87,H1
"Lowndes County, MS",2011-2012,59586,59641,55,0.092,247,-192,28,87,H1
"Lowndes County, MS",2012-2013,59641,59901,260,0.436,311,-51,28,87,H1
"Lowndes County, MS",2013-2014,59901,59730,-171,-0.285,265,-436,28,87,H1
"Lowndes County, MS",2014-2015,59750,59710,-40,-0.067,231,-271,28,87,H1
"Lowndes County, MS",2015-2016,59710,59460,-250,-0.419,168,-418,28,87,H1
"Lowndes County, MS",2016-2017,59460,59186,-274,-0.461,196,-470,28,87,H1
"Madison County, MS",2000-2001,75089,76580,1491,1.986,454,1037,28,89,H1
"Madison County, MS",2001-2002,76580,78092,1512,1.974,270,1242,28,89,H1
"Madison County, MS",2002-2003,78092,79997,1905,2.439,257,1648,28,89,H1
"Madison County, MS",2003-2004,79997,82283,2286,2.858,245,2041,28,89,H1
"Madison County, MS",2004-2005,82283,84846,2563,3.115,215,2348,28,89,H1
"Madison County, MS",2005-2006,84846,87844,2998,3.533,332,2666,28,89,H1
"Madison County, MS",2006-2007,87844,90195,2351,2.676,389,1962,28,89,H1
"Madison County, MS",2007-2008,90195,92274,2079,2.305,431,1648,28,89,H1
"Madison County, MS",2008-2009,92274,94071,1797,1.947,337,1460,28,89,H1
"Madison County, MS",2009-2010,94071,95590,1519,1.615,218,1301,28,89,H1
"Madison County, MS",2010-2011,95590,97110,1520,1.59,316,1204,28,89,H1
"Madison County, MS",2011-2012,97110,98479,1369,1.41,332,1037,28,89,H1
"Madison County, MS",2012-2013,98479,100241,1762,1.789,155,1607,28,89,H1
"Madison County, MS",2013-2014,100241,101688,1447,1.444,187,1260,28,89,H1
"Madison County, MS",2014-2015,101690,103465,1775,1.746,168,1607,28,89,H1
"Madison County, MS",2015-2016,103465,103875,410,0.396,336,74,28,89,H1
"Madison County, MS",2016-2017,103875,104618,743,0.715,231,512,28,89,H1
"Marion County, MS",2000-2001,25616,25391,-225,-0.878,13,-238,28,91,H1
"Marion County, MS",2001-2002,25391,25360,-31,-0.122,58,-89,28,91,H1
"Marion County, MS",2002-2003,25360,25497,137,0.54,81,56,28,91,H1
"Marion County, MS",2003-2004,25497,25617,120,0.471,20,100,28,91,H1
"Marion County, MS",2004-2005,25617,25706,89,0.347,64,25,28,91,H1
"Marion County, MS",2005-2006,25706,26291,585,2.276,28,557,28,91,H1
"Marion County, MS",2006-2007,26291,26610,319,1.213,134,185,28,91,H1
"Marion County, MS",2007-2008,26610,26825,215,0.808,103,112,28,91,H1
"Marion County, MS",2008-2009,26825,26979,154,0.574,73,81,28,91,H1
"Marion County, MS",2009-2010,26979,27054,75,0.278,78,-3,28,91,H1
"Marion County, MS",2010-2011,27054,26750,-304,-1.124,27,-331,28,91,H1
"Marion County, MS",2011-2012,26750,26398,-352,-1.316,0,-352,28,91,H1
"Marion County, MS",2012-2013,26398,26173,-225,-0.852,-21,-204,28,91,H1
"Marion County, MS",2013-2014,26173,25868,-305,-1.165,7,-312,28,91,H1
"Marion County, MS",2014-2015,25786,25563,-223,-0.865,-21,-202,28,91,H1
"Marion County, MS",2015-2016,25563,25113,-450,-1.76,-41,-409,28,91,H1
"Marion County, MS",2016-2017,25113,25069,-44,-0.175,-39,-5,28,91,H1
"Marshall County, MS",2000-2001,35004,35052,48,0.137,208,-160,28,93,H1
"Marshall County, MS",2001-2002,35052,35345,293,0.836,191,102,28,93,H1
"Marshall County, MS",2002-2003,35345,35767,422,1.194,112,310,28,93,H1
"Marshall County, MS",2003-2004,35767,35720,-47,-0.131,114,-161,28,93,H1
"Marshall County, MS",2004-2005,35720,36052,332,0.929,150,182,28,93,H1
"Marshall County, MS",2005-2006,36052,36374,322,0.893,89,233,28,93,H1
"Marshall County, MS",2006-2007,36374,36950,576,1.584,170,406,28,93,H1
"Marshall County, MS",2007-2008,36950,37351,401,1.085,219,182,28,93,H1
"Marshall County, MS",2008-2009,37351,37231,-120,-0.321,159,-279,28,93,H1
"Marshall County, MS",2009-2010,37231,37073,-158,-0.424,67,-225,28,93,H1
"Marshall County, MS",2010-2011,37073,36765,-308,-0.831,86,-394,28,93,H1
"Marshall County, MS",2011-2012,36765,36587,-178,-0.484,50,-228,28,93,H1
"Marshall County, MS",2012-2013,36587,36520,-67,-0.183,31,-98,28,93,H1
"Marshall County, MS",2013-2014,36520,36234,-286,-0.783,17,-303,28,93,H1
"Marshall County, MS",2014-2015,36191,35916,-275,-0.76,14,-289,28,93,H1
"Marshall County, MS",2015-2016,35916,35780,-136,-0.379,21,-157,28,93,H1
"Marshall County, MS",2016-2017,35780,35619,-161,-0.45,-6,-155,28,93,H1
"Monroe County, MS",2000-2001,37981,38005,24,0.063,126,-102,28,95,H1
"Monroe County, MS",2001-2002,38005,37690,-315,-0.829,114,-429,28,95,H1
"Monroe County, MS",2002-2003,37690,37646,-44,-0.117,82,-126,28,95,H1
"Monroe County, MS",2003-2004,37646,37678,32,0.085,102,-70,28,95,H1
"Monroe County, MS",2004-2005,37678,37464,-214,-0.568,115,-329,28,95,H1
"Monroe County, MS",2005-2006,37464,37454,-10,-0.027,136,-146,28,95,H1
"Monroe County, MS",2006-2007,37454,37355,-99,-0.264,163,-262,28,95,H1
"Monroe County, MS",2007-2008,37355,37453,98,0.262,142,-44,28,95,H1
"Monroe County, MS",2008-2009,37453,37258,-195,-0.521,111,-306,28,95,H1
"Monroe County, MS",2009-2010,37258,36890,-368,-0.988,105,-473,28,95,H1
"Monroe County, MS",2010-2011,36890,36534,-356,-0.965,-10,-346,28,95,H1
"Monroe County, MS",2011-2012,36534,36378,-156,-0.427,22,-178,28,95,H1
"Monroe County, MS",2012-2013,36378,36112,-266,-0.731,54,-320,28,95,H1
"Monroe County, MS",2013-2014,36112,36003,-109,-0.302,47,-156,28,95,H1
"Monroe County, MS",2014-2015,36006,35827,-179,-0.497,53,-232,28,95,H1
"Monroe County, MS",2015-2016,35827,35908,81,0.226,-51,132,28,95,H1
"Monroe County, MS",2016-2017,35908,35872,-36,-0.1,-22,-14,28,95,H1
"Montgomery County, MS",2000-2001,12115,12042,-73,-0.603,29,-102,28,97,H1
"Montgomery County, MS",2001-2002,12042,11829,-213,-1.769,25,-238,28,97,H1
"Montgomery County, MS",2002-2003,11829,11647,-182,-1.539,7,-189,28,97,H1
"Montgomery County, MS",2003-2004,11647,11507,-140,-1.202,21,-161,28,97,H1
"Montgomery County, MS",2004-2005,11507,11474,-33,-0.287,23,-56,28,97,H1
"Montgomery County, MS",2005-2006,11474,11453,-21,-0.183,38,-59,28,97,H1
"Montgomery County, MS",2006-2007,11453,11297,-156,-1.362,59,-215,28,97,H1
"Montgomery County, MS",2007-2008,11297,11067,-230,-2.036,-2,-228,28,97,H1
"Montgomery County, MS",2008-2009,11067,10948,-119,-1.075,6,-125,28,97,H1
"Montgomery County, MS",2009-2010,10948,10906,-42,-0.384,17,-59,28,97,H1
"Montgomery County, MS",2010-2011,10906,10755,-151,-1.385,-30,-121,28,97,H1
"Montgomery County, MS",2011-2012,10755,10557,-198,-1.841,-37,-161,28,97,H1
"Montgomery County, MS",2012-2013,10557,10550,-7,-0.066,35,-42,28,97,H1
"Montgomery County, MS",2013-2014,10550,10400,-150,-1.422,23,-173,28,97,H1
"Montgomery County, MS",2014-2015,10327,10152,-175,-1.695,-13,-162,28,97,H1
"Montgomery County, MS",2015-2016,10152,10259,107,1.054,36,71,28,97,H1
"Montgomery County, MS",2016-2017,10259,10173,-86,-0.838,0,-86,28,97,H1
"Neshoba County, MS",2000-2001,28689,28396,-293,-1.021,149,-442,28,99,H1
"Neshoba County, MS",2001-2002,28396,28490,94,0.331,141,-47,28,99,H1
"Neshoba County, MS",2002-2003,28490,28807,317,1.113,194,123,28,99,H1
"Neshoba County, MS",2003-2004,28807,29139,332,1.152,206,126,28,99,H1
"Neshoba County, MS",2004-2005,29139,29364,225,0.772,175,50,28,99,H1
"Neshoba County, MS",2005-2006,29364,29381,17,0.058,218,-201,28,99,H1
"Neshoba County, MS",2006-2007,29381,29399,18,0.061,237,-219,28,99,H1
"Neshoba County, MS",2007-2008,29399,29562,163,0.554,224,-61,28,99,H1
"Neshoba County, MS",2008-2009,29562,29694,132,0.447,227,-95,28,99,H1
"Neshoba County, MS",2009-2010,29694,29668,-26,-0.088,225,-251,28,99,H1
"Neshoba County, MS",2010-2011,29668,29705,37,0.125,113,-76,28,99,H1
"Neshoba County, MS",2011-2012,29705,29679,-26,-0.088,112,-138,28,99,H1
"Neshoba County, MS",2012-2013,29679,29461,-218,-0.735,82,-300,28,99,H1
"Neshoba County, MS",2013-2014,29461,29465,4,0.014,78,-74,28,99,H1
"Neshoba County, MS",2014-2015,29457,29463,6,0.02,92,-86,28,99,H1
"Neshoba County, MS",2015-2016,29463,29439,-24,-0.081,22,-46,28,99,H1
"Neshoba County, MS",2016-2017,29439,29369,-70,-0.238,31,-101,28,99,H1
"Newton County, MS",2000-2001,21791,21715,-76,-0.349,92,-168,28,101,H1
"Newton County, MS",2001-2002,21715,21493,-222,-1.022,105,-327,28,101,H1
"Newton County, MS",2002-2003,21493,21510,17,0.079,85,-68,28,101,H1
"Newton County, MS",2003-2004,21510,21535,25,0.116,94,-69,28,101,H1
"Newton County, MS",2004-2005,21535,21611,76,0.353,177,-101,28,101,H1
"Newton County, MS",2005-2006,21611,21814,203,0.939,130,73,28,101,H1
"Newton County, MS",2006-2007,21814,21965,151,0.692,121,30,28,101,H1
"Newton County, MS",2007-2008,21965,21851,-114,-0.519,147,-261,28,101,H1
"Newton County, MS",2008-2009,21851,21790,-61,-0.279,106,-167,28,101,H1
"Newton County, MS",2009-2010,21790,21679,-111,-0.509,84,-195,28,101,H1
"Newton County, MS",2010-2011,21679,21509,-170,-0.784,77,-247,28,101,H1
"Newton County, MS",2011-2012,21509,21625,116,0.539,67,49,28,101,H1
"Newton County, MS",2012-2013,21625,21709,84,0.388,-23,107,28,101,H1
"Newton County, MS",2013-2014,21709,21832,123,0.567,-38,161,28,101,H1
"Newton County, MS",2014-2015,21816,21747,-69,-0.316,3,-72,28,101,H1
"Newton County, MS",2015-2016,21747,21385,-362,-1.665,29,-391,28,101,H1
"Newton County, MS",2016-2017,21385,21185,-200,-0.935,-22,-178,28,101,H1
"Noxubee County, MS",2000-2001,12536,12434,-102,-0.814,91,-193,28,103,H1
"Noxubee County, MS",2001-2002,12434,12312,-122,-0.981,103,-225,28,103,H1
"Noxubee County, MS",2002-2003,12312,12147,-165,-1.34,65,-230,28,103,H1
"Noxubee County, MS",2003-2004,12147,12056,-91,-0.749,61,-152,28,103,H1
"Noxubee County, MS",2004-2005,12056,11973,-83,-0.688,104,-187,28,103,H1
"Noxubee County, MS",2005-2006,11973,11875,-98,-0.819,90,-188,28,103,H1
"Noxubee County, MS",2006-2007,11875,11880,5,0.042,110,-105,28,103,H1
"Noxubee County, MS",2007-2008,11880,11823,-57,-0.48,97,-154,28,103,H1
"Noxubee County, MS",2008-2009,11823,11646,-177,-1.497,67,-244,28,103,H1
"Noxubee County, MS",2009-2010,11646,11507,-139,-1.194,82,-221,28,103,H1
"Noxubee County, MS",2010-2011,11507,11335,-172,-1.495,29,-201,28,103,H1
"Noxubee County, MS",2011-2012,11335,11175,-160,-1.412,46,-206,28,103,H1
"Noxubee County, MS",2012-2013,11175,11069,-106,-0.949,51,-157,28,103,H1
"Noxubee County, MS",2013-2014,11069,11115,46,0.416,17,29,28,103,H1
"Noxubee County, MS",2014-2015,11121,11043,-78,-0.701,22,-100,28,103,H1
"Noxubee County, MS",2015-2016,11043,10914,-129,-1.168,47,-176,28,103,H1
"Noxubee County, MS",2016-2017,10914,10742,-172,-1.576,15,-187,28,103,H1
"Oktibbeha County, MS",2000-2001,43122,43186,64,0.148,306,-242,28,105,H1
"Oktibbeha County, MS",2001-2002,43186,43036,-150,-0.347,280,-430,28,105,H1
"Oktibbeha County, MS",2002-2003,43036,43188,152,0.353,238,-86,28,105,H1
"Oktibbeha County, MS",2003-2004,43188,43382,194,0.449,304,-110,28,105,H1
"Oktibbeha County, MS",2004-2005,43382,43985,603,1.39,311,292,28,105,H1
"Oktibbeha County, MS",2005-2006,43985,45052,1067,2.426,330,737,28,105,H1
"Oktibbeha County, MS",2006-2007,45052,46032,980,2.175,334,646,28,105,H1
"Oktibbeha County, MS",2007-2008,46032,46470,438,0.952,301,137,28,105,H1
"Oktibbeha County, MS",2008-2009,46470,47400,930,2.001,320,610,28,105,H1
"Oktibbeha County, MS",2009-2010,47400,47689,289,0.61,311,-22,28,105,H1
"Oktibbeha County, MS",2010-2011,47689,47853,164,0.344,268,-104,28,105,H1
"Oktibbeha County, MS",2011-2012,47853,48956,1103,2.305,279,824,28,105,H1
"Oktibbeha County, MS",2012-2013,48956,49284,328,0.67,292,36,28,105,H1
"Oktibbeha County, MS",2013-2014,49284,49414,130,0.264,212,-82,28,105,H1
"Oktibbeha County, MS",2014-2015,49343,49800,457,0.926,206,251,28,105,H1
"Oktibbeha County, MS",2015-2016,49800,49579,-221,-0.444,222,-443,28,105,H1
"Oktibbeha County, MS",2016-2017,49579,49799,220,0.444,201,19,28,105,H1
"Panola County, MS",2000-2001,34379,34401,22,0.064,235,-213,28,107,H1
"Panola County, MS",2001-2002,34401,34623,222,0.645,241,-19,28,107,H1
"Panola County, MS",2002-2003,34623,34661,38,0.11,187,-149,28,107,H1
"Panola County, MS",2003-2004,34661,34701,40,0.115,212,-172,28,107,H1
"Panola County, MS",2004-2005,34701,34684,-17,-0.049,218,-235,28,107,H1
"Panola County, MS",2005-2006,34684,34705,21,0.061,96,-75,28,107,H1
"Panola County, MS",2006-2007,34705,34813,108,0.311,241,-133,28,107,H1
"Panola County, MS",2007-2008,34813,34923,110,0.316,226,-116,28,107,H1
"Panola County, MS",2008-2009,34923,34768,-155,-0.444,201,-356,28,107,H1
"Panola County, MS",2009-2010,34768,34670,-98,-0.282,197,-295,28,107,H1
"Panola County, MS",2010-2011,34670,34517,-153,-0.441,129,-282,28,107,H1
"Panola County, MS",2011-2012,34517,34464,-53,-0.154,133,-186,28,107,H1
"Panola County, MS",2012-2013,34464,34439,-25,-0.073,106,-131,28,107,H1
"Panola County, MS",2013-2014,34439,34444,5,0.015,113,-108,28,107,H1
"Panola County, MS",2014-2015,34378,34167,-211,-0.614,110,-321,28,107,H1
"Panola County, MS",2015-2016,34167,34160,-7,-0.02,79,-86,28,107,H1
"Panola County, MS",2016-2017,34160,33994,-166,-0.486,65,-231,28,107,H1
"Pearl River County, MS",2000-2001,48621,49083,462,0.95,186,276,28,109,H1
"Pearl River County, MS",2001-2002,49083,49659,576,1.174,187,389,28,109,H1
"Pearl River County, MS",2002-2003,49659,49968,309,0.622,149,160,28,109,H1
"Pearl River County, MS",2003-2004,49968,50624,656,1.313,163,493,28,109,H1
"Pearl River County, MS",2004-2005,50624,50990,366,0.723,147,219,28,109,H1
"Pearl River County, MS",2005-2006,50990,55153,4163,8.164,210,3953,28,109,H1
"Pearl River County, MS",2006-2007,55153,56053,900,1.632,239,661,28,109,H1
"Pearl River County, MS",2007-2008,56053,56538,485,0.865,248,237,28,109,H1
"Pearl River County, MS",2008-2009,56538,56085,-453,-0.801,200,-653,28,109,H1
"Pearl River County, MS",2009-2010,56085,55723,-362,-0.645,131,-493,28,109,H1
"Pearl River County, MS",2010-2011,55723,55469,-254,-0.456,84,-338,28,109,H1
"Pearl River County, MS",2011-2012,55469,55090,-379,-0.683,111,-490,28,109,H1
"Pearl River County, MS",2012-2013,55090,54957,-133,-0.241,36,-169,28,109,H1
"Pearl River County, MS",2013-2014,54957,55224,267,0.486,17,250,28,109,H1
"Pearl River County, MS",2014-2015,55298,55191,-107,-0.193,20,-127,28,109,H1
"Pearl River County, MS",2015-2016,55191,55072,-119,-0.216,-25,-94,28,109,H1
"Pearl River County, MS",2016-2017,55072,55270,198,0.36,-23,221,28,109,H1
"Perry County, MS",2000-2001,12149,12156,7,0.058,34,-27,28,111,H1
"Perry County, MS",2001-2002,12156,12232,76,0.625,28,48,28,111,H1
"Perry County, MS",2002-2003,12232,12245,13,0.106,71,-58,28,111,H1
"Perry County, MS",2003-2004,12245,12233,-12,-0.098,40,-52,28,111,H1
"Perry County, MS",2004-2005,12233,12088,-145,-1.185,45,-190,28,111,H1
"Perry County, MS",2005-2006,12088,12098,10,0.083,50,-40,28,111,H1
"Perry County, MS",2006-2007,12098,12316,218,1.802,66,152,28,111,H1
"Perry County, MS",2007-2008,12316,12337,21,0.171,74,-53,28,111,H1
"Perry County, MS",2008-2009,12337,12206,-131,-1.062,62,-193,28,111,H1
"Perry County, MS",2009-2010,12206,12207,1,0.008,47,-46,28,111,H1
"Perry County, MS",2010-2011,12207,12232,25,0.205,14,11,28,111,H1
"Perry County, MS",2011-2012,12232,12080,-152,-1.243,60,-212,28,111,H1
"Perry County, MS",2012-2013,12080,12118,38,0.315,43,-5,28,111,H1
"Perry County, MS",2013-2014,12118,12227,109,0.899,34,75,28,111,H1
"Perry County, MS",2014-2015,12219,12277,58,0.475,37,21,28,111,H1
"Perry County, MS",2015-2016,12277,12076,-201,-1.637,6,-207,28,111,H1
"Perry County, MS",2016-2017,12076,12032,-44,-0.364,10,-54,28,111,H1
"Pike County, MS",2000-2001,38995,38739,-256,-0.656,181,-437,28,113,H1
"Pike County, MS",2001-2002,38739,38734,-5,-0.013,174,-179,28,113,H1
"Pike County, MS",2002-2003,38734,38649,-85,-0.219,189,-274,28,113,H1
"Pike County, MS",2003-2004,38649,38700,51,0.132,212,-161,28,113,H1
"Pike County, MS",2004-2005,38700,38905,205,0.53,150,55,28,113,H1
"Pike County, MS",2005-2006,38905,40241,1336,3.434,167,1169,28,113,H1
"Pike County, MS",2006-2007,40241,40141,-100,-0.249,228,-328,28,113,H1
"Pike County, MS",2007-2008,40141,40290,149,0.371,223,-74,28,113,H1
"Pike County, MS",2008-2009,40290,40332,42,0.104,144,-102,28,113,H1
"Pike County, MS",2009-2010,40332,40443,111,0.275,155,-44,28,113,H1
"Pike County, MS",2010-2011,40443,40420,-23,-0.057,97,-120,28,113,H1
"Pike County, MS",2011-2012,40420,40111,-309,-0.764,100,-409,28,113,H1
"Pike County, MS",2012-2013,40111,40015,-96,-0.239,79,-175,28,113,H1
"Pike County, MS",2013-2014,40015,40058,43,0.107,47,-4,28,113,H1
"Pike County, MS",2014-2015,39961,39956,-5,-0.013,23,-28,28,113,H1
"Pike County, MS",2015-2016,39956,39608,-348,-0.871,13,-361,28,113,H1
"Pike County, MS",2016-2017,39608,39468,-140,-0.353,16,-156,28,113,H1
"Pontotoc County, MS",2000-2001,26967,27274,307,1.138,131,176,28,115,H1
"Pontotoc County, MS",2001-2002,27274,27427,153,0.561,109,44,28,115,H1
"Pontotoc County, MS",2002-2003,27427,27990,563,2.053,161,402,28,115,H1
"Pontotoc County, MS",2003-2004,27990,28276,286,1.022,128,158,28,115,H1
"Pontotoc County, MS",2004-2005,28276,28567,291,1.029,229,62,28,115,H1
"Pontotoc County, MS",2005-2006,28567,29098,531,1.859,192,339,28,115,H1
"Pontotoc County, MS",2006-2007,29098,29264,166,0.57,228,-62,28,115,H1
"Pontotoc County, MS",2007-2008,29264,29475,211,0.721,259,-48,28,115,H1
"Pontotoc County, MS",2008-2009,29475,29770,295,1.001,199,96,28,115,H1
"Pontotoc County, MS",2009-2010,29770,30023,253,0.85,183,70,28,115,H1
"Pontotoc County, MS",2010-2011,30023,29784,-239,-0.796,124,-363,28,115,H1
"Pontotoc County, MS",2011-2012,29784,30345,561,1.884,182,379,28,115,H1
"Pontotoc County, MS",2012-2013,30345,30770,425,1.401,230,195,28,115,H1
"Pontotoc County, MS",2013-2014,30770,30950,180,0.585,226,-46,28,115,H1
"Pontotoc County, MS",2014-2015,30840,30908,68,0.22,168,-100,28,115,H1
"Pontotoc County, MS",2015-2016,30908,31437,529,1.712,174,355,28,115,H1
"Pontotoc County, MS",2016-2017,31437,31640,203,0.646,190,13,28,115,H1
"Prentiss County, MS",2000-2001,25662,25452,-210,-0.818,84,-294,28,117,H1
"Prentiss County, MS",2001-2002,25452,25463,11,0.043,71,-60,28,117,H1
"Prentiss County, MS",2002-2003,25463,25611,148,0.581,102,46,28,117,H1
"Prentiss County, MS",2003-2004,25611,25568,-43,-0.168,37,-80,28,117,H1
"Prentiss County, MS",2004-2005,25568,25608,40,0.156,43,-3,28,117,H1
"Prentiss County, MS",2005-2006,25608,25463,-145,-0.566,32,-177,28,117,H1
"Prentiss County, MS",2006-2007,25463,25370,-93,-0.365,119,-212,28,117,H1
"Prentiss County, MS",2007-2008,25370,25481,111,0.438,117,-6,28,117,H1
"Prentiss County, MS",2008-2009,25481,25553,72,0.283,88,-16,28,117,H1
"Prentiss County, MS",2009-2010,25553,25218,-335,-1.311,66,-401,28,117,H1
"Prentiss County, MS",2010-2011,25218,25307,89,0.353,39,50,28,117,H1
"Prentiss County, MS",2011-2012,25307,25310,3,0.012,119,-116,28,117,H1
"Prentiss County, MS",2012-2013,25310,25426,116,0.458,55,61,28,117,H1
"Prentiss County, MS",2013-2014,25426,25428,2,0.008,118,-116,28,117,H1
"Prentiss County, MS",2014-2015,25411,25459,48,0.189,121,-73,28,117,H1
"Prentiss County, MS",2015-2016,25459,25394,-65,-0.255,31,-96,28,117,H1
"Prentiss County, MS",2016-2017,25394,25261,-133,-0.524,59,-192,28,117,H1
"Quitman County, MS",2000-2001,10055,9952,-103,-1.024,48,-151,28,119,H1
"Quitman County, MS",2001-2002,9952,9828,-124,-1.246,65,-189,28,119,H1
"Quitman County, MS",2002-2003,9828,9541,-287,-2.92,41,-328,28,119,H1
"Quitman County, MS",2003-2004,9541,9494,-47,-0.493,6,-53,28,119,H1
"Quitman County, MS",2004-2005,9494,9238,-256,-2.696,1,-257,28,119,H1
"Quitman County, MS",2005-2006,9238,9008,-230,-2.49,38,-268,28,119,H1
"Quitman County, MS",2006-2007,9008,8723,-285,-3.164,20,-305,28,119,H1
"Quitman County, MS",2007-2008,8723,8501,-222,-2.545,36,-258,28,119,H1
"Quitman County, MS",2008-2009,8501,8336,-165,-1.941,14,-179,28,119,H1
"Quitman County, MS",2009-2010,8336,8175,-161,-1.931,38,-199,28,119,H1
"Quitman County, MS",2010-2011,8175,8030,-145,-1.774,-16,-129,28,119,H1
"Quitman County, MS",2011-2012,8030,7802,-228,-2.839,8,-236,28,119,H1
"Quitman County, MS",2012-2013,7802,7824,22,0.282,25,-3,28,119,H1
"Quitman County, MS",2013-2014,7824,7678,-146,-1.866,4,-150,28,119,H1
"Quitman County, MS",2014-2015,7676,7486,-190,-2.475,-17,-173,28,119,H1
"Quitman County, MS",2015-2016,7486,7404,-82,-1.095,20,-102,28,119,H1
"Quitman County, MS",2016-2017,7404,7269,-135,-1.823,0,-135,28,119,H1
"Rankin County, MS",2000-2001,116255,118774,2519,2.167,896,1623,28,121,H1
"Rankin County, MS",2001-2002,118774,120937,2163,1.821,860,1303,28,121,H1
"Rankin County, MS",2002-2003,120937,123796,2859,2.364,991,1868,28,121,H1
"Rankin County, MS",2003-2004,123796,127232,3436,2.776,1088,2348,28,121,H1
"Rankin County, MS",2004-2005,127232,130354,3122,2.454,1120,2002,28,121,H1
"Rankin County, MS",2005-2006,130354,134132,3778,2.898,1149,2629,28,121,H1
"Rankin County, MS",2006-2007,134132,136694,2562,1.91,1235,1327,28,121,H1
"Rankin County, MS",2007-2008,136694,139136,2442,1.786,1253,1189,28,121,H1
"Rankin County, MS",2008-2009,139136,140634,1498,1.077,1142,356,28,121,H1
"Rankin County, MS",2009-2010,140634,142532,1898,1.35,1046,852,28,121,H1
"Rankin County, MS",2010-2011,142532,144075,1543,1.083,937,606,28,121,H1
"Rankin County, MS",2011-2012,144075,145604,1529,1.061,873,656,28,121,H1
"Rankin County, MS",2012-2013,145604,147135,1531,1.051,785,746,28,121,H1
"Rankin County, MS",2013-2014,147135,148070,935,0.635,782,153,28,121,H1
"Rankin County, MS",2014-2015,148081,149039,958,0.647,804,154,28,121,H1
"Rankin County, MS",2015-2016,149039,151074,2035,1.365,648,1387,28,121,H1
"Rankin County, MS",2016-2017,151074,152080,1006,0.666,646,360,28,121,H1
"Scott County, MS",2000-2001,28393,28321,-72,-0.254,181,-253,28,123,H1
"Scott County, MS",2001-2002,28321,27948,-373,-1.317,111,-484,28,123,H1
"Scott County, MS",2002-2003,27948,28126,178,0.637,198,-20,28,123,H1
"Scott County, MS",2003-2004,28126,28097,-29,-0.103,218,-247,28,123,H1
"Scott County, MS",2004-2005,28097,28122,25,0.089,243,-218,28,123,H1
"Scott County, MS",2005-2006,28122,28170,48,0.171,265,-217,28,123,H1
"Scott County, MS",2006-2007,28170,28175,5,0.018,275,-270,28,123,H1
"Scott County, MS",2007-2008,28175,28098,-77,-0.273,259,-336,28,123,H1
"Scott County, MS",2008-2009,28098,28101,3,0.011,246,-243,28,123,H1
"Scott County, MS",2009-2010,28101,28315,214,0.762,249,-35,28,123,H1
"Scott County, MS",2010-2011,28315,28297,-18,-0.064,143,-161,28,123,H1
"Scott County, MS",2011-2012,28297,28248,-49,-0.173,214,-263,28,123,H1
"Scott County, MS",2012-2013,28248,28241,-7,-0.025,146,-153,28,123,H1
"Scott County, MS",2013-2014,28241,28461,220,0.779,120,100,28,123,H1
"Scott County, MS",2014-2015,28433,28265,-168,-0.591,119,-287,28,123,H1
"Scott County, MS",2015-2016,28265,28378,113,0.4,217,-104,28,123,H1
"Scott County, MS",2016-2017,28378,28420,42,0.148,160,-118,28,123,H1
"Sharkey County, MS",2000-2001,6520,6303,-217,-3.328,41,-258,28,125,H1
"Sharkey County, MS",2001-2002,6303,6186,-117,-1.856,52,-169,28,125,H1
"Sharkey County, MS",2002-2003,6186,6052,-134,-2.166,28,-162,28,125,H1
"Sharkey County, MS",2003-2004,6052,5845,-207,-3.42,32,-239,28,125,H1
"Sharkey County, MS",2004-2005,5845,5707,-138,-2.361,34,-172,28,125,H1
"Sharkey County, MS",2005-2006,5707,5510,-197,-3.452,69,-266,28,125,H1
"Sharkey County, MS",2006-2007,5510,5238,-272,-4.936,10,-282,28,125,H1
"Sharkey County, MS",2007-2008,5238,5191,-47,-0.897,60,-107,28,125,H1
"Sharkey County, MS",2008-2009,5191,5076,-115,-2.215,50,-165,28,125,H1
"Sharkey County, MS",2009-2010,5076,4878,-198,-3.901,43,-241,28,125,H1
"Sharkey County, MS",2010-2011,4878,4875,-3,-0.062,3,-6,28,125,H1
"Sharkey County, MS",2011-2012,4875,4787,-88,-1.805,31,-119,28,125,H1
"Sharkey County, MS",2012-2013,4787,4684,-103,-2.152,24,-127,28,125,H1
"Sharkey County, MS",2013-2014,4684,4647,-37,-0.79,20,-57,28,125,H1
"Sharkey County, MS",2014-2015,4628,4585,-43,-0.929,14,-57,28,125,H1
"Sharkey County, MS",2015-2016,4585,4534,-51,-1.112,11,-62,28,125,H1
"Sharkey County, MS",2016-2017,4534,4435,-99,-2.184,2,-101,28,125,H1
"Simpson County, MS",2000-2001,27641,27376,-265,-0.959,79,-344,28,127,H1
"Simpson County, MS",2001-2002,27376,27547,171,0.625,63,108,28,127,H1
"Simpson County, MS",2002-2003,27547,27368,-179,-0.65,90,-269,28,127,H1
"Simpson County, MS",2003-2004,27368,27362,-6,-0.022,103,-109,28,127,H1
"Simpson County, MS",2004-2005,27362,27633,271,0.99,122,149,28,127,H1
"Simpson County, MS",2005-2006,27633,27658,25,0.09,132,-107,28,127,H1
"Simpson County, MS",2006-2007,27658,27512,-146,-0.528,150,-296,28,127,H1
"Simpson County, MS",2007-2008,27512,27682,170,0.618,126,44,28,127,H1
"Simpson County, MS",2008-2009,27682,27512,-170,-0.614,73,-243,28,127,H1
"Simpson County, MS",2009-2010,27512,27503,-9,-0.033,82,-91,28,127,H1
"Simpson County, MS",2010-2011,27503,27346,-157,-0.571,61,-218,28,127,H1
"Simpson County, MS",2011-2012,27346,27334,-12,-0.044,57,-69,28,127,H1
"Simpson County, MS",2012-2013,27334,27477,143,0.523,56,87,28,127,H1
"Simpson County, MS",2013-2014,27477,27463,-14,-0.051,38,-52,28,127,H1
"Simpson County, MS",2014-2015,27535,27222,-313,-1.137,47,-360,28,127,H1
"Simpson County, MS",2015-2016,27222,26980,-242,-0.889,-5,-237,28,127,H1
"Simpson County, MS",2016-2017,26980,26947,-33,-0.122,-3,-30,28,127,H1
"Smith County, MS",2000-2001,16182,16181,-1,-0.006,23,-24,28,129,H1
"Smith County, MS",2001-2002,16181,16077,-104,-0.643,48,-152,28,129,H1
"Smith County, MS",2002-2003,16077,16070,-7,-0.044,51,-58,28,129,H1
"Smith County, MS",2003-2004,16070,16126,56,0.348,57,-1,28,129,H1
"Smith County, MS",2004-2005,16126,16332,206,1.277,-12,218,28,129,H1
"Smith County, MS",2005-2006,16332,16427,95,0.582,-11,106,28,129,H1
"Smith County, MS",2006-2007,16427,16462,35,0.213,-17,52,28,129,H1
"Smith County, MS",2007-2008,16462,16345,-117,-0.711,69,-186,28,129,H1
"Smith County, MS",2008-2009,16345,16520,175,1.071,82,93,28,129,H1
"Smith County, MS",2009-2010,16520,16466,-54,-0.327,60,-114,28,129,H1
"Smith County, MS",2010-2011,16466,16515,49,0.298,73,-24,28,129,H1
"Smith County, MS",2011-2012,16515,16333,-182,-1.102,12,-194,28,129,H1
"Smith County, MS",2012-2013,16333,16216,-117,-0.716,31,-148,28,129,H1
"Smith County, MS",2013-2014,16216,16188,-28,-0.173,29,-57,28,129,H1
"Smith County, MS",2014-2015,16168,16059,-109,-0.674,11,-120,28,129,H1
"Smith County, MS",2015-2016,16059,15971,-88,-0.548,33,-121,28,129,H1
"Smith County, MS",2016-2017,15971,16078,107,0.67,10,97,28,129,H1
"Stone County, MS",2000-2001,13664,14130,466,3.41,61,405,28,131,H1
"Stone County, MS",2001-2002,14130,14163,33,0.234,50,-17,28,131,H1
"Stone County, MS",2002-2003,14163,14439,276,1.949,44,232,28,131,H1
"Stone County, MS",2003-2004,14439,14694,255,1.766,63,192,28,131,H1
"Stone County, MS",2004-2005,14694,15189,495,3.369,19,476,28,131,H1
"Stone County, MS",2005-2006,15189,15968,779,5.129,37,742,28,131,H1
"Stone County, MS",2006-2007,15968,16264,296,1.854,62,234,28,131,H1
"Stone County, MS",2007-2008,16264,17084,820,5.042,92,728,28,131,H1
"Stone County, MS",2008-2009,17084,17408,324,1.897,79,245,28,131,H1
"Stone County, MS",2009-2010,17408,17896,488,2.803,50,438,28,131,H1
"Stone County, MS",2010-2011,17896,17924,28,0.156,37,-9,28,131,H1
"Stone County, MS",2011-2012,17924,18049,125,0.697,3,122,28,131,H1
"Stone County, MS",2012-2013,18049,17962,-87,-0.482,37,-124,28,131,H1
"Stone County, MS",2013-2014,17962,17875,-87,-0.484,28,-115,28,131,H1
"Stone County, MS",2014-2015,17892,18070,178,0.995,51,127,28,131,H1
"Stone County, MS",2015-2016,18070,17951,-119,-0.659,19,-138,28,131,H1
"Stone County, MS",2016-2017,17951,18112,161,0.897,23,138,28,131,H1
"Sunflower County, MS",2000-2001,34249,34042,-207,-0.604,182,-389,28,133,H1
"Sunflower County, MS",2001-2002,34042,33676,-366,-1.075,183,-549,28,133,H1
"Sunflower County, MS",2002-2003,33676,33453,-223,-0.662,121,-344,28,133,H1
"Sunflower County, MS",2003-2004,33453,32349,-1104,-3.3,145,-1249,28,133,H1
"Sunflower County, MS",2004-2005,32349,31724,-625,-1.932,150,-775,28,133,H1
"Sunflower County, MS",2005-2006,31724,31464,-260,-0.82,172,-432,28,133,H1
"Sunflower County, MS",2006-2007,31464,31463,-1,-0.003,223,-224,28,133,H1
"Sunflower County, MS",2007-2008,31463,30614,-849,-2.698,105,-954,28,133,H1
"Sunflower County, MS",2008-2009,30614,29574,-1040,-3.397,105,-1145,28,133,H1
"Sunflower County, MS",2009-2010,29574,29023,-551,-1.863,96,-647,28,133,H1
"Sunflower County, MS",2010-2011,29023,28574,-449,-1.547,44,-493,28,133,H1
"Sunflower County, MS",2011-2012,28574,28473,-101,-0.353,66,-167,28,133,H1
"Sunflower County, MS",2012-2013,28473,28003,-470,-1.651,42,-512,28,133,H1
"Sunflower County, MS",2013-2014,28003,27496,-507,-1.811,33,-540,28,133,H1
"Sunflower County, MS",2014-2015,27509,27005,-504,-1.832,45,-549,28,133,H1
"Sunflower County, MS",2015-2016,27005,26389,-616,-2.281,-16,-600,28,133,H1
"Sunflower County, MS",2016-2017,26389,25981,-408,-1.546,-9,-399,28,133,H1
"Tallahatchie County, MS",2000-2001,14927,14981,54,0.362,50,4,28,135,H1
"Tallahatchie County, MS",2001-2002,14981,15025,44,0.294,49,-5,28,135,H1
"Tallahatchie County, MS",2002-2003,15025,15124,99,0.659,47,52,28,135,H1
"Tallahatchie County, MS",2003-2004,15124,15249,125,0.827,56,69,28,135,H1
"Tallahatchie County, MS",2004-2005,15249,15348,99,0.649,38,61,28,135,H1
"Tallahatchie County, MS",2005-2006,15348,15283,-65,-0.424,67,-132,28,135,H1
"Tallahatchie County, MS",2006-2007,15283,15231,-52,-0.34,91,-143,28,135,H1
"Tallahatchie County, MS",2007-2008,15231,15225,-6,-0.039,135,-141,28,135,H1
"Tallahatchie County, MS",2008-2009,15225,15266,41,0.269,52,-11,28,135,H1
"Tallahatchie County, MS",2009-2010,15266,15344,78,0.511,52,26,28,135,H1
"Tallahatchie County, MS",2010-2011,15344,15359,15,0.098,35,-20,28,135,H1
"Tallahatchie County, MS",2011-2012,15359,15103,-256,-1.667,-6,-250,28,135,H1
"Tallahatchie County, MS",2012-2013,15103,15051,-52,-0.344,7,-59,28,135,H1
"Tallahatchie County, MS",2013-2014,15051,14761,-290,-1.927,-15,-275,28,135,H1
"Tallahatchie County, MS",2014-2015,14736,14588,-148,-1.004,-5,-143,28,135,H1
"Tallahatchie County, MS",2015-2016,14588,14383,-205,-1.405,31,-236,28,135,H1
"Tallahatchie County, MS",2016-2017,14383,14125,-258,-1.794,-11,-247,28,135,H1
"Tate County, MS",2000-2001,25477,25653,176,0.691,140,36,28,137,H1
"Tate County, MS",2001-2002,25653,25776,123,0.479,122,1,28,137,H1
"Tate County, MS",2002-2003,25776,26134,358,1.389,159,199,28,137,H1
"Tate County, MS",2003-2004,26134,26599,465,1.779,140,325,28,137,H1
"Tate County, MS",2004-2005,26599,26968,369,1.387,146,223,28,137,H1
"Tate County, MS",2005-2006,26968,27473,505,1.873,136,369,28,137,H1
"Tate County, MS",2006-2007,27473,27803,330,1.201,178,152,28,137,H1
"Tate County, MS",2007-2008,27803,28222,419,1.507,147,272,28,137,H1
"Tate County, MS",2008-2009,28222,28509,287,1.017,134,153,28,137,H1
"Tate County, MS",2009-2010,28509,28992,483,1.694,120,363,28,137,H1
"Tate County, MS",2010-2011,28992,28734,-258,-0.89,81,-339,28,137,H1
"Tate County, MS",2011-2012,28734,28506,-228,-0.793,97,-325,28,137,H1
"Tate County, MS",2012-2013,28506,28349,-157,-0.551,37,-194,28,137,H1
"Tate County, MS",2013-2014,28349,28204,-145,-0.511,38,-183,28,137,H1
"Tate County, MS",2014-2015,28206,28296,90,0.319,2,88,28,137,H1
"Tate County, MS",2015-2016,28296,28246,-50,-0.177,60,-110,28,137,H1
"Tate County, MS",2016-2017,28246,28441,195,0.69,31,164,28,137,H1
"Tippah County, MS",2000-2001,20925,20979,54,0.258,68,-14,28,139,H1
"Tippah County, MS",2001-2002,20979,21066,87,0.415,41,46,28,139,H1
"Tippah County, MS",2002-2003,21066,21179,113,0.536,75,38,28,139,H1
"Tippah County, MS",2003-2004,21179,21261,82,0.387,75,7,28,139,H1
"Tippah County, MS",2004-2005,21261,21536,275,1.293,70,205,28,139,H1
"Tippah County, MS",2005-2006,21536,21688,152,0.706,110,42,28,139,H1
"Tippah County, MS",2006-2007,21688,21884,196,0.904,95,101,28,139,H1
"Tippah County, MS",2007-2008,21884,21982,98,0.448,87,11,28,139,H1
"Tippah County, MS",2008-2009,21982,22171,189,0.86,80,109,28,139,H1
"Tippah County, MS",2009-2010,22171,22187,16,0.072,66,-50,28,139,H1
"Tippah County, MS",2010-2011,22187,22067,-120,-0.541,2,-122,28,139,H1
"Tippah County, MS",2011-2012,22067,21965,-102,-0.462,0,-102,28,139,H1
"Tippah County, MS",2012-2013,21965,22086,121,0.551,25,96,28,139,H1
"Tippah County, MS",2013-2014,22086,22039,-47,-0.213,24,-71,28,139,H1
"Tippah County, MS",2014-2015,22054,22131,77,0.349,64,13,28,139,H1
"Tippah County, MS",2015-2016,22131,22045,-86,-0.389,16,-102,28,139,H1
"Tippah County, MS",2016-2017,22045,21969,-76,-0.345,25,-101,28,139,H1
"Tishomingo County, MS",2000-2001,19158,19020,-138,-0.72,-41,-97,28,141,H1
"Tishomingo County, MS",2001-2002,19020,19144,124,0.652,-56,180,28,141,H1
"Tishomingo County, MS",2002-2003,19144,19070,-74,-0.387,-23,-51,28,141,H1
"Tishomingo County, MS",2003-2004,19070,19145,75,0.393,-18,93,28,141,H1
"Tishomingo County, MS",2004-2005,19145,19232,87,0.454,-35,122,28,141,H1
"Tishomingo County, MS",2005-2006,19232,19424,192,0.998,-18,210,28,141,H1
"Tishomingo County, MS",2006-2007,19424,19581,157,0.808,0,157,28,141,H1
"Tishomingo County, MS",2007-2008,19581,19524,-57,-0.291,-23,-34,28,141,H1
"Tishomingo County, MS",2008-2009,19524,19552,28,0.143,-37,65,28,141,H1
"Tishomingo County, MS",2009-2010,19552,19594,42,0.215,-49,91,28,141,H1
"Tishomingo County, MS",2010-2011,19594,19595,1,0.005,-73,74,28,141,H1
"Tishomingo County, MS",2011-2012,19595,19589,-6,-0.031,-89,83,28,141,H1
"Tishomingo County, MS",2012-2013,19589,19461,-128,-0.653,-94,-34,28,141,H1
"Tishomingo County, MS",2013-2014,19461,19420,-41,-0.211,-96,55,28,141,H1
"Tishomingo County, MS",2014-2015,19452,19552,100,0.514,-77,177,28,141,H1
"Tishomingo County, MS",2015-2016,19552,19460,-92,-0.471,-69,-23,28,141,H1
"Tishomingo County, MS",2016-2017,19460,19542,82,0.421,-74,156,28,141,H1
"Tunica County, MS",2000-2001,9242,9416,174,1.883,84,90,28,143,H1
"Tunica County, MS",2001-2002,9416,9823,407,4.322,78,329,28,143,H1
"Tunica County, MS",2002-2003,9823,10142,319,3.247,115,204,28,143,H1
"Tunica County, MS",2003-2004,10142,10221,79,0.779,98,-19,28,143,H1
"Tunica County, MS",2004-2005,10221,10425,204,1.996,101,103,28,143,H1
"Tunica County, MS",2005-2006,10425,10723,298,2.859,106,192,28,143,H1
"Tunica County, MS",2006-2007,10723,10853,130,1.212,127,3,28,143,H1
"Tunica County, MS",2007-2008,10853,10910,57,0.525,168,-111,28,143,H1
"Tunica County, MS",2008-2009,10910,10862,-48,-0.44,87,-135,28,143,H1
"Tunica County, MS",2009-2010,10862,10760,-102,-0.939,93,-195,28,143,H1
"Tunica County, MS",2010-2011,10760,10587,-173,-1.608,59,-232,28,143,H1
"Tunica County, MS",2011-2012,10587,10458,-129,-1.218,106,-235,28,143,H1
"Tunica County, MS",2012-2013,10458,10512,54,0.516,137,-83,28,143,H1
"Tunica County, MS",2013-2014,10512,10598,86,0.818,124,-38,28,143,H1
"Tunica County, MS",2014-2015,10545,10343,-202,-1.916,105,-307,28,143,H1
"Tunica County, MS",2015-2016,10343,10156,-187,-1.808,88,-275,28,143,H1
"Tunica County, MS",2016-2017,10156,10024,-132,-1.3,90,-222,28,143,H1
"Union County, MS",2000-2001,25484,25649,165,0.647,122,43,28,145,H1
"Union County, MS",2001-2002,25649,25711,62,0.242,81,-19,28,145,H1
"Union County, MS",2002-2003,25711,25949,238,0.926,93,145,28,145,H1
"Union County, MS",2003-2004,25949,26076,127,0.489,72,55,28,145,H1
"Union County, MS",2004-2005,26076,26569,493,1.891,128,365,28,145,H1
"Union County, MS",2005-2006,26569,26762,193,0.726,107,86,28,145,H1
"Union County, MS",2006-2007,26762,26684,-78,-0.291,178,-256,28,145,H1
"Union County, MS",2007-2008,26684,26931,247,0.926,154,93,28,145,H1
"Union County, MS",2008-2009,26931,27070,139,0.516,129,10,28,145,H1
"Union County, MS",2009-2010,27070,27153,83,0.307,117,-34,28,145,H1
"Union County, MS",2010-2011,27153,27335,182,0.67,67,115,28,145,H1
"Union County, MS",2011-2012,27335,27352,17,0.062,59,-42,28,145,H1
"Union County, MS",2012-2013,27352,27745,393,1.437,156,237,28,145,H1
"Union County, MS",2013-2014,27745,28097,352,1.269,147,205,28,145,H1
"Union County, MS",2014-2015,28168,28429,261,0.927,177,84,28,145,H1
"Union County, MS",2015-2016,28429,28325,-104,-0.366,112,-216,28,145,H1
"Union County, MS",2016-2017,28325,28556,231,0.816,102,129,28,145,H1
"Walthall County, MS",2000-2001,15099,15114,15,0.099,38,-23,28,147,H1
"Walthall County, MS",2001-2002,15114,14988,-126,-0.834,47,-173,28,147,H1
"Walthall County, MS",2002-2003,14988,15049,61,0.407,55,6,28,147,H1
"Walthall County, MS",2003-2004,15049,15104,55,0.365,71,-16,28,147,H1
"Walthall County, MS",2004-2005,15104,15081,-23,-0.152,19,-42,28,147,H1
"Walthall County, MS",2005-2006,15081,15594,513,3.402,62,451,28,147,H1
"Walthall County, MS",2006-2007,15594,15515,-79,-0.507,104,-183,28,147,H1
"Walthall County, MS",2007-2008,15515,15622,107,0.69,37,70,28,147,H1
"Walthall County, MS",2008-2009,15622,15505,-117,-0.749,29,-146,28,147,H1
"Walthall County, MS",2009-2010,15505,15401,-104,-0.671,26,-130,28,147,H1
"Walthall County, MS",2010-2011,15401,15381,-20,-0.13,24,-44,28,147,H1
"Walthall County, MS",2011-2012,15381,15088,-293,-1.905,12,-305,28,147,H1
"Walthall County, MS",2012-2013,15088,14903,-185,-1.226,22,-207,28,147,H1
"Walthall County, MS",2013-2014,14903,14859,-44,-0.295,-27,-17,28,147,H1
"Walthall County, MS",2014-2015,14878,14638,-240,-1.613,-4,-236,28,147,H1
"Walthall County, MS",2015-2016,14638,14570,-68,-0.465,-2,-66,28,147,H1
"Walthall County, MS",2016-2017,14570,14499,-71,-0.487,-12,-59,28,147,H1
"Warren County, MS",2000-2001,49598,49292,-306,-0.617,284,-590,28,149,H1
"Warren County, MS",2001-2002,49292,49115,-177,-0.359,205,-382,28,149,H1
"Warren County, MS",2002-2003,49115,48946,-169,-0.344,210,-379,28,149,H1
"Warren County, MS",2003-2004,48946,49092,146,0.298,259,-113,28,149,H1
"Warren County, MS",2004-2005,49092,48836,-256,-0.521,256,-512,28,149,H1
"Warren County, MS",2005-2006,48836,49440,604,1.237,253,351,28,149,H1
"Warren County, MS",2006-2007,49440,49163,-277,-0.56,340,-617,28,149,H1
"Warren County, MS",2007-2008,49163,48457,-706,-1.436,236,-942,28,149,H1
"Warren County, MS",2008-2009,48457,48548,91,0.188,254,-163,28,149,H1
"Warren County, MS",2009-2010,48548,48812,264,0.544,255,9,28,149,H1
"Warren County, MS",2010-2011,48812,48253,-559,-1.145,88,-647,28,149,H1
"Warren County, MS",2011-2012,48253,48120,-133,-0.276,149,-282,28,149,H1
"Warren County, MS",2012-2013,48120,48286,166,0.345,128,38,28,149,H1
"Warren County, MS",2013-2014,48286,47983,-303,-0.628,123,-426,28,149,H1
"Warren County, MS",2014-2015,47966,47485,-481,-1.003,105,-586,28,149,H1
"Warren County, MS",2015-2016,47485,47041,-444,-0.935,67,-511,28,149,H1
"Warren County, MS",2016-2017,47041,46768,-273,-0.58,62,-335,28,149,H1
"Washington County, MS",2000-2001,62657,61221,-1436,-2.292,432,-1868,28,151,H1
"Washington County, MS",2001-2002,61221,59570,-1651,-2.697,352,-2003,28,151,H1
"Washington County, MS",2002-2003,59570,58072,-1498,-2.515,334,-1832,28,151,H1
"Washington County, MS",2003-2004,58072,56802,-1270,-2.187,318,-1588,28,151,H1
"Washington County, MS",2004-2005,56802,55872,-930,-1.637,290,-1220,28,151,H1
"Washington County, MS",2005-2006,55872,54325,-1547,-2.769,322,-1869,28,151,H1
"Washington County, MS",2006-2007,54325,53069,-1256,-2.312,401,-1657,28,151,H1
"Washington County, MS",2007-2008,53069,52236,-833,-1.57,362,-1195,28,151,H1
"Washington County, MS",2008-2009,52236,51565,-671,-1.285,289,-960,28,151,H1
"Washington County, MS",2009-2010,51565,51093,-472,-0.915,267,-739,28,151,H1
"Washington County, MS",2010-2011,51093,50450,-643,-1.258,236,-879,28,151,H1
"Washington County, MS",2011-2012,50450,50051,-399,-0.791,235,-634,28,151,H1
"Washington County, MS",2012-2013,50051,49638,-413,-0.825,154,-567,28,151,H1
"Washington County, MS",2013-2014,49638,48958,-680,-1.37,101,-781,28,151,H1
"Washington County, MS",2014-2015,49135,48130,-1005,-2.045,151,-1156,28,151,H1
"Washington County, MS",2015-2016,48130,47191,-939,-1.951,89,-1028,28,151,H1
"Washington County, MS",2016-2017,47191,46221,-970,-2.055,41,-1011,28,151,H1
"Wayne County, MS",2000-2001,21342,21258,-84,-0.394,110,-194,28,153,H1
"Wayne County, MS",2001-2002,21258,21260,2,0.009,104,-102,28,153,H1
"Wayne County, MS",2002-2003,21260,21135,-125,-0.588,85,-210,28,153,H1
"Wayne County, MS",2003-2004,21135,21069,-66,-0.312,115,-181,28,153,H1
"Wayne County, MS",2004-2005,21069,21021,-48,-0.228,46,-94,28,153,H1
"Wayne County, MS",2005-2006,21021,21111,90,0.428,141,-51,28,153,H1
"Wayne County, MS",2006-2007,21111,21276,165,0.782,162,3,28,153,H1
"Wayne County, MS",2007-2008,21276,20963,-313,-1.471,100,-413,28,153,H1
"Wayne County, MS",2008-2009,20963,20763,-200,-0.954,44,-244,28,153,H1
"Wayne County, MS",2009-2010,20763,20771,8,0.039,65,-57,28,153,H1
"Wayne County, MS",2010-2011,20771,20649,-122,-0.587,98,-220,28,153,H1
"Wayne County, MS",2011-2012,20649,20635,-14,-0.068,53,-67,28,153,H1
"Wayne County, MS",2012-2013,20635,20508,-127,-0.615,60,-187,28,153,H1
"Wayne County, MS",2013-2014,20508,20490,-18,-0.088,67,-85,28,153,H1
"Wayne County, MS",2014-2015,20516,20566,50,0.244,105,-55,28,153,H1
"Wayne County, MS",2015-2016,20566,20450,-116,-0.564,58,-174,28,153,H1
"Wayne County, MS",2016-2017,20450,20446,-4,-0.02,86,-90,28,153,H1
"Webster County, MS",2000-2001,10282,10250,-32,-0.311,-6,-26,28,155,H1
"Webster County, MS",2001-2002,10250,10213,-37,-0.361,7,-44,28,155,H1
"Webster County, MS",2002-2003,10213,10044,-169,-1.655,-21,-148,28,155,H1
"Webster County, MS",2003-2004,10044,10057,13,0.129,16,-3,28,155,H1
"Webster County, MS",2004-2005,10057,9979,-78,-0.776,-27,-51,28,155,H1
"Webster County, MS",2005-2006,9979,10022,43,0.431,8,35,28,155,H1
"Webster County, MS",2006-2007,10022,10035,13,0.13,-8,21,28,155,H1
"Webster County, MS",2007-2008,10035,10204,169,1.684,-17,186,28,155,H1
"Webster County, MS",2008-2009,10204,10164,-40,-0.392,8,-48,28,155,H1
"Webster County, MS",2009-2010,10164,10283,119,1.171,-1,120,28,155,H1
"Webster County, MS",2010-2011,10283,10128,-155,-1.507,3,-158,28,155,H1
"Webster County, MS",2011-2012,10128,10051,-77,-0.76,-1,-76,28,155,H1
"Webster County, MS",2012-2013,10051,9949,-102,-1.015,-20,-82,28,155,H1
"Webster County, MS",2013-2014,9949,9972,23,0.231,-14,37,28,155,H1
"Webster County, MS",2014-2015,9975,9899,-76,-0.762,-14,-62,28,155,H1
"Webster County, MS",2015-2016,9899,9777,-122,-1.232,0,-122,28,155,H1
"Webster County, MS",2016-2017,9777,9765,-12,-0.123,-19,7,28,155,H1
"Wilkinson County, MS",2000-2001,10307,10280,-27,-0.262,9,-36,28,157,H1
"Wilkinson County, MS",2001-2002,10280,10266,-14,-0.136,-16,2,28,157,H1
"Wilkinson County, MS",2002-2003,10266,10283,17,0.166,-33,50,28,157,H1
"Wilkinson County, MS",2003-2004,10283,10185,-98,-0.953,48,-146,28,157,H1
"Wilkinson County, MS",2004-2005,10185,10123,-62,-0.609,5,-67,28,157,H1
"Wilkinson County, MS",2005-2006,10123,10306,183,1.808,1,182,28,157,H1
"Wilkinson County, MS",2006-2007,10306,10142,-164,-1.591,36,-200,28,157,H1
"Wilkinson County, MS",2007-2008,10142,10061,-81,-0.799,17,-98,28,157,H1
"Wilkinson County, MS",2008-2009,10061,9994,-67,-0.666,-5,-62,28,157,H1
"Wilkinson County, MS",2009-2010,9994,9852,-142,-1.421,-4,-138,28,157,H1
"Wilkinson County, MS",2010-2011,9852,9571,-281,-2.852,12,-293,28,157,H1
"Wilkinson County, MS",2011-2012,9571,9451,-120,-1.254,5,-125,28,157,H1
"Wilkinson County, MS",2012-2013,9451,9338,-113,-1.196,6,-119,28,157,H1
"Wilkinson County, MS",2013-2014,9338,9191,-147,-1.574,-23,-124,28,157,H1
"Wilkinson County, MS",2014-2015,9216,9122,-94,-1.02,-8,-86,28,157,H1
"Wilkinson County, MS",2015-2016,9122,9008,-114,-1.25,-26,-88,28,157,H1
"Wilkinson County, MS",2016-2017,9008,8804,-204,-2.265,-34,-170,28,157,H1
"Winston County, MS",2000-2001,20152,20031,-121,-0.6,61,-182,28,159,H1
"Winston County, MS",2001-2002,20031,19860,-171,-0.854,39,-210,28,159,H1
"Winston County, MS",2002-2003,19860,19796,-64,-0.322,46,-110,28,159,H1
"Winston County, MS",2003-2004,19796,19715,-81,-0.409,54,-135,28,159,H1
"Winston County, MS",2004-2005,19715,19583,-132,-0.67,78,-210,28,159,H1
"Winston County, MS",2005-2006,19583,19538,-45,-0.23,36,-81,28,159,H1
"Winston County, MS",2006-2007,19538,19606,68,0.348,111,-43,28,159,H1
"Winston County, MS",2007-2008,19606,19342,-264,-1.347,28,-292,28,159,H1
"Winston County, MS",2008-2009,19342,19211,-131,-0.677,24,-155,28,159,H1
"Winston County, MS",2009-2010,19211,19197,-14,-0.073,63,-77,28,159,H1
"Winston County, MS",2010-2011,19197,19024,-173,-0.901,-13,-160,28,159,H1
"Winston County, MS",2011-2012,19024,18985,-39,-0.205,-19,-20,28,159,H1
"Winston County, MS",2012-2013,18985,18727,-258,-1.359,-41,-217,28,159,H1
"Winston County, MS",2013-2014,18727,18478,-249,-1.33,-53,-196,28,159,H1
"Winston County, MS",2014-2015,18480,18317,-163,-0.882,-21,-142,28,159,H1
"Winston County, MS",2015-2016,18317,18360,43,0.235,-12,55,28,159,H1
"Winston County, MS",2016-2017,18360,18246,-114,-0.621,-27,-87,28,159,H1
"Yalobusha County, MS",2000-2001,13125,13265,140,1.067,47,93,28,161,H1
"Yalobusha County, MS",2001-2002,13265,13139,-126,-0.95,33,-159,28,161,H1
"Yalobusha County, MS",2002-2003,13139,13089,-50,-0.381,16,-66,28,161,H1
"Yalobusha County, MS",2003-2004,13089,12961,-128,-0.978,29,-157,28,161,H1
"Yalobusha County, MS",2004-2005,12961,12979,18,0.139,47,-29,28,161,H1
"Yalobusha County, MS",2005-2006,12979,12976,-3,-0.023,58,-61,28,161,H1
"Yalobusha County, MS",2006-2007,12976,13036,60,0.462,50,10,28,161,H1
"Yalobusha County, MS",2007-2008,13036,12857,-179,-1.373,28,-207,28,161,H1
"Yalobusha County, MS",2008-2009,12857,12827,-30,-0.233,15,-45,28,161,H1
"Yalobusha County, MS",2009-2010,12827,12648,-179,-1.395,12,-191,28,161,H1
"Yalobusha County, MS",2010-2011,12648,12510,-138,-1.091,-1,-137,28,161,H1
"Yalobusha County, MS",2011-2012,12510,12373,-137,-1.095,-17,-120,28,161,H1
"Yalobusha County, MS",2012-2013,12373,12358,-15,-0.121,-15,0,28,161,H1
"Yalobusha County, MS",2013-2014,12358,12276,-82,-0.664,-28,-54,28,161,H1
"Yalobusha County, MS",2014-2015,12272,12447,175,1.426,-12,187,28,161,H1
"Yalobusha County, MS",2015-2016,12447,12489,42,0.337,18,24,28,161,H1
"Yalobusha County, MS",2016-2017,12489,12497,8,0.064,-13,21,28,161,H1
"Yazoo County, MS",2000-2001,28119,27764,-355,-1.262,101,-456,28,163,H1
"Yazoo County, MS",2001-2002,27764,27735,-29,-0.104,135,-164,28,163,H1
"Yazoo County, MS",2002-2003,27735,27932,197,0.71,149,48,28,163,H1
"Yazoo County, MS",2003-2004,27932,27963,31,0.111,107,-76,28,163,H1
"Yazoo County, MS",2004-2005,27963,28107,144,0.515,190,-46,28,163,H1
"Yazoo County, MS",2005-2006,28107,28714,607,2.16,151,456,28,163,H1
"Yazoo County, MS",2006-2007,28714,28641,-73,-0.254,235,-308,28,163,H1
"Yazoo County, MS",2007-2008,28641,28441,-200,-0.698,175,-375,28,163,H1
"Yazoo County, MS",2008-2009,28441,28201,-240,-0.844,146,-386,28,163,H1
"Yazoo County, MS",2009-2010,28201,28096,-105,-0.372,139,-244,28,163,H1
"Yazoo County, MS",2010-2011,28096,28232,136,0.484,154,-18,28,163,H1
"Yazoo County, MS",2011-2012,28232,28282,50,0.177,118,-68,28,163,H1
"Yazoo County, MS",2012-2013,28282,27955,-327,-1.156,90,-417,28,163,H1
"Yazoo County, MS",2013-2014,27955,27817,-138,-0.494,122,-260,28,163,H1
"Yazoo County, MS",2014-2015,27759,27387,-372,-1.34,95,-467,28,163,H1
"Yazoo County, MS",2015-2016,27387,27206,-181,-0.661,-15,-166,28,163,H1
"Yazoo County, MS",2016-2017,27206,27057,-149,-0.548,28,-177,28,163,H1
Missouri,2000-2001,5607285,5641142,33857,0.604,20834,13023,29,0,STATE
Missouri,2001-2002,5641142,5674825,33683,0.597,19680,14003,29,0,STATE
Missouri,2002-2003,5674825,5709403,34578,0.609,20750,13828,29,0,STATE
Missouri,2003-2004,5709403,5747741,38338,0.671,22569,15769,29,0,STATE
Missouri,2004-2005,5747741,5790300,42559,0.74,23548,19011,29,0,STATE
Missouri,2005-2006,5790300,5842704,52404,0.905,25250,27154,29,0,STATE
Missouri,2006-2007,5842704,5887612,44908,0.769,27497,17411,29,0,STATE
Missouri,2007-2008,5887612,5923916,36304,0.617,26999,9305,29,0,STATE
Missouri,2008-2009,5923916,5961088,37172,0.627,25416,11756,29,0,STATE
Missouri,2009-2010,5961088,5996052,34964,0.587,24767,10197,29,0,STATE
Missouri,2010-2011,5996052,6010587,14535,0.242,20262,-5727,29,0,STATE
Missouri,2011-2012,6010587,6025468,14881,0.248,19797,-4916,29,0,STATE
Missouri,2012-2013,6025468,6043708,18240,0.303,17601,639,29,0,STATE
Missouri,2013-2014,6043708,6063827,20119,0.333,19209,910,29,0,STATE
Missouri,2014-2015,6063827,6083672,19845,0.327,19068,777,29,0,STATE
Missouri,2015-2016,6083672,6091176,7504,0.123,15863,-8359,29,0,STATE
Missouri,2016-2017,6091176,6113532,22356,0.367,15408,6948,29,0,STATE
"Adair County, MO",2000-2001,24956,24967,11,0.044,52,-41,29,1,H1
"Adair County, MO",2001-2002,24967,25072,105,0.421,52,53,29,1,H1
"Adair County, MO",2002-2003,25072,24958,-114,-0.455,52,-166,29,1,H1
"Adair County, MO",2003-2004,24958,24988,30,0.12,74,-44,29,1,H1
"Adair County, MO",2004-2005,24988,24849,-139,-0.556,46,-185,29,1,H1
"Adair County, MO",2005-2006,24849,25007,158,0.636,54,104,29,1,H1
"Adair County, MO",2006-2007,25007,24983,-24,-0.096,101,-125,29,1,H1
"Adair County, MO",2007-2008,24983,25399,416,1.665,127,289,29,1,H1
"Adair County, MO",2008-2009,25399,25577,178,0.701,102,76,29,1,H1
"Adair County, MO",2009-2010,25577,25619,42,0.164,49,-7,29,1,H1
"Adair County, MO",2010-2011,25619,25607,-12,-0.047,39,-51,29,1,H1
"Adair County, MO",2011-2012,25607,25671,64,0.25,55,9,29,1,H1
"Adair County, MO",2012-2013,25671,25713,42,0.164,32,10,29,1,H1
"Adair County, MO",2013-2014,25713,25602,-111,-0.432,60,-171,29,1,H1
"Adair County, MO",2014-2015,25530,25378,-152,-0.595,39,-191,29,1,H1
"Adair County, MO",2015-2016,25378,25223,-155,-0.611,59,-214,29,1,H1
"Adair County, MO",2016-2017,25223,25377,154,0.611,69,85,29,1,H1
"Andrew County, MO",2000-2001,16522,16580,58,0.351,12,46,29,3,H1
"Andrew County, MO",2001-2002,16580,16501,-79,-0.476,-3,-76,29,3,H1
"Andrew County, MO",2002-2003,16501,16608,107,0.648,32,75,29,3,H1
"Andrew County, MO",2003-2004,16608,16580,-28,-0.169,13,-41,29,3,H1
"Andrew County, MO",2004-2005,16580,16511,-69,-0.416,15,-84,29,3,H1
"Andrew County, MO",2005-2006,16511,16861,350,2.12,-7,357,29,3,H1
"Andrew County, MO",2006-2007,16861,16834,-27,-0.16,22,-49,29,3,H1
"Andrew County, MO",2007-2008,16834,16924,90,0.535,23,67,29,3,H1
"Andrew County, MO",2008-2009,16924,17036,112,0.662,36,76,29,3,H1
"Andrew County, MO",2009-2010,17036,17349,313,1.837,34,279,29,3,H1
"Andrew County, MO",2010-2011,17349,17295,-54,-0.311,34,-88,29,3,H1
"Andrew County, MO",2011-2012,17295,17420,125,0.723,14,111,29,3,H1
"Andrew County, MO",2012-2013,17420,17420,0,0,5,-5,29,3,H1
"Andrew County, MO",2013-2014,17420,17379,-41,-0.235,12,-53,29,3,H1
"Andrew County, MO",2014-2015,17322,17296,-26,-0.15,17,-43,29,3,H1
"Andrew County, MO",2015-2016,17296,17339,43,0.249,-18,61,29,3,H1
"Andrew County, MO",2016-2017,17339,17555,216,1.246,28,188,29,3,H1
"Atchison County, MO",2000-2001,6389,6344,-45,-0.704,-29,-16,29,5,H1
"Atchison County, MO",2001-2002,6344,6189,-155,-2.443,-41,-114,29,5,H1
"Atchison County, MO",2002-2003,6189,6193,4,0.065,-21,25,29,5,H1
"Atchison County, MO",2003-2004,6193,6153,-40,-0.646,-23,-17,29,5,H1
"Atchison County, MO",2004-2005,6153,6053,-100,-1.625,-24,-76,29,5,H1
"Atchison County, MO",2005-2006,6053,5908,-145,-2.396,-6,-139,29,5,H1
"Atchison County, MO",2006-2007,5908,5909,1,0.017,-5,6,29,5,H1
"Atchison County, MO",2007-2008,5909,5798,-111,-1.878,-28,-83,29,5,H1
"Atchison County, MO",2008-2009,5798,5781,-17,-0.293,-25,8,29,5,H1
"Atchison County, MO",2009-2010,5781,5659,-122,-2.11,-11,-111,29,5,H1
"Atchison County, MO",2010-2011,5659,5595,-64,-1.131,-31,-33,29,5,H1
"Atchison County, MO",2011-2012,5595,5532,-63,-1.126,-37,-26,29,5,H1
"Atchison County, MO",2012-2013,5532,5433,-99,-1.79,-9,-90,29,5,H1
"Atchison County, MO",2013-2014,5433,5382,-51,-0.939,-26,-25,29,5,H1
"Atchison County, MO",2014-2015,5371,5306,-65,-1.21,-14,-51,29,5,H1
"Atchison County, MO",2015-2016,5306,5310,4,0.075,-3,7,29,5,H1
"Atchison County, MO",2016-2017,5310,5275,-35,-0.659,-21,-14,29,5,H1
"Audrain County, MO",2000-2001,25862,25784,-78,-0.302,126,-204,29,7,H1
"Audrain County, MO",2001-2002,25784,25800,16,0.062,64,-48,29,7,H1
"Audrain County, MO",2002-2003,25800,25728,-72,-0.279,54,-126,29,7,H1
"Audrain County, MO",2003-2004,25728,25555,-173,-0.672,88,-261,29,7,H1
"Audrain County, MO",2004-2005,25555,25725,170,0.665,90,80,29,7,H1
"Audrain County, MO",2005-2006,25725,25869,144,0.56,114,30,29,7,H1
"Audrain County, MO",2006-2007,25869,25658,-211,-0.816,75,-286,29,7,H1
"Audrain County, MO",2007-2008,25658,25774,116,0.452,110,6,29,7,H1
"Audrain County, MO",2008-2009,25774,25628,-146,-0.566,114,-260,29,7,H1
"Audrain County, MO",2009-2010,25628,25461,-167,-0.652,109,-276,29,7,H1
"Audrain County, MO",2010-2011,25461,25593,132,0.518,83,49,29,7,H1
"Audrain County, MO",2011-2012,25593,25610,17,0.066,46,-29,29,7,H1
"Audrain County, MO",2012-2013,25610,25635,25,0.098,47,-22,29,7,H1
"Audrain County, MO",2013-2014,25635,25887,252,0.983,28,224,29,7,H1
"Audrain County, MO",2014-2015,25935,26096,161,0.621,74,87,29,7,H1
"Audrain County, MO",2015-2016,26096,25875,-221,-0.847,42,-263,29,7,H1
"Audrain County, MO",2016-2017,25875,25641,-234,-0.904,72,-306,29,7,H1
"Barry County, MO",2000-2001,33971,33981,10,0.029,129,-119,29,9,H1
"Barry County, MO",2001-2002,33981,34111,130,0.383,93,37,29,9,H1
"Barry County, MO",2002-2003,34111,34555,444,1.302,107,337,29,9,H1
"Barry County, MO",2003-2004,34555,34849,294,0.851,76,218,29,9,H1
"Barry County, MO",2004-2005,34849,35241,392,1.125,146,246,29,9,H1
"Barry County, MO",2005-2006,35241,35756,515,1.461,135,380,29,9,H1
"Barry County, MO",2006-2007,35756,35844,88,0.246,176,-88,29,9,H1
"Barry County, MO",2007-2008,35844,35935,91,0.254,121,-30,29,9,H1
"Barry County, MO",2008-2009,35935,35640,-295,-0.821,94,-389,29,9,H1
"Barry County, MO",2009-2010,35640,35777,137,0.384,105,32,29,9,H1
"Barry County, MO",2010-2011,35777,35660,-117,-0.327,23,-140,29,9,H1
"Barry County, MO",2011-2012,35660,35646,-14,-0.039,44,-58,29,9,H1
"Barry County, MO",2012-2013,35646,35660,14,0.039,18,-4,29,9,H1
"Barry County, MO",2013-2014,35660,35662,2,0.006,43,-41,29,9,H1
"Barry County, MO",2014-2015,35758,35829,71,0.199,31,40,29,9,H1
"Barry County, MO",2015-2016,35829,35339,-490,-1.368,30,-520,29,9,H1
"Barry County, MO",2016-2017,35339,35668,329,0.931,17,312,29,9,H1
"Barton County, MO",2000-2001,12542,12684,142,1.132,34,108,29,11,H1
"Barton County, MO",2001-2002,12684,12780,96,0.757,42,54,29,11,H1
"Barton County, MO",2002-2003,12780,12924,144,1.127,38,106,29,11,H1
"Barton County, MO",2003-2004,12924,12941,17,0.132,22,-5,29,11,H1
"Barton County, MO",2004-2005,12941,12976,35,0.27,7,28,29,11,H1
"Barton County, MO",2005-2006,12976,12972,-4,-0.031,37,-41,29,11,H1
"Barton County, MO",2006-2007,12972,12769,-203,-1.565,64,-267,29,11,H1
"Barton County, MO",2007-2008,12769,12589,-180,-1.41,20,-200,29,11,H1
"Barton County, MO",2008-2009,12589,12454,-135,-1.072,14,-149,29,11,H1
"Barton County, MO",2009-2010,12454,12381,-73,-0.586,7,-80,29,11,H1
"Barton County, MO",2010-2011,12381,12382,1,0.008,19,-18,29,11,H1
"Barton County, MO",2011-2012,12382,12365,-17,-0.137,12,-29,29,11,H1
"Barton County, MO",2012-2013,12365,12247,-118,-0.954,-4,-114,29,11,H1
"Barton County, MO",2013-2014,12247,12057,-190,-1.551,12,-202,29,11,H1
"Barton County, MO",2014-2015,12019,11880,-139,-1.157,16,-155,29,11,H1
"Barton County, MO",2015-2016,11880,11859,-21,-0.177,4,-25,29,11,H1
"Barton County, MO",2016-2017,11859,11850,-9,-0.076,19,-28,29,11,H1
"Bates County, MO",2000-2001,16700,16801,101,0.605,-11,112,29,13,H1
"Bates County, MO",2001-2002,16801,17009,208,1.238,-16,224,29,13,H1
"Bates County, MO",2002-2003,17009,17109,100,0.588,13,87,29,13,H1
"Bates County, MO",2003-2004,17109,17088,-21,-0.123,29,-50,29,13,H1
"Bates County, MO",2004-2005,17088,17117,29,0.17,17,12,29,13,H1
"Bates County, MO",2005-2006,17117,17193,76,0.444,24,52,29,13,H1
"Bates County, MO",2006-2007,17193,17189,-4,-0.023,29,-33,29,13,H1
"Bates County, MO",2007-2008,17189,17194,5,0.029,7,-2,29,13,H1
"Bates County, MO",2008-2009,17194,17044,-150,-0.872,29,-179,29,13,H1
"Bates County, MO",2009-2010,17044,17047,3,0.018,8,-5,29,13,H1
"Bates County, MO",2010-2011,17047,17028,-19,-0.111,-29,10,29,13,H1
"Bates County, MO",2011-2012,17028,16709,-319,-1.873,-7,-312,29,13,H1
"Bates County, MO",2012-2013,16709,16531,-178,-1.065,-9,-169,29,13,H1
"Bates County, MO",2013-2014,16531,16584,53,0.321,-4,57,29,13,H1
"Bates County, MO",2014-2015,16562,16446,-116,-0.7,8,-124,29,13,H1
"Bates County, MO",2015-2016,16446,16371,-75,-0.456,-17,-58,29,13,H1
"Bates County, MO",2016-2017,16371,16334,-37,-0.226,-11,-26,29,13,H1
"Benton County, MO",2000-2001,17202,17399,197,1.145,-107,304,29,15,H1
"Benton County, MO",2001-2002,17399,17588,189,1.086,-83,272,29,15,H1
"Benton County, MO",2002-2003,17588,17996,408,2.32,-101,509,29,15,H1
"Benton County, MO",2003-2004,17996,18336,340,1.889,-84,424,29,15,H1
"Benton County, MO",2004-2005,18336,18688,352,1.92,-89,441,29,15,H1
"Benton County, MO",2005-2006,18688,18749,61,0.326,-123,184,29,15,H1
"Benton County, MO",2006-2007,18749,19025,276,1.472,-86,362,29,15,H1
"Benton County, MO",2007-2008,19025,19046,21,0.11,-123,144,29,15,H1
"Benton County, MO",2008-2009,19046,18996,-50,-0.263,-95,45,29,15,H1
"Benton County, MO",2009-2010,18996,19119,123,0.648,-97,220,29,15,H1
"Benton County, MO",2010-2011,19119,19028,-91,-0.476,-77,-14,29,15,H1
"Benton County, MO",2011-2012,19028,18958,-70,-0.368,-150,80,29,15,H1
"Benton County, MO",2012-2013,18958,18895,-63,-0.332,-135,72,29,15,H1
"Benton County, MO",2013-2014,18895,18806,-89,-0.471,-138,49,29,15,H1
"Benton County, MO",2014-2015,18775,18670,-105,-0.559,-139,34,29,15,H1
"Benton County, MO",2015-2016,18670,18921,251,1.344,-152,403,29,15,H1
"Benton County, MO",2016-2017,18921,19074,153,0.809,-126,279,29,15,H1
"Bollinger County, MO",2000-2001,12047,12294,247,2.05,0,247,29,17,H1
"Bollinger County, MO",2001-2002,12294,12367,73,0.594,33,40,29,17,H1
"Bollinger County, MO",2002-2003,12367,12400,33,0.267,46,-13,29,17,H1
"Bollinger County, MO",2003-2004,12400,12427,27,0.218,-9,36,29,17,H1
"Bollinger County, MO",2004-2005,12427,12466,39,0.314,7,32,29,17,H1
"Bollinger County, MO",2005-2006,12466,12496,30,0.241,11,19,29,17,H1
"Bollinger County, MO",2006-2007,12496,12554,58,0.464,39,19,29,17,H1
"Bollinger County, MO",2007-2008,12554,12429,-125,-0.996,28,-153,29,17,H1
"Bollinger County, MO",2008-2009,12429,12412,-17,-0.137,23,-40,29,17,H1
"Bollinger County, MO",2009-2010,12412,12345,-67,-0.54,18,-85,29,17,H1
"Bollinger County, MO",2010-2011,12345,12384,39,0.316,10,29,29,17,H1
"Bollinger County, MO",2011-2012,12384,12405,21,0.17,36,-15,29,17,H1
"Bollinger County, MO",2012-2013,12405,12444,39,0.314,-15,54,29,17,H1
"Bollinger County, MO",2013-2014,12444,12394,-50,-0.402,15,-65,29,17,H1
"Bollinger County, MO",2014-2015,12373,12182,-191,-1.544,4,-195,29,17,H1
"Bollinger County, MO",2015-2016,12182,12204,22,0.181,-4,26,29,17,H1
"Bollinger County, MO",2016-2017,12204,12306,102,0.836,-15,117,29,17,H1
"Boone County, MO",2000-2001,135940,138181,2241,1.649,915,1326,29,19,H1
"Boone County, MO",2001-2002,138181,140695,2514,1.819,889,1625,29,19,H1
"Boone County, MO",2002-2003,140695,143019,2324,1.652,975,1349,29,19,H1
"Boone County, MO",2003-2004,143019,145348,2329,1.628,1029,1300,29,19,H1
"Boone County, MO",2004-2005,145348,148786,3438,2.365,1144,2294,29,19,H1
"Boone County, MO",2005-2006,148786,152784,3998,2.687,1112,2886,29,19,H1
"Boone County, MO",2006-2007,152784,155666,2882,1.886,1195,1687,29,19,H1
"Boone County, MO",2007-2008,155666,158089,2423,1.557,1202,1221,29,19,H1
"Boone County, MO",2008-2009,158089,160565,2476,1.566,1178,1298,29,19,H1
"Boone County, MO",2009-2010,160565,163182,2617,1.63,1181,1436,29,19,H1
"Boone County, MO",2010-2011,163182,165922,2740,1.679,1127,1613,29,19,H1
"Boone County, MO",2011-2012,165922,168592,2670,1.609,1165,1505,29,19,H1
"Boone County, MO",2012-2013,168592,170929,2337,1.386,1117,1220,29,19,H1
"Boone County, MO",2013-2014,170929,172717,1788,1.046,1157,631,29,19,H1
"Boone County, MO",2014-2015,173019,174974,1955,1.13,1172,783,29,19,H1
"Boone County, MO",2015-2016,174974,176555,1581,0.904,1130,451,29,19,H1
"Boone County, MO",2016-2017,176555,178271,1716,0.972,1017,699,29,19,H1
"Buchanan County, MO",2000-2001,86192,86026,-166,-0.193,138,-304,29,21,H1
"Buchanan County, MO",2001-2002,86026,86027,1,0.001,213,-212,29,21,H1
"Buchanan County, MO",2002-2003,86027,85887,-140,-0.163,182,-322,29,21,H1
"Buchanan County, MO",2003-2004,85887,86039,152,0.177,192,-40,29,21,H1
"Buchanan County, MO",2004-2005,86039,86378,339,0.394,198,141,29,21,H1
"Buchanan County, MO",2005-2006,86378,86543,165,0.191,242,-77,29,21,H1
"Buchanan County, MO",2006-2007,86543,87740,1197,1.383,371,826,29,21,H1
"Buchanan County, MO",2007-2008,87740,88317,577,0.658,444,133,29,21,H1
"Buchanan County, MO",2008-2009,88317,89233,916,1.037,304,612,29,21,H1
"Buchanan County, MO",2009-2010,89233,89095,-138,-0.155,369,-507,29,21,H1
"Buchanan County, MO",2010-2011,89095,89583,488,0.548,241,247,29,21,H1
"Buchanan County, MO",2011-2012,89583,89779,196,0.219,255,-59,29,21,H1
"Buchanan County, MO",2012-2013,89779,89738,-41,-0.046,231,-272,29,21,H1
"Buchanan County, MO",2013-2014,89738,89486,-252,-0.281,298,-550,29,21,H1
"Buchanan County, MO",2014-2015,89525,89100,-425,-0.475,247,-672,29,21,H1
"Buchanan County, MO",2015-2016,89100,89354,254,0.285,273,-19,29,21,H1
"Buchanan County, MO",2016-2017,89354,89065,-289,-0.323,268,-557,29,21,H1
"Butler County, MO",2000-2001,40826,40837,11,0.027,49,-38,29,23,H1
"Butler County, MO",2001-2002,40837,41068,231,0.566,17,214,29,23,H1
"Butler County, MO",2002-2003,41068,41131,63,0.153,-62,125,29,23,H1
"Butler County, MO",2003-2004,41131,41476,345,0.839,29,316,29,23,H1
"Butler County, MO",2004-2005,41476,41995,519,1.251,84,435,29,23,H1
"Butler County, MO",2005-2006,41995,42246,251,0.598,44,207,29,23,H1
"Butler County, MO",2006-2007,42246,42109,-137,-0.324,42,-179,29,23,H1
"Butler County, MO",2007-2008,42109,42351,242,0.575,100,142,29,23,H1
"Butler County, MO",2008-2009,42351,42683,332,0.784,77,255,29,23,H1
"Butler County, MO",2009-2010,42683,42809,126,0.295,24,102,29,23,H1
"Butler County, MO",2010-2011,42809,42999,190,0.444,-25,215,29,23,H1
"Butler County, MO",2011-2012,42999,43012,13,0.03,65,-52,29,23,H1
"Butler County, MO",2012-2013,43012,42992,-20,-0.046,56,-76,29,23,H1
"Butler County, MO",2013-2014,42992,42972,-20,-0.047,52,-72,29,23,H1
"Butler County, MO",2014-2015,42887,42951,64,0.149,19,45,29,23,H1
"Butler County, MO",2015-2016,42951,42789,-162,-0.377,19,-181,29,23,H1
"Butler County, MO",2016-2017,42789,42666,-123,-0.287,24,-147,29,23,H1
"Caldwell County, MO",2000-2001,8975,9006,31,0.345,-9,40,29,25,H1
"Caldwell County, MO",2001-2002,9006,9041,35,0.389,21,14,29,25,H1
"Caldwell County, MO",2002-2003,9041,9152,111,1.228,16,95,29,25,H1
"Caldwell County, MO",2003-2004,9152,9230,78,0.852,38,40,29,25,H1
"Caldwell County, MO",2004-2005,9230,9273,43,0.466,20,23,29,25,H1
"Caldwell County, MO",2005-2006,9273,9343,70,0.755,21,49,29,25,H1
"Caldwell County, MO",2006-2007,9343,9395,52,0.557,19,33,29,25,H1
"Caldwell County, MO",2007-2008,9395,9359,-36,-0.383,3,-39,29,25,H1
"Caldwell County, MO",2008-2009,9359,9365,6,0.064,8,-2,29,25,H1
"Caldwell County, MO",2009-2010,9365,9447,82,0.876,29,53,29,25,H1
"Caldwell County, MO",2010-2011,9447,9210,-237,-2.509,-6,-231,29,25,H1
"Caldwell County, MO",2011-2012,9210,9116,-94,-1.021,-21,-73,29,25,H1
"Caldwell County, MO",2012-2013,9116,9075,-41,-0.45,-11,-30,29,25,H1
"Caldwell County, MO",2013-2014,9075,9034,-41,-0.452,1,-42,29,25,H1
"Caldwell County, MO",2014-2015,9017,9014,-3,-0.033,-11,8,29,25,H1
"Caldwell County, MO",2015-2016,9014,9070,56,0.621,20,36,29,25,H1
"Caldwell County, MO",2016-2017,9070,9100,30,0.331,20,10,29,25,H1
"Callaway County, MO",2000-2001,40927,41490,563,1.376,180,383,29,27,H1
"Callaway County, MO",2001-2002,41490,41973,483,1.164,128,355,29,27,H1
"Callaway County, MO",2002-2003,41973,42023,50,0.119,171,-121,29,27,H1
"Callaway County, MO",2003-2004,42023,41767,-256,-0.609,122,-378,29,27,H1
"Callaway County, MO",2004-2005,41767,42683,916,2.193,220,696,29,27,H1
"Callaway County, MO",2005-2006,42683,43118,435,1.019,163,272,29,27,H1
"Callaway County, MO",2006-2007,43118,43414,296,0.686,209,87,29,27,H1
"Callaway County, MO",2007-2008,43414,43855,441,1.016,184,257,29,27,H1
"Callaway County, MO",2008-2009,43855,44041,186,0.424,193,-7,29,27,H1
"Callaway County, MO",2009-2010,44041,44338,297,0.674,167,130,29,27,H1
"Callaway County, MO",2010-2011,44338,44332,-6,-0.014,152,-158,29,27,H1
"Callaway County, MO",2011-2012,44332,44458,126,0.284,124,2,29,27,H1
"Callaway County, MO",2012-2013,44458,44535,77,0.173,182,-105,29,27,H1
"Callaway County, MO",2013-2014,44535,44750,215,0.483,150,65,29,27,H1
"Callaway County, MO",2014-2015,44743,44834,91,0.203,172,-81,29,27,H1
"Callaway County, MO",2015-2016,44834,45077,243,0.542,81,162,29,27,H1
"Callaway County, MO",2016-2017,45077,45032,-45,-0.1,89,-134,29,27,H1
"Camden County, MO",2000-2001,37053,37497,444,1.198,-29,473,29,29,H1
"Camden County, MO",2001-2002,37497,38263,766,2.043,12,754,29,29,H1
"Camden County, MO",2002-2003,38263,38832,569,1.487,-53,622,29,29,H1
"Camden County, MO",2003-2004,38832,39572,740,1.906,-15,755,29,29,H1
"Camden County, MO",2004-2005,39572,40641,1069,2.701,-20,1089,29,29,H1
"Camden County, MO",2005-2006,40641,41832,1191,2.931,58,1133,29,29,H1
"Camden County, MO",2006-2007,41832,42744,912,2.18,37,875,29,29,H1
"Camden County, MO",2007-2008,42744,43462,718,1.68,16,702,29,29,H1
"Camden County, MO",2008-2009,43462,43762,300,0.69,23,277,29,29,H1
"Camden County, MO",2009-2010,43762,44034,272,0.622,-48,320,29,29,H1
"Camden County, MO",2010-2011,44034,43600,-434,-0.986,2,-436,29,29,H1
"Camden County, MO",2011-2012,43600,43870,270,0.619,-70,340,29,29,H1
"Camden County, MO",2012-2013,43870,43839,-31,-0.071,-55,24,29,29,H1
"Camden County, MO",2013-2014,43839,44021,182,0.415,-59,241,29,29,H1
"Camden County, MO",2014-2015,44053,44237,184,0.418,-64,248,29,29,H1
"Camden County, MO",2015-2016,44237,45009,772,1.745,-90,862,29,29,H1
"Camden County, MO",2016-2017,45009,45632,623,1.384,-89,712,29,29,H1
"Cape Girardeau County, MO",2000-2001,68796,69340,544,0.791,230,314,29,31,H1
"Cape Girardeau County, MO",2001-2002,69340,69735,395,0.57,139,256,29,31,H1
"Cape Girardeau County, MO",2002-2003,69735,70186,451,0.647,219,232,29,31,H1
"Cape Girardeau County, MO",2003-2004,70186,71121,935,1.332,242,693,29,31,H1
"Cape Girardeau County, MO",2004-2005,71121,71793,672,0.945,137,535,29,31,H1
"Cape Girardeau County, MO",2005-2006,71793,72941,1148,1.599,231,917,29,31,H1
"Cape Girardeau County, MO",2006-2007,72941,73510,569,0.78,282,287,29,31,H1
"Cape Girardeau County, MO",2007-2008,73510,74141,631,0.858,251,380,29,31,H1
"Cape Girardeau County, MO",2008-2009,74141,74927,786,1.06,263,523,29,31,H1
"Cape Girardeau County, MO",2009-2010,74927,75870,943,1.259,276,667,29,31,H1
"Cape Girardeau County, MO",2010-2011,75870,76630,760,1.002,113,647,29,31,H1
"Cape Girardeau County, MO",2011-2012,76630,77080,450,0.587,225,225,29,31,H1
"Cape Girardeau County, MO",2012-2013,77080,77530,450,0.584,218,232,29,31,H1
"Cape Girardeau County, MO",2013-2014,77530,78043,513,0.662,229,284,29,31,H1
"Cape Girardeau County, MO",2014-2015,78108,78572,464,0.594,245,219,29,31,H1
"Cape Girardeau County, MO",2015-2016,78572,78390,-182,-0.232,122,-304,29,31,H1
"Cape Girardeau County, MO",2016-2017,78390,78161,-229,-0.292,132,-361,29,31,H1
"Carroll County, MO",2000-2001,10267,10136,-131,-1.276,-33,-98,29,33,H1
"Carroll County, MO",2001-2002,10136,10097,-39,-0.385,-12,-27,29,33,H1
"Carroll County, MO",2002-2003,10097,1.00E+04,-97,-0.961,-10,-87,29,33,H1
"Carroll County, MO",2003-2004,1.00E+04,9922,-78,-0.78,-36,-42,29,33,H1
"Carroll County, MO",2004-2005,9922,9912,-10,-0.101,-13,3,29,33,H1
"Carroll County, MO",2005-2006,9912,9743,-169,-1.705,-13,-156,29,33,H1
"Carroll County, MO",2006-2007,9743,9622,-121,-1.242,4,-125,29,33,H1
"Carroll County, MO",2007-2008,9622,9451,-171,-1.777,-41,-130,29,33,H1
"Carroll County, MO",2008-2009,9451,9314,-137,-1.45,-18,-119,29,33,H1
"Carroll County, MO",2009-2010,9314,9275,-39,-0.419,-14,-25,29,33,H1
"Carroll County, MO",2010-2011,9275,9249,-26,-0.28,-19,-7,29,33,H1
"Carroll County, MO",2011-2012,9249,9095,-154,-1.665,-1,-153,29,33,H1
"Carroll County, MO",2012-2013,9095,9121,26,0.286,-8,34,29,33,H1
"Carroll County, MO",2013-2014,9121,9043,-78,-0.855,-11,-67,29,33,H1
"Carroll County, MO",2014-2015,9021,8992,-29,-0.321,-7,-22,29,33,H1
"Carroll County, MO",2015-2016,8992,8854,-138,-1.535,-14,-124,29,33,H1
"Carroll County, MO",2016-2017,8854,8796,-58,-0.655,-21,-37,29,33,H1
"Carter County, MO",2000-2001,5974,5915,-59,-0.988,-7,-52,29,35,H1
"Carter County, MO",2001-2002,5915,5944,29,0.49,7,22,29,35,H1
"Carter County, MO",2002-2003,5944,5994,50,0.841,16,34,29,35,H1
"Carter County, MO",2003-2004,5994,5982,-12,-0.2,5,-17,29,35,H1
"Carter County, MO",2004-2005,5982,6008,26,0.435,4,22,29,35,H1
"Carter County, MO",2005-2006,6008,6030,22,0.366,-4,26,29,35,H1
"Carter County, MO",2006-2007,6030,6117,87,1.443,29,58,29,35,H1
"Carter County, MO",2007-2008,6117,6122,5,0.082,1,4,29,35,H1
"Carter County, MO",2008-2009,6122,6138,16,0.261,-5,21,29,35,H1
"Carter County, MO",2009-2010,6138,6292,154,2.509,10,144,29,35,H1
"Carter County, MO",2010-2011,6292,6309,17,0.27,-12,29,29,35,H1
"Carter County, MO",2011-2012,6309,6253,-56,-0.888,-16,-40,29,35,H1
"Carter County, MO",2012-2013,6253,6304,51,0.816,41,10,29,35,H1
"Carter County, MO",2013-2014,6304,6258,-46,-0.73,9,-55,29,35,H1
"Carter County, MO",2014-2015,6265,6263,-2,-0.032,4,-6,29,35,H1
"Carter County, MO",2015-2016,6263,6207,-56,-0.894,-5,-51,29,35,H1
"Carter County, MO",2016-2017,6207,6169,-38,-0.612,-13,-25,29,35,H1
"Cass County, MO",2000-2001,82592,84504,1912,2.315,387,1525,29,37,H1
"Cass County, MO",2001-2002,84504,86645,2141,2.534,413,1728,29,37,H1
"Cass County, MO",2002-2003,86645,88020,1375,1.587,496,879,29,37,H1
"Cass County, MO",2003-2004,88020,90759,2739,3.112,486,2253,29,37,H1
"Cass County, MO",2004-2005,90759,92520,1761,1.94,475,1286,29,37,H1
"Cass County, MO",2005-2006,92520,94494,1974,2.134,521,1453,29,37,H1
"Cass County, MO",2006-2007,94494,96845,2351,2.488,567,1784,29,37,H1
"Cass County, MO",2007-2008,96845,98095,1250,1.291,468,782,29,37,H1
"Cass County, MO",2008-2009,98095,98835,740,0.754,553,187,29,37,H1
"Cass County, MO",2009-2010,98835,99697,862,0.872,484,378,29,37,H1
"Cass County, MO",2010-2011,99697,99927,230,0.231,377,-147,29,37,H1
"Cass County, MO",2011-2012,99927,100439,512,0.512,336,176,29,37,H1
"Cass County, MO",2012-2013,100439,100744,305,0.304,256,49,29,37,H1
"Cass County, MO",2013-2014,100744,100889,145,0.144,286,-141,29,37,H1
"Cass County, MO",2014-2015,100978,101603,625,0.619,335,290,29,37,H1
"Cass County, MO",2015-2016,101603,102780,1177,1.158,303,874,29,37,H1
"Cass County, MO",2016-2017,102780,103724,944,0.918,241,703,29,37,H1
"Cedar County, MO",2000-2001,13720,13901,181,1.319,-52,233,29,39,H1
"Cedar County, MO",2001-2002,13901,13909,8,0.058,-48,56,29,39,H1
"Cedar County, MO",2002-2003,13909,13975,66,0.475,-39,105,29,39,H1
"Cedar County, MO",2003-2004,13975,14073,98,0.701,-12,110,29,39,H1
"Cedar County, MO",2004-2005,14073,14297,224,1.592,-37,261,29,39,H1
"Cedar County, MO",2005-2006,14297,14229,-68,-0.476,-33,-35,29,39,H1
"Cedar County, MO",2006-2007,14229,14169,-60,-0.422,14,-74,29,39,H1
"Cedar County, MO",2007-2008,14169,14120,-49,-0.346,-56,7,29,39,H1
"Cedar County, MO",2008-2009,14120,13964,-156,-1.105,-39,-117,29,39,H1
"Cedar County, MO",2009-2010,13964,13989,25,0.179,-35,60,29,39,H1
"Cedar County, MO",2010-2011,13989,13839,-150,-1.072,-45,-105,29,39,H1
"Cedar County, MO",2011-2012,13839,13834,-5,-0.036,-7,2,29,39,H1
"Cedar County, MO",2012-2013,13834,13947,113,0.817,-17,130,29,39,H1
"Cedar County, MO",2013-2014,13947,13952,5,0.036,-27,32,29,39,H1
"Cedar County, MO",2014-2015,13933,13934,1,0.007,-30,31,29,39,H1
"Cedar County, MO",2015-2016,13934,13886,-48,-0.344,-24,-24,29,39,H1
"Cedar County, MO",2016-2017,13886,14073,187,1.347,-21,208,29,39,H1
"Chariton County, MO",2000-2001,8411,8276,-135,-1.605,-40,-95,29,41,H1
"Chariton County, MO",2001-2002,8276,8277,1,0.012,-53,54,29,41,H1
"Chariton County, MO",2002-2003,8277,8193,-84,-1.015,-66,-18,29,41,H1
"Chariton County, MO",2003-2004,8193,8174,-19,-0.232,-1,-18,29,41,H1
"Chariton County, MO",2004-2005,8174,8092,-82,-1.003,-41,-41,29,41,H1
"Chariton County, MO",2005-2006,8092,8013,-79,-0.976,-18,-61,29,41,H1
"Chariton County, MO",2006-2007,8013,7900,-113,-1.41,-18,-95,29,41,H1
"Chariton County, MO",2007-2008,7900,7829,-71,-0.899,3,-74,29,41,H1
"Chariton County, MO",2008-2009,7829,7767,-62,-0.792,-4,-58,29,41,H1
"Chariton County, MO",2009-2010,7767,7849,82,1.056,-12,94,29,41,H1
"Chariton County, MO",2010-2011,7849,7744,-105,-1.338,-13,-92,29,41,H1
"Chariton County, MO",2011-2012,7744,7683,-61,-0.788,-19,-42,29,41,H1
"Chariton County, MO",2012-2013,7683,7664,-19,-0.247,30,-49,29,41,H1
"Chariton County, MO",2013-2014,7664,7694,30,0.391,-18,48,29,41,H1
"Chariton County, MO",2014-2015,7659,7589,-70,-0.914,-15,-55,29,41,H1
"Chariton County, MO",2015-2016,7589,7529,-60,-0.791,15,-75,29,41,H1
"Chariton County, MO",2016-2017,7529,7480,-49,-0.651,-17,-32,29,41,H1
"Christian County, MO",2000-2001,54936,56824,1888,3.437,446,1442,29,43,H1
"Christian County, MO",2001-2002,56824,58674,1850,3.256,397,1453,29,43,H1
"Christian County, MO",2002-2003,58674,60672,1998,3.405,326,1672,29,43,H1
"Christian County, MO",2003-2004,60672,63171,2499,4.119,486,2013,29,43,H1
"Christian County, MO",2004-2005,63171,65963,2792,4.42,547,2245,29,43,H1
"Christian County, MO",2005-2006,65963,69394,3431,5.201,537,2894,29,43,H1
"Christian County, MO",2006-2007,69394,72545,3151,4.541,587,2564,29,43,H1
"Christian County, MO",2007-2008,72545,74705,2160,2.977,521,1639,29,43,H1
"Christian County, MO",2008-2009,74705,76309,1604,2.147,541,1063,29,43,H1
"Christian County, MO",2009-2010,76309,77887,1578,2.068,457,1121,29,43,H1
"Christian County, MO",2010-2011,77887,78709,822,1.055,550,272,29,43,H1
"Christian County, MO",2011-2012,78709,79781,1072,1.362,413,659,29,43,H1
"Christian County, MO",2012-2013,79781,80803,1022,1.281,408,614,29,43,H1
"Christian County, MO",2013-2014,80803,82101,1298,1.606,415,883,29,43,H1
"Christian County, MO",2014-2015,82039,83279,1240,1.511,431,809,29,43,H1
"Christian County, MO",2015-2016,83279,84159,880,1.057,406,474,29,43,H1
"Christian County, MO",2016-2017,84159,85432,1273,1.513,423,850,29,43,H1
"Clark County, MO",2000-2001,7387,7433,46,0.623,13,33,29,45,H1
"Clark County, MO",2001-2002,7433,7366,-67,-0.901,-1,-66,29,45,H1
"Clark County, MO",2002-2003,7366,7281,-85,-1.154,-23,-62,29,45,H1
"Clark County, MO",2003-2004,7281,7239,-42,-0.577,-6,-36,29,45,H1
"Clark County, MO",2004-2005,7239,7224,-15,-0.207,6,-21,29,45,H1
"Clark County, MO",2005-2006,7224,7206,-18,-0.249,8,-26,29,45,H1
"Clark County, MO",2006-2007,7206,7212,6,0.083,16,-10,29,45,H1
"Clark County, MO",2007-2008,7212,7168,-44,-0.61,4,-48,29,45,H1
"Clark County, MO",2008-2009,7168,7111,-57,-0.795,0,-57,29,45,H1
"Clark County, MO",2009-2010,7111,7137,26,0.366,1,25,29,45,H1
"Clark County, MO",2010-2011,7137,7041,-96,-1.345,-7,-89,29,45,H1
"Clark County, MO",2011-2012,7041,6987,-54,-0.767,-1,-53,29,45,H1
"Clark County, MO",2012-2013,6987,6923,-64,-0.916,-2,-62,29,45,H1
"Clark County, MO",2013-2014,6923,6917,-6,-0.087,19,-25,29,45,H1
"Clark County, MO",2014-2015,6881,6801,-80,-1.163,7,-87,29,45,H1
"Clark County, MO",2015-2016,6801,6731,-70,-1.029,-5,-65,29,45,H1
"Clark County, MO",2016-2017,6731,6723,-8,-0.119,8,-16,29,45,H1
"Clay County, MO",2000-2001,184703,188024,3321,1.798,1364,1957,29,47,H1
"Clay County, MO",2001-2002,188024,190959,2935,1.561,1423,1512,29,47,H1
"Clay County, MO",2002-2003,190959,193436,2477,1.297,1452,1025,29,47,H1
"Clay County, MO",2003-2004,193436,196718,3282,1.697,1511,1771,29,47,H1
"Clay County, MO",2004-2005,196718,200659,3941,2.003,1519,2422,29,47,H1
"Clay County, MO",2005-2006,200659,206369,5710,2.846,1678,4032,29,47,H1
"Clay County, MO",2006-2007,206369,211179,4810,2.331,1752,3058,29,47,H1
"Clay County, MO",2007-2008,211179,215142,3963,1.877,1761,2202,29,47,H1
"Clay County, MO",2008-2009,215142,219669,4527,2.104,1787,2740,29,47,H1
"Clay County, MO",2009-2010,219669,222696,3027,1.378,1718,1309,29,47,H1
"Clay County, MO",2010-2011,222696,225148,2452,1.101,1513,939,29,47,H1
"Clay County, MO",2011-2012,225148,227689,2541,1.129,1417,1124,29,47,H1
"Clay County, MO",2012-2013,227689,230706,3017,1.325,1564,1453,29,47,H1
"Clay County, MO",2013-2014,230706,233682,2976,1.29,1500,1476,29,47,H1
"Clay County, MO",2014-2015,233297,235637,2340,1.003,1433,907,29,47,H1
"Clay County, MO",2015-2016,235637,238762,3125,1.326,1294,1831,29,47,H1
"Clay County, MO",2016-2017,238762,242874,4112,1.722,1310,2802,29,47,H1
"Clinton County, MO",2000-2001,19046,19371,325,1.706,32,293,29,49,H1
"Clinton County, MO",2001-2002,19371,19525,154,0.795,28,126,29,49,H1
"Clinton County, MO",2002-2003,19525,20034,509,2.607,23,486,29,49,H1
"Clinton County, MO",2003-2004,20034,20409,375,1.872,22,353,29,49,H1
"Clinton County, MO",2004-2005,20409,20392,-17,-0.083,-49,32,29,49,H1
"Clinton County, MO",2005-2006,20392,20347,-45,-0.221,45,-90,29,49,H1
"Clinton County, MO",2006-2007,20347,20774,427,2.099,24,403,29,49,H1
"Clinton County, MO",2007-2008,20774,20781,7,0.034,9,-2,29,49,H1
"Clinton County, MO",2008-2009,20781,20765,-16,-0.077,4,-20,29,49,H1
"Clinton County, MO",2009-2010,20765,20749,-16,-0.077,-6,-10,29,49,H1
"Clinton County, MO",2010-2011,20749,20671,-78,-0.376,-14,-64,29,49,H1
"Clinton County, MO",2011-2012,20671,20505,-166,-0.803,-36,-130,29,49,H1
"Clinton County, MO",2012-2013,20505,20503,-2,-0.01,-2,0,29,49,H1
"Clinton County, MO",2013-2014,20503,20299,-204,-0.995,-9,-195,29,49,H1
"Clinton County, MO",2014-2015,20259,20609,350,1.728,-28,378,29,49,H1
"Clinton County, MO",2015-2016,20609,20530,-79,-0.383,-16,-63,29,49,H1
"Clinton County, MO",2016-2017,20530,20554,24,0.117,-3,27,29,49,H1
"Cole County, MO",2000-2001,71485,71650,165,0.231,263,-98,29,51,H1
"Cole County, MO",2001-2002,71650,72138,488,0.681,359,129,29,51,H1
"Cole County, MO",2002-2003,72138,72728,590,0.818,374,216,29,51,H1
"Cole County, MO",2003-2004,72728,72427,-301,-0.414,390,-691,29,51,H1
"Cole County, MO",2004-2005,72427,72948,521,0.719,388,133,29,51,H1
"Cole County, MO",2005-2006,72948,73509,561,0.769,355,206,29,51,H1
"Cole County, MO",2006-2007,73509,73977,468,0.637,477,-9,29,51,H1
"Cole County, MO",2007-2008,73977,74760,783,1.058,399,384,29,51,H1
"Cole County, MO",2008-2009,74760,75408,648,0.867,433,215,29,51,H1
"Cole County, MO",2009-2010,75408,76116,708,0.939,403,305,29,51,H1
"Cole County, MO",2010-2011,76116,76431,315,0.414,328,-13,29,51,H1
"Cole County, MO",2011-2012,76431,76377,-54,-0.071,301,-355,29,51,H1
"Cole County, MO",2012-2013,76377,76649,272,0.356,338,-66,29,51,H1
"Cole County, MO",2013-2014,76649,76557,-92,-0.12,298,-390,29,51,H1
"Cole County, MO",2014-2015,76531,76720,189,0.247,302,-113,29,51,H1
"Cole County, MO",2015-2016,76720,76775,55,0.072,236,-181,29,51,H1
"Cole County, MO",2016-2017,76775,76708,-67,-0.087,225,-292,29,51,H1
"Cooper County, MO",2000-2001,16764,16714,-50,-0.298,3,-53,29,53,H1
"Cooper County, MO",2001-2002,16714,16999,285,1.705,14,271,29,53,H1
"Cooper County, MO",2002-2003,16999,17002,3,0.018,16,-13,29,53,H1
"Cooper County, MO",2003-2004,17002,17203,201,1.182,10,191,29,53,H1
"Cooper County, MO",2004-2005,17203,17380,177,1.029,0,177,29,53,H1
"Cooper County, MO",2005-2006,17380,17547,167,0.961,28,139,29,53,H1
"Cooper County, MO",2006-2007,17547,17693,146,0.832,21,125,29,53,H1
"Cooper County, MO",2007-2008,17693,17502,-191,-1.08,48,-239,29,53,H1
"Cooper County, MO",2008-2009,17502,17564,62,0.354,22,40,29,53,H1
"Cooper County, MO",2009-2010,17564,17589,25,0.142,32,-7,29,53,H1
"Cooper County, MO",2010-2011,17589,17573,-16,-0.091,13,-29,29,53,H1
"Cooper County, MO",2011-2012,17573,17529,-44,-0.25,-7,-37,29,53,H1
"Cooper County, MO",2012-2013,17529,17650,121,0.69,12,109,29,53,H1
"Cooper County, MO",2013-2014,17650,17585,-65,-0.368,24,-89,29,53,H1
"Cooper County, MO",2014-2015,17572,17642,70,0.398,21,49,29,53,H1
"Cooper County, MO",2015-2016,17642,17683,41,0.232,-33,74,29,53,H1
"Cooper County, MO",2016-2017,17683,17644,-39,-0.221,-4,-35,29,53,H1
"Crawford County, MO",2000-2001,22828,22876,48,0.21,47,1,29,55,H1
"Crawford County, MO",2001-2002,22876,23420,544,2.378,49,495,29,55,H1
"Crawford County, MO",2002-2003,23420,23734,314,1.341,49,265,29,55,H1
"Crawford County, MO",2003-2004,23734,23918,184,0.775,39,145,29,55,H1
"Crawford County, MO",2004-2005,23918,24137,219,0.916,50,169,29,55,H1
"Crawford County, MO",2005-2006,24137,24373,236,0.978,75,161,29,55,H1
"Crawford County, MO",2006-2007,24373,24689,316,1.297,117,199,29,55,H1
"Crawford County, MO",2007-2008,24689,24698,9,0.036,56,-47,29,55,H1
"Crawford County, MO",2008-2009,24698,24802,104,0.421,61,43,29,55,H1
"Crawford County, MO",2009-2010,24802,24610,-192,-0.774,50,-242,29,55,H1
"Crawford County, MO",2010-2011,24610,24814,204,0.829,21,183,29,55,H1
"Crawford County, MO",2011-2012,24814,24774,-40,-0.161,-40,0,29,55,H1
"Crawford County, MO",2012-2013,24774,24554,-220,-0.888,37,-257,29,55,H1
"Crawford County, MO",2013-2014,24554,24650,96,0.391,10,86,29,55,H1
"Crawford County, MO",2014-2015,24638,24526,-112,-0.455,29,-141,29,55,H1
"Crawford County, MO",2015-2016,24526,24232,-294,-1.199,-31,-263,29,55,H1
"Crawford County, MO",2016-2017,24232,24102,-130,-0.536,-41,-89,29,55,H1
"Dade County, MO",2000-2001,7915,7920,5,0.063,-32,37,29,57,H1
"Dade County, MO",2001-2002,7920,7899,-21,-0.265,-40,19,29,57,H1
"Dade County, MO",2002-2003,7899,7896,-3,-0.038,-52,49,29,57,H1
"Dade County, MO",2003-2004,7896,7893,-3,-0.038,-38,35,29,57,H1
"Dade County, MO",2004-2005,7893,7910,17,0.215,-57,74,29,57,H1
"Dade County, MO",2005-2006,7910,7974,64,0.809,-18,82,29,57,H1
"Dade County, MO",2006-2007,7974,7969,-5,-0.063,-30,25,29,57,H1
"Dade County, MO",2007-2008,7969,7951,-18,-0.226,-26,8,29,57,H1
"Dade County, MO",2008-2009,7951,7885,-66,-0.83,-40,-26,29,57,H1
"Dade County, MO",2009-2010,7885,7862,-23,-0.292,-33,10,29,57,H1
"Dade County, MO",2010-2011,7862,7777,-85,-1.081,-32,-53,29,57,H1
"Dade County, MO",2011-2012,7777,7566,-211,-2.713,-24,-187,29,57,H1
"Dade County, MO",2012-2013,7566,7559,-7,-0.093,-24,17,29,57,H1
"Dade County, MO",2013-2014,7559,7628,69,0.913,-47,116,29,57,H1
"Dade County, MO",2014-2015,7615,7595,-20,-0.263,-46,26,29,57,H1
"Dade County, MO",2015-2016,7595,7606,11,0.145,-37,48,29,57,H1
"Dade County, MO",2016-2017,7606,7588,-18,-0.237,-36,18,29,57,H1
"Dallas County, MO",2000-2001,15751,15802,51,0.324,37,14,29,59,H1
"Dallas County, MO",2001-2002,15802,15908,106,0.671,34,72,29,59,H1
"Dallas County, MO",2002-2003,15908,16031,123,0.773,33,90,29,59,H1
"Dallas County, MO",2003-2004,16031,16275,244,1.522,45,199,29,59,H1
"Dallas County, MO",2004-2005,16275,16325,50,0.307,31,19,29,59,H1
"Dallas County, MO",2005-2006,16325,16580,255,1.562,49,206,29,59,H1
"Dallas County, MO",2006-2007,16580,16953,373,2.25,59,314,29,59,H1
"Dallas County, MO",2007-2008,16953,16955,2,0.012,46,-44,29,59,H1
"Dallas County, MO",2008-2009,16955,16816,-139,-0.82,59,-198,29,59,H1
"Dallas County, MO",2009-2010,16816,16731,-85,-0.505,53,-138,29,59,H1
"Dallas County, MO",2010-2011,16731,16762,31,0.185,8,23,29,59,H1
"Dallas County, MO",2011-2012,16762,16775,13,0.078,69,-56,29,59,H1
"Dallas County, MO",2012-2013,16775,16504,-271,-1.615,22,-293,29,59,H1
"Dallas County, MO",2013-2014,16504,16389,-115,-0.697,-1,-114,29,59,H1
"Dallas County, MO",2014-2015,16385,16393,8,0.049,-4,12,29,59,H1
"Dallas County, MO",2015-2016,16393,16380,-13,-0.079,17,-30,29,59,H1
"Dallas County, MO",2016-2017,16380,16673,293,1.789,13,280,29,59,H1
"Daviess County, MO",2000-2001,7998,7972,-26,-0.325,14,-40,29,61,H1
"Daviess County, MO",2001-2002,7972,8040,68,0.853,30,38,29,61,H1
"Daviess County, MO",2002-2003,8040,8125,85,1.057,45,40,29,61,H1
"Daviess County, MO",2003-2004,8125,8228,103,1.268,37,66,29,61,H1
"Daviess County, MO",2004-2005,8228,8231,3,0.036,29,-26,29,61,H1
"Daviess County, MO",2005-2006,8231,8331,100,1.215,38,62,29,61,H1
"Daviess County, MO",2006-2007,8331,8309,-22,-0.264,40,-62,29,61,H1
"Daviess County, MO",2007-2008,8309,8330,21,0.253,59,-38,29,61,H1
"Daviess County, MO",2008-2009,8330,8382,52,0.624,52,0,29,61,H1
"Daviess County, MO",2009-2010,8382,8453,71,0.847,24,47,29,61,H1
"Daviess County, MO",2010-2011,8453,8322,-131,-1.55,27,-158,29,61,H1
"Daviess County, MO",2011-2012,8322,8271,-51,-0.613,36,-87,29,61,H1
"Daviess County, MO",2012-2013,8271,8277,6,0.073,8,-2,29,61,H1
"Daviess County, MO",2013-2014,8277,8297,20,0.242,32,-12,29,61,H1
"Daviess County, MO",2014-2015,8294,8253,-41,-0.494,42,-83,29,61,H1
"Daviess County, MO",2015-2016,8253,8233,-20,-0.242,23,-43,29,61,H1
"Daviess County, MO",2016-2017,8233,8361,128,1.555,22,106,29,61,H1
"DeKalb County, MO",2000-2001,13137,13111,-26,-0.198,-6,-20,29,63,H1
"DeKalb County, MO",2001-2002,13111,13180,69,0.526,20,49,29,63,H1
"DeKalb County, MO",2002-2003,13180,13284,104,0.789,-7,111,29,63,H1
"DeKalb County, MO",2003-2004,13284,12734,-550,-4.14,-11,-539,29,63,H1
"DeKalb County, MO",2004-2005,12734,12727,-7,-0.055,-15,8,29,63,H1
"DeKalb County, MO",2005-2006,12727,12882,155,1.218,7,148,29,63,H1
"DeKalb County, MO",2006-2007,12882,12921,39,0.303,-20,59,29,63,H1
"DeKalb County, MO",2007-2008,12921,12833,-88,-0.681,-8,-80,29,63,H1
"DeKalb County, MO",2008-2009,12833,12825,-8,-0.062,1,-9,29,63,H1
"DeKalb County, MO",2009-2010,12825,12878,53,0.413,13,40,29,63,H1
"DeKalb County, MO",2010-2011,12878,12914,36,0.28,-18,54,29,63,H1
"DeKalb County, MO",2011-2012,12914,12874,-40,-0.31,-9,-31,29,63,H1
"DeKalb County, MO",2012-2013,12874,12762,-112,-0.87,-16,-96,29,63,H1
"DeKalb County, MO",2013-2014,12762,12692,-70,-0.549,1,-71,29,63,H1
"DeKalb County, MO",2014-2015,12684,12687,3,0.024,8,-5,29,63,H1
"DeKalb County, MO",2015-2016,12687,12505,-182,-1.435,5,-187,29,63,H1
"DeKalb County, MO",2016-2017,12505,12588,83,0.664,20,63,29,63,H1
"Dent County, MO",2000-2001,14947,15088,141,0.943,-15,156,29,65,H1
"Dent County, MO",2001-2002,15088,14935,-153,-1.014,-51,-102,29,65,H1
"Dent County, MO",2002-2003,14935,15050,115,0.77,-17,132,29,65,H1
"Dent County, MO",2003-2004,15050,15157,107,0.711,1,106,29,65,H1
"Dent County, MO",2004-2005,15157,15257,100,0.66,-22,122,29,65,H1
"Dent County, MO",2005-2006,15257,15419,162,1.062,3,159,29,65,H1
"Dent County, MO",2006-2007,15419,15344,-75,-0.486,21,-96,29,65,H1
"Dent County, MO",2007-2008,15344,15495,151,0.984,-28,179,29,65,H1
"Dent County, MO",2008-2009,15495,15544,49,0.316,-16,65,29,65,H1
"Dent County, MO",2009-2010,15544,15718,174,1.119,0,174,29,65,H1
"Dent County, MO",2010-2011,15718,15602,-116,-0.738,-44,-72,29,65,H1
"Dent County, MO",2011-2012,15602,15665,63,0.404,-23,86,29,65,H1
"Dent County, MO",2012-2013,15665,15766,101,0.645,10,91,29,65,H1
"Dent County, MO",2013-2014,15766,15655,-111,-0.704,-27,-84,29,65,H1
"Dent County, MO",2014-2015,15578,15593,15,0.096,-21,36,29,65,H1
"Dent County, MO",2015-2016,15593,15425,-168,-1.077,0,-168,29,65,H1
"Dent County, MO",2016-2017,15425,15480,55,0.357,-22,77,29,65,H1
"Douglas County, MO",2000-2001,13097,13070,-27,-0.206,-21,-6,29,67,H1
"Douglas County, MO",2001-2002,13070,13270,200,1.53,-23,223,29,67,H1
"Douglas County, MO",2002-2003,13270,13239,-31,-0.234,-13,-18,29,67,H1
"Douglas County, MO",2003-2004,13239,13372,133,1.005,-4,137,29,67,H1
"Douglas County, MO",2004-2005,13372,13474,102,0.763,13,89,29,67,H1
"Douglas County, MO",2005-2006,13474,13573,99,0.735,15,84,29,67,H1
"Douglas County, MO",2006-2007,13573,13637,64,0.472,-15,79,29,67,H1
"Douglas County, MO",2007-2008,13637,13800,163,1.195,41,122,29,67,H1
"Douglas County, MO",2008-2009,13800,13793,-7,-0.051,31,-38,29,67,H1
"Douglas County, MO",2009-2010,13793,13645,-148,-1.073,-10,-138,29,67,H1
"Douglas County, MO",2010-2011,13645,13625,-20,-0.147,-13,-7,29,67,H1
"Douglas County, MO",2011-2012,13625,13598,-27,-0.198,16,-43,29,67,H1
"Douglas County, MO",2012-2013,13598,13463,-135,-0.993,-27,-108,29,67,H1
"Douglas County, MO",2013-2014,13463,13546,83,0.617,-32,115,29,67,H1
"Douglas County, MO",2014-2015,13544,13373,-171,-1.263,1,-172,29,67,H1
"Douglas County, MO",2015-2016,13373,13352,-21,-0.157,-34,13,29,67,H1
"Douglas County, MO",2016-2017,13352,13300,-52,-0.389,-15,-37,29,67,H1
"Dunklin County, MO",2000-2001,33148,33006,-142,-0.428,21,-163,29,69,H1
"Dunklin County, MO",2001-2002,33006,32871,-135,-0.409,-6,-129,29,69,H1
"Dunklin County, MO",2002-2003,32871,32723,-148,-0.45,-27,-121,29,69,H1
"Dunklin County, MO",2003-2004,32723,32420,-303,-0.926,3,-306,29,69,H1
"Dunklin County, MO",2004-2005,32420,32581,161,0.497,24,137,29,69,H1
"Dunklin County, MO",2005-2006,32581,32388,-193,-0.592,15,-208,29,69,H1
"Dunklin County, MO",2006-2007,32388,32255,-133,-0.411,38,-171,29,69,H1
"Dunklin County, MO",2007-2008,32255,32158,-97,-0.301,93,-190,29,69,H1
"Dunklin County, MO",2008-2009,32158,31977,-181,-0.563,23,-204,29,69,H1
"Dunklin County, MO",2009-2010,31977,31952,-25,-0.078,11,-36,29,69,H1
"Dunklin County, MO",2010-2011,31952,32031,79,0.247,68,11,29,69,H1
"Dunklin County, MO",2011-2012,32031,31872,-159,-0.496,-17,-142,29,69,H1
"Dunklin County, MO",2012-2013,31872,31692,-180,-0.565,51,-231,29,69,H1
"Dunklin County, MO",2013-2014,31692,31344,-348,-1.098,4,-352,29,69,H1
"Dunklin County, MO",2014-2015,31356,30895,-461,-1.47,3,-464,29,69,H1
"Dunklin County, MO",2015-2016,30895,30556,-339,-1.097,13,-352,29,69,H1
"Dunklin County, MO",2016-2017,30556,30119,-437,-1.43,-26,-411,29,69,H1
"Franklin County, MO",2000-2001,94050,94872,822,0.874,439,383,29,71,H1
"Franklin County, MO",2001-2002,94872,95771,899,0.948,435,464,29,71,H1
"Franklin County, MO",2002-2003,95771,96480,709,0.74,389,320,29,71,H1
"Franklin County, MO",2003-2004,96480,97465,985,1.021,418,567,29,71,H1
"Franklin County, MO",2004-2005,97465,98417,952,0.977,441,511,29,71,H1
"Franklin County, MO",2005-2006,98417,99341,924,0.939,431,493,29,71,H1
"Franklin County, MO",2006-2007,99341,100265,924,0.93,456,468,29,71,H1
"Franklin County, MO",2007-2008,100265,101149,884,0.882,371,513,29,71,H1
"Franklin County, MO",2008-2009,101149,101422,273,0.27,410,-137,29,71,H1
"Franklin County, MO",2009-2010,101422,101537,115,0.113,375,-260,29,71,H1
"Franklin County, MO",2010-2011,101537,101648,111,0.109,245,-134,29,71,H1
"Franklin County, MO",2011-2012,101648,101386,-262,-0.258,332,-594,29,71,H1
"Franklin County, MO",2012-2013,101386,101757,371,0.366,293,78,29,71,H1
"Franklin County, MO",2013-2014,101757,102084,327,0.321,309,18,29,71,H1
"Franklin County, MO",2014-2015,101999,102426,427,0.419,262,165,29,71,H1
"Franklin County, MO",2015-2016,102426,102754,328,0.32,187,141,29,71,H1
"Franklin County, MO",2016-2017,102754,103330,576,0.561,209,367,29,71,H1
"Gasconade County, MO",2000-2001,15374,15395,21,0.137,-24,45,29,73,H1
"Gasconade County, MO",2001-2002,15395,15407,12,0.078,-57,69,29,73,H1
"Gasconade County, MO",2002-2003,15407,15460,53,0.344,-35,88,29,73,H1
"Gasconade County, MO",2003-2004,15460,15464,4,0.026,-19,23,29,73,H1
"Gasconade County, MO",2004-2005,15464,15516,52,0.336,-81,133,29,73,H1
"Gasconade County, MO",2005-2006,15516,15479,-37,-0.238,-18,-19,29,73,H1
"Gasconade County, MO",2006-2007,15479,15450,-29,-0.187,-16,-13,29,73,H1
"Gasconade County, MO",2007-2008,15450,15309,-141,-0.913,-33,-108,29,73,H1
"Gasconade County, MO",2008-2009,15309,15204,-105,-0.686,-11,-94,29,73,H1
"Gasconade County, MO",2009-2010,15204,15221,17,0.112,-40,57,29,73,H1
"Gasconade County, MO",2010-2011,15221,15104,-117,-0.769,-26,-91,29,73,H1
"Gasconade County, MO",2011-2012,15104,14980,-124,-0.821,-88,-36,29,73,H1
"Gasconade County, MO",2012-2013,14980,14899,-81,-0.541,-30,-51,29,73,H1
"Gasconade County, MO",2013-2014,14899,14866,-33,-0.221,-46,13,29,73,H1
"Gasconade County, MO",2014-2015,14885,14858,-27,-0.181,-17,-10,29,73,H1
"Gasconade County, MO",2015-2016,14858,14750,-108,-0.727,-20,-88,29,73,H1
"Gasconade County, MO",2016-2017,14750,14726,-24,-0.163,-35,11,29,73,H1
"Gentry County, MO",2000-2001,6873,6875,2,0.029,-29,31,29,75,H1
"Gentry County, MO",2001-2002,6875,6780,-95,-1.382,-33,-62,29,75,H1
"Gentry County, MO",2002-2003,6780,6725,-55,-0.811,-29,-26,29,75,H1
"Gentry County, MO",2003-2004,6725,6771,46,0.684,-8,54,29,75,H1
"Gentry County, MO",2004-2005,6771,6780,9,0.133,-24,33,29,75,H1
"Gentry County, MO",2005-2006,6780,6776,-4,-0.059,8,-12,29,75,H1
"Gentry County, MO",2006-2007,6776,6758,-18,-0.266,-12,-6,29,75,H1
"Gentry County, MO",2007-2008,6758,6806,48,0.71,3,45,29,75,H1
"Gentry County, MO",2008-2009,6806,6740,-66,-0.97,5,-71,29,75,H1
"Gentry County, MO",2009-2010,6740,6732,-8,-0.119,-6,-2,29,75,H1
"Gentry County, MO",2010-2011,6732,6820,88,1.307,-3,91,29,75,H1
"Gentry County, MO",2011-2012,6820,6799,-21,-0.308,2,-23,29,75,H1
"Gentry County, MO",2012-2013,6799,6783,-16,-0.235,11,-27,29,75,H1
"Gentry County, MO",2013-2014,6783,6826,43,0.634,8,35,29,75,H1
"Gentry County, MO",2014-2015,6816,6692,-124,-1.819,2,-126,29,75,H1
"Gentry County, MO",2015-2016,6692,6637,-55,-0.822,15,-70,29,75,H1
"Gentry County, MO",2016-2017,6637,6665,28,0.422,11,17,29,75,H1
"Greene County, MO",2000-2001,241015,243305,2290,0.95,698,1592,29,77,H1
"Greene County, MO",2001-2002,243305,245822,2517,1.035,662,1855,29,77,H1
"Greene County, MO",2002-2003,245822,249312,3490,1.42,789,2701,29,77,H1
"Greene County, MO",2003-2004,249312,253130,3818,1.531,797,3021,29,77,H1
"Greene County, MO",2004-2005,253130,257282,4152,1.64,1072,3080,29,77,H1
"Greene County, MO",2005-2006,257282,263046,5764,2.24,1007,4757,29,77,H1
"Greene County, MO",2006-2007,263046,267576,4530,1.722,1151,3379,29,77,H1
"Greene County, MO",2007-2008,267576,270901,3325,1.243,1483,1842,29,77,H1
"Greene County, MO",2008-2009,270901,274013,3112,1.149,1182,1930,29,77,H1
"Greene County, MO",2009-2010,274013,275377,1364,0.498,1207,157,29,77,H1
"Greene County, MO",2010-2011,275377,277386,2009,0.73,1024,985,29,77,H1
"Greene County, MO",2011-2012,277386,280686,3300,1.19,925,2375,29,77,H1
"Greene County, MO",2012-2013,280686,283970,3284,1.17,1049,2235,29,77,H1
"Greene County, MO",2013-2014,283970,285865,1895,0.667,1019,876,29,77,H1
"Greene County, MO",2014-2015,285852,288072,2220,0.777,984,1236,29,77,H1
"Greene County, MO",2015-2016,288072,287881,-191,-0.066,702,-893,29,77,H1
"Greene County, MO",2016-2017,287881,289805,1924,0.668,761,1163,29,77,H1
"Grundy County, MO",2000-2001,10513,10427,-86,-0.818,-19,-67,29,79,H1
"Grundy County, MO",2001-2002,10427,10253,-174,-1.669,-39,-135,29,79,H1
"Grundy County, MO",2002-2003,10253,10304,51,0.497,-19,70,29,79,H1
"Grundy County, MO",2003-2004,10304,10209,-95,-0.922,-14,-81,29,79,H1
"Grundy County, MO",2004-2005,10209,10280,71,0.695,-2,73,29,79,H1
"Grundy County, MO",2005-2006,10280,10187,-93,-0.905,-13,-80,29,79,H1
"Grundy County, MO",2006-2007,10187,10199,12,0.118,-17,29,29,79,H1
"Grundy County, MO",2007-2008,10199,10196,-3,-0.029,5,-8,29,79,H1
"Grundy County, MO",2008-2009,10196,10215,19,0.186,-29,48,29,79,H1
"Grundy County, MO",2009-2010,10215,10260,45,0.441,-14,59,29,79,H1
"Grundy County, MO",2010-2011,10260,10251,-9,-0.088,-3,-6,29,79,H1
"Grundy County, MO",2011-2012,10251,10323,72,0.702,23,49,29,79,H1
"Grundy County, MO",2012-2013,10323,10366,43,0.417,23,20,29,79,H1
"Grundy County, MO",2013-2014,10366,10197,-169,-1.63,26,-195,29,79,H1
"Grundy County, MO",2014-2015,10209,10097,-112,-1.097,38,-150,29,79,H1
"Grundy County, MO",2015-2016,10097,10080,-17,-0.168,0,-17,29,79,H1
"Grundy County, MO",2016-2017,10080,9949,-131,-1.3,14,-145,29,79,H1
"Harrison County, MO",2000-2001,8873,8779,-94,-1.059,-29,-65,29,81,H1
"Harrison County, MO",2001-2002,8779,8771,-8,-0.091,-34,26,29,81,H1
"Harrison County, MO",2002-2003,8771,8791,20,0.228,-6,26,29,81,H1
"Harrison County, MO",2003-2004,8791,8753,-38,-0.432,-30,-8,29,81,H1
"Harrison County, MO",2004-2005,8753,8893,140,1.599,-3,143,29,81,H1
"Harrison County, MO",2005-2006,8893,8870,-23,-0.259,6,-29,29,81,H1
"Harrison County, MO",2006-2007,8870,8951,81,0.913,2,79,29,81,H1
"Harrison County, MO",2007-2008,8951,8956,5,0.056,3,2,29,81,H1
"Harrison County, MO",2008-2009,8956,8987,31,0.346,-12,43,29,81,H1
"Harrison County, MO",2009-2010,8987,8952,-35,-0.389,-6,-29,29,81,H1
"Harrison County, MO",2010-2011,8952,8906,-46,-0.514,9,-55,29,81,H1
"Harrison County, MO",2011-2012,8906,8741,-165,-1.853,-17,-148,29,81,H1
"Harrison County, MO",2012-2013,8741,8736,-5,-0.057,8,-13,29,81,H1
"Harrison County, MO",2013-2014,8736,8639,-97,-1.11,1,-98,29,81,H1
"Harrison County, MO",2014-2015,8634,8615,-19,-0.22,-12,-7,29,81,H1
"Harrison County, MO",2015-2016,8615,8590,-25,-0.29,-2,-23,29,81,H1
"Harrison County, MO",2016-2017,8590,8524,-66,-0.768,-14,-52,29,81,H1
"Henry County, MO",2000-2001,22108,22307,199,0.9,-4,203,29,83,H1
"Henry County, MO",2001-2002,22307,22179,-128,-0.574,-26,-102,29,83,H1
"Henry County, MO",2002-2003,22179,22410,231,1.042,-2,233,29,83,H1
"Henry County, MO",2003-2004,22410,22442,32,0.143,-37,69,29,83,H1
"Henry County, MO",2004-2005,22442,22354,-88,-0.392,-28,-60,29,83,H1
"Henry County, MO",2005-2006,22354,22556,202,0.904,11,191,29,83,H1
"Henry County, MO",2006-2007,22556,22474,-82,-0.364,-8,-74,29,83,H1
"Henry County, MO",2007-2008,22474,22291,-183,-0.814,-40,-143,29,83,H1
"Henry County, MO",2008-2009,22291,22277,-14,-0.063,-37,23,29,83,H1
"Henry County, MO",2009-2010,22277,22241,-36,-0.162,-19,-17,29,83,H1
"Henry County, MO",2010-2011,22241,22188,-53,-0.238,-39,-14,29,83,H1
"Henry County, MO",2011-2012,22188,22150,-38,-0.171,-51,13,29,83,H1
"Henry County, MO",2012-2013,22150,22061,-89,-0.402,-35,-54,29,83,H1
"Henry County, MO",2013-2014,22061,22028,-33,-0.15,-31,-2,29,83,H1
"Henry County, MO",2014-2015,22021,21737,-284,-1.29,-39,-245,29,83,H1
"Henry County, MO",2015-2016,21737,21617,-120,-0.552,-50,-70,29,83,H1
"Henry County, MO",2016-2017,21617,21718,101,0.467,-36,137,29,83,H1
"Hickory County, MO",2000-2001,8940,9036,96,1.074,-49,145,29,85,H1
"Hickory County, MO",2001-2002,9036,8929,-107,-1.184,-74,-33,29,85,H1
"Hickory County, MO",2002-2003,8929,9171,242,2.71,-56,298,29,85,H1
"Hickory County, MO",2003-2004,9171,9316,145,1.581,-67,212,29,85,H1
"Hickory County, MO",2004-2005,9316,9476,160,1.717,-68,228,29,85,H1
"Hickory County, MO",2005-2006,9476,9518,42,0.443,-78,120,29,85,H1
"Hickory County, MO",2006-2007,9518,9594,76,0.798,-23,99,29,85,H1
"Hickory County, MO",2007-2008,9594,9592,-2,-0.021,-47,45,29,85,H1
"Hickory County, MO",2008-2009,9592,9561,-31,-0.323,-62,31,29,85,H1
"Hickory County, MO",2009-2010,9561,9633,72,0.753,-63,135,29,85,H1
"Hickory County, MO",2010-2011,9633,9583,-50,-0.519,-71,21,29,85,H1
"Hickory County, MO",2011-2012,9583,9392,-191,-1.993,-81,-110,29,85,H1
"Hickory County, MO",2012-2013,9392,9274,-118,-1.256,-63,-55,29,85,H1
"Hickory County, MO",2013-2014,9274,9219,-55,-0.593,-60,5,29,85,H1
"Hickory County, MO",2014-2015,9228,9201,-27,-0.293,-63,36,29,85,H1
"Hickory County, MO",2015-2016,9201,9374,173,1.88,-76,249,29,85,H1
"Hickory County, MO",2016-2017,9374,9475,101,1.077,-48,149,29,85,H1
"Holt County, MO",2000-2001,5326,5310,-16,-0.3,-19,3,29,87,H1
"Holt County, MO",2001-2002,5310,5148,-162,-3.051,-18,-144,29,87,H1
"Holt County, MO",2002-2003,5148,5154,6,0.117,-21,27,29,87,H1
"Holt County, MO",2003-2004,5154,5116,-38,-0.737,-2,-36,29,87,H1
"Holt County, MO",2004-2005,5116,5047,-69,-1.349,-11,-58,29,87,H1
"Holt County, MO",2005-2006,5047,4976,-71,-1.407,-16,-55,29,87,H1
"Holt County, MO",2006-2007,4976,4997,21,0.422,-14,35,29,87,H1
"Holt County, MO",2007-2008,4997,4926,-71,-1.421,4,-75,29,87,H1
"Holt County, MO",2008-2009,4926,4911,-15,-0.305,-1,-14,29,87,H1
"Holt County, MO",2009-2010,4911,4900,-11,-0.224,-5,-6,29,87,H1
"Holt County, MO",2010-2011,4900,4830,-70,-1.429,-6,-64,29,87,H1
"Holt County, MO",2011-2012,4830,4656,-174,-3.602,-14,-160,29,87,H1
"Holt County, MO",2012-2013,4656,4571,-85,-1.826,-19,-66,29,87,H1
"Holt County, MO",2013-2014,4571,4516,-55,-1.203,-15,-40,29,87,H1
"Holt County, MO",2014-2015,4520,4484,-36,-0.796,-7,-29,29,87,H1
"Holt County, MO",2015-2016,4484,4479,-5,-0.112,0,-5,29,87,H1
"Holt County, MO",2016-2017,4479,4413,-66,-1.474,-7,-59,29,87,H1
"Howard County, MO",2000-2001,10182,10155,-27,-0.265,13,-40,29,89,H1
"Howard County, MO",2001-2002,10155,10072,-83,-0.817,-2,-81,29,89,H1
"Howard County, MO",2002-2003,10072,10056,-16,-0.159,-21,5,29,89,H1
"Howard County, MO",2003-2004,10056,10012,-44,-0.438,-3,-41,29,89,H1
"Howard County, MO",2004-2005,10012,10091,79,0.789,25,54,29,89,H1
"Howard County, MO",2005-2006,10091,10089,-2,-0.02,3,-5,29,89,H1
"Howard County, MO",2006-2007,10089,10079,-10,-0.099,5,-15,29,89,H1
"Howard County, MO",2007-2008,10079,10138,59,0.585,-5,64,29,89,H1
"Howard County, MO",2008-2009,10138,10172,34,0.335,8,26,29,89,H1
"Howard County, MO",2009-2010,10172,10127,-45,-0.442,12,-57,29,89,H1
"Howard County, MO",2010-2011,10127,10189,62,0.612,-6,68,29,89,H1
"Howard County, MO",2011-2012,10189,10181,-8,-0.079,40,-48,29,89,H1
"Howard County, MO",2012-2013,10181,10260,79,0.776,37,42,29,89,H1
"Howard County, MO",2013-2014,10260,10159,-101,-0.984,35,-136,29,89,H1
"Howard County, MO",2014-2015,10141,10139,-2,-0.02,42,-44,29,89,H1
"Howard County, MO",2015-2016,10139,10062,-77,-0.759,35,-112,29,89,H1
"Howard County, MO",2016-2017,10062,10139,77,0.765,37,40,29,89,H1
"Howell County, MO",2000-2001,37285,37259,-26,-0.07,-3,-23,29,91,H1
"Howell County, MO",2001-2002,37259,37429,170,0.456,11,159,29,91,H1
"Howell County, MO",2002-2003,37429,37717,288,0.769,61,227,29,91,H1
"Howell County, MO",2003-2004,37717,38036,319,0.846,48,271,29,91,H1
"Howell County, MO",2004-2005,38036,38704,668,1.756,36,632,29,91,H1
"Howell County, MO",2005-2006,38704,39067,363,0.938,41,322,29,91,H1
"Howell County, MO",2006-2007,39067,39391,324,0.829,75,249,29,91,H1
"Howell County, MO",2007-2008,39391,39910,519,1.318,100,419,29,91,H1
"Howell County, MO",2008-2009,39910,39917,7,0.018,71,-64,29,91,H1
"Howell County, MO",2009-2010,39917,40608,691,1.731,44,647,29,91,H1
"Howell County, MO",2010-2011,40608,40642,34,0.084,64,-30,29,91,H1
"Howell County, MO",2011-2012,40642,40622,-20,-0.049,41,-61,29,91,H1
"Howell County, MO",2012-2013,40622,40298,-324,-0.798,-18,-306,29,91,H1
"Howell County, MO",2013-2014,40298,40173,-125,-0.31,-11,-114,29,91,H1
"Howell County, MO",2014-2015,40116,40117,1,0.002,20,-19,29,91,H1
"Howell County, MO",2015-2016,40117,40140,23,0.057,16,7,29,91,H1
"Howell County, MO",2016-2017,40140,40103,-37,-0.092,0,-37,29,91,H1
"Iron County, MO",2000-2001,10628,10616,-12,-0.113,-46,34,29,93,H1
"Iron County, MO",2001-2002,10616,10608,-8,-0.075,-40,32,29,93,H1
"Iron County, MO",2002-2003,10608,10508,-100,-0.943,-43,-57,29,93,H1
"Iron County, MO",2003-2004,10508,10617,109,1.037,-25,134,29,93,H1
"Iron County, MO",2004-2005,10617,10630,13,0.122,-46,59,29,93,H1
"Iron County, MO",2005-2006,10630,10710,80,0.753,1,79,29,93,H1
"Iron County, MO",2006-2007,10710,10681,-29,-0.271,3,-32,29,93,H1
"Iron County, MO",2007-2008,10681,10667,-14,-0.131,-49,35,29,93,H1
"Iron County, MO",2008-2009,10667,10715,48,0.45,-42,90,29,93,H1
"Iron County, MO",2009-2010,10715,10601,-114,-1.064,-48,-66,29,93,H1
"Iron County, MO",2010-2011,10601,10485,-116,-1.094,-31,-85,29,93,H1
"Iron County, MO",2011-2012,10485,10424,-61,-0.582,-20,-41,29,93,H1
"Iron County, MO",2012-2013,10424,10344,-80,-0.767,-18,-62,29,93,H1
"Iron County, MO",2013-2014,10344,10267,-77,-0.744,-40,-37,29,93,H1
"Iron County, MO",2014-2015,10240,10125,-115,-1.123,-58,-57,29,93,H1
"Iron County, MO",2015-2016,10125,10147,22,0.217,-33,55,29,93,H1
"Iron County, MO",2016-2017,10147,10226,79,0.779,-42,121,29,93,H1
"Jackson County, MO",2000-2001,655709,657012,1303,0.199,3968,-2665,29,95,H1
"Jackson County, MO",2001-2002,657012,658765,1753,0.267,4031,-2278,29,95,H1
"Jackson County, MO",2002-2003,658765,658914,149,0.023,4331,-4182,29,95,H1
"Jackson County, MO",2003-2004,658914,658307,-607,-0.092,4410,-5017,29,95,H1
"Jackson County, MO",2004-2005,658307,658592,285,0.043,4222,-3937,29,95,H1
"Jackson County, MO",2005-2006,658592,660539,1947,0.296,4596,-2649,29,95,H1
"Jackson County, MO",2006-2007,660539,662995,2456,0.372,4525,-2069,29,95,H1
"Jackson County, MO",2007-2008,662995,665427,2432,0.367,4571,-2139,29,95,H1
"Jackson County, MO",2008-2009,665427,670763,5336,0.802,4352,984,29,95,H1
"Jackson County, MO",2009-2010,670763,674920,4157,0.62,4774,-617,29,95,H1
"Jackson County, MO",2010-2011,674920,675251,331,0.049,3460,-3129,29,95,H1
"Jackson County, MO",2011-2012,675251,677390,2139,0.317,3630,-1491,29,95,H1
"Jackson County, MO",2012-2013,677390,680082,2692,0.397,3440,-748,29,95,H1
"Jackson County, MO",2013-2014,680082,683191,3109,0.457,3319,-210,29,95,H1
"Jackson County, MO",2014-2015,683683,687623,3940,0.576,3347,593,29,95,H1
"Jackson County, MO",2015-2016,687623,693115,5492,0.799,3045,2447,29,95,H1
"Jackson County, MO",2016-2017,693115,698895,5780,0.834,2969,2811,29,95,H1
"Jasper County, MO",2000-2001,104966,105628,662,0.631,634,28,29,97,H1
"Jasper County, MO",2001-2002,105628,106684,1056,1,614,442,29,97,H1
"Jasper County, MO",2002-2003,106684,107690,1006,0.943,563,443,29,97,H1
"Jasper County, MO",2003-2004,107690,108897,1207,1.121,581,626,29,97,H1
"Jasper County, MO",2004-2005,108897,110219,1322,1.214,771,551,29,97,H1
"Jasper County, MO",2005-2006,110219,112030,1811,1.643,700,1111,29,97,H1
"Jasper County, MO",2006-2007,112030,113754,1724,1.539,726,998,29,97,H1
"Jasper County, MO",2007-2008,113754,115144,1390,1.222,785,605,29,97,H1
"Jasper County, MO",2008-2009,115144,116448,1304,1.132,759,545,29,97,H1
"Jasper County, MO",2009-2010,116448,117774,1326,1.139,698,628,29,97,H1
"Jasper County, MO",2010-2011,117774,117858,84,0.071,534,-450,29,97,H1
"Jasper County, MO",2011-2012,117858,115382,-2476,-2.101,603,-3079,29,97,H1
"Jasper County, MO",2012-2013,115382,116424,1042,0.903,601,441,29,97,H1
"Jasper County, MO",2013-2014,116424,117543,1119,0.961,650,469,29,97,H1
"Jasper County, MO",2014-2015,117566,118596,1030,0.876,596,434,29,97,H1
"Jasper County, MO",2015-2016,118596,119298,702,0.592,532,170,29,97,H1
"Jasper County, MO",2016-2017,119298,120217,919,0.77,507,412,29,97,H1
"Jefferson County, MO",2000-2001,198937,200682,1745,0.877,1138,607,29,99,H1
"Jefferson County, MO",2001-2002,200682,202477,1795,0.894,1093,702,29,99,H1
"Jefferson County, MO",2002-2003,202477,204912,2435,1.203,1120,1315,29,99,H1
"Jefferson County, MO",2003-2004,204912,207829,2917,1.424,1210,1707,29,99,H1
"Jefferson County, MO",2004-2005,207829,210142,2313,1.113,1346,967,29,99,H1
"Jefferson County, MO",2005-2006,210142,213105,2963,1.41,1255,1708,29,99,H1
"Jefferson County, MO",2006-2007,213105,214948,1843,0.865,1404,439,29,99,H1
"Jefferson County, MO",2007-2008,214948,216409,1461,0.68,1240,221,29,99,H1
"Jefferson County, MO",2008-2009,216409,217764,1355,0.626,1227,128,29,99,H1
"Jefferson County, MO",2009-2010,217764,219083,1319,0.606,1065,254,29,99,H1
"Jefferson County, MO",2010-2011,219083,219644,561,0.256,846,-285,29,99,H1
"Jefferson County, MO",2011-2012,219644,220102,458,0.209,816,-358,29,99,H1
"Jefferson County, MO",2012-2013,220102,221245,1143,0.519,885,258,29,99,H1
"Jefferson County, MO",2013-2014,221245,222716,1471,0.665,764,707,29,99,H1
"Jefferson County, MO",2014-2015,222644,224124,1480,0.665,640,840,29,99,H1
"Jefferson County, MO",2015-2016,224124,223413,-711,-0.317,590,-1301,29,99,H1
"Jefferson County, MO",2016-2017,223413,223810,397,0.178,459,-62,29,99,H1
"Johnson County, MO",2000-2001,48534,49355,821,1.692,374,447,29,101,H1
"Johnson County, MO",2001-2002,49355,49796,441,0.894,340,101,29,101,H1
"Johnson County, MO",2002-2003,49796,50027,231,0.464,366,-135,29,101,H1
"Johnson County, MO",2003-2004,50027,50905,878,1.755,435,443,29,101,H1
"Johnson County, MO",2004-2005,50905,51178,273,0.536,340,-67,29,101,H1
"Johnson County, MO",2005-2006,51178,51500,322,0.629,396,-74,29,101,H1
"Johnson County, MO",2006-2007,51500,51750,250,0.485,426,-176,29,101,H1
"Johnson County, MO",2007-2008,51750,51889,139,0.269,417,-278,29,101,H1
"Johnson County, MO",2008-2009,51889,52351,462,0.89,393,69,29,101,H1
"Johnson County, MO",2009-2010,52351,52702,351,0.67,405,-54,29,101,H1
"Johnson County, MO",2010-2011,52702,53432,730,1.385,301,429,29,101,H1
"Johnson County, MO",2011-2012,53432,54418,986,1.845,357,629,29,101,H1
"Johnson County, MO",2012-2013,54418,54482,64,0.118,358,-294,29,101,H1
"Johnson County, MO",2013-2014,54482,54362,-120,-0.22,351,-471,29,101,H1
"Johnson County, MO",2014-2015,54410,53951,-459,-0.844,355,-814,29,101,H1
"Johnson County, MO",2015-2016,53951,53651,-300,-0.556,262,-562,29,101,H1
"Johnson County, MO",2016-2017,53651,53897,246,0.459,289,-43,29,101,H1
"Knox County, MO",2000-2001,4356,4296,-60,-1.377,-5,-55,29,103,H1
"Knox County, MO",2001-2002,4296,4282,-14,-0.326,-13,-1,29,103,H1
"Knox County, MO",2002-2003,4282,4254,-28,-0.654,-10,-18,29,103,H1
"Knox County, MO",2003-2004,4254,4236,-18,-0.423,4,-22,29,103,H1
"Knox County, MO",2004-2005,4236,4188,-48,-1.133,-8,-40,29,103,H1
"Knox County, MO",2005-2006,4188,4158,-30,-0.716,-4,-26,29,103,H1
"Knox County, MO",2006-2007,4158,4152,-6,-0.144,-22,16,29,103,H1
"Knox County, MO",2007-2008,4152,4117,-35,-0.843,-13,-22,29,103,H1
"Knox County, MO",2008-2009,4117,4111,-6,-0.146,-11,5,29,103,H1
"Knox County, MO",2009-2010,4111,4125,14,0.341,-3,17,29,103,H1
"Knox County, MO",2010-2011,4125,4111,-14,-0.339,-13,-1,29,103,H1
"Knox County, MO",2011-2012,4111,4084,-27,-0.657,-3,-24,29,103,H1
"Knox County, MO",2012-2013,4084,4070,-14,-0.343,14,-28,29,103,H1
"Knox County, MO",2013-2014,4070,4.00E+03,-70,-1.72,11,-81,29,103,H1
"Knox County, MO",2014-2015,3996,3910,-86,-2.152,14,-100,29,103,H1
"Knox County, MO",2015-2016,3910,3945,35,0.895,10,25,29,103,H1
"Knox County, MO",2016-2017,3945,3977,32,0.811,-1,33,29,103,H1
"Laclede County, MO",2000-2001,32598,32889,291,0.893,139,152,29,105,H1
"Laclede County, MO",2001-2002,32889,32862,-27,-0.082,80,-107,29,105,H1
"Laclede County, MO",2002-2003,32862,33155,293,0.892,106,187,29,105,H1
"Laclede County, MO",2003-2004,33155,33513,358,1.08,117,241,29,105,H1
"Laclede County, MO",2004-2005,33513,34236,723,2.157,145,578,29,105,H1
"Laclede County, MO",2005-2006,34236,34937,701,2.048,184,517,29,105,H1
"Laclede County, MO",2006-2007,34937,35333,396,1.133,140,256,29,105,H1
"Laclede County, MO",2007-2008,35333,35518,185,0.524,149,36,29,105,H1
"Laclede County, MO",2008-2009,35518,35355,-163,-0.459,135,-298,29,105,H1
"Laclede County, MO",2009-2010,35355,35654,299,0.846,90,209,29,105,H1
"Laclede County, MO",2010-2011,35654,35577,-77,-0.216,86,-163,29,105,H1
"Laclede County, MO",2011-2012,35577,35412,-165,-0.464,99,-264,29,105,H1
"Laclede County, MO",2012-2013,35412,35640,228,0.644,61,167,29,105,H1
"Laclede County, MO",2013-2014,35640,35439,-201,-0.564,84,-285,29,105,H1
"Laclede County, MO",2014-2015,35471,35473,2,0.006,97,-95,29,105,H1
"Laclede County, MO",2015-2016,35473,35427,-46,-0.13,105,-151,29,105,H1
"Laclede County, MO",2016-2017,35427,35443,16,0.045,101,-85,29,105,H1
"Lafayette County, MO",2000-2001,3.30E+04,32927,-73,-0.221,7,-80,29,107,H1
"Lafayette County, MO",2001-2002,32927,32984,57,0.173,-27,84,29,107,H1
"Lafayette County, MO",2002-2003,32984,33081,97,0.294,55,42,29,107,H1
"Lafayette County, MO",2003-2004,33081,33110,29,0.088,20,9,29,107,H1
"Lafayette County, MO",2004-2005,33110,33280,170,0.513,82,88,29,107,H1
"Lafayette County, MO",2005-2006,33280,33288,8,0.024,2,6,29,107,H1
"Lafayette County, MO",2006-2007,33288,33186,-102,-0.306,71,-173,29,107,H1
"Lafayette County, MO",2007-2008,33186,33434,248,0.747,60,188,29,107,H1
"Lafayette County, MO",2008-2009,33434,33246,-188,-0.562,49,-237,29,107,H1
"Lafayette County, MO",2009-2010,33246,33409,163,0.49,11,152,29,107,H1
"Lafayette County, MO",2010-2011,33409,33241,-168,-0.503,73,-241,29,107,H1
"Lafayette County, MO",2011-2012,33241,33109,-132,-0.397,27,-159,29,107,H1
"Lafayette County, MO",2012-2013,33109,32898,-211,-0.637,-1,-210,29,107,H1
"Lafayette County, MO",2013-2014,32898,32688,-210,-0.638,40,-250,29,107,H1
"Lafayette County, MO",2014-2015,32671,32701,30,0.092,22,8,29,107,H1
"Lafayette County, MO",2015-2016,32701,32542,-159,-0.486,-56,-103,29,107,H1
"Lafayette County, MO",2016-2017,32542,32641,99,0.304,-6,105,29,107,H1
"Lawrence County, MO",2000-2001,35352,35665,313,0.885,56,257,29,109,H1
"Lawrence County, MO",2001-2002,35665,36234,569,1.595,70,499,29,109,H1
"Lawrence County, MO",2002-2003,36234,36441,207,0.571,104,103,29,109,H1
"Lawrence County, MO",2003-2004,36441,36798,357,0.98,99,258,29,109,H1
"Lawrence County, MO",2004-2005,36798,37399,601,1.633,113,488,29,109,H1
"Lawrence County, MO",2005-2006,37399,37779,380,1.016,51,329,29,109,H1
"Lawrence County, MO",2006-2007,37779,38323,544,1.44,120,424,29,109,H1
"Lawrence County, MO",2007-2008,38323,38508,185,0.483,119,66,29,109,H1
"Lawrence County, MO",2008-2009,38508,38652,144,0.374,118,26,29,109,H1
"Lawrence County, MO",2009-2010,38652,38575,-77,-0.199,106,-183,29,109,H1
"Lawrence County, MO",2010-2011,38575,38464,-111,-0.288,54,-165,29,109,H1
"Lawrence County, MO",2011-2012,38464,38373,-91,-0.237,62,-153,29,109,H1
"Lawrence County, MO",2012-2013,38373,38095,-278,-0.724,60,-338,29,109,H1
"Lawrence County, MO",2013-2014,38095,38023,-72,-0.189,63,-135,29,109,H1
"Lawrence County, MO",2014-2015,38026,38180,154,0.405,73,81,29,109,H1
"Lawrence County, MO",2015-2016,38180,38224,44,0.115,81,-37,29,109,H1
"Lawrence County, MO",2016-2017,38224,38434,210,0.549,64,146,29,109,H1
"Lewis County, MO",2000-2001,10500,10420,-80,-0.762,-19,-61,29,111,H1
"Lewis County, MO",2001-2002,10420,10408,-12,-0.115,11,-23,29,111,H1
"Lewis County, MO",2002-2003,10408,10354,-54,-0.519,18,-72,29,111,H1
"Lewis County, MO",2003-2004,10354,10319,-35,-0.338,-20,-15,29,111,H1
"Lewis County, MO",2004-2005,10319,10272,-47,-0.455,-19,-28,29,111,H1
"Lewis County, MO",2005-2006,10272,10286,14,0.136,-22,36,29,111,H1
"Lewis County, MO",2006-2007,10286,10286,0,0,21,-21,29,111,H1
"Lewis County, MO",2007-2008,10286,10196,-90,-0.875,12,-102,29,111,H1
"Lewis County, MO",2008-2009,10196,10204,8,0.078,2,6,29,111,H1
"Lewis County, MO",2009-2010,10204,10200,-4,-0.039,-5,1,29,111,H1
"Lewis County, MO",2010-2011,10200,10239,39,0.382,9,30,29,111,H1
"Lewis County, MO",2011-2012,10239,10160,-79,-0.772,-5,-74,29,111,H1
"Lewis County, MO",2012-2013,10160,10145,-15,-0.148,15,-30,29,111,H1
"Lewis County, MO",2013-2014,10145,10138,-7,-0.069,14,-21,29,111,H1
"Lewis County, MO",2014-2015,10126,10207,81,0.8,20,61,29,111,H1
"Lewis County, MO",2015-2016,10207,10083,-124,-1.215,12,-136,29,111,H1
"Lewis County, MO",2016-2017,10083,9967,-116,-1.15,6,-122,29,111,H1
"Lincoln County, MO",2000-2001,39196,40610,1414,3.608,258,1156,29,113,H1
"Lincoln County, MO",2001-2002,40610,41970,1360,3.349,265,1095,29,113,H1
"Lincoln County, MO",2002-2003,41970,43580,1610,3.836,236,1374,29,113,H1
"Lincoln County, MO",2003-2004,43580,44995,1415,3.247,259,1156,29,113,H1
"Lincoln County, MO",2004-2005,44995,46945,1950,4.334,366,1584,29,113,H1
"Lincoln County, MO",2005-2006,46945,49117,2172,4.627,371,1801,29,113,H1
"Lincoln County, MO",2006-2007,49117,50758,1641,3.341,403,1238,29,113,H1
"Lincoln County, MO",2007-2008,50758,51847,1089,2.145,391,698,29,113,H1
"Lincoln County, MO",2008-2009,51847,52243,396,0.764,404,-8,29,113,H1
"Lincoln County, MO",2009-2010,52243,52708,465,0.89,342,123,29,113,H1
"Lincoln County, MO",2010-2011,52708,53107,399,0.757,324,75,29,113,H1
"Lincoln County, MO",2011-2012,53107,53348,241,0.454,289,-48,29,113,H1
"Lincoln County, MO",2012-2013,53348,53878,530,0.993,299,231,29,113,H1
"Lincoln County, MO",2013-2014,53878,54249,371,0.689,312,59,29,113,H1
"Lincoln County, MO",2014-2015,54256,54696,440,0.811,307,133,29,113,H1
"Lincoln County, MO",2015-2016,54696,55186,490,0.896,224,266,29,113,H1
"Lincoln County, MO",2016-2017,55186,56183,997,1.807,297,700,29,113,H1
"Linn County, MO",2000-2001,13722,13617,-105,-0.765,-57,-48,29,115,H1
"Linn County, MO",2001-2002,13617,13495,-122,-0.896,-16,-106,29,115,H1
"Linn County, MO",2002-2003,13495,13365,-130,-0.963,-5,-125,29,115,H1
"Linn County, MO",2003-2004,13365,13256,-109,-0.816,-18,-91,29,115,H1
"Linn County, MO",2004-2005,13256,13074,-182,-1.373,-31,-151,29,115,H1
"Linn County, MO",2005-2006,13074,12928,-146,-1.117,21,-167,29,115,H1
"Linn County, MO",2006-2007,12928,12875,-53,-0.41,3,-56,29,115,H1
"Linn County, MO",2007-2008,12875,12788,-87,-0.676,-5,-82,29,115,H1
"Linn County, MO",2008-2009,12788,12775,-13,-0.102,-22,9,29,115,H1
"Linn County, MO",2009-2010,12775,12753,-22,-0.172,-6,-16,29,115,H1
"Linn County, MO",2010-2011,12753,12572,-181,-1.419,-39,-142,29,115,H1
"Linn County, MO",2011-2012,12572,12486,-86,-0.684,-40,-46,29,115,H1
"Linn County, MO",2012-2013,12486,12349,-137,-1.097,-26,-111,29,115,H1
"Linn County, MO",2013-2014,12349,12311,-38,-0.308,-38,0,29,115,H1
"Linn County, MO",2014-2015,12326,12308,-18,-0.146,-10,-8,29,115,H1
"Linn County, MO",2015-2016,12308,12140,-168,-1.365,-36,-132,29,115,H1
"Linn County, MO",2016-2017,12140,12194,54,0.445,-25,79,29,115,H1
"Livingston County, MO",2000-2001,14519,14596,77,0.53,-23,100,29,117,H1
"Livingston County, MO",2001-2002,14596,14556,-40,-0.274,-25,-15,29,117,H1
"Livingston County, MO",2002-2003,14556,14589,33,0.227,-38,71,29,117,H1
"Livingston County, MO",2003-2004,14589,14604,15,0.103,5,10,29,117,H1
"Livingston County, MO",2004-2005,14604,14624,20,0.137,-26,46,29,117,H1
"Livingston County, MO",2005-2006,14624,14717,93,0.636,-35,128,29,117,H1
"Livingston County, MO",2006-2007,14717,14852,135,0.917,-12,147,29,117,H1
"Livingston County, MO",2007-2008,14852,14929,77,0.518,-36,113,29,117,H1
"Livingston County, MO",2008-2009,14929,15110,181,1.212,-17,198,29,117,H1
"Livingston County, MO",2009-2010,15110,15114,4,0.026,-14,18,29,117,H1
"Livingston County, MO",2010-2011,15114,15108,-6,-0.04,-31,25,29,117,H1
"Livingston County, MO",2011-2012,15108,15023,-85,-0.563,-32,-53,29,117,H1
"Livingston County, MO",2012-2013,15023,14870,-153,-1.018,-10,-143,29,117,H1
"Livingston County, MO",2013-2014,14870,15053,183,1.231,-11,194,29,117,H1
"Livingston County, MO",2014-2015,15092,15028,-64,-0.424,-30,-34,29,117,H1
"Livingston County, MO",2015-2016,15028,15138,110,0.732,-50,160,29,117,H1
"Livingston County, MO",2016-2017,15138,15173,35,0.231,-27,62,29,117,H1
"McDonald County, MO",2000-2001,21665,21688,23,0.106,155,-132,29,119,H1
"McDonald County, MO",2001-2002,21688,21712,24,0.111,162,-138,29,119,H1
"McDonald County, MO",2002-2003,21712,22105,393,1.81,170,223,29,119,H1
"McDonald County, MO",2003-2004,22105,22410,305,1.38,168,137,29,119,H1
"McDonald County, MO",2004-2005,22410,22718,308,1.374,159,149,29,119,H1
"McDonald County, MO",2005-2006,22718,22977,259,1.14,189,70,29,119,H1
"McDonald County, MO",2006-2007,22977,22996,19,0.083,141,-122,29,119,H1
"McDonald County, MO",2007-2008,22996,22943,-53,-0.23,155,-208,29,119,H1
"McDonald County, MO",2008-2009,22943,23076,133,0.58,190,-57,29,119,H1
"McDonald County, MO",2009-2010,23076,23065,-11,-0.048,150,-161,29,119,H1
"McDonald County, MO",2010-2011,23065,22870,-195,-0.845,92,-287,29,119,H1
"McDonald County, MO",2011-2012,22870,22920,50,0.219,109,-59,29,119,H1
"McDonald County, MO",2012-2013,22920,22600,-320,-1.396,112,-432,29,119,H1
"McDonald County, MO",2013-2014,22600,22800,200,0.885,98,102,29,119,H1
"McDonald County, MO",2014-2015,22792,22643,-149,-0.654,91,-240,29,119,H1
"McDonald County, MO",2015-2016,22643,22767,124,0.548,133,-9,29,119,H1
"McDonald County, MO",2016-2017,22767,22828,61,0.268,138,-77,29,119,H1
"Macon County, MO",2000-2001,15734,15613,-121,-0.769,-31,-90,29,121,H1
"Macon County, MO",2001-2002,15613,15441,-172,-1.102,-31,-141,29,121,H1
"Macon County, MO",2002-2003,15441,15568,127,0.822,-38,165,29,121,H1
"Macon County, MO",2003-2004,15568,15497,-71,-0.456,-40,-31,29,121,H1
"Macon County, MO",2004-2005,15497,15595,98,0.632,-13,111,29,121,H1
"Macon County, MO",2005-2006,15595,15562,-33,-0.212,-30,-3,29,121,H1
"Macon County, MO",2006-2007,15562,15533,-29,-0.186,-27,-2,29,121,H1
"Macon County, MO",2007-2008,15533,15512,-21,-0.135,-32,11,29,121,H1
"Macon County, MO",2008-2009,15512,15509,-3,-0.019,-13,10,29,121,H1
"Macon County, MO",2009-2010,15509,15605,96,0.619,-5,101,29,121,H1
"Macon County, MO",2010-2011,15605,15482,-123,-0.788,-20,-103,29,121,H1
"Macon County, MO",2011-2012,15482,15556,74,0.478,-33,107,29,121,H1
"Macon County, MO",2012-2013,15556,15512,-44,-0.283,-2,-42,29,121,H1
"Macon County, MO",2013-2014,15512,15479,-33,-0.213,-2,-31,29,121,H1
"Macon County, MO",2014-2015,15469,15335,-134,-0.866,9,-143,29,121,H1
"Macon County, MO",2015-2016,15335,15143,-192,-1.252,-42,-150,29,121,H1
"Macon County, MO",2016-2017,15143,15251,108,0.713,-5,113,29,121,H1
"Madison County, MO",2000-2001,11853,11855,2,0.017,-5,7,29,123,H1
"Madison County, MO",2001-2002,11855,11877,22,0.186,-24,46,29,123,H1
"Madison County, MO",2002-2003,11877,11835,-42,-0.354,-12,-30,29,123,H1
"Madison County, MO",2003-2004,11835,11937,102,0.862,1,101,29,123,H1
"Madison County, MO",2004-2005,11937,12007,70,0.586,-8,78,29,123,H1
"Madison County, MO",2005-2006,12007,12130,123,1.024,2,121,29,123,H1
"Madison County, MO",2006-2007,12130,12310,180,1.484,-9,189,29,123,H1
"Madison County, MO",2007-2008,12310,12396,86,0.699,-10,96,29,123,H1
"Madison County, MO",2008-2009,12396,12313,-83,-0.67,-14,-69,29,123,H1
"Madison County, MO",2009-2010,12313,12202,-111,-0.901,2,-113,29,123,H1
"Madison County, MO",2010-2011,12202,12332,130,1.065,1,129,29,123,H1
"Madison County, MO",2011-2012,12332,12467,135,1.095,-36,171,29,123,H1
"Madison County, MO",2012-2013,12467,12398,-69,-0.553,-30,-39,29,123,H1
"Madison County, MO",2013-2014,12398,12368,-30,-0.242,-43,13,29,123,H1
"Madison County, MO",2014-2015,12385,12408,23,0.186,-31,54,29,123,H1
"Madison County, MO",2015-2016,12408,12231,-177,-1.426,-11,-166,29,123,H1
"Madison County, MO",2016-2017,12231,12243,12,0.098,-27,39,29,123,H1
"Maries County, MO",2000-2001,8918,8822,-96,-1.076,10,-106,29,125,H1
"Maries County, MO",2001-2002,8822,8824,2,0.023,1,1,29,125,H1
"Maries County, MO",2002-2003,8824,8850,26,0.295,-19,45,29,125,H1
"Maries County, MO",2003-2004,8850,9077,227,2.565,15,212,29,125,H1
"Maries County, MO",2004-2005,9077,9170,93,1.025,31,62,29,125,H1
"Maries County, MO",2005-2006,9170,9235,65,0.709,7,58,29,125,H1
"Maries County, MO",2006-2007,9235,9281,46,0.498,-15,61,29,125,H1
"Maries County, MO",2007-2008,9281,9191,-90,-0.97,20,-110,29,125,H1
"Maries County, MO",2008-2009,9191,9122,-69,-0.751,0,-69,29,125,H1
"Maries County, MO",2009-2010,9122,9176,54,0.592,-7,61,29,125,H1
"Maries County, MO",2010-2011,9176,9198,22,0.24,-21,43,29,125,H1
"Maries County, MO",2011-2012,9198,9036,-162,-1.761,-6,-156,29,125,H1
"Maries County, MO",2012-2013,9036,9065,29,0.321,-13,42,29,125,H1
"Maries County, MO",2013-2014,9065,9013,-52,-0.574,-9,-43,29,125,H1
"Maries County, MO",2014-2015,9006,8963,-43,-0.477,-26,-17,29,125,H1
"Maries County, MO",2015-2016,8963,8874,-89,-0.993,5,-94,29,125,H1
"Maries County, MO",2016-2017,8874,8867,-7,-0.079,-10,3,29,125,H1
"Marion County, MO",2000-2001,28285,28115,-170,-0.601,99,-269,29,127,H1
"Marion County, MO",2001-2002,28115,28067,-48,-0.171,52,-100,29,127,H1
"Marion County, MO",2002-2003,28067,28282,215,0.766,5,210,29,127,H1
"Marion County, MO",2003-2004,28282,28193,-89,-0.315,4,-93,29,127,H1
"Marion County, MO",2004-2005,28193,28309,116,0.411,29,87,29,127,H1
"Marion County, MO",2005-2006,28309,28468,159,0.562,40,119,29,127,H1
"Marion County, MO",2006-2007,28468,28365,-103,-0.362,80,-183,29,127,H1
"Marion County, MO",2007-2008,28365,28550,185,0.652,95,90,29,127,H1
"Marion County, MO",2008-2009,28550,28720,170,0.595,64,106,29,127,H1
"Marion County, MO",2009-2010,28720,28792,72,0.251,27,45,29,127,H1
"Marion County, MO",2010-2011,28792,28796,4,0.014,59,-55,29,127,H1
"Marion County, MO",2011-2012,28796,28809,13,0.045,23,-10,29,127,H1
"Marion County, MO",2012-2013,28809,28901,92,0.319,95,-3,29,127,H1
"Marion County, MO",2013-2014,28901,28920,19,0.066,67,-48,29,127,H1
"Marion County, MO",2014-2015,28875,28880,5,0.017,65,-60,29,127,H1
"Marion County, MO",2015-2016,28880,28667,-213,-0.738,31,-244,29,127,H1
"Marion County, MO",2016-2017,28667,28634,-33,-0.115,68,-101,29,127,H1
"Mercer County, MO",2000-2001,3747,3750,3,0.08,-14,17,29,129,H1
"Mercer County, MO",2001-2002,3750,3699,-51,-1.36,-3,-48,29,129,H1
"Mercer County, MO",2002-2003,3699,3717,18,0.487,8,10,29,129,H1
"Mercer County, MO",2003-2004,3717,3701,-16,-0.43,-3,-13,29,129,H1
"Mercer County, MO",2004-2005,3701,3684,-17,-0.459,4,-21,29,129,H1
"Mercer County, MO",2005-2006,3684,3668,-16,-0.434,8,-24,29,129,H1
"Mercer County, MO",2006-2007,3668,3684,16,0.436,3,13,29,129,H1
"Mercer County, MO",2007-2008,3684,3748,64,1.737,21,43,29,129,H1
"Mercer County, MO",2008-2009,3748,3776,28,0.747,4,24,29,129,H1
"Mercer County, MO",2009-2010,3776,3774,-2,-0.053,11,-13,29,129,H1
"Mercer County, MO",2010-2011,3774,3780,6,0.159,-7,13,29,129,H1
"Mercer County, MO",2011-2012,3780,3714,-66,-1.746,-9,-57,29,129,H1
"Mercer County, MO",2012-2013,3714,3689,-25,-0.673,9,-34,29,129,H1
"Mercer County, MO",2013-2014,3689,3719,30,0.813,16,14,29,129,H1
"Mercer County, MO",2014-2015,3711,3694,-17,-0.458,-4,-13,29,129,H1
"Mercer County, MO",2015-2016,3694,3658,-36,-0.975,11,-47,29,129,H1
"Mercer County, MO",2016-2017,3658,3678,20,0.547,10,10,29,129,H1
"Miller County, MO",2000-2001,23617,23911,294,1.245,35,259,29,131,H1
"Miller County, MO",2001-2002,23911,24082,171,0.715,46,125,29,131,H1
"Miller County, MO",2002-2003,24082,24056,-26,-0.108,29,-55,29,131,H1
"Miller County, MO",2003-2004,24056,24488,432,1.796,68,364,29,131,H1
"Miller County, MO",2004-2005,24488,24582,94,0.384,57,37,29,131,H1
"Miller County, MO",2005-2006,24582,24759,177,0.72,42,135,29,131,H1
"Miller County, MO",2006-2007,24759,24843,84,0.339,115,-31,29,131,H1
"Miller County, MO",2007-2008,24843,24867,24,0.097,44,-20,29,131,H1
"Miller County, MO",2008-2009,24867,24840,-27,-0.109,45,-72,29,131,H1
"Miller County, MO",2009-2010,24840,24725,-115,-0.463,48,-163,29,131,H1
"Miller County, MO",2010-2011,24725,24841,116,0.469,42,74,29,131,H1
"Miller County, MO",2011-2012,24841,24753,-88,-0.354,-30,-58,29,131,H1
"Miller County, MO",2012-2013,24753,25066,313,1.264,51,262,29,131,H1
"Miller County, MO",2013-2014,25066,25141,75,0.299,42,33,29,131,H1
"Miller County, MO",2014-2015,25077,25113,36,0.144,46,-10,29,131,H1
"Miller County, MO",2015-2016,25113,24994,-119,-0.474,31,-150,29,131,H1
"Miller County, MO",2016-2017,24994,25228,234,0.936,52,182,29,131,H1
"Mississippi County, MO",2000-2001,13395,13424,29,0.216,47,-18,29,133,H1
"Mississippi County, MO",2001-2002,13424,13526,102,0.76,22,80,29,133,H1
"Mississippi County, MO",2002-2003,13526,13626,100,0.739,28,72,29,133,H1
"Mississippi County, MO",2003-2004,13626,13669,43,0.316,-13,56,29,133,H1
"Mississippi County, MO",2004-2005,13669,13872,203,1.485,21,182,29,133,H1
"Mississippi County, MO",2005-2006,13872,14033,161,1.161,26,135,29,133,H1
"Mississippi County, MO",2006-2007,14033,14058,25,0.178,16,9,29,133,H1
"Mississippi County, MO",2007-2008,14058,14087,29,0.206,-10,39,29,133,H1
"Mississippi County, MO",2008-2009,14087,14146,59,0.419,19,40,29,133,H1
"Mississippi County, MO",2009-2010,14146,14334,188,1.329,32,156,29,133,H1
"Mississippi County, MO",2010-2011,14334,14257,-77,-0.537,-31,-46,29,133,H1
"Mississippi County, MO",2011-2012,14257,14305,48,0.337,10,38,29,133,H1
"Mississippi County, MO",2012-2013,14305,14251,-54,-0.377,5,-59,29,133,H1
"Mississippi County, MO",2013-2014,14251,14232,-19,-0.133,-5,-14,29,133,H1
"Mississippi County, MO",2014-2015,14221,14036,-185,-1.301,-10,-175,29,133,H1
"Mississippi County, MO",2015-2016,14036,13737,-299,-2.13,1,-300,29,133,H1
"Mississippi County, MO",2016-2017,13737,13586,-151,-1.099,-32,-119,29,133,H1
"Moniteau County, MO",2000-2001,14847,14805,-42,-0.283,23,-65,29,135,H1
"Moniteau County, MO",2001-2002,14805,15006,201,1.358,50,151,29,135,H1
"Moniteau County, MO",2002-2003,15006,15105,99,0.66,71,28,29,135,H1
"Moniteau County, MO",2003-2004,15105,15082,-23,-0.152,52,-75,29,135,H1
"Moniteau County, MO",2004-2005,15082,15312,230,1.525,76,154,29,135,H1
"Moniteau County, MO",2005-2006,15312,15340,28,0.183,61,-33,29,135,H1
"Moniteau County, MO",2006-2007,15340,15416,76,0.495,82,-6,29,135,H1
"Moniteau County, MO",2007-2008,15416,15424,8,0.052,103,-95,29,135,H1
"Moniteau County, MO",2008-2009,15424,15545,121,0.784,79,42,29,135,H1
"Moniteau County, MO",2009-2010,15545,15621,76,0.489,79,-3,29,135,H1
"Moniteau County, MO",2010-2011,15621,15696,75,0.48,60,15,29,135,H1
"Moniteau County, MO",2011-2012,15696,15671,-25,-0.159,73,-98,29,135,H1
"Moniteau County, MO",2012-2013,15671,15750,79,0.504,70,9,29,135,H1
"Moniteau County, MO",2013-2014,15750,15856,106,0.673,69,37,29,135,H1
"Moniteau County, MO",2014-2015,15882,15963,81,0.51,61,20,29,135,H1
"Moniteau County, MO",2015-2016,15963,16007,44,0.276,72,-28,29,135,H1
"Moniteau County, MO",2016-2017,16007,16063,56,0.35,45,11,29,135,H1
"Monroe County, MO",2000-2001,9329,9291,-38,-0.407,23,-61,29,137,H1
"Monroe County, MO",2001-2002,9291,9259,-32,-0.344,-3,-29,29,137,H1
"Monroe County, MO",2002-2003,9259,9274,15,0.162,1,14,29,137,H1
"Monroe County, MO",2003-2004,9274,9254,-20,-0.216,-15,-5,29,137,H1
"Monroe County, MO",2004-2005,9254,9209,-45,-0.486,-7,-38,29,137,H1
"Monroe County, MO",2005-2006,9209,9219,10,0.109,-10,20,29,137,H1
"Monroe County, MO",2006-2007,9219,9216,-3,-0.033,-18,15,29,137,H1
"Monroe County, MO",2007-2008,9216,9157,-59,-0.64,3,-62,29,137,H1
"Monroe County, MO",2008-2009,9157,9014,-143,-1.562,10,-153,29,137,H1
"Monroe County, MO",2009-2010,9014,8795,-219,-2.43,-4,-215,29,137,H1
"Monroe County, MO",2010-2011,8795,8685,-110,-1.251,17,-127,29,137,H1
"Monroe County, MO",2011-2012,8685,8686,1,0.012,-8,9,29,137,H1
"Monroe County, MO",2012-2013,8686,8754,68,0.783,20,48,29,137,H1
"Monroe County, MO",2013-2014,8754,8707,-47,-0.537,9,-56,29,137,H1
"Monroe County, MO",2014-2015,8695,8583,-112,-1.288,5,-117,29,137,H1
"Monroe County, MO",2015-2016,8583,8637,54,0.629,8,46,29,137,H1
"Monroe County, MO",2016-2017,8637,8612,-25,-0.289,12,-37,29,137,H1
"Montgomery County, MO",2000-2001,12141,12120,-21,-0.173,-8,-13,29,139,H1
"Montgomery County, MO",2001-2002,12120,12084,-36,-0.297,-9,-27,29,139,H1
"Montgomery County, MO",2002-2003,12084,12095,11,0.091,-11,22,29,139,H1
"Montgomery County, MO",2003-2004,12095,12236,141,1.166,26,115,29,139,H1
"Montgomery County, MO",2004-2005,12236,12285,49,0.4,9,40,29,139,H1
"Montgomery County, MO",2005-2006,12285,12242,-43,-0.35,-36,-7,29,139,H1
"Montgomery County, MO",2006-2007,12242,12299,57,0.466,13,44,29,139,H1
"Montgomery County, MO",2007-2008,12299,12273,-26,-0.211,-6,-20,29,139,H1
"Montgomery County, MO",2008-2009,12273,12179,-94,-0.766,-5,-89,29,139,H1
"Montgomery County, MO",2009-2010,12179,12238,59,0.484,-18,77,29,139,H1
"Montgomery County, MO",2010-2011,12238,12228,-10,-0.082,-2,-8,29,139,H1
"Montgomery County, MO",2011-2012,12228,12024,-204,-1.668,-14,-190,29,139,H1
"Montgomery County, MO",2012-2013,12024,11940,-84,-0.699,6,-90,29,139,H1
"Montgomery County, MO",2013-2014,11940,11841,-99,-0.829,0,-99,29,139,H1
"Montgomery County, MO",2014-2015,11816,11703,-113,-0.956,-23,-90,29,139,H1
"Montgomery County, MO",2015-2016,11703,11477,-226,-1.931,-40,-186,29,139,H1
"Montgomery County, MO",2016-2017,11477,11438,-39,-0.34,-30,-9,29,139,H1
"Morgan County, MO",2000-2001,19291,19543,252,1.306,-8,260,29,141,H1
"Morgan County, MO",2001-2002,19543,19588,45,0.23,-29,74,29,141,H1
"Morgan County, MO",2002-2003,19588,19831,243,1.241,-45,288,29,141,H1
"Morgan County, MO",2003-2004,19831,20106,275,1.387,-13,288,29,141,H1
"Morgan County, MO",2004-2005,20106,20273,167,0.831,-10,177,29,141,H1
"Morgan County, MO",2005-2006,20273,20570,297,1.465,41,256,29,141,H1
"Morgan County, MO",2006-2007,20570,20716,146,0.71,17,129,29,141,H1
"Morgan County, MO",2007-2008,20716,20745,29,0.14,35,-6,29,141,H1
"Morgan County, MO",2008-2009,20745,20566,-179,-0.863,-4,-175,29,141,H1
"Morgan County, MO",2009-2010,20566,20563,-3,-0.015,-12,9,29,141,H1
"Morgan County, MO",2010-2011,20563,20396,-167,-0.812,-69,-98,29,141,H1
"Morgan County, MO",2011-2012,20396,20141,-255,-1.25,-33,-222,29,141,H1
"Morgan County, MO",2012-2013,20141,20232,91,0.452,-39,130,29,141,H1
"Morgan County, MO",2013-2014,20232,20240,8,0.04,-22,30,29,141,H1
"Morgan County, MO",2014-2015,20212,20171,-41,-0.203,-25,-16,29,141,H1
"Morgan County, MO",2015-2016,20171,20099,-72,-0.357,-22,-50,29,141,H1
"Morgan County, MO",2016-2017,20099,20145,46,0.229,-34,80,29,141,H1
"New Madrid County, MO",2000-2001,19657,19638,-19,-0.097,15,-34,29,143,H1
"New Madrid County, MO",2001-2002,19638,19416,-222,-1.13,-9,-213,29,143,H1
"New Madrid County, MO",2002-2003,19416,19405,-11,-0.057,-4,-7,29,143,H1
"New Madrid County, MO",2003-2004,19405,19235,-170,-0.876,4,-174,29,143,H1
"New Madrid County, MO",2004-2005,19235,18919,-316,-1.643,50,-366,29,143,H1
"New Madrid County, MO",2005-2006,18919,18821,-98,-0.518,-3,-95,29,143,H1
"New Madrid County, MO",2006-2007,18821,18780,-41,-0.218,1,-42,29,143,H1
"New Madrid County, MO",2007-2008,18780,18805,25,0.133,8,17,29,143,H1
"New Madrid County, MO",2008-2009,18805,18896,91,0.484,23,68,29,143,H1
"New Madrid County, MO",2009-2010,18896,18931,35,0.185,41,-6,29,143,H1
"New Madrid County, MO",2010-2011,18931,18789,-142,-0.75,-27,-115,29,143,H1
"New Madrid County, MO",2011-2012,18789,18479,-310,-1.65,-43,-267,29,143,H1
"New Madrid County, MO",2012-2013,18479,18368,-111,-0.601,21,-132,29,143,H1
"New Madrid County, MO",2013-2014,18368,18272,-96,-0.523,11,-107,29,143,H1
"New Madrid County, MO",2014-2015,18248,18208,-40,-0.219,21,-61,29,143,H1
"New Madrid County, MO",2015-2016,18208,17890,-318,-1.746,25,-343,29,143,H1
"New Madrid County, MO",2016-2017,17890,17582,-308,-1.722,-15,-293,29,143,H1
"Newton County, MO",2000-2001,52699,52939,240,0.455,176,64,29,145,H1
"Newton County, MO",2001-2002,52939,53408,469,0.886,195,274,29,145,H1
"Newton County, MO",2002-2003,53408,54347,939,1.758,193,746,29,145,H1
"Newton County, MO",2003-2004,54347,55100,753,1.386,202,551,29,145,H1
"Newton County, MO",2004-2005,55100,55941,841,1.526,223,618,29,145,H1
"Newton County, MO",2005-2006,55941,56671,730,1.305,248,482,29,145,H1
"Newton County, MO",2006-2007,56671,57470,799,1.41,291,508,29,145,H1
"Newton County, MO",2007-2008,57470,57600,130,0.226,210,-80,29,145,H1
"Newton County, MO",2008-2009,57600,57946,346,0.601,195,151,29,145,H1
"Newton County, MO",2009-2010,57946,58148,202,0.349,244,-42,29,145,H1
"Newton County, MO",2010-2011,58148,58822,674,1.159,171,503,29,145,H1
"Newton County, MO",2011-2012,58822,59063,241,0.41,205,36,29,145,H1
"Newton County, MO",2012-2013,59063,58785,-278,-0.471,40,-318,29,145,H1
"Newton County, MO",2013-2014,58785,58598,-187,-0.318,114,-301,29,145,H1
"Newton County, MO",2014-2015,58596,58615,19,0.032,136,-117,29,145,H1
"Newton County, MO",2015-2016,58615,58219,-396,-0.676,46,-442,29,145,H1
"Newton County, MO",2016-2017,58219,58290,71,0.122,75,-4,29,145,H1
"Nodaway County, MO",2000-2001,21897,22070,173,0.79,44,129,29,147,H1
"Nodaway County, MO",2001-2002,22070,22239,169,0.766,4,165,29,147,H1
"Nodaway County, MO",2002-2003,22239,22319,80,0.36,30,50,29,147,H1
"Nodaway County, MO",2003-2004,22319,22517,198,0.887,43,155,29,147,H1
"Nodaway County, MO",2004-2005,22517,22588,71,0.315,46,25,29,147,H1
"Nodaway County, MO",2005-2006,22588,22698,110,0.487,49,61,29,147,H1
"Nodaway County, MO",2006-2007,22698,22804,106,0.467,35,71,29,147,H1
"Nodaway County, MO",2007-2008,22804,23026,222,0.974,53,169,29,147,H1
"Nodaway County, MO",2008-2009,23026,23242,216,0.938,78,138,29,147,H1
"Nodaway County, MO",2009-2010,23242,23375,133,0.572,78,55,29,147,H1
"Nodaway County, MO",2010-2011,23375,23428,53,0.227,23,30,29,147,H1
"Nodaway County, MO",2011-2012,23428,23367,-61,-0.26,12,-73,29,147,H1
"Nodaway County, MO",2012-2013,23367,23229,-138,-0.591,53,-191,29,147,H1
"Nodaway County, MO",2013-2014,23229,23081,-148,-0.637,47,-195,29,147,H1
"Nodaway County, MO",2014-2015,23090,22810,-280,-1.213,55,-335,29,147,H1
"Nodaway County, MO",2015-2016,22810,22492,-318,-1.394,50,-368,29,147,H1
"Nodaway County, MO",2016-2017,22492,22472,-20,-0.089,65,-85,29,147,H1
"Oregon County, MO",2000-2001,10327,10219,-108,-1.046,-37,-71,29,149,H1
"Oregon County, MO",2001-2002,10219,10328,109,1.067,-32,141,29,149,H1
"Oregon County, MO",2002-2003,10328,10422,94,0.91,-13,107,29,149,H1
"Oregon County, MO",2003-2004,10422,10503,81,0.777,-19,100,29,149,H1
"Oregon County, MO",2004-2005,10503,10513,10,0.095,-34,44,29,149,H1
"Oregon County, MO",2005-2006,10513,10669,156,1.484,11,145,29,149,H1
"Oregon County, MO",2006-2007,10669,10685,16,0.15,-23,39,29,149,H1
"Oregon County, MO",2007-2008,10685,10697,12,0.112,-8,20,29,149,H1
"Oregon County, MO",2008-2009,10697,10724,27,0.252,-7,34,29,149,H1
"Oregon County, MO",2009-2010,10724,10922,198,1.846,-10,208,29,149,H1
"Oregon County, MO",2010-2011,10922,11056,134,1.227,-14,148,29,149,H1
"Oregon County, MO",2011-2012,11056,10997,-59,-0.534,17,-76,29,149,H1
"Oregon County, MO",2012-2013,10997,10989,-8,-0.073,-19,11,29,149,H1
"Oregon County, MO",2013-2014,10989,10911,-78,-0.71,-16,-62,29,149,H1
"Oregon County, MO",2014-2015,10890,10953,63,0.579,5,58,29,149,H1
"Oregon County, MO",2015-2016,10953,10739,-214,-1.954,-31,-183,29,149,H1
"Oregon County, MO",2016-2017,10739,10558,-181,-1.685,-27,-154,29,149,H1
"Osage County, MO",2000-2001,13026,13046,20,0.154,23,-3,29,151,H1
"Osage County, MO",2001-2002,13046,13073,27,0.207,19,8,29,151,H1
"Osage County, MO",2002-2003,13073,13315,242,1.851,81,161,29,151,H1
"Osage County, MO",2003-2004,13315,13361,46,0.345,75,-29,29,151,H1
"Osage County, MO",2004-2005,13361,13507,146,1.093,74,72,29,151,H1
"Osage County, MO",2005-2006,13507,13687,180,1.333,66,114,29,151,H1
"Osage County, MO",2006-2007,13687,13648,-39,-0.285,94,-133,29,151,H1
"Osage County, MO",2007-2008,13648,13753,105,0.769,27,78,29,151,H1
"Osage County, MO",2008-2009,13753,13886,133,0.967,50,83,29,151,H1
"Osage County, MO",2009-2010,13886,13875,-11,-0.079,64,-75,29,151,H1
"Osage County, MO",2010-2011,13875,13918,43,0.31,11,32,29,151,H1
"Osage County, MO",2011-2012,13918,13860,-58,-0.417,32,-90,29,151,H1
"Osage County, MO",2012-2013,13860,13704,-156,-1.126,31,-187,29,151,H1
"Osage County, MO",2013-2014,13704,13703,-1,-0.007,28,-29,29,151,H1
"Osage County, MO",2014-2015,13691,13628,-63,-0.46,13,-76,29,151,H1
"Osage County, MO",2015-2016,13628,13596,-32,-0.235,46,-78,29,151,H1
"Osage County, MO",2016-2017,13596,13662,66,0.485,39,27,29,151,H1
"Ozark County, MO",2000-2001,9532,9447,-85,-0.892,-28,-57,29,153,H1
"Ozark County, MO",2001-2002,9447,9496,49,0.519,-9,58,29,153,H1
"Ozark County, MO",2002-2003,9496,9582,86,0.906,-25,111,29,153,H1
"Ozark County, MO",2003-2004,9582,9555,-27,-0.282,-15,-12,29,153,H1
"Ozark County, MO",2004-2005,9555,9557,2,0.021,-37,39,29,153,H1
"Ozark County, MO",2005-2006,9557,9667,110,1.151,-11,121,29,153,H1
"Ozark County, MO",2006-2007,9667,9655,-12,-0.124,-10,-2,29,153,H1
"Ozark County, MO",2007-2008,9655,9718,63,0.653,-29,92,29,153,H1
"Ozark County, MO",2008-2009,9718,9673,-45,-0.463,-20,-25,29,153,H1
"Ozark County, MO",2009-2010,9673,9734,61,0.631,-34,95,29,153,H1
"Ozark County, MO",2010-2011,9734,9661,-73,-0.75,-38,-35,29,153,H1
"Ozark County, MO",2011-2012,9661,9624,-37,-0.383,-34,-3,29,153,H1
"Ozark County, MO",2012-2013,9624,9550,-74,-0.769,-31,-43,29,153,H1
"Ozark County, MO",2013-2014,9550,9492,-58,-0.607,-37,-21,29,153,H1
"Ozark County, MO",2014-2015,9473,9409,-64,-0.676,-47,-17,29,153,H1
"Ozark County, MO",2015-2016,9409,9187,-222,-2.359,-36,-186,29,153,H1
"Ozark County, MO",2016-2017,9187,9186,-1,-0.011,-53,52,29,153,H1
"Pemiscot County, MO",2000-2001,20060,19887,-173,-0.862,101,-274,29,155,H1
"Pemiscot County, MO",2001-2002,19887,19839,-48,-0.241,103,-151,29,155,H1
"Pemiscot County, MO",2002-2003,19839,19592,-247,-1.245,96,-343,29,155,H1
"Pemiscot County, MO",2003-2004,19592,19338,-254,-1.296,61,-315,29,155,H1
"Pemiscot County, MO",2004-2005,19338,19211,-127,-0.657,71,-198,29,155,H1
"Pemiscot County, MO",2005-2006,19211,18953,-258,-1.343,103,-361,29,155,H1
"Pemiscot County, MO",2006-2007,18953,18788,-165,-0.871,39,-204,29,155,H1
"Pemiscot County, MO",2007-2008,18788,18552,-236,-1.256,84,-320,29,155,H1
"Pemiscot County, MO",2008-2009,18552,18378,-174,-0.938,88,-262,29,155,H1
"Pemiscot County, MO",2009-2010,18378,18253,-125,-0.68,101,-226,29,155,H1
"Pemiscot County, MO",2010-2011,18253,18216,-37,-0.203,85,-122,29,155,H1
"Pemiscot County, MO",2011-2012,18216,18117,-99,-0.543,43,-142,29,155,H1
"Pemiscot County, MO",2012-2013,18117,17816,-301,-1.661,54,-355,29,155,H1
"Pemiscot County, MO",2013-2014,17816,17650,-166,-0.932,21,-187,29,155,H1
"Pemiscot County, MO",2014-2015,17608,17482,-126,-0.716,44,-170,29,155,H1
"Pemiscot County, MO",2015-2016,17482,17102,-380,-2.174,41,-421,29,155,H1
"Pemiscot County, MO",2016-2017,17102,16826,-276,-1.614,11,-287,29,155,H1
"Perry County, MO",2000-2001,18134,18171,37,0.204,24,13,29,157,H1
"Perry County, MO",2001-2002,18171,18318,147,0.809,74,73,29,157,H1
"Perry County, MO",2002-2003,18318,18313,-5,-0.027,45,-50,29,157,H1
"Perry County, MO",2003-2004,18313,18454,141,0.77,76,65,29,157,H1
"Perry County, MO",2004-2005,18454,18602,148,0.802,58,90,29,157,H1
"Perry County, MO",2005-2006,18602,18672,70,0.376,73,-3,29,157,H1
"Perry County, MO",2006-2007,18672,18961,289,1.548,128,161,29,157,H1
"Perry County, MO",2007-2008,18961,18976,15,0.079,51,-36,29,157,H1
"Perry County, MO",2008-2009,18976,19050,74,0.39,59,15,29,157,H1
"Perry County, MO",2009-2010,19050,18968,-82,-0.43,23,-105,29,157,H1
"Perry County, MO",2010-2011,18968,18898,-70,-0.369,33,-103,29,157,H1
"Perry County, MO",2011-2012,18898,19024,126,0.667,29,97,29,157,H1
"Perry County, MO",2012-2013,19024,19118,94,0.494,40,54,29,157,H1
"Perry County, MO",2013-2014,19118,19202,84,0.439,21,63,29,157,H1
"Perry County, MO",2014-2015,19222,19183,-39,-0.203,6,-45,29,157,H1
"Perry County, MO",2015-2016,19183,19201,18,0.094,16,2,29,157,H1
"Perry County, MO",2016-2017,19201,19225,24,0.125,3,21,29,157,H1
"Pettis County, MO",2000-2001,39486,39577,91,0.23,128,-37,29,159,H1
"Pettis County, MO",2001-2002,39577,39543,-34,-0.086,129,-163,29,159,H1
"Pettis County, MO",2002-2003,39543,39669,126,0.319,172,-46,29,159,H1
"Pettis County, MO",2003-2004,39669,39883,214,0.539,150,64,29,159,H1
"Pettis County, MO",2004-2005,39883,40455,572,1.434,200,372,29,159,H1
"Pettis County, MO",2005-2006,40455,40937,482,1.191,250,232,29,159,H1
"Pettis County, MO",2006-2007,40937,41239,302,0.738,234,68,29,159,H1
"Pettis County, MO",2007-2008,41239,41565,326,0.791,267,59,29,159,H1
"Pettis County, MO",2008-2009,41565,41907,342,0.823,225,117,29,159,H1
"Pettis County, MO",2009-2010,41907,42244,337,0.804,203,134,29,159,H1
"Pettis County, MO",2010-2011,42244,42118,-126,-0.298,141,-267,29,159,H1
"Pettis County, MO",2011-2012,42118,42279,161,0.382,183,-22,29,159,H1
"Pettis County, MO",2012-2013,42279,42199,-80,-0.189,181,-261,29,159,H1
"Pettis County, MO",2013-2014,42199,42225,26,0.062,184,-158,29,159,H1
"Pettis County, MO",2014-2015,42213,42255,42,0.099,193,-151,29,159,H1
"Pettis County, MO",2015-2016,42255,42280,25,0.059,123,-98,29,159,H1
"Pettis County, MO",2016-2017,42280,42558,278,0.658,156,122,29,159,H1
"Phelps County, MO",2000-2001,39945,40219,274,0.686,90,184,29,161,H1
"Phelps County, MO",2001-2002,40219,41193,974,2.422,46,928,29,161,H1
"Phelps County, MO",2002-2003,41193,41883,690,1.675,157,533,29,161,H1
"Phelps County, MO",2003-2004,41883,42616,733,1.75,93,640,29,161,H1
"Phelps County, MO",2004-2005,42616,43327,711,1.668,119,592,29,161,H1
"Phelps County, MO",2005-2006,43327,44025,698,1.611,230,468,29,161,H1
"Phelps County, MO",2006-2007,44025,44300,275,0.625,155,120,29,161,H1
"Phelps County, MO",2007-2008,44300,44200,-100,-0.226,113,-213,29,161,H1
"Phelps County, MO",2008-2009,44200,44540,340,0.769,100,240,29,161,H1
"Phelps County, MO",2009-2010,44540,45316,776,1.742,140,636,29,161,H1
"Phelps County, MO",2010-2011,45316,45175,-141,-0.311,107,-248,29,161,H1
"Phelps County, MO",2011-2012,45175,45183,8,0.018,162,-154,29,161,H1
"Phelps County, MO",2012-2013,45183,44936,-247,-0.547,104,-351,29,161,H1
"Phelps County, MO",2013-2014,44936,44847,-89,-0.198,115,-204,29,161,H1
"Phelps County, MO",2014-2015,44960,44794,-166,-0.369,100,-266,29,161,H1
"Phelps County, MO",2015-2016,44794,44828,34,0.076,59,-25,29,161,H1
"Phelps County, MO",2016-2017,44828,44744,-84,-0.187,54,-138,29,161,H1
"Pike County, MO",2000-2001,18301,18258,-43,-0.235,-24,-19,29,163,H1
"Pike County, MO",2001-2002,18258,18311,53,0.29,43,10,29,163,H1
"Pike County, MO",2002-2003,18311,18426,115,0.628,-2,117,29,163,H1
"Pike County, MO",2003-2004,18426,18434,8,0.043,44,-36,29,163,H1
"Pike County, MO",2004-2005,18434,18725,291,1.579,19,272,29,163,H1
"Pike County, MO",2005-2006,18725,18707,-18,-0.096,20,-38,29,163,H1
"Pike County, MO",2006-2007,18707,18588,-119,-0.636,26,-145,29,163,H1
"Pike County, MO",2007-2008,18588,18602,14,0.075,39,-25,29,163,H1
"Pike County, MO",2008-2009,18602,18544,-58,-0.312,49,-107,29,163,H1
"Pike County, MO",2009-2010,18544,18486,-58,-0.313,43,-101,29,163,H1
"Pike County, MO",2010-2011,18486,18652,166,0.898,51,115,29,163,H1
"Pike County, MO",2011-2012,18652,18551,-101,-0.541,48,-149,29,163,H1
"Pike County, MO",2012-2013,18551,18633,82,0.442,19,63,29,163,H1
"Pike County, MO",2013-2014,18633,18541,-92,-0.494,29,-121,29,163,H1
"Pike County, MO",2014-2015,18485,18348,-137,-0.741,16,-153,29,163,H1
"Pike County, MO",2015-2016,18348,18504,156,0.85,27,129,29,163,H1
"Pike County, MO",2016-2017,18504,18567,63,0.34,31,32,29,163,H1
"Platte County, MO",2000-2001,74316,76143,1827,2.458,530,1297,29,165,H1
"Platte County, MO",2001-2002,76143,77986,1843,2.42,510,1333,29,165,H1
"Platte County, MO",2002-2003,77986,79577,1591,2.04,614,977,29,165,H1
"Platte County, MO",2003-2004,79577,81106,1529,1.921,542,987,29,165,H1
"Platte County, MO",2004-2005,81106,82615,1509,1.861,597,912,29,165,H1
"Platte County, MO",2005-2006,82615,83913,1298,1.571,546,752,29,165,H1
"Platte County, MO",2006-2007,83913,85656,1743,2.077,561,1182,29,165,H1
"Platte County, MO",2007-2008,85656,87003,1347,1.573,568,779,29,165,H1
"Platte County, MO",2008-2009,87003,88219,1216,1.398,587,629,29,165,H1
"Platte County, MO",2009-2010,88219,89727,1508,1.709,509,999,29,165,H1
"Platte County, MO",2010-2011,89727,90852,1125,1.254,572,553,29,165,H1
"Platte County, MO",2011-2012,90852,92126,1274,1.402,553,721,29,165,H1
"Platte County, MO",2012-2013,92126,93253,1127,1.223,543,584,29,165,H1
"Platte County, MO",2013-2014,93253,94788,1535,1.646,578,957,29,165,H1
"Platte County, MO",2014-2015,94735,96096,1361,1.437,559,802,29,165,H1
"Platte County, MO",2015-2016,96096,98653,2557,2.661,542,2015,29,165,H1
"Platte County, MO",2016-2017,98653,101187,2534,2.569,584,1950,29,165,H1
"Polk County, MO",2000-2001,26999,27421,422,1.563,88,334,29,167,H1
"Polk County, MO",2001-2002,27421,27826,405,1.477,27,378,29,167,H1
"Polk County, MO",2002-2003,27826,28345,519,1.865,27,492,29,167,H1
"Polk County, MO",2003-2004,28345,28690,345,1.217,67,278,29,167,H1
"Polk County, MO",2004-2005,28690,29308,618,2.154,76,542,29,167,H1
"Polk County, MO",2005-2006,29308,30053,745,2.542,68,677,29,167,H1
"Polk County, MO",2006-2007,30053,30576,523,1.74,149,374,29,167,H1
"Polk County, MO",2007-2008,30576,30790,214,0.7,102,112,29,167,H1
"Polk County, MO",2008-2009,30790,31085,295,0.958,93,202,29,167,H1
"Polk County, MO",2009-2010,31085,31171,86,0.277,45,41,29,167,H1
"Polk County, MO",2010-2011,31171,31206,35,0.112,44,-9,29,167,H1
"Polk County, MO",2011-2012,31206,31105,-101,-0.324,27,-128,29,167,H1
"Polk County, MO",2012-2013,31105,31073,-32,-0.103,48,-80,29,167,H1
"Polk County, MO",2013-2014,31073,31054,-19,-0.061,0,-19,29,167,H1
"Polk County, MO",2014-2015,31032,31229,197,0.635,42,155,29,167,H1
"Polk County, MO",2015-2016,31229,31412,183,0.586,54,129,29,167,H1
"Polk County, MO",2016-2017,31412,31794,382,1.216,15,367,29,167,H1
"Pulaski County, MO",2000-2001,41957,43558,1601,3.816,336,1265,29,169,H1
"Pulaski County, MO",2001-2002,43558,44535,977,2.243,333,644,29,169,H1
"Pulaski County, MO",2002-2003,44535,44507,-28,-0.063,373,-401,29,169,H1
"Pulaski County, MO",2003-2004,44507,45301,794,1.784,345,449,29,169,H1
"Pulaski County, MO",2004-2005,45301,45570,269,0.594,411,-142,29,169,H1
"Pulaski County, MO",2005-2006,45570,46482,912,2.001,458,454,29,169,H1
"Pulaski County, MO",2006-2007,46482,47357,875,1.882,432,443,29,169,H1
"Pulaski County, MO",2007-2008,47357,48300,943,1.991,508,435,29,169,H1
"Pulaski County, MO",2008-2009,48300,50630,2330,4.824,443,1887,29,169,H1
"Pulaski County, MO",2009-2010,50630,52869,2239,4.422,562,1677,29,169,H1
"Pulaski County, MO",2010-2011,52869,53277,408,0.772,636,-228,29,169,H1
"Pulaski County, MO",2011-2012,53277,53389,112,0.21,468,-356,29,169,H1
"Pulaski County, MO",2012-2013,53389,53743,354,0.663,584,-230,29,169,H1
"Pulaski County, MO",2013-2014,53743,53436,-307,-0.571,570,-877,29,169,H1
"Pulaski County, MO",2014-2015,53535,53221,-314,-0.587,557,-871,29,169,H1
"Pulaski County, MO",2015-2016,53221,52611,-610,-1.146,500,-1110,29,169,H1
"Pulaski County, MO",2016-2017,52611,52059,-552,-1.049,498,-1050,29,169,H1
"Putnam County, MO",2000-2001,5231,5203,-28,-0.535,-17,-11,29,171,H1
"Putnam County, MO",2001-2002,5203,5180,-23,-0.442,-20,-3,29,171,H1
"Putnam County, MO",2002-2003,5180,5161,-19,-0.367,-32,13,29,171,H1
"Putnam County, MO",2003-2004,5161,5131,-30,-0.581,-4,-26,29,171,H1
"Putnam County, MO",2004-2005,5131,5153,22,0.429,-11,33,29,171,H1
"Putnam County, MO",2005-2006,5153,5167,14,0.272,9,5,29,171,H1
"Putnam County, MO",2006-2007,5167,5047,-120,-2.322,-28,-92,29,171,H1
"Putnam County, MO",2007-2008,5047,5028,-19,-0.376,-18,-1,29,171,H1
"Putnam County, MO",2008-2009,5028,4988,-40,-0.796,-19,-21,29,171,H1
"Putnam County, MO",2009-2010,4988,4967,-21,-0.421,-12,-9,29,171,H1
"Putnam County, MO",2010-2011,4967,4954,-13,-0.262,-3,-10,29,171,H1
"Putnam County, MO",2011-2012,4954,4930,-24,-0.484,-16,-8,29,171,H1
"Putnam County, MO",2012-2013,4930,4874,-56,-1.136,-12,-44,29,171,H1
"Putnam County, MO",2013-2014,4874,4829,-45,-0.923,0,-45,29,171,H1
"Putnam County, MO",2014-2015,4840,4858,18,0.372,5,13,29,171,H1
"Putnam County, MO",2015-2016,4858,4831,-27,-0.556,-4,-23,29,171,H1
"Putnam County, MO",2016-2017,4831,4811,-20,-0.414,3,-23,29,171,H1
"Ralls County, MO",2000-2001,9669,9704,35,0.362,-14,49,29,173,H1
"Ralls County, MO",2001-2002,9704,9755,51,0.526,-23,74,29,173,H1
"Ralls County, MO",2002-2003,9755,9755,0,0,-2,2,29,173,H1
"Ralls County, MO",2003-2004,9755,9792,37,0.379,15,22,29,173,H1
"Ralls County, MO",2004-2005,9792,9998,206,2.104,36,170,29,173,H1
"Ralls County, MO",2005-2006,9998,10092,94,0.94,33,61,29,173,H1
"Ralls County, MO",2006-2007,10092,10148,56,0.555,48,8,29,173,H1
"Ralls County, MO",2007-2008,10148,10117,-31,-0.305,46,-77,29,173,H1
"Ralls County, MO",2008-2009,10117,10109,-8,-0.079,22,-30,29,173,H1
"Ralls County, MO",2009-2010,10109,10175,66,0.653,18,48,29,173,H1
"Ralls County, MO",2010-2011,10175,10281,106,1.042,17,89,29,173,H1
"Ralls County, MO",2011-2012,10281,10238,-43,-0.418,16,-59,29,173,H1
"Ralls County, MO",2012-2013,10238,10172,-66,-0.645,-6,-60,29,173,H1
"Ralls County, MO",2013-2014,10172,10255,83,0.816,4,79,29,173,H1
"Ralls County, MO",2014-2015,10280,10196,-84,-0.817,23,-107,29,173,H1
"Ralls County, MO",2015-2016,10196,10228,32,0.314,-3,35,29,173,H1
"Ralls County, MO",2016-2017,10228,10224,-4,-0.039,3,-7,29,173,H1
"Randolph County, MO",2000-2001,24660,24679,19,0.077,44,-25,29,175,H1
"Randolph County, MO",2001-2002,24679,24701,22,0.089,67,-45,29,175,H1
"Randolph County, MO",2002-2003,24701,25010,309,1.251,32,277,29,175,H1
"Randolph County, MO",2003-2004,25010,25211,201,0.804,87,114,29,175,H1
"Randolph County, MO",2004-2005,25211,25451,240,0.952,99,141,29,175,H1
"Randolph County, MO",2005-2006,25451,25480,29,0.114,49,-20,29,175,H1
"Randolph County, MO",2006-2007,25480,25597,117,0.459,124,-7,29,175,H1
"Randolph County, MO",2007-2008,25597,25597,0,0,52,-52,29,175,H1
"Randolph County, MO",2008-2009,25597,25364,-233,-0.91,62,-295,29,175,H1
"Randolph County, MO",2009-2010,25364,25446,82,0.323,61,21,29,175,H1
"Randolph County, MO",2010-2011,25446,25259,-187,-0.735,39,-226,29,175,H1
"Randolph County, MO",2011-2012,25259,25305,46,0.182,0,46,29,175,H1
"Randolph County, MO",2012-2013,25305,24954,-351,-1.387,11,-362,29,175,H1
"Randolph County, MO",2013-2014,24954,25072,118,0.473,24,94,29,175,H1
"Randolph County, MO",2014-2015,25065,25104,39,0.156,33,6,29,175,H1
"Randolph County, MO",2015-2016,25104,24970,-134,-0.534,23,-157,29,175,H1
"Randolph County, MO",2016-2017,24970,24945,-25,-0.1,28,-53,29,175,H1
"Ray County, MO",2000-2001,23393,23427,34,0.145,59,-25,29,177,H1
"Ray County, MO",2001-2002,23427,23538,111,0.474,40,71,29,177,H1
"Ray County, MO",2002-2003,23538,23703,165,0.701,65,100,29,177,H1
"Ray County, MO",2003-2004,23703,23739,36,0.152,79,-43,29,177,H1
"Ray County, MO",2004-2005,23739,23605,-134,-0.564,5,-139,29,177,H1
"Ray County, MO",2005-2006,23605,23842,237,1.004,119,118,29,177,H1
"Ray County, MO",2006-2007,23842,23712,-130,-0.545,68,-198,29,177,H1
"Ray County, MO",2007-2008,23712,23764,52,0.219,44,8,29,177,H1
"Ray County, MO",2008-2009,23764,23541,-223,-0.938,44,-267,29,177,H1
"Ray County, MO",2009-2010,23541,23477,-64,-0.272,53,-117,29,177,H1
"Ray County, MO",2010-2011,23477,23320,-157,-0.669,19,-176,29,177,H1
"Ray County, MO",2011-2012,23320,23058,-262,-1.123,-7,-255,29,177,H1
"Ray County, MO",2012-2013,23058,23028,-30,-0.13,-2,-28,29,177,H1
"Ray County, MO",2013-2014,23028,22949,-79,-0.343,-27,-52,29,177,H1
"Ray County, MO",2014-2015,22950,22810,-140,-0.61,-13,-127,29,177,H1
"Ray County, MO",2015-2016,22810,22721,-89,-0.39,-6,-83,29,177,H1
"Ray County, MO",2016-2017,22721,22855,134,0.59,-19,153,29,177,H1
"Reynolds County, MO",2000-2001,6708,6557,-151,-2.251,-27,-124,29,179,H1
"Reynolds County, MO",2001-2002,6557,6664,107,1.632,-9,116,29,179,H1
"Reynolds County, MO",2002-2003,6664,6668,4,0.06,-26,30,29,179,H1
"Reynolds County, MO",2003-2004,6668,6717,49,0.735,-11,60,29,179,H1
"Reynolds County, MO",2004-2005,6717,6707,-10,-0.149,-22,12,29,179,H1
"Reynolds County, MO",2005-2006,6707,6707,0,0,-14,14,29,179,H1
"Reynolds County, MO",2006-2007,6707,6736,29,0.432,-7,36,29,179,H1
"Reynolds County, MO",2007-2008,6736,6688,-48,-0.713,-20,-28,29,179,H1
"Reynolds County, MO",2008-2009,6688,6667,-21,-0.314,-28,7,29,179,H1
"Reynolds County, MO",2009-2010,6667,6688,21,0.315,-19,40,29,179,H1
"Reynolds County, MO",2010-2011,6688,6691,3,0.045,-24,27,29,179,H1
"Reynolds County, MO",2011-2012,6691,6671,-20,-0.299,-11,-9,29,179,H1
"Reynolds County, MO",2012-2013,6671,6603,-68,-1.019,-6,-62,29,179,H1
"Reynolds County, MO",2013-2014,6603,6565,-38,-0.575,-26,-12,29,179,H1
"Reynolds County, MO",2014-2015,6540,6432,-108,-1.651,-32,-76,29,179,H1
"Reynolds County, MO",2015-2016,6432,6370,-62,-0.964,-10,-52,29,179,H1
"Reynolds County, MO",2016-2017,6370,6275,-95,-1.491,-25,-70,29,179,H1
"Ripley County, MO",2000-2001,13482,13460,-22,-0.163,19,-41,29,181,H1
"Ripley County, MO",2001-2002,13460,13608,148,1.1,5,143,29,181,H1
"Ripley County, MO",2002-2003,13608,13752,144,1.058,9,135,29,181,H1
"Ripley County, MO",2003-2004,13752,13843,91,0.662,8,83,29,181,H1
"Ripley County, MO",2004-2005,13843,13920,77,0.556,-13,90,29,181,H1
"Ripley County, MO",2005-2006,13920,14049,129,0.927,7,122,29,181,H1
"Ripley County, MO",2006-2007,14049,14059,10,0.071,-57,67,29,181,H1
"Ripley County, MO",2007-2008,14059,14039,-20,-0.142,-22,2,29,181,H1
"Ripley County, MO",2008-2009,14039,14033,-6,-0.043,-10,4,29,181,H1
"Ripley County, MO",2009-2010,14033,14106,73,0.52,12,61,29,181,H1
"Ripley County, MO",2010-2011,14106,14138,32,0.227,7,25,29,181,H1
"Ripley County, MO",2011-2012,14138,14035,-103,-0.729,-10,-93,29,181,H1
"Ripley County, MO",2012-2013,14035,14033,-2,-0.014,-10,8,29,181,H1
"Ripley County, MO",2013-2014,14033,13969,-64,-0.456,-31,-33,29,181,H1
"Ripley County, MO",2014-2015,13969,13802,-167,-1.196,-17,-150,29,181,H1
"Ripley County, MO",2015-2016,13802,13781,-21,-0.152,-22,1,29,181,H1
"Ripley County, MO",2016-2017,13781,13564,-217,-1.575,-29,-188,29,181,H1
"St. Charles County, MO",2000-2001,286218,294908,8690,3.036,2618,6072,29,183,H1
"St. Charles County, MO",2001-2002,294908,303224,8316,2.82,2532,5784,29,183,H1
"St. Charles County, MO",2002-2003,303224,311405,8181,2.698,2459,5722,29,183,H1
"St. Charles County, MO",2003-2004,311405,319729,8324,2.673,2549,5775,29,183,H1
"St. Charles County, MO",2004-2005,319729,328892,9163,2.866,2700,6463,29,183,H1
"St. Charles County, MO",2005-2006,328892,337952,9060,2.755,2532,6528,29,183,H1
"St. Charles County, MO",2006-2007,337952,345395,7443,2.202,2695,4748,29,183,H1
"St. Charles County, MO",2007-2008,345395,351179,5784,1.675,2737,3047,29,183,H1
"St. Charles County, MO",2008-2009,351179,356902,5723,1.63,2746,2977,29,183,H1
"St. Charles County, MO",2009-2010,356902,361671,4769,1.336,2322,2447,29,183,H1
"St. Charles County, MO",2010-2011,361671,365051,3380,0.935,2363,1017,29,183,H1
"St. Charles County, MO",2011-2012,365051,368791,3740,1.025,2041,1699,29,183,H1
"St. Charles County, MO",2012-2013,368791,373900,5109,1.385,2152,2957,29,183,H1
"St. Charles County, MO",2013-2014,373900,379493,5593,1.496,2048,3545,29,183,H1
"St. Charles County, MO",2014-2015,379952,385590,5638,1.484,2089,3549,29,183,H1
"St. Charles County, MO",2015-2016,385590,390795,5205,1.35,1843,3362,29,183,H1
"St. Charles County, MO",2016-2017,390795,395504,4709,1.205,1742,2967,29,183,H1
"St. Clair County, MO",2000-2001,9698,9656,-42,-0.433,-46,4,29,185,H1
"St. Clair County, MO",2001-2002,9656,9692,36,0.373,-42,78,29,185,H1
"St. Clair County, MO",2002-2003,9692,9656,-36,-0.371,-66,30,29,185,H1
"St. Clair County, MO",2003-2004,9656,9711,55,0.57,-39,94,29,185,H1
"St. Clair County, MO",2004-2005,9711,9733,22,0.227,-41,63,29,185,H1
"St. Clair County, MO",2005-2006,9733,9694,-39,-0.401,-51,12,29,185,H1
"St. Clair County, MO",2006-2007,9694,9802,108,1.114,-49,157,29,185,H1
"St. Clair County, MO",2007-2008,9802,9757,-45,-0.459,-23,-22,29,185,H1
"St. Clair County, MO",2008-2009,9757,9708,-49,-0.502,-30,-19,29,185,H1
"St. Clair County, MO",2009-2010,9708,9833,125,1.288,-57,182,29,185,H1
"St. Clair County, MO",2010-2011,9833,9718,-115,-1.17,-27,-88,29,185,H1
"St. Clair County, MO",2011-2012,9718,9530,-188,-1.935,-59,-129,29,185,H1
"St. Clair County, MO",2012-2013,9530,9509,-21,-0.22,-58,37,29,185,H1
"St. Clair County, MO",2013-2014,9509,9457,-52,-0.547,-56,4,29,185,H1
"St. Clair County, MO",2014-2015,9454,9440,-14,-0.148,-45,31,29,185,H1
"St. Clair County, MO",2015-2016,9440,9293,-147,-1.557,-51,-96,29,185,H1
"St. Clair County, MO",2016-2017,9293,9362,69,0.742,-55,124,29,185,H1
"Ste. Genevieve County, MO",2000-2001,17973,18013,40,0.223,24,16,29,186,H1
"Ste. Genevieve County, MO",2001-2002,18013,18039,26,0.144,-13,39,29,186,H1
"Ste. Genevieve County, MO",2002-2003,18039,18161,122,0.676,23,99,29,186,H1
"Ste. Genevieve County, MO",2003-2004,18161,18218,57,0.314,25,32,29,186,H1
"Ste. Genevieve County, MO",2004-2005,18218,18233,15,0.082,39,-24,29,186,H1
"Ste. Genevieve County, MO",2005-2006,18233,18263,30,0.165,10,20,29,186,H1
"Ste. Genevieve County, MO",2006-2007,18263,18293,30,0.164,48,-18,29,186,H1
"Ste. Genevieve County, MO",2007-2008,18293,18186,-107,-0.585,44,-151,29,186,H1
"Ste. Genevieve County, MO",2008-2009,18186,18156,-30,-0.165,22,-52,29,186,H1
"Ste. Genevieve County, MO",2009-2010,18156,18122,-34,-0.187,6,-40,29,186,H1
"Ste. Genevieve County, MO",2010-2011,18122,18241,119,0.657,8,111,29,186,H1
"Ste. Genevieve County, MO",2011-2012,18241,17872,-369,-2.023,-54,-315,29,186,H1
"Ste. Genevieve County, MO",2012-2013,17872,17934,62,0.347,-11,73,29,186,H1
"Ste. Genevieve County, MO",2013-2014,17934,17914,-20,-0.112,-10,-10,29,186,H1
"Ste. Genevieve County, MO",2014-2015,17984,17919,-65,-0.361,7,-72,29,186,H1
"Ste. Genevieve County, MO",2015-2016,17919,17880,-39,-0.218,-10,-29,29,186,H1
"Ste. Genevieve County, MO",2016-2017,17880,17843,-37,-0.207,-10,-27,29,186,H1
"St. Francois County, MO",2000-2001,55773,56242,469,0.841,-3,472,29,187,H1
"St. Francois County, MO",2001-2002,56242,56823,581,1.033,-17,598,29,187,H1
"St. Francois County, MO",2002-2003,56823,58118,1295,2.279,78,1217,29,187,H1
"St. Francois County, MO",2003-2004,58118,60829,2711,4.665,64,2647,29,187,H1
"St. Francois County, MO",2004-2005,60829,62298,1469,2.415,30,1439,29,187,H1
"St. Francois County, MO",2005-2006,62298,62917,619,0.994,95,524,29,187,H1
"St. Francois County, MO",2006-2007,62917,63636,719,1.143,201,518,29,187,H1
"St. Francois County, MO",2007-2008,63636,64280,644,1.012,139,505,29,187,H1
"St. Francois County, MO",2008-2009,64280,64864,584,0.909,93,491,29,187,H1
"St. Francois County, MO",2009-2010,64864,65521,657,1.013,64,593,29,187,H1
"St. Francois County, MO",2010-2011,65521,65552,31,0.047,-8,39,29,187,H1
"St. Francois County, MO",2011-2012,65552,65835,283,0.432,23,260,29,187,H1
"St. Francois County, MO",2012-2013,65835,66199,364,0.553,6,358,29,187,H1
"St. Francois County, MO",2013-2014,66199,65960,-239,-0.361,5,-244,29,187,H1
"St. Francois County, MO",2014-2015,65948,66520,572,0.867,-16,588,29,187,H1
"St. Francois County, MO",2015-2016,66520,66393,-127,-0.191,-44,-83,29,187,H1
"St. Francois County, MO",2016-2017,66393,66705,312,0.47,-68,380,29,187,H1
"St. Louis County, MO",2000-2001,1016178,1016243,65,0.006,2895,-2830,29,189,H1
"St. Louis County, MO",2001-2002,1016243,1014359,-1884,-0.185,2441,-4325,29,189,H1
"St. Louis County, MO",2002-2003,1014359,1011678,-2681,-0.264,2494,-5175,29,189,H1
"St. Louis County, MO",2003-2004,1011678,1007813,-3865,-0.382,2806,-6671,29,189,H1
"St. Louis County, MO",2004-2005,1007813,1004109,-3704,-0.368,2623,-6327,29,189,H1
"St. Louis County, MO",2005-2006,1004109,1002050,-2059,-0.205,2896,-4955,29,189,H1
"St. Louis County, MO",2006-2007,1002050,999389,-2661,-0.266,3190,-5851,29,189,H1
"St. Louis County, MO",2007-2008,999389,998331,-1058,-0.106,3019,-4077,29,189,H1
"St. Louis County, MO",2008-2009,998331,998618,287,0.029,2664,-2377,29,189,H1
"St. Louis County, MO",2009-2010,998618,998880,262,0.026,2847,-2585,29,189,H1
"St. Louis County, MO",2010-2011,998880,999067,187,0.019,2543,-2356,29,189,H1
"St. Louis County, MO",2011-2012,999067,1000800,1733,0.173,2498,-765,29,189,H1
"St. Louis County, MO",2012-2013,1000800,1001491,691,0.069,2010,-1319,29,189,H1
"St. Louis County, MO",2013-2014,1001491,1001876,385,0.038,1993,-1608,29,189,H1
"St. Louis County, MO",2014-2015,1002188,1003362,1174,0.117,2073,-899,29,189,H1
"St. Louis County, MO",2015-2016,1003362,998216,-5146,-0.513,1573,-6719,29,189,H1
"St. Louis County, MO",2016-2017,998216,996726,-1490,-0.149,1487,-2977,29,189,H1
"Saline County, MO",2000-2001,23747,23399,-348,-1.465,-28,-320,29,195,H1
"Saline County, MO",2001-2002,23399,22960,-439,-1.876,1,-440,29,195,H1
"Saline County, MO",2002-2003,22960,22896,-64,-0.279,51,-115,29,195,H1
"Saline County, MO",2003-2004,22896,23058,162,0.708,-5,167,29,195,H1
"Saline County, MO",2004-2005,23058,23053,-5,-0.022,-27,22,29,195,H1
"Saline County, MO",2005-2006,23053,23008,-45,-0.195,16,-61,29,195,H1
"Saline County, MO",2006-2007,23008,23029,21,0.091,38,-17,29,195,H1
"Saline County, MO",2007-2008,23029,22967,-62,-0.269,34,-96,29,195,H1
"Saline County, MO",2008-2009,22967,23221,254,1.106,77,177,29,195,H1
"Saline County, MO",2009-2010,23221,23409,188,0.81,87,101,29,195,H1
"Saline County, MO",2010-2011,23409,23331,-78,-0.333,66,-144,29,195,H1
"Saline County, MO",2011-2012,23331,23472,141,0.604,61,80,29,195,H1
"Saline County, MO",2012-2013,23472,23258,-214,-0.912,37,-251,29,195,H1
"Saline County, MO",2013-2014,23258,23347,89,0.383,60,29,29,195,H1
"Saline County, MO",2014-2015,23360,23258,-102,-0.437,64,-166,29,195,H1
"Saline County, MO",2015-2016,23258,22852,-406,-1.746,16,-422,29,195,H1
"Saline County, MO",2016-2017,22852,22660,-192,-0.84,7,-199,29,195,H1
"Schuyler County, MO",2000-2001,4178,4184,6,0.144,1,5,29,197,H1
"Schuyler County, MO",2001-2002,4184,4245,61,1.458,-11,72,29,197,H1
"Schuyler County, MO",2002-2003,4245,4264,19,0.448,-23,42,29,197,H1
"Schuyler County, MO",2003-2004,4264,4313,49,1.149,-7,56,29,197,H1
"Schuyler County, MO",2004-2005,4313,4280,-33,-0.765,-14,-19,29,197,H1
"Schuyler County, MO",2005-2006,4280,4267,-13,-0.304,-7,-6,29,197,H1
"Schuyler County, MO",2006-2007,4267,4313,46,1.078,-4,50,29,197,H1
"Schuyler County, MO",2007-2008,4313,4383,70,1.623,-8,78,29,197,H1
"Schuyler County, MO",2008-2009,4383,4414,31,0.707,-4,35,29,197,H1
"Schuyler County, MO",2009-2010,4414,4439,25,0.566,-6,31,29,197,H1
"Schuyler County, MO",2010-2011,4439,4385,-54,-1.216,7,-61,29,197,H1
"Schuyler County, MO",2011-2012,4385,4388,3,0.068,14,-11,29,197,H1
"Schuyler County, MO",2012-2013,4388,4359,-29,-0.661,5,-34,29,197,H1
"Schuyler County, MO",2013-2014,4359,4370,11,0.252,5,6,29,197,H1
"Schuyler County, MO",2014-2015,4391,4436,45,1.025,17,28,29,197,H1
"Schuyler County, MO",2015-2016,4436,4491,55,1.24,21,34,29,197,H1
"Schuyler County, MO",2016-2017,4491,4508,17,0.379,28,-11,29,197,H1
"Scotland County, MO",2000-2001,4976,4956,-20,-0.402,-10,-10,29,199,H1
"Scotland County, MO",2001-2002,4956,4877,-79,-1.594,-6,-73,29,199,H1
"Scotland County, MO",2002-2003,4877,4879,2,0.041,-4,6,29,199,H1
"Scotland County, MO",2003-2004,4879,4838,-41,-0.84,19,-60,29,199,H1
"Scotland County, MO",2004-2005,4838,4793,-45,-0.93,-12,-33,29,199,H1
"Scotland County, MO",2005-2006,4793,4823,30,0.626,7,23,29,199,H1
"Scotland County, MO",2006-2007,4823,4830,7,0.145,5,2,29,199,H1
"Scotland County, MO",2007-2008,4830,4818,-12,-0.248,23,-35,29,199,H1
"Scotland County, MO",2008-2009,4818,4842,24,0.498,6,18,29,199,H1
"Scotland County, MO",2009-2010,4842,4828,-14,-0.289,11,-25,29,199,H1
"Scotland County, MO",2010-2011,4828,4833,5,0.104,13,-8,29,199,H1
"Scotland County, MO",2011-2012,4833,4872,39,0.807,31,8,29,199,H1
"Scotland County, MO",2012-2013,4872,4916,44,0.903,32,12,29,199,H1
"Scotland County, MO",2013-2014,4916,4863,-53,-1.078,28,-81,29,199,H1
"Scotland County, MO",2014-2015,4858,4854,-4,-0.082,29,-33,29,199,H1
"Scotland County, MO",2015-2016,4854,4908,54,1.112,41,13,29,199,H1
"Scotland County, MO",2016-2017,4908,4963,55,1.121,50,5,29,199,H1
"Scott County, MO",2000-2001,40371,40206,-165,-0.409,133,-298,29,201,H1
"Scott County, MO",2001-2002,40206,39885,-321,-0.798,178,-499,29,201,H1
"Scott County, MO",2002-2003,39885,39850,-35,-0.088,139,-174,29,201,H1
"Scott County, MO",2003-2004,39850,39704,-146,-0.366,188,-334,29,201,H1
"Scott County, MO",2004-2005,39704,39719,15,0.038,209,-194,29,201,H1
"Scott County, MO",2005-2006,39719,39626,-93,-0.234,210,-303,29,201,H1
"Scott County, MO",2006-2007,39626,39509,-117,-0.295,256,-373,29,201,H1
"Scott County, MO",2007-2008,39509,39293,-216,-0.547,171,-387,29,201,H1
"Scott County, MO",2008-2009,39293,39185,-108,-0.275,176,-284,29,201,H1
"Scott County, MO",2009-2010,39185,39259,74,0.189,175,-101,29,201,H1
"Scott County, MO",2010-2011,39259,39154,-105,-0.267,135,-240,29,201,H1
"Scott County, MO",2011-2012,39154,39149,-5,-0.013,92,-97,29,201,H1
"Scott County, MO",2012-2013,39149,39221,72,0.184,103,-31,29,201,H1
"Scott County, MO",2013-2014,39221,38903,-318,-0.811,74,-392,29,201,H1
"Scott County, MO",2014-2015,38856,39008,152,0.391,63,89,29,201,H1
"Scott County, MO",2015-2016,39008,38723,-285,-0.731,31,-316,29,201,H1
"Scott County, MO",2016-2017,38723,38541,-182,-0.47,18,-200,29,201,H1
"Shannon County, MO",2000-2001,8331,8303,-28,-0.336,15,-43,29,203,H1
"Shannon County, MO",2001-2002,8303,8273,-30,-0.361,4,-34,29,203,H1
"Shannon County, MO",2002-2003,8273,8213,-60,-0.725,-12,-48,29,203,H1
"Shannon County, MO",2003-2004,8213,8254,41,0.499,-7,48,29,203,H1
"Shannon County, MO",2004-2005,8254,8300,46,0.557,26,20,29,203,H1
"Shannon County, MO",2005-2006,8300,8313,13,0.157,3,10,29,203,H1
"Shannon County, MO",2006-2007,8313,8402,89,1.071,28,61,29,203,H1
"Shannon County, MO",2007-2008,8402,8420,18,0.214,9,9,29,203,H1
"Shannon County, MO",2008-2009,8420,8446,26,0.309,14,12,29,203,H1
"Shannon County, MO",2009-2010,8446,8442,-4,-0.047,10,-14,29,203,H1
"Shannon County, MO",2010-2011,8442,8419,-23,-0.272,5,-28,29,203,H1
"Shannon County, MO",2011-2012,8419,8323,-96,-1.14,6,-102,29,203,H1
"Shannon County, MO",2012-2013,8323,8285,-38,-0.457,0,-38,29,203,H1
"Shannon County, MO",2013-2014,8285,8329,44,0.531,18,26,29,203,H1
"Shannon County, MO",2014-2015,8307,8258,-49,-0.59,11,-60,29,203,H1
"Shannon County, MO",2015-2016,8258,8244,-14,-0.17,0,-14,29,203,H1
"Shannon County, MO",2016-2017,8244,8249,5,0.061,1,4,29,203,H1
"Shelby County, MO",2000-2001,6790,6787,-3,-0.044,9,-12,29,205,H1
"Shelby County, MO",2001-2002,6787,6724,-63,-0.928,-28,-35,29,205,H1
"Shelby County, MO",2002-2003,6724,6669,-55,-0.818,-15,-40,29,205,H1
"Shelby County, MO",2003-2004,6669,6661,-8,-0.12,0,-8,29,205,H1
"Shelby County, MO",2004-2005,6661,6683,22,0.33,-8,30,29,205,H1
"Shelby County, MO",2005-2006,6683,6533,-150,-2.245,5,-155,29,205,H1
"Shelby County, MO",2006-2007,6533,6500,-33,-0.505,0,-33,29,205,H1
"Shelby County, MO",2007-2008,6500,6421,-79,-1.215,0,-79,29,205,H1
"Shelby County, MO",2008-2009,6421,6369,-52,-0.81,-9,-43,29,205,H1
"Shelby County, MO",2009-2010,6369,6367,-2,-0.031,-3,1,29,205,H1
"Shelby County, MO",2010-2011,6367,6233,-134,-2.105,-30,-104,29,205,H1
"Shelby County, MO",2011-2012,6233,6226,-7,-0.112,2,-9,29,205,H1
"Shelby County, MO",2012-2013,6226,6156,-70,-1.124,1,-71,29,205,H1
"Shelby County, MO",2013-2014,6156,6108,-48,-0.78,0,-48,29,205,H1
"Shelby County, MO",2014-2015,6129,6128,-1,-0.016,5,-6,29,205,H1
"Shelby County, MO",2015-2016,6128,6051,-77,-1.257,-6,-71,29,205,H1
"Shelby County, MO",2016-2017,6051,6021,-30,-0.496,14,-44,29,205,H1
"Stoddard County, MO",2000-2001,29756,29772,16,0.054,-21,37,29,207,H1
"Stoddard County, MO",2001-2002,29772,29976,204,0.685,-60,264,29,207,H1
"Stoddard County, MO",2002-2003,29976,29908,-68,-0.227,-13,-55,29,207,H1
"Stoddard County, MO",2003-2004,29908,30064,156,0.522,0,156,29,207,H1
"Stoddard County, MO",2004-2005,30064,30240,176,0.585,23,153,29,207,H1
"Stoddard County, MO",2005-2006,30240,30314,74,0.245,14,60,29,207,H1
"Stoddard County, MO",2006-2007,30314,30253,-61,-0.201,-19,-42,29,207,H1
"Stoddard County, MO",2007-2008,30253,30062,-191,-0.631,-2,-189,29,207,H1
"Stoddard County, MO",2008-2009,30062,29821,-241,-0.802,9,-250,29,207,H1
"Stoddard County, MO",2009-2010,29821,30012,191,0.64,1,190,29,207,H1
"Stoddard County, MO",2010-2011,30012,29838,-174,-0.58,-17,-157,29,207,H1
"Stoddard County, MO",2011-2012,29838,29828,-10,-0.034,-42,32,29,207,H1
"Stoddard County, MO",2012-2013,29828,29774,-54,-0.181,0,-54,29,207,H1
"Stoddard County, MO",2013-2014,29774,29867,93,0.312,-16,109,29,207,H1
"Stoddard County, MO",2014-2015,29870,29862,-8,-0.027,10,-18,29,207,H1
"Stoddard County, MO",2015-2016,29862,29483,-379,-1.269,-84,-295,29,207,H1
"Stoddard County, MO",2016-2017,29483,29369,-114,-0.387,-69,-45,29,207,H1
"Stone County, MO",2000-2001,28600,28841,241,0.843,18,223,29,209,H1
"Stone County, MO",2001-2002,28841,29347,506,1.754,-37,543,29,209,H1
"Stone County, MO",2002-2003,29347,30044,697,2.375,-9,706,29,209,H1
"Stone County, MO",2003-2004,30044,30542,498,1.658,-22,520,29,209,H1
"Stone County, MO",2004-2005,30542,30800,258,0.845,-14,272,29,209,H1
"Stone County, MO",2005-2006,30800,31546,746,2.422,-23,769,29,209,H1
"Stone County, MO",2006-2007,31546,31966,420,1.331,-7,427,29,209,H1
"Stone County, MO",2007-2008,31966,32119,153,0.479,-44,197,29,209,H1
"Stone County, MO",2008-2009,32119,32214,95,0.296,-18,113,29,209,H1
"Stone County, MO",2009-2010,32214,32043,-171,-0.531,-68,-103,29,209,H1
"Stone County, MO",2010-2011,32043,31853,-190,-0.593,-95,-95,29,209,H1
"Stone County, MO",2011-2012,31853,31613,-240,-0.753,-74,-166,29,209,H1
"Stone County, MO",2012-2013,31613,31351,-262,-0.829,-125,-137,29,209,H1
"Stone County, MO",2013-2014,31351,31104,-247,-0.788,-109,-138,29,209,H1
"Stone County, MO",2014-2015,31101,30943,-158,-0.508,-117,-41,29,209,H1
"Stone County, MO",2015-2016,30943,31534,591,1.91,-108,699,29,209,H1
"Stone County, MO",2016-2017,31534,31699,165,0.523,-127,292,29,209,H1
"Sullivan County, MO",2000-2001,7227,7237,10,0.138,12,-2,29,211,H1
"Sullivan County, MO",2001-2002,7237,7247,10,0.138,16,-6,29,211,H1
"Sullivan County, MO",2002-2003,7247,7042,-205,-2.829,-7,-198,29,211,H1
"Sullivan County, MO",2003-2004,7042,6925,-117,-1.661,7,-124,29,211,H1
"Sullivan County, MO",2004-2005,6925,6840,-85,-1.227,-1,-84,29,211,H1
"Sullivan County, MO",2005-2006,6840,6783,-57,-0.833,2,-59,29,211,H1
"Sullivan County, MO",2006-2007,6783,6706,-77,-1.135,56,-133,29,211,H1
"Sullivan County, MO",2007-2008,6706,6736,30,0.447,20,10,29,211,H1
"Sullivan County, MO",2008-2009,6736,6689,-47,-0.698,19,-66,29,211,H1
"Sullivan County, MO",2009-2010,6689,6717,28,0.419,14,14,29,211,H1
"Sullivan County, MO",2010-2011,6717,6656,-61,-0.908,2,-63,29,211,H1
"Sullivan County, MO",2011-2012,6656,6525,-131,-1.968,9,-140,29,211,H1
"Sullivan County, MO",2012-2013,6525,6448,-77,-1.18,10,-87,29,211,H1
"Sullivan County, MO",2013-2014,6448,6411,-37,-0.574,16,-53,29,211,H1
"Sullivan County, MO",2014-2015,6474,6353,-121,-1.869,12,-133,29,211,H1
"Sullivan County, MO",2015-2016,6353,6343,-10,-0.157,32,-42,29,211,H1
"Sullivan County, MO",2016-2017,6343,6229,-114,-1.797,20,-134,29,211,H1
"Taney County, MO",2000-2001,40059,40609,550,1.373,120,430,29,213,H1
"Taney County, MO",2001-2002,40609,41554,945,2.327,128,817,29,213,H1
"Taney County, MO",2002-2003,41554,42447,893,2.149,108,785,29,213,H1
"Taney County, MO",2003-2004,42447,43381,934,2.2,166,768,29,213,H1
"Taney County, MO",2004-2005,43381,44635,1254,2.891,137,1117,29,213,H1
"Taney County, MO",2005-2006,44635,46200,1565,3.506,140,1425,29,213,H1
"Taney County, MO",2006-2007,46200,48020,1820,3.939,236,1584,29,213,H1
"Taney County, MO",2007-2008,48020,49711,1691,3.521,238,1453,29,213,H1
"Taney County, MO",2008-2009,49711,50794,1083,2.179,206,877,29,213,H1
"Taney County, MO",2009-2010,50794,51940,1146,2.256,206,940,29,213,H1
"Taney County, MO",2010-2011,51940,52690,750,1.444,127,623,29,213,H1
"Taney County, MO",2011-2012,52690,53062,372,0.706,125,247,29,213,H1
"Taney County, MO",2012-2013,53062,53508,446,0.841,68,378,29,213,H1
"Taney County, MO",2013-2014,53508,54230,722,1.349,110,612,29,213,H1
"Taney County, MO",2014-2015,54138,54592,454,0.839,136,318,29,213,H1
"Taney County, MO",2015-2016,54592,54749,157,0.288,59,98,29,213,H1
"Taney County, MO",2016-2017,54749,55355,606,1.107,111,495,29,213,H1
"Texas County, MO",2000-2001,23049,24174,1125,4.881,0,1125,29,215,H1
"Texas County, MO",2001-2002,24174,24464,290,1.2,-36,326,29,215,H1
"Texas County, MO",2002-2003,24464,24388,-76,-0.311,0,-76,29,215,H1
"Texas County, MO",2003-2004,24388,24845,457,1.874,-22,479,29,215,H1
"Texas County, MO",2004-2005,24845,24961,116,0.467,-7,123,29,215,H1
"Texas County, MO",2005-2006,24961,25385,424,1.699,5,419,29,215,H1
"Texas County, MO",2006-2007,25385,25490,105,0.414,15,90,29,215,H1
"Texas County, MO",2007-2008,25490,25597,107,0.42,4,103,29,215,H1
"Texas County, MO",2008-2009,25597,25790,193,0.754,15,178,29,215,H1
"Texas County, MO",2009-2010,25790,26023,233,0.903,14,219,29,215,H1
"Texas County, MO",2010-2011,26023,25932,-91,-0.35,13,-104,29,215,H1
"Texas County, MO",2011-2012,25932,25748,-184,-0.71,7,-191,29,215,H1
"Texas County, MO",2012-2013,25748,25637,-111,-0.431,15,-126,29,215,H1
"Texas County, MO",2013-2014,25637,25642,5,0.02,20,-15,29,215,H1
"Texas County, MO",2014-2015,25654,25690,36,0.14,30,6,29,215,H1
"Texas County, MO",2015-2016,25690,25852,162,0.631,23,139,29,215,H1
"Texas County, MO",2016-2017,25852,25735,-117,-0.453,20,-137,29,215,H1
"Vernon County, MO",2000-2001,20428,20514,86,0.421,78,8,29,217,H1
"Vernon County, MO",2001-2002,20514,20454,-60,-0.292,-18,-42,29,217,H1
"Vernon County, MO",2002-2003,20454,20481,27,0.132,23,4,29,217,H1
"Vernon County, MO",2003-2004,20481,20620,139,0.679,31,108,29,217,H1
"Vernon County, MO",2004-2005,20620,20722,102,0.495,56,46,29,217,H1
"Vernon County, MO",2005-2006,20722,20715,-7,-0.034,41,-48,29,217,H1
"Vernon County, MO",2006-2007,20715,20746,31,0.15,36,-5,29,217,H1
"Vernon County, MO",2007-2008,20746,20891,145,0.699,50,95,29,217,H1
"Vernon County, MO",2008-2009,20891,21071,180,0.862,36,144,29,217,H1
"Vernon County, MO",2009-2010,21071,21150,79,0.375,21,58,29,217,H1
"Vernon County, MO",2010-2011,21150,21005,-145,-0.686,-16,-129,29,217,H1
"Vernon County, MO",2011-2012,21005,20798,-207,-0.985,-8,-199,29,217,H1
"Vernon County, MO",2012-2013,20798,20967,169,0.813,46,123,29,217,H1
"Vernon County, MO",2013-2014,20967,21001,34,0.162,47,-13,29,217,H1
"Vernon County, MO",2014-2015,20935,20826,-109,-0.521,38,-147,29,217,H1
"Vernon County, MO",2015-2016,20826,20554,-272,-1.306,30,-302,29,217,H1
"Vernon County, MO",2016-2017,20554,20437,-117,-0.569,37,-154,29,217,H1
"Warren County, MO",2000-2001,24745,25426,681,2.752,109,572,29,219,H1
"Warren County, MO",2001-2002,25426,26266,840,3.304,135,705,29,219,H1
"Warren County, MO",2002-2003,26266,27169,903,3.438,130,773,29,219,H1
"Warren County, MO",2003-2004,27169,27971,802,2.952,109,693,29,219,H1
"Warren County, MO",2004-2005,27971,29095,1124,4.018,181,943,29,219,H1
"Warren County, MO",2005-2006,29095,30175,1080,3.712,220,860,29,219,H1
"Warren County, MO",2006-2007,30175,31152,977,3.238,276,701,29,219,H1
"Warren County, MO",2007-2008,31152,31975,823,2.642,177,646,29,219,H1
"Warren County, MO",2008-2009,31975,32320,345,1.079,199,146,29,219,H1
"Warren County, MO",2009-2010,32320,32574,254,0.786,187,67,29,219,H1
"Warren County, MO",2010-2011,32574,32614,40,0.123,154,-114,29,219,H1
"Warren County, MO",2011-2012,32614,32785,171,0.524,128,43,29,219,H1
"Warren County, MO",2012-2013,32785,33010,225,0.686,153,72,29,219,H1
"Warren County, MO",2013-2014,33010,33253,243,0.736,124,119,29,219,H1
"Warren County, MO",2014-2015,33253,33513,260,0.782,104,156,29,219,H1
"Warren County, MO",2015-2016,33513,33815,302,0.901,128,174,29,219,H1
"Warren County, MO",2016-2017,33815,34373,558,1.65,124,434,29,219,H1
"Washington County, MO",2000-2001,23395,23514,119,0.509,104,15,29,221,H1
"Washington County, MO",2001-2002,23514,23796,282,1.199,132,150,29,221,H1
"Washington County, MO",2002-2003,23796,23956,160,0.672,50,110,29,221,H1
"Washington County, MO",2003-2004,23956,24174,218,0.91,64,154,29,221,H1
"Washington County, MO",2004-2005,24174,24211,37,0.153,67,-30,29,221,H1
"Washington County, MO",2005-2006,24211,24619,408,1.685,137,271,29,221,H1
"Washington County, MO",2006-2007,24619,24856,237,0.963,85,152,29,221,H1
"Washington County, MO",2007-2008,24856,25113,257,1.034,85,172,29,221,H1
"Washington County, MO",2008-2009,25113,25111,-2,-0.008,49,-51,29,221,H1
"Washington County, MO",2009-2010,25111,25164,53,0.211,52,1,29,221,H1
"Washington County, MO",2010-2011,25164,25094,-70,-0.278,66,-136,29,221,H1
"Washington County, MO",2011-2012,25094,25091,-3,-0.012,58,-61,29,221,H1
"Washington County, MO",2012-2013,25091,25137,46,0.183,24,22,29,221,H1
"Washington County, MO",2013-2014,25137,25077,-60,-0.239,14,-74,29,221,H1
"Washington County, MO",2014-2015,25076,24788,-288,-1.149,8,-296,29,221,H1
"Washington County, MO",2015-2016,24788,24832,44,0.178,-17,61,29,221,H1
"Washington County, MO",2016-2017,24832,25022,190,0.765,14,176,29,221,H1
"Wayne County, MO",2000-2001,13259,13368,109,0.822,14,95,29,223,H1
"Wayne County, MO",2001-2002,13368,13318,-50,-0.374,-29,-21,29,223,H1
"Wayne County, MO",2002-2003,13318,13435,117,0.879,-71,188,29,223,H1
"Wayne County, MO",2003-2004,13435,13394,-41,-0.305,-69,28,29,223,H1
"Wayne County, MO",2004-2005,13394,13514,120,0.896,-57,177,29,223,H1
"Wayne County, MO",2005-2006,13514,13429,-85,-0.629,-26,-59,29,223,H1
"Wayne County, MO",2006-2007,13429,13356,-73,-0.544,-71,-2,29,223,H1
"Wayne County, MO",2007-2008,13356,13397,41,0.307,-56,97,29,223,H1
"Wayne County, MO",2008-2009,13397,13486,89,0.664,-64,153,29,223,H1
"Wayne County, MO",2009-2010,13486,13513,27,0.2,-39,66,29,223,H1
"Wayne County, MO",2010-2011,13513,13386,-127,-0.94,-52,-75,29,223,H1
"Wayne County, MO",2011-2012,13386,13377,-9,-0.067,-61,52,29,223,H1
"Wayne County, MO",2012-2013,13377,13421,44,0.329,-7,51,29,223,H1
"Wayne County, MO",2013-2014,13421,13452,31,0.231,-55,86,29,223,H1
"Wayne County, MO",2014-2015,13415,13405,-10,-0.075,-60,50,29,223,H1
"Wayne County, MO",2015-2016,13405,13207,-198,-1.477,-53,-145,29,223,H1
"Wayne County, MO",2016-2017,13207,13296,89,0.674,-51,140,29,223,H1
"Webster County, MO",2000-2001,31219,31863,644,2.063,251,393,29,225,H1
"Webster County, MO",2001-2002,31863,32299,436,1.368,170,266,29,225,H1
"Webster County, MO",2002-2003,32299,32680,381,1.18,219,162,29,225,H1
"Webster County, MO",2003-2004,32680,33394,714,2.185,194,520,29,225,H1
"Webster County, MO",2004-2005,33394,34005,611,1.83,298,313,29,225,H1
"Webster County, MO",2005-2006,34005,34692,687,2.02,245,442,29,225,H1
"Webster County, MO",2006-2007,34692,35477,785,2.263,263,522,29,225,H1
"Webster County, MO",2007-2008,35477,35938,461,1.299,302,159,29,225,H1
"Webster County, MO",2008-2009,35938,35997,59,0.164,261,-202,29,225,H1
"Webster County, MO",2009-2010,35997,36278,281,0.781,208,73,29,225,H1
"Webster County, MO",2010-2011,36278,36302,24,0.066,190,-166,29,225,H1
"Webster County, MO",2011-2012,36302,36334,32,0.088,235,-203,29,225,H1
"Webster County, MO",2012-2013,36334,36502,168,0.462,215,-47,29,225,H1
"Webster County, MO",2013-2014,36502,36888,386,1.057,213,173,29,225,H1
"Webster County, MO",2014-2015,36880,37483,603,1.635,228,375,29,225,H1
"Webster County, MO",2015-2016,37483,38065,582,1.553,234,348,29,225,H1
"Webster County, MO",2016-2017,38065,38665,600,1.576,231,369,29,225,H1
"Worth County, MO",2000-2001,2382,2324,-58,-2.435,-26,-32,29,227,H1
"Worth County, MO",2001-2002,2324,2320,-4,-0.172,-1,-3,29,227,H1
"Worth County, MO",2002-2003,2320,2291,-29,-1.25,-20,-9,29,227,H1
"Worth County, MO",2003-2004,2291,2269,-22,-0.96,-1,-21,29,227,H1
"Worth County, MO",2004-2005,2269,2231,-38,-1.675,-5,-33,29,227,H1
"Worth County, MO",2005-2006,2231,2202,-29,-1.3,-20,-9,29,227,H1
"Worth County, MO",2006-2007,2202,2217,15,0.681,-16,31,29,227,H1
"Worth County, MO",2007-2008,2217,2166,-51,-2.3,8,-59,29,227,H1
"Worth County, MO",2008-2009,2166,2199,33,1.524,-6,39,29,227,H1
"Worth County, MO",2009-2010,2199,2152,-47,-2.137,-2,-45,29,227,H1
"Worth County, MO",2010-2011,2152,2123,-29,-1.348,-21,-8,29,227,H1
"Worth County, MO",2011-2012,2123,2078,-45,-2.12,3,-48,29,227,H1
"Worth County, MO",2012-2013,2078,2086,8,0.385,9,-1,29,227,H1
"Worth County, MO",2013-2014,2086,2073,-13,-0.623,4,-17,29,227,H1
"Worth County, MO",2014-2015,2062,2057,-5,-0.242,2,-7,29,227,H1
"Worth County, MO",2015-2016,2057,2028,-29,-1.41,-6,-23,29,227,H1
"Worth County, MO",2016-2017,2028,2057,29,1.43,-4,33,29,227,H1
"Wright County, MO",2000-2001,17926,17963,37,0.206,60,-23,29,229,H1
"Wright County, MO",2001-2002,17963,18147,184,1.024,30,154,29,229,H1
"Wright County, MO",2002-2003,18147,18217,70,0.386,42,28,29,229,H1
"Wright County, MO",2003-2004,18217,18226,9,0.049,25,-16,29,229,H1
"Wright County, MO",2004-2005,18226,18489,263,1.443,89,174,29,229,H1
"Wright County, MO",2005-2006,18489,18554,65,0.352,48,17,29,229,H1
"Wright County, MO",2006-2007,18554,18713,159,0.857,56,103,29,229,H1
"Wright County, MO",2007-2008,18713,18904,191,1.021,65,126,29,229,H1
"Wright County, MO",2008-2009,18904,18633,-271,-1.434,44,-315,29,229,H1
"Wright County, MO",2009-2010,18633,18859,226,1.213,29,197,29,229,H1
"Wright County, MO",2010-2011,18859,18635,-224,-1.188,-4,-220,29,229,H1
"Wright County, MO",2011-2012,18635,18610,-25,-0.134,34,-59,29,229,H1
"Wright County, MO",2012-2013,18610,18430,-180,-0.967,22,-202,29,229,H1
"Wright County, MO",2013-2014,18430,18291,-139,-0.754,20,-159,29,229,H1
"Wright County, MO",2014-2015,18303,18268,-35,-0.191,20,-55,29,229,H1
"Wright County, MO",2015-2016,18268,18275,7,0.038,27,-20,29,229,H1
"Wright County, MO",2016-2017,18275,18331,56,0.306,12,44,29,229,H1
"St. Louis city, MO",2000-2001,347144,343243,-3901,-1.124,1152,-5053,29,510,C7
"St. Louis city, MO",2001-2002,343243,338457,-4786,-1.394,1176,-5962,29,510,C7
"St. Louis city, MO",2002-2003,338457,334893,-3564,-1.053,1100,-4664,29,510,C7
"St. Louis city, MO",2003-2004,334893,330988,-3905,-1.166,1492,-5397,29,510,C7
"St. Louis city, MO",2004-2005,330988,324945,-6043,-1.826,1479,-7522,29,510,C7
"St. Louis city, MO",2005-2006,324945,320131,-4814,-1.481,1804,-6618,29,510,C7
"St. Louis city, MO",2006-2007,320131,317959,-2172,-0.678,1861,-4033,29,510,C7
"St. Louis city, MO",2007-2008,317959,317955,-4,-0.001,2194,-2198,29,510,C7
"St. Louis city, MO",2008-2009,317955,318842,887,0.279,1848,-961,29,510,C7
"St. Louis city, MO",2009-2010,318842,319258,416,0.13,1997,-1581,29,510,C7
"St. Louis city, MO",2010-2011,319258,319188,-70,-0.022,1741,-1811,29,510,C7
"St. Louis city, MO",2011-2012,319188,319274,86,0.027,1971,-1885,29,510,C7
"St. Louis city, MO",2012-2013,319274,318496,-778,-0.244,1730,-2508,29,510,C7
"St. Louis city, MO",2013-2014,318496,317419,-1077,-0.338,1563,-2640,29,510,C7
"St. Louis city, MO",2014-2015,317222,315685,-1537,-0.485,1639,-3176,29,510,C7
"St. Louis city, MO",2015-2016,315685,313144,-2541,-0.805,1465,-4006,29,510,C7
"St. Louis city, MO",2016-2017,313144,308626,-4518,-1.443,1273,-5791,29,510,C7
Montana,2000-2001,903773,906961,3188,0.353,2730,458,30,0,STATE
Montana,2001-2002,906961,911667,4706,0.519,2573,2133,30,0,STATE
Montana,2002-2003,911667,919630,7963,0.873,2787,5176,30,0,STATE
Montana,2003-2004,919630,930009,10379,1.129,3003,7376,30,0,STATE
Montana,2004-2005,930009,940102,10093,1.085,3140,6953,30,0,STATE
Montana,2005-2006,940102,952692,12590,1.339,3729,8861,30,0,STATE
Montana,2006-2007,952692,964706,12014,1.261,4008,8006,30,0,STATE
Montana,2007-2008,964706,976415,11709,1.214,4224,7485,30,0,STATE
Montana,2008-2009,976415,983982,7567,0.775,4080,3487,30,0,STATE
Montana,2009-2010,983982,990643,6661,0.677,3982,2679,30,0,STATE
Montana,2010-2011,990643,997746,7103,0.717,2874,4229,30,0,STATE
Montana,2011-2012,997746,1005157,7411,0.743,3073,4338,30,0,STATE
Montana,2012-2013,1005157,1014402,9245,0.92,2768,6477,30,0,STATE
Montana,2013-2014,1014402,1023252,8850,0.872,3443,5407,30,0,STATE
Montana,2014-2015,1023252,1032949,9697,0.948,3389,6308,30,0,STATE
Montana,2015-2016,1032949,1038656,5707,0.552,2938,2769,30,0,STATE
Montana,2016-2017,1038656,1050493,11837,1.14,2844,8993,30,0,STATE
"Beaverhead County, MT",2000-2001,9204,9058,-146,-1.586,4,-150,30,1,H1
"Beaverhead County, MT",2001-2002,9058,9018,-40,-0.442,31,-71,30,1,H1
"Beaverhead County, MT",2002-2003,9018,8924,-94,-1.042,-15,-79,30,1,H1
"Beaverhead County, MT",2003-2004,8924,8908,-16,-0.179,12,-28,30,1,H1
"Beaverhead County, MT",2004-2005,8908,8904,-4,-0.045,4,-8,30,1,H1
"Beaverhead County, MT",2005-2006,8904,9012,108,1.213,5,103,30,1,H1
"Beaverhead County, MT",2006-2007,9012,9028,16,0.178,23,-7,30,1,H1
"Beaverhead County, MT",2007-2008,9028,9166,138,1.529,29,109,30,1,H1
"Beaverhead County, MT",2008-2009,9166,9200,34,0.371,12,22,30,1,H1
"Beaverhead County, MT",2009-2010,9200,9248,48,0.522,21,27,30,1,H1
"Beaverhead County, MT",2010-2011,9248,9212,-36,-0.389,17,-53,30,1,H1
"Beaverhead County, MT",2011-2012,9212,9356,144,1.563,21,123,30,1,H1
"Beaverhead County, MT",2012-2013,9356,9308,-48,-0.513,19,-67,30,1,H1
"Beaverhead County, MT",2013-2014,9308,9345,37,0.398,7,30,30,1,H1
"Beaverhead County, MT",2014-2015,9310,9300,-10,-0.107,1,-11,30,1,H1
"Beaverhead County, MT",2015-2016,9300,9444,144,1.548,8,136,30,1,H1
"Beaverhead County, MT",2016-2017,9444,9434,-10,-0.106,2,-12,30,1,H1
"Big Horn County, MT",2000-2001,12669,12783,114,0.9,158,-44,30,3,H1
"Big Horn County, MT",2001-2002,12783,12713,-70,-0.548,170,-240,30,3,H1
"Big Horn County, MT",2002-2003,12713,12652,-61,-0.48,151,-212,30,3,H1
"Big Horn County, MT",2003-2004,12652,12731,79,0.624,169,-90,30,3,H1
"Big Horn County, MT",2004-2005,12731,12634,-97,-0.762,154,-251,30,3,H1
"Big Horn County, MT",2005-2006,12634,12540,-94,-0.744,140,-234,30,3,H1
"Big Horn County, MT",2006-2007,12540,12549,9,0.072,155,-146,30,3,H1
"Big Horn County, MT",2007-2008,12549,12564,15,0.12,180,-165,30,3,H1
"Big Horn County, MT",2008-2009,12564,12747,183,1.457,164,19,30,3,H1
"Big Horn County, MT",2009-2010,12747,12919,172,1.349,185,-13,30,3,H1
"Big Horn County, MT",2010-2011,12919,13054,135,1.045,151,-16,30,3,H1
"Big Horn County, MT",2011-2012,13054,13008,-46,-0.352,147,-193,30,3,H1
"Big Horn County, MT",2012-2013,13008,13134,126,0.969,137,-11,30,3,H1
"Big Horn County, MT",2013-2014,13134,13282,148,1.127,125,23,30,3,H1
"Big Horn County, MT",2014-2015,13313,13242,-71,-0.533,148,-219,30,3,H1
"Big Horn County, MT",2015-2016,13242,13371,129,0.974,83,46,30,3,H1
"Big Horn County, MT",2016-2017,13371,13360,-11,-0.082,112,-123,30,3,H1
"Blaine County, MT",2000-2001,6968,6748,-220,-3.157,20,-240,30,5,H1
"Blaine County, MT",2001-2002,6748,6769,21,0.311,14,7,30,5,H1
"Blaine County, MT",2002-2003,6769,6699,-70,-1.034,49,-119,30,5,H1
"Blaine County, MT",2003-2004,6699,6571,-128,-1.911,49,-177,30,5,H1
"Blaine County, MT",2004-2005,6571,6592,21,0.32,77,-56,30,5,H1
"Blaine County, MT",2005-2006,6592,6536,-56,-0.85,58,-114,30,5,H1
"Blaine County, MT",2006-2007,6536,6472,-64,-0.979,38,-102,30,5,H1
"Blaine County, MT",2007-2008,6472,6401,-71,-1.097,76,-147,30,5,H1
"Blaine County, MT",2008-2009,6401,6445,44,0.687,71,-27,30,5,H1
"Blaine County, MT",2009-2010,6445,6484,39,0.605,99,-60,30,5,H1
"Blaine County, MT",2010-2011,6484,6556,72,1.11,41,31,30,5,H1
"Blaine County, MT",2011-2012,6556,6637,81,1.236,38,43,30,5,H1
"Blaine County, MT",2012-2013,6637,6582,-55,-0.829,58,-113,30,5,H1
"Blaine County, MT",2013-2014,6582,6619,37,0.562,45,-8,30,5,H1
"Blaine County, MT",2014-2015,6635,6577,-58,-0.874,42,-100,30,5,H1
"Blaine County, MT",2015-2016,6577,6657,80,1.216,55,25,30,5,H1
"Blaine County, MT",2016-2017,6657,6708,51,0.766,53,-2,30,5,H1
"Broadwater County, MT",2000-2001,4378,4438,60,1.37,-13,73,30,7,H1
"Broadwater County, MT",2001-2002,4438,4478,40,0.901,-6,46,30,7,H1
"Broadwater County, MT",2002-2003,4478,4562,84,1.876,-3,87,30,7,H1
"Broadwater County, MT",2003-2004,4562,4711,149,3.266,-7,156,30,7,H1
"Broadwater County, MT",2004-2005,4711,4775,64,1.359,-2,66,30,7,H1
"Broadwater County, MT",2005-2006,4775,4958,183,3.832,-20,203,30,7,H1
"Broadwater County, MT",2006-2007,4958,5089,131,2.642,-24,155,30,7,H1
"Broadwater County, MT",2007-2008,5089,5261,172,3.38,3,169,30,7,H1
"Broadwater County, MT",2008-2009,5261,5496,235,4.467,0,235,30,7,H1
"Broadwater County, MT",2009-2010,5496,5638,142,2.584,-4,146,30,7,H1
"Broadwater County, MT",2010-2011,5638,5732,94,1.667,-3,97,30,7,H1
"Broadwater County, MT",2011-2012,5732,5762,30,0.523,-2,32,30,7,H1
"Broadwater County, MT",2012-2013,5762,5687,-75,-1.302,4,-79,30,7,H1
"Broadwater County, MT",2013-2014,5687,5667,-20,-0.352,6,-26,30,7,H1
"Broadwater County, MT",2014-2015,5631,5689,58,1.03,3,55,30,7,H1
"Broadwater County, MT",2015-2016,5689,5788,99,1.74,-4,103,30,7,H1
"Broadwater County, MT",2016-2017,5788,5936,148,2.557,-5,153,30,7,H1
"Carbon County, MT",2000-2001,9561,9665,104,1.088,-9,113,30,9,H1
"Carbon County, MT",2001-2002,9665,9714,49,0.507,-11,60,30,9,H1
"Carbon County, MT",2002-2003,9714,9747,33,0.34,-31,64,30,9,H1
"Carbon County, MT",2003-2004,9747,9796,49,0.503,19,30,30,9,H1
"Carbon County, MT",2004-2005,9796,9921,125,1.276,-2,127,30,9,H1
"Carbon County, MT",2005-2006,9921,9916,-5,-0.05,-12,7,30,9,H1
"Carbon County, MT",2006-2007,9916,9973,57,0.575,-7,64,30,9,H1
"Carbon County, MT",2007-2008,9973,9965,-8,-0.08,-7,-1,30,9,H1
"Carbon County, MT",2008-2009,9965,10033,68,0.682,-17,85,30,9,H1
"Carbon County, MT",2009-2010,10033,10057,24,0.239,-32,56,30,9,H1
"Carbon County, MT",2010-2011,10057,10076,19,0.189,3,16,30,9,H1
"Carbon County, MT",2011-2012,10076,10109,33,0.328,-18,51,30,9,H1
"Carbon County, MT",2012-2013,10109,10305,196,1.939,-10,206,30,9,H1
"Carbon County, MT",2013-2014,10305,10399,94,0.912,-2,96,30,9,H1
"Carbon County, MT",2014-2015,10413,10408,-5,-0.048,1,-6,30,9,H1
"Carbon County, MT",2015-2016,10408,10498,90,0.865,-28,118,30,9,H1
"Carbon County, MT",2016-2017,10498,10696,198,1.886,-14,212,30,9,H1
"Carter County, MT",2000-2001,1335,1337,2,0.15,-11,13,30,11,H1
"Carter County, MT",2001-2002,1337,1319,-18,-1.346,-6,-12,30,11,H1
"Carter County, MT",2002-2003,1319,1290,-29,-2.199,-16,-13,30,11,H1
"Carter County, MT",2003-2004,1290,1284,-6,-0.465,-4,-2,30,11,H1
"Carter County, MT",2004-2005,1284,1258,-26,-2.025,-2,-24,30,11,H1
"Carter County, MT",2005-2006,1258,1227,-31,-2.464,-6,-25,30,11,H1
"Carter County, MT",2006-2007,1227,1216,-11,-0.896,-12,1,30,11,H1
"Carter County, MT",2007-2008,1216,1172,-44,-3.618,-2,-42,30,11,H1
"Carter County, MT",2008-2009,1172,1180,8,0.683,-1,9,30,11,H1
"Carter County, MT",2009-2010,1180,1154,-26,-2.203,1,-27,30,11,H1
"Carter County, MT",2010-2011,1154,1142,-12,-1.04,-5,-7,30,11,H1
"Carter County, MT",2011-2012,1142,1174,32,2.802,-10,42,30,11,H1
"Carter County, MT",2012-2013,1174,1169,-5,-0.426,7,-12,30,11,H1
"Carter County, MT",2013-2014,1169,1169,0,0,-4,4,30,11,H1
"Carter County, MT",2014-2015,1176,1180,4,0.34,6,-2,30,11,H1
"Carter County, MT",2015-2016,1180,1177,-3,-0.254,4,-7,30,11,H1
"Carter County, MT",2016-2017,1177,1222,45,3.823,-1,46,30,11,H1
"Cascade County, MT",2000-2001,80318,80055,-263,-0.327,253,-516,30,13,H1
"Cascade County, MT",2001-2002,80055,79848,-207,-0.259,259,-466,30,13,H1
"Cascade County, MT",2002-2003,79848,79633,-215,-0.269,363,-578,30,13,H1
"Cascade County, MT",2003-2004,79633,80198,565,0.71,368,197,30,13,H1
"Cascade County, MT",2004-2005,80198,80041,-157,-0.196,353,-510,30,13,H1
"Cascade County, MT",2005-2006,80041,79984,-57,-0.071,374,-431,30,13,H1
"Cascade County, MT",2006-2007,79984,80099,115,0.144,504,-389,30,13,H1
"Cascade County, MT",2007-2008,80099,80529,430,0.537,446,-16,30,13,H1
"Cascade County, MT",2008-2009,80529,80680,151,0.188,393,-242,30,13,H1
"Cascade County, MT",2009-2010,80680,81506,826,1.024,429,397,30,13,H1
"Cascade County, MT",2010-2011,81506,81747,241,0.296,376,-135,30,13,H1
"Cascade County, MT",2011-2012,81747,81765,18,0.022,389,-371,30,13,H1
"Cascade County, MT",2012-2013,81765,82404,639,0.782,405,234,30,13,H1
"Cascade County, MT",2013-2014,82404,82344,-60,-0.073,406,-466,30,13,H1
"Cascade County, MT",2014-2015,82268,82278,10,0.012,429,-419,30,13,H1
"Cascade County, MT",2015-2016,82278,81488,-790,-0.96,226,-1016,30,13,H1
"Cascade County, MT",2016-2017,81488,81654,166,0.204,294,-128,30,13,H1
"Chouteau County, MT",2000-2001,6062,5899,-163,-2.689,-27,-136,30,15,H1
"Chouteau County, MT",2001-2002,5899,5811,-88,-1.492,-5,-83,30,15,H1
"Chouteau County, MT",2002-2003,5811,5775,-36,-0.62,-13,-23,30,15,H1
"Chouteau County, MT",2003-2004,5775,5729,-46,-0.797,-30,-16,30,15,H1
"Chouteau County, MT",2004-2005,5729,5708,-21,-0.367,-6,-15,30,15,H1
"Chouteau County, MT",2005-2006,5708,5709,1,0.018,-22,23,30,15,H1
"Chouteau County, MT",2006-2007,5709,5746,37,0.648,-22,59,30,15,H1
"Chouteau County, MT",2007-2008,5746,5774,28,0.487,4,24,30,15,H1
"Chouteau County, MT",2008-2009,5774,5793,19,0.329,-6,25,30,15,H1
"Chouteau County, MT",2009-2010,5793,5811,18,0.311,-20,38,30,15,H1
"Chouteau County, MT",2010-2011,5811,5803,-8,-0.138,3,-11,30,15,H1
"Chouteau County, MT",2011-2012,5803,5927,124,2.137,-20,144,30,15,H1
"Chouteau County, MT",2012-2013,5927,5861,-66,-1.114,-6,-60,30,15,H1
"Chouteau County, MT",2013-2014,5861,5894,33,0.563,-21,54,30,15,H1
"Chouteau County, MT",2014-2015,5900,5767,-133,-2.254,-20,-113,30,15,H1
"Chouteau County, MT",2015-2016,5767,5794,27,0.468,20,7,30,15,H1
"Chouteau County, MT",2016-2017,5794,5765,-29,-0.501,2,-31,30,15,H1
"Custer County, MT",2000-2001,11678,11484,-194,-1.661,4,-198,30,17,H1
"Custer County, MT",2001-2002,11484,11510,26,0.226,-18,44,30,17,H1
"Custer County, MT",2002-2003,11510,11438,-72,-0.626,3,-75,30,17,H1
"Custer County, MT",2003-2004,11438,11510,72,0.629,-7,79,30,17,H1
"Custer County, MT",2004-2005,11510,11423,-87,-0.756,-5,-82,30,17,H1
"Custer County, MT",2005-2006,11423,11395,-28,-0.245,7,-35,30,17,H1
"Custer County, MT",2006-2007,11395,11480,85,0.746,14,71,30,17,H1
"Custer County, MT",2007-2008,11480,11515,35,0.305,-2,37,30,17,H1
"Custer County, MT",2008-2009,11515,11646,131,1.138,10,121,30,17,H1
"Custer County, MT",2009-2010,11646,11699,53,0.455,9,44,30,17,H1
"Custer County, MT",2010-2011,11699,11772,73,0.624,11,62,30,17,H1
"Custer County, MT",2011-2012,11772,11845,73,0.62,2,71,30,17,H1
"Custer County, MT",2012-2013,11845,11936,91,0.768,21,70,30,17,H1
"Custer County, MT",2013-2014,11936,12092,156,1.307,13,143,30,17,H1
"Custer County, MT",2014-2015,12068,12135,67,0.555,11,56,30,17,H1
"Custer County, MT",2015-2016,12135,11821,-314,-2.588,8,-322,30,17,H1
"Custer County, MT",2016-2017,11821,11721,-100,-0.846,13,-113,30,17,H1
"Daniels County, MT",2000-2001,2005,1999,-6,-0.299,-4,-2,30,19,H1
"Daniels County, MT",2001-2002,1999,1912,-87,-4.352,-14,-73,30,19,H1
"Daniels County, MT",2002-2003,1912,1881,-31,-1.621,-20,-11,30,19,H1
"Daniels County, MT",2003-2004,1881,1804,-77,-4.094,-27,-50,30,19,H1
"Daniels County, MT",2004-2005,1804,1782,-22,-1.22,-12,-10,30,19,H1
"Daniels County, MT",2005-2006,1782,1748,-34,-1.908,-9,-25,30,19,H1
"Daniels County, MT",2006-2007,1748,1702,-46,-2.632,-10,-36,30,19,H1
"Daniels County, MT",2007-2008,1702,1704,2,0.118,-1,3,30,19,H1
"Daniels County, MT",2008-2009,1704,1732,28,1.643,-6,34,30,19,H1
"Daniels County, MT",2009-2010,1732,1742,10,0.577,-6,16,30,19,H1
"Daniels County, MT",2010-2011,1742,1769,27,1.55,-13,40,30,19,H1
"Daniels County, MT",2011-2012,1769,1779,10,0.565,4,6,30,19,H1
"Daniels County, MT",2012-2013,1779,1783,4,0.225,2,2,30,19,H1
"Daniels County, MT",2013-2014,1783,1793,10,0.561,-2,12,30,19,H1
"Daniels County, MT",2014-2015,1801,1760,-41,-2.277,6,-47,30,19,H1
"Daniels County, MT",2015-2016,1760,1734,-26,-1.477,-3,-23,30,19,H1
"Daniels County, MT",2016-2017,1734,1737,3,0.173,0,3,30,19,H1
"Dawson County, MT",2000-2001,9050,8963,-87,-0.961,1,-88,30,21,H1
"Dawson County, MT",2001-2002,8963,8801,-162,-1.807,-26,-136,30,21,H1
"Dawson County, MT",2002-2003,8801,8812,11,0.125,-27,38,30,21,H1
"Dawson County, MT",2003-2004,8812,8764,-48,-0.545,-30,-18,30,21,H1
"Dawson County, MT",2004-2005,8764,8800,36,0.411,-10,46,30,21,H1
"Dawson County, MT",2005-2006,8800,8853,53,0.602,2,51,30,21,H1
"Dawson County, MT",2006-2007,8853,8944,91,1.028,5,86,30,21,H1
"Dawson County, MT",2007-2008,8944,8925,-19,-0.212,2,-21,30,21,H1
"Dawson County, MT",2008-2009,8925,9008,83,0.93,-24,107,30,21,H1
"Dawson County, MT",2009-2010,9008,8930,-78,-0.866,-6,-72,30,21,H1
"Dawson County, MT",2010-2011,8930,9006,76,0.851,15,61,30,21,H1
"Dawson County, MT",2011-2012,9006,9239,233,2.587,-5,238,30,21,H1
"Dawson County, MT",2012-2013,9239,9400,161,1.743,9,152,30,21,H1
"Dawson County, MT",2013-2014,9400,9518,118,1.255,22,96,30,21,H1
"Dawson County, MT",2014-2015,9543,9625,82,0.859,41,41,30,21,H1
"Dawson County, MT",2015-2016,9625,9243,-382,-3.969,31,-413,30,21,H1
"Dawson County, MT",2016-2017,9243,8950,-293,-3.17,32,-325,30,21,H1
"Deer Lodge County, MT",2000-2001,9409,9303,-106,-1.127,-43,-63,30,23,H6
"Deer Lodge County, MT",2001-2002,9303,9238,-65,-0.699,-52,-13,30,23,H6
"Deer Lodge County, MT",2002-2003,9238,9189,-49,-0.53,-48,-1,30,23,H6
"Deer Lodge County, MT",2003-2004,9189,9274,85,0.925,-50,135,30,23,H6
"Deer Lodge County, MT",2004-2005,9274,9274,0,0,-49,49,30,23,H6
"Deer Lodge County, MT",2005-2006,9274,9180,-94,-1.014,-51,-43,30,23,H6
"Deer Lodge County, MT",2006-2007,9180,9264,84,0.915,-36,120,30,23,H6
"Deer Lodge County, MT",2007-2008,9264,9351,87,0.939,-33,120,30,23,H6
"Deer Lodge County, MT",2008-2009,9351,9260,-91,-0.973,-44,-47,30,23,H6
"Deer Lodge County, MT",2009-2010,9260,9297,37,0.4,-47,84,30,23,H6
"Deer Lodge County, MT",2010-2011,9297,9261,-36,-0.387,-56,20,30,23,H6
"Deer Lodge County, MT",2011-2012,9261,9222,-39,-0.421,-66,27,30,23,H6
"Deer Lodge County, MT",2012-2013,9222,9287,65,0.705,-37,102,30,23,H6
"Deer Lodge County, MT",2013-2014,9287,9150,-137,-1.475,-44,-93,30,23,H6
"Deer Lodge County, MT",2014-2015,9152,9139,-13,-0.142,-50,37,30,23,H6
"Deer Lodge County, MT",2015-2016,9139,9069,-70,-0.766,-42,-28,30,23,H6
"Deer Lodge County, MT",2016-2017,9069,9106,37,0.408,-47,84,30,23,H6
"Fallon County, MT",2000-2001,2816,2741,-75,-2.663,-8,-67,30,25,H1
"Fallon County, MT",2001-2002,2741,2725,-16,-0.584,-10,-6,30,25,H1
"Fallon County, MT",2002-2003,2725,2769,44,1.615,-2,46,30,25,H1
"Fallon County, MT",2003-2004,2769,2773,4,0.144,6,-2,30,25,H1
"Fallon County, MT",2004-2005,2773,2712,-61,-2.2,7,-68,30,25,H1
"Fallon County, MT",2005-2006,2712,2722,10,0.369,7,3,30,25,H1
"Fallon County, MT",2006-2007,2722,2768,46,1.69,13,33,30,25,H1
"Fallon County, MT",2007-2008,2768,2807,39,1.409,5,34,30,25,H1
"Fallon County, MT",2008-2009,2807,2882,75,2.672,13,62,30,25,H1
"Fallon County, MT",2009-2010,2882,2891,9,0.312,31,-22,30,25,H1
"Fallon County, MT",2010-2011,2891,2934,43,1.487,22,21,30,25,H1
"Fallon County, MT",2011-2012,2934,3031,97,3.306,23,74,30,25,H1
"Fallon County, MT",2012-2013,3031,3056,25,0.825,18,7,30,25,H1
"Fallon County, MT",2013-2014,3056,3108,52,1.702,20,32,30,25,H1
"Fallon County, MT",2014-2015,3111,3190,79,2.539,28,51,30,25,H1
"Fallon County, MT",2015-2016,3190,3091,-99,-3.103,18,-117,30,25,H1
"Fallon County, MT",2016-2017,3091,3009,-82,-2.653,15,-97,30,25,H1
"Fergus County, MT",2000-2001,11902,11736,-166,-1.395,-80,-86,30,27,H1
"Fergus County, MT",2001-2002,11736,11666,-70,-0.596,-41,-29,30,27,H1
"Fergus County, MT",2002-2003,11666,11565,-101,-0.866,-63,-38,30,27,H1
"Fergus County, MT",2003-2004,11565,11546,-19,-0.164,-44,25,30,27,H1
"Fergus County, MT",2004-2005,11546,11444,-102,-0.883,-56,-46,30,27,H1
"Fergus County, MT",2005-2006,11444,11501,57,0.498,-50,107,30,27,H1
"Fergus County, MT",2006-2007,11501,11463,-38,-0.33,-31,-7,30,27,H1
"Fergus County, MT",2007-2008,11463,11448,-15,-0.131,-58,43,30,27,H1
"Fergus County, MT",2008-2009,11448,11571,123,1.074,-52,175,30,27,H1
"Fergus County, MT",2009-2010,11571,11578,7,0.06,-46,53,30,27,H1
"Fergus County, MT",2010-2011,11578,11498,-80,-0.691,-44,-36,30,27,H1
"Fergus County, MT",2011-2012,11498,11439,-59,-0.513,-67,8,30,27,H1
"Fergus County, MT",2012-2013,11439,11522,83,0.726,-13,96,30,27,H1
"Fergus County, MT",2013-2014,11522,11442,-80,-0.694,-29,-51,30,27,H1
"Fergus County, MT",2014-2015,11433,11427,-6,-0.052,-22,16,30,27,H1
"Fergus County, MT",2015-2016,11427,11300,-127,-1.111,-34,-93,30,27,H1
"Fergus County, MT",2016-2017,11300,11291,-9,-0.08,-8,-1,30,27,H1
"Flathead County, MT",2000-2001,74774,76171,1397,1.868,291,1106,30,29,H1
"Flathead County, MT",2001-2002,76171,77583,1412,1.854,316,1096,30,29,H1
"Flathead County, MT",2002-2003,77583,79643,2060,2.655,292,1768,30,29,H1
"Flathead County, MT",2003-2004,79643,81247,1604,2.014,213,1391,30,29,H1
"Flathead County, MT",2004-2005,81247,83320,2073,2.551,357,1716,30,29,H1
"Flathead County, MT",2005-2006,83320,85759,2439,2.927,421,2018,30,29,H1
"Flathead County, MT",2006-2007,85759,88245,2486,2.899,438,2048,30,29,H1
"Flathead County, MT",2007-2008,88245,90260,2015,2.283,496,1519,30,29,H1
"Flathead County, MT",2008-2009,90260,90910,650,0.72,453,197,30,29,H1
"Flathead County, MT",2009-2010,90910,90902,-8,-0.009,326,-334,30,29,H1
"Flathead County, MT",2010-2011,90902,91222,320,0.352,355,-35,30,29,H1
"Flathead County, MT",2011-2012,91222,91692,470,0.515,279,191,30,29,H1
"Flathead County, MT",2012-2013,91692,93125,1433,1.563,339,1094,30,29,H1
"Flathead County, MT",2013-2014,93125,94924,1799,1.932,320,1479,30,29,H1
"Flathead County, MT",2014-2015,94726,96165,1439,1.519,317,1122,30,29,H1
"Flathead County, MT",2015-2016,96165,97693,1528,1.589,298,1230,30,29,H1
"Flathead County, MT",2016-2017,97693,1.00E+05,2307,2.361,333,1974,30,29,H1
"Gallatin County, MT",2000-2001,68375,70120,1745,2.552,472,1273,30,31,H1
"Gallatin County, MT",2001-2002,70120,71824,1704,2.43,509,1195,30,31,H1
"Gallatin County, MT",2002-2003,71824,74504,2680,3.731,611,2069,30,31,H1
"Gallatin County, MT",2003-2004,74504,77124,2620,3.517,630,1990,30,31,H1
"Gallatin County, MT",2004-2005,77124,80310,3186,4.131,618,2568,30,31,H1
"Gallatin County, MT",2005-2006,80310,83984,3674,4.575,784,2890,30,31,H1
"Gallatin County, MT",2006-2007,83984,86620,2636,3.139,794,1842,30,31,H1
"Gallatin County, MT",2007-2008,86620,88932,2312,2.669,817,1495,30,31,H1
"Gallatin County, MT",2008-2009,88932,89187,255,0.287,856,-601,30,31,H1
"Gallatin County, MT",2009-2010,89187,89599,412,0.462,777,-365,30,31,H1
"Gallatin County, MT",2010-2011,89599,91333,1734,1.935,523,1211,30,31,H1
"Gallatin County, MT",2011-2012,91333,92604,1271,1.392,608,663,30,31,H1
"Gallatin County, MT",2012-2013,92604,94694,2090,2.257,628,1462,30,31,H1
"Gallatin County, MT",2013-2014,94694,97308,2614,2.76,613,2001,30,31,H1
"Gallatin County, MT",2014-2015,97276,100739,3463,3.56,668,2795,30,31,H1
"Gallatin County, MT",2015-2016,100739,104072,3333,3.309,729,2604,30,31,H1
"Gallatin County, MT",2016-2017,104072,107810,3738,3.592,680,3058,30,31,H1
"Garfield County, MT",2000-2001,1268,1269,1,0.079,3,-2,30,33,H1
"Garfield County, MT",2001-2002,1269,1258,-11,-0.867,4,-15,30,33,H1
"Garfield County, MT",2002-2003,1258,1254,-4,-0.318,-2,-2,30,33,H1
"Garfield County, MT",2003-2004,1254,1236,-18,-1.435,7,-25,30,33,H1
"Garfield County, MT",2004-2005,1236,1202,-34,-2.751,0,-34,30,33,H1
"Garfield County, MT",2005-2006,1202,1233,31,2.579,10,21,30,33,H1
"Garfield County, MT",2006-2007,1233,1234,1,0.081,0,1,30,33,H1
"Garfield County, MT",2007-2008,1234,1205,-29,-2.35,7,-36,30,33,H1
"Garfield County, MT",2008-2009,1205,1240,35,2.905,9,26,30,33,H1
"Garfield County, MT",2009-2010,1240,1186,-54,-4.355,8,-62,30,33,H1
"Garfield County, MT",2010-2011,1186,1277,91,7.673,5,86,30,33,H1
"Garfield County, MT",2011-2012,1277,1264,-13,-1.018,6,-19,30,33,H1
"Garfield County, MT",2012-2013,1264,1282,18,1.424,0,18,30,33,H1
"Garfield County, MT",2013-2014,1282,1309,27,2.106,2,25,30,33,H1
"Garfield County, MT",2014-2015,1308,1314,6,0.459,-1,7,30,33,H1
"Garfield County, MT",2015-2016,1314,1308,-6,-0.457,14,-20,30,33,H1
"Garfield County, MT",2016-2017,1308,1293,-15,-1.147,7,-22,30,33,H1
"Glacier County, MT",2000-2001,13183,13098,-85,-0.645,132,-217,30,35,H1
"Glacier County, MT",2001-2002,13098,13101,3,0.023,137,-134,30,35,H1
"Glacier County, MT",2002-2003,13101,13168,67,0.511,183,-116,30,35,H1
"Glacier County, MT",2003-2004,13168,13388,220,1.671,167,53,30,35,H1
"Glacier County, MT",2004-2005,13388,13264,-124,-0.926,121,-245,30,35,H1
"Glacier County, MT",2005-2006,13264,13250,-14,-0.106,144,-158,30,35,H1
"Glacier County, MT",2006-2007,13250,13179,-71,-0.536,120,-191,30,35,H1
"Glacier County, MT",2007-2008,13179,13109,-70,-0.531,187,-257,30,35,H1
"Glacier County, MT",2008-2009,13109,13266,157,1.198,178,-21,30,35,H1
"Glacier County, MT",2009-2010,13266,13447,181,1.364,161,20,30,35,H1
"Glacier County, MT",2010-2011,13447,13578,131,0.974,148,-17,30,35,H1
"Glacier County, MT",2011-2012,13578,13684,106,0.781,90,16,30,35,H1
"Glacier County, MT",2012-2013,13684,13801,117,0.855,97,20,30,35,H1
"Glacier County, MT",2013-2014,13801,13696,-105,-0.761,90,-195,30,35,H1
"Glacier County, MT",2014-2015,13698,13647,-51,-0.372,92,-143,30,35,H1
"Glacier County, MT",2015-2016,13647,13669,22,0.161,76,-54,30,35,H1
"Glacier County, MT",2016-2017,13669,13640,-29,-0.212,75,-104,30,35,H1
"Golden Valley County, MT",2000-2001,1019,992,-27,-2.65,10,-37,30,37,H1
"Golden Valley County, MT",2001-2002,992,1012,20,2.016,3,17,30,37,H1
"Golden Valley County, MT",2002-2003,1012,981,-31,-3.063,4,-35,30,37,H1
"Golden Valley County, MT",2003-2004,981,1001,20,2.039,1,19,30,37,H1
"Golden Valley County, MT",2004-2005,1001,1014,13,1.299,0,13,30,37,H1
"Golden Valley County, MT",2005-2006,1014,973,-41,-4.043,0,-41,30,37,H1
"Golden Valley County, MT",2006-2007,973,964,-9,-0.925,-1,-8,30,37,H1
"Golden Valley County, MT",2007-2008,964,890,-74,-7.676,-6,-68,30,37,H1
"Golden Valley County, MT",2008-2009,890,897,7,0.787,5,2,30,37,H1
"Golden Valley County, MT",2009-2010,897,883,-14,-1.561,2,-16,30,37,H1
"Golden Valley County, MT",2010-2011,883,840,-43,-4.87,-5,-38,30,37,H1
"Golden Valley County, MT",2011-2012,840,842,2,0.238,-2,4,30,37,H1
"Golden Valley County, MT",2012-2013,842,857,15,1.781,-3,18,30,37,H1
"Golden Valley County, MT",2013-2014,857,852,-5,-0.583,1,-6,30,37,H1
"Golden Valley County, MT",2014-2015,852,827,-25,-2.934,2,-27,30,37,H1
"Golden Valley County, MT",2015-2016,827,815,-12,-1.451,3,-15,30,37,H1
"Golden Valley County, MT",2016-2017,815,822,7,0.859,1,6,30,37,H1
"Granite County, MT",2000-2001,2849,2905,56,1.966,-8,64,30,39,H1
"Granite County, MT",2001-2002,2905,2919,14,0.482,-16,30,30,39,H1
"Granite County, MT",2002-2003,2919,2931,12,0.411,-13,25,30,39,H1
"Granite County, MT",2003-2004,2931,2943,12,0.409,15,-3,30,39,H1
"Granite County, MT",2004-2005,2943,3009,66,2.243,-2,68,30,39,H1
"Granite County, MT",2005-2006,3009,3013,4,0.133,-8,12,30,39,H1
"Granite County, MT",2006-2007,3013,3039,26,0.863,14,12,30,39,H1
"Granite County, MT",2007-2008,3039,3031,-8,-0.263,3,-11,30,39,H1
"Granite County, MT",2008-2009,3031,3057,26,0.858,3,23,30,39,H1
"Granite County, MT",2009-2010,3057,3073,16,0.523,-1,17,30,39,H1
"Granite County, MT",2010-2011,3073,3145,72,2.343,-10,82,30,39,H1
"Granite County, MT",2011-2012,3145,3107,-38,-1.208,-14,-24,30,39,H1
"Granite County, MT",2012-2013,3107,3130,23,0.74,-14,37,30,39,H1
"Granite County, MT",2013-2014,3130,3209,79,2.524,-13,92,30,39,H1
"Granite County, MT",2014-2015,3215,3240,25,0.778,-9,34,30,39,H1
"Granite County, MT",2015-2016,3240,3292,52,1.605,-6,58,30,39,H1
"Granite County, MT",2016-2017,3292,3358,66,2.005,-13,79,30,39,H1
"Hill County, MT",2000-2001,16605,16378,-227,-1.367,123,-350,30,41,H1
"Hill County, MT",2001-2002,16378,16139,-239,-1.459,116,-355,30,41,H1
"Hill County, MT",2002-2003,16139,15988,-151,-0.936,83,-234,30,41,H1
"Hill County, MT",2003-2004,15988,15947,-41,-0.256,115,-156,30,41,H1
"Hill County, MT",2004-2005,15947,15870,-77,-0.483,122,-199,30,41,H1
"Hill County, MT",2005-2006,15870,15981,111,0.699,146,-35,30,41,H1
"Hill County, MT",2006-2007,15981,16031,50,0.313,114,-64,30,41,H1
"Hill County, MT",2007-2008,16031,15889,-142,-0.886,172,-314,30,41,H1
"Hill County, MT",2008-2009,15889,15981,92,0.579,180,-88,30,41,H1
"Hill County, MT",2009-2010,15981,16142,161,1.007,148,13,30,41,H1
"Hill County, MT",2010-2011,16142,16403,261,1.617,126,135,30,41,H1
"Hill County, MT",2011-2012,16403,16427,24,0.146,160,-136,30,41,H1
"Hill County, MT",2012-2013,16427,16604,177,1.077,163,14,30,41,H1
"Hill County, MT",2013-2014,16604,16596,-8,-0.048,159,-167,30,41,H1
"Hill County, MT",2014-2015,16599,16572,-27,-0.163,167,-194,30,41,H1
"Hill County, MT",2015-2016,16572,16446,-126,-0.76,160,-286,30,41,H1
"Hill County, MT",2016-2017,16446,16463,17,0.103,153,-136,30,41,H1
"Jefferson County, MT",2000-2001,10052,10087,35,0.348,-8,43,30,43,H1
"Jefferson County, MT",2001-2002,10087,10181,94,0.932,-1,95,30,43,H1
"Jefferson County, MT",2002-2003,10181,10262,81,0.796,8,73,30,43,H1
"Jefferson County, MT",2003-2004,10262,10511,249,2.426,27,222,30,43,H1
"Jefferson County, MT",2004-2005,10511,10709,198,1.884,10,188,30,43,H1
"Jefferson County, MT",2005-2006,10709,10801,92,0.859,24,68,30,43,H1
"Jefferson County, MT",2006-2007,10801,11040,239,2.213,37,202,30,43,H1
"Jefferson County, MT",2007-2008,11040,11203,163,1.476,2,161,30,43,H1
"Jefferson County, MT",2008-2009,11203,11364,161,1.437,10,151,30,43,H1
"Jefferson County, MT",2009-2010,11364,11410,46,0.405,6,40,30,43,H1
"Jefferson County, MT",2010-2011,11410,11450,40,0.351,-2,42,30,43,H1
"Jefferson County, MT",2011-2012,11450,11400,-50,-0.437,-25,-25,30,43,H1
"Jefferson County, MT",2012-2013,11400,11505,105,0.921,-12,117,30,43,H1
"Jefferson County, MT",2013-2014,11505,11558,53,0.461,-31,84,30,43,H1
"Jefferson County, MT",2014-2015,11552,11645,93,0.805,-22,115,30,43,H1
"Jefferson County, MT",2015-2016,11645,11770,125,1.073,16,109,30,43,H1
"Jefferson County, MT",2016-2017,11770,11891,121,1.028,-25,146,30,43,H1
"Judith Basin County, MT",2000-2001,2330,2266,-64,-2.747,-6,-58,30,45,H1
"Judith Basin County, MT",2001-2002,2266,2246,-20,-0.883,1,-21,30,45,H1
"Judith Basin County, MT",2002-2003,2246,2201,-45,-2.004,-6,-39,30,45,H1
"Judith Basin County, MT",2003-2004,2201,2196,-5,-0.227,-8,3,30,45,H1
"Judith Basin County, MT",2004-2005,2196,2161,-35,-1.594,-5,-30,30,45,H1
"Judith Basin County, MT",2005-2006,2161,2146,-15,-0.694,-2,-13,30,45,H1
"Judith Basin County, MT",2006-2007,2146,2083,-63,-2.936,-11,-52,30,45,H1
"Judith Basin County, MT",2007-2008,2083,2071,-12,-0.576,11,-23,30,45,H1
"Judith Basin County, MT",2008-2009,2071,2076,5,0.241,5,0,30,45,H1
"Judith Basin County, MT",2009-2010,2076,2062,-14,-0.674,-1,-13,30,45,H1
"Judith Basin County, MT",2010-2011,2062,2028,-34,-1.649,-11,-23,30,45,H1
"Judith Basin County, MT",2011-2012,2028,2021,-7,-0.345,-9,2,30,45,H1
"Judith Basin County, MT",2012-2013,2021,2011,-10,-0.495,5,-15,30,45,H1
"Judith Basin County, MT",2013-2014,2011,1991,-20,-0.995,0,-20,30,45,H1
"Judith Basin County, MT",2014-2015,1991,1926,-65,-3.265,2,-67,30,45,H1
"Judith Basin County, MT",2015-2016,1926,1949,23,1.194,9,14,30,45,H1
"Judith Basin County, MT",2016-2017,1949,1961,12,0.616,9,3,30,45,H1
"Lake County, MT",2000-2001,26588,26810,222,0.835,119,103,30,47,H1
"Lake County, MT",2001-2002,26810,26814,4,0.015,87,-83,30,47,H1
"Lake County, MT",2002-2003,26814,27117,303,1.13,131,172,30,47,H1
"Lake County, MT",2003-2004,27117,27634,517,1.907,121,396,30,47,H1
"Lake County, MT",2004-2005,27634,28023,389,1.408,97,292,30,47,H1
"Lake County, MT",2005-2006,28023,28283,260,0.928,159,101,30,47,H1
"Lake County, MT",2006-2007,28283,28235,-48,-0.17,146,-194,30,47,H1
"Lake County, MT",2007-2008,28235,28515,280,0.992,182,98,30,47,H1
"Lake County, MT",2008-2009,28515,28668,153,0.537,181,-28,30,47,H1
"Lake County, MT",2009-2010,28668,28785,117,0.408,156,-39,30,47,H1
"Lake County, MT",2010-2011,28785,29029,244,0.848,77,167,30,47,H1
"Lake County, MT",2011-2012,29029,28999,-30,-0.103,145,-175,30,47,H1
"Lake County, MT",2012-2013,28999,29023,24,0.083,101,-77,30,47,H1
"Lake County, MT",2013-2014,29023,29099,76,0.262,89,-13,30,47,H1
"Lake County, MT",2014-2015,29204,29457,253,0.866,80,173,30,47,H1
"Lake County, MT",2015-2016,29457,29711,254,0.862,53,201,30,47,H1
"Lake County, MT",2016-2017,29711,30273,562,1.892,53,509,30,47,H1
"Lewis and Clark County, MT",2000-2001,55886,56262,376,0.673,223,153,30,49,H1
"Lewis and Clark County, MT",2001-2002,56262,56271,9,0.016,175,-166,30,49,H1
"Lewis and Clark County, MT",2002-2003,56271,57110,839,1.491,189,650,30,49,H1
"Lewis and Clark County, MT",2003-2004,57110,58041,931,1.63,168,763,30,49,H1
"Lewis and Clark County, MT",2004-2005,58041,58529,488,0.841,201,287,30,49,H1
"Lewis and Clark County, MT",2005-2006,58529,59529,1.00E+03,1.709,184,816,30,49,H1
"Lewis and Clark County, MT",2006-2007,59529,60646,1117,1.876,298,819,30,49,H1
"Lewis and Clark County, MT",2007-2008,60646,61747,1101,1.815,261,840,30,49,H1
"Lewis and Clark County, MT",2008-2009,61747,62671,924,1.496,236,688,30,49,H1
"Lewis and Clark County, MT",2009-2010,62671,63590,919,1.466,231,688,30,49,H1
"Lewis and Clark County, MT",2010-2011,63590,64237,647,1.017,221,426,30,49,H1
"Lewis and Clark County, MT",2011-2012,64237,64845,608,0.946,187,421,30,49,H1
"Lewis and Clark County, MT",2012-2013,64845,65333,488,0.753,223,265,30,49,H1
"Lewis and Clark County, MT",2013-2014,65333,65856,523,0.801,180,343,30,49,H1
"Lewis and Clark County, MT",2014-2015,65904,66418,514,0.78,185,329,30,49,H1
"Lewis and Clark County, MT",2015-2016,66418,66792,374,0.563,204,170,30,49,H1
"Lewis and Clark County, MT",2016-2017,66792,67773,981,1.469,180,801,30,49,H1
"Liberty County, MT",2000-2001,2168,2163,-5,-0.231,-1,-4,30,51,H1
"Liberty County, MT",2001-2002,2163,2144,-19,-0.878,-3,-16,30,51,H1
"Liberty County, MT",2002-2003,2144,2212,68,3.172,-9,77,30,51,H1
"Liberty County, MT",2003-2004,2212,2263,51,2.306,-7,58,30,51,H1
"Liberty County, MT",2004-2005,2263,2266,3,0.133,-4,7,30,51,H1
"Liberty County, MT",2005-2006,2266,2216,-50,-2.207,-12,-38,30,51,H1
"Liberty County, MT",2006-2007,2216,2236,20,0.903,-11,31,30,51,H1
"Liberty County, MT",2007-2008,2236,2225,-11,-0.492,-2,-9,30,51,H1
"Liberty County, MT",2008-2009,2225,2283,58,2.607,-2,60,30,51,H1
"Liberty County, MT",2009-2010,2283,2354,71,3.11,-3,74,30,51,H1
"Liberty County, MT",2010-2011,2354,2382,28,1.189,2,26,30,51,H1
"Liberty County, MT",2011-2012,2382,2395,13,0.546,-9,22,30,51,H1
"Liberty County, MT",2012-2013,2395,2373,-22,-0.919,10,-32,30,51,H1
"Liberty County, MT",2013-2014,2373,2359,-14,-0.59,0,-14,30,51,H1
"Liberty County, MT",2014-2015,2363,2408,45,1.904,4,41,30,51,H1
"Liberty County, MT",2015-2016,2408,2428,20,0.831,14,6,30,51,H1
"Liberty County, MT",2016-2017,2428,2427,-1,-0.041,10,-11,30,51,H1
"Lincoln County, MT",2000-2001,18818,18646,-172,-0.914,2,-174,30,53,H1
"Lincoln County, MT",2001-2002,18646,18669,23,0.123,-2,25,30,53,H1
"Lincoln County, MT",2002-2003,18669,18861,192,1.028,14,178,30,53,H1
"Lincoln County, MT",2003-2004,18861,18991,130,0.689,-52,182,30,53,H1
"Lincoln County, MT",2004-2005,18991,19180,189,0.995,-34,223,30,53,H1
"Lincoln County, MT",2005-2006,19180,19228,48,0.25,-26,74,30,53,H1
"Lincoln County, MT",2006-2007,19228,19440,212,1.103,-47,259,30,53,H1
"Lincoln County, MT",2007-2008,19440,19541,101,0.52,-58,159,30,53,H1
"Lincoln County, MT",2008-2009,19541,19657,116,0.594,-26,142,30,53,H1
"Lincoln County, MT",2009-2010,19657,19681,24,0.122,-9,33,30,53,H1
"Lincoln County, MT",2010-2011,19681,19599,-82,-0.417,-55,-27,30,53,H1
"Lincoln County, MT",2011-2012,19599,19469,-130,-0.663,-49,-81,30,53,H1
"Lincoln County, MT",2012-2013,19469,19403,-66,-0.339,-35,-31,30,53,H1
"Lincoln County, MT",2013-2014,19403,19125,-278,-1.433,-56,-222,30,53,H1
"Lincoln County, MT",2014-2015,19139,19052,-87,-0.455,-69,-18,30,53,H1
"Lincoln County, MT",2015-2016,19052,19230,178,0.934,-78,256,30,53,H1
"Lincoln County, MT",2016-2017,19230,19440,210,1.092,-84,294,30,53,H1
"McCone County, MT",2000-2001,1960,1874,-86,-4.388,-1,-85,30,55,H1
"McCone County, MT",2001-2002,1874,1828,-46,-2.455,-2,-44,30,55,H1
"McCone County, MT",2002-2003,1828,1797,-31,-1.696,-9,-22,30,55,H1
"McCone County, MT",2003-2004,1797,1781,-16,-0.89,0,-16,30,55,H1
"McCone County, MT",2004-2005,1781,1778,-3,-0.168,-6,3,30,55,H1
"McCone County, MT",2005-2006,1778,1765,-13,-0.731,-3,-10,30,55,H1
"McCone County, MT",2006-2007,1765,1767,2,0.113,-4,6,30,55,H1
"McCone County, MT",2007-2008,1767,1720,-47,-2.66,0,-47,30,55,H1
"McCone County, MT",2008-2009,1720,1705,-15,-0.872,-1,-14,30,55,H1
"McCone County, MT",2009-2010,1705,1734,29,1.701,5,24,30,55,H1
"McCone County, MT",2010-2011,1734,1708,-26,-1.499,-9,-17,30,55,H1
"McCone County, MT",2011-2012,1708,1693,-15,-0.878,-13,-2,30,55,H1
"McCone County, MT",2012-2013,1693,1704,11,0.65,4,7,30,55,H1
"McCone County, MT",2013-2014,1704,1694,-10,-0.587,-1,-9,30,55,H1
"McCone County, MT",2014-2015,1704,1683,-21,-1.232,4,-25,30,55,H1
"McCone County, MT",2015-2016,1683,1739,56,3.327,8,48,30,55,H1
"McCone County, MT",2016-2017,1739,1718,-21,-1.208,8,-29,30,55,H1
"Madison County, MT",2000-2001,6870,6856,-14,-0.204,-39,25,30,57,H1
"Madison County, MT",2001-2002,6856,6935,79,1.152,-18,97,30,57,H1
"Madison County, MT",2002-2003,6935,6894,-41,-0.591,-24,-17,30,57,H1
"Madison County, MT",2003-2004,6894,6999,105,1.523,-34,139,30,57,H1
"Madison County, MT",2004-2005,6999,7211,212,3.029,-5,217,30,57,H1
"Madison County, MT",2005-2006,7211,7343,132,1.831,-5,137,30,57,H1
"Madison County, MT",2006-2007,7343,7560,217,2.955,-28,245,30,57,H1
"Madison County, MT",2007-2008,7560,7674,114,1.508,-33,147,30,57,H1
"Madison County, MT",2008-2009,7674,7674,0,0,-18,18,30,57,H1
"Madison County, MT",2009-2010,7674,7683,9,0.117,-20,29,30,57,H1
"Madison County, MT",2010-2011,7683,7695,12,0.156,-15,27,30,57,H1
"Madison County, MT",2011-2012,7695,7725,30,0.39,-14,44,30,57,H1
"Madison County, MT",2012-2013,7725,7694,-31,-0.401,-20,-11,30,57,H1
"Madison County, MT",2013-2014,7694,7820,126,1.638,-6,132,30,57,H1
"Madison County, MT",2014-2015,7806,7915,109,1.396,-3,112,30,57,H1
"Madison County, MT",2015-2016,7915,7969,54,0.682,-23,77,30,57,H1
"Madison County, MT",2016-2017,7969,8175,206,2.585,-16,222,30,57,H1
"Meagher County, MT",2000-2001,1916,1906,-10,-0.522,-5,-5,30,59,H1
"Meagher County, MT",2001-2002,1906,1895,-11,-0.577,4,-15,30,59,H1
"Meagher County, MT",2002-2003,1895,1913,18,0.95,-4,22,30,59,H1
"Meagher County, MT",2003-2004,1913,1935,22,1.15,-4,26,30,59,H1
"Meagher County, MT",2004-2005,1935,1899,-36,-1.86,-11,-25,30,59,H1
"Meagher County, MT",2005-2006,1899,1923,24,1.264,5,19,30,59,H1
"Meagher County, MT",2006-2007,1923,1908,-15,-0.78,5,-20,30,59,H1
"Meagher County, MT",2007-2008,1908,1893,-15,-0.786,-1,-14,30,59,H1
"Meagher County, MT",2008-2009,1893,1897,4,0.211,-2,6,30,59,H1
"Meagher County, MT",2009-2010,1897,1890,-7,-0.369,0,-7,30,59,H1
"Meagher County, MT",2010-2011,1890,1888,-2,-0.106,-6,4,30,59,H1
"Meagher County, MT",2011-2012,1888,1897,9,0.477,-2,11,30,59,H1
"Meagher County, MT",2012-2013,1897,1912,15,0.791,1,14,30,59,H1
"Meagher County, MT",2013-2014,1912,1853,-59,-3.086,-5,-54,30,59,H1
"Meagher County, MT",2014-2015,1865,1830,-35,-1.877,-8,-27,30,59,H1
"Meagher County, MT",2015-2016,1830,1842,12,0.656,3,9,30,59,H1
"Meagher County, MT",2016-2017,1842,1851,9,0.489,1,8,30,59,H1
"Mineral County, MT",2000-2001,3877,3839,-38,-0.98,8,-46,30,61,H1
"Mineral County, MT",2001-2002,3839,3837,-2,-0.052,2,-4,30,61,H1
"Mineral County, MT",2002-2003,3837,3936,99,2.58,-16,115,30,61,H1
"Mineral County, MT",2003-2004,3936,3985,49,1.245,10,39,30,61,H1
"Mineral County, MT",2004-2005,3985,4133,148,3.714,9,139,30,61,H1
"Mineral County, MT",2005-2006,4133,4211,78,1.887,0,78,30,61,H1
"Mineral County, MT",2006-2007,4211,4156,-55,-1.306,-2,-53,30,61,H1
"Mineral County, MT",2007-2008,4156,4177,21,0.505,7,14,30,61,H1
"Mineral County, MT",2008-2009,4177,4200,23,0.551,-7,30,30,61,H1
"Mineral County, MT",2009-2010,4200,4211,11,0.262,-7,18,30,61,H1
"Mineral County, MT",2010-2011,4211,4248,37,0.879,-4,41,30,61,H1
"Mineral County, MT",2011-2012,4248,4164,-84,-1.977,4,-88,30,61,H1
"Mineral County, MT",2012-2013,4164,4271,107,2.57,4,103,30,61,H1
"Mineral County, MT",2013-2014,4271,4257,-14,-0.328,9,-23,30,61,H1
"Mineral County, MT",2014-2015,4244,4251,7,0.165,2,5,30,61,H1
"Mineral County, MT",2015-2016,4251,4125,-126,-2.964,-8,-118,30,61,H1
"Mineral County, MT",2016-2017,4125,4255,130,3.152,-7,137,30,61,H1
"Missoula County, MT",2000-2001,96178,97435,1257,1.307,458,799,30,63,H1
"Missoula County, MT",2001-2002,97435,98968,1533,1.573,461,1072,30,63,H1
"Missoula County, MT",2002-2003,98968,99976,1008,1.019,399,609,30,63,H1
"Missoula County, MT",2003-2004,99976,100934,958,0.958,485,473,30,63,H1
"Missoula County, MT",2004-2005,100934,102298,1364,1.351,479,885,30,63,H1
"Missoula County, MT",2005-2006,102298,104372,2074,2.027,563,1511,30,63,H1
"Missoula County, MT",2006-2007,104372,106110,1738,1.665,593,1145,30,63,H1
"Missoula County, MT",2007-2008,106110,107747,1637,1.543,578,1059,30,63,H1
"Missoula County, MT",2008-2009,107747,108717,970,0.9,567,403,30,63,H1
"Missoula County, MT",2009-2010,108717,109425,708,0.651,535,173,30,63,H1
"Missoula County, MT",2010-2011,109425,110121,696,0.636,398,298,30,63,H1
"Missoula County, MT",2011-2012,110121,111054,933,0.847,454,479,30,63,H1
"Missoula County, MT",2012-2013,111054,111769,715,0.644,448,267,30,63,H1
"Missoula County, MT",2013-2014,111769,112684,915,0.819,425,490,30,63,H1
"Missoula County, MT",2014-2015,112681,114181,1500,1.331,464,1036,30,63,H1
"Missoula County, MT",2015-2016,114181,115896,1715,1.502,364,1351,30,63,H1
"Missoula County, MT",2016-2017,115896,117441,1545,1.333,364,1181,30,63,H1
"Musselshell County, MT",2000-2001,4471,4368,-103,-2.304,-7,-96,30,65,H1
"Musselshell County, MT",2001-2002,4368,4353,-15,-0.343,-16,1,30,65,H1
"Musselshell County, MT",2002-2003,4353,4361,8,0.184,0,8,30,65,H1
"Musselshell County, MT",2003-2004,4361,4370,9,0.206,-25,34,30,65,H1
"Musselshell County, MT",2004-2005,4370,4323,-47,-1.076,2,-49,30,65,H1
"Musselshell County, MT",2005-2006,4323,4398,75,1.735,-12,87,30,65,H1
"Musselshell County, MT",2006-2007,4398,4394,-4,-0.091,-9,5,30,65,H1
"Musselshell County, MT",2007-2008,4394,4423,29,0.66,-18,47,30,65,H1
"Musselshell County, MT",2008-2009,4423,4478,55,1.243,-9,64,30,65,H1
"Musselshell County, MT",2009-2010,4478,4548,70,1.563,-13,83,30,65,H1
"Musselshell County, MT",2010-2011,4548,4745,197,4.332,-13,210,30,65,H1
"Musselshell County, MT",2011-2012,4745,4675,-70,-1.475,-17,-53,30,65,H1
"Musselshell County, MT",2012-2013,4675,4625,-50,-1.07,-12,-38,30,65,H1
"Musselshell County, MT",2013-2014,4625,4589,-36,-0.778,-14,-22,30,65,H1
"Musselshell County, MT",2014-2015,4604,4582,-22,-0.478,-15,-7,30,65,H1
"Musselshell County, MT",2015-2016,4582,4636,54,1.179,-13,67,30,65,H1
"Musselshell County, MT",2016-2017,4636,4639,3,0.065,-13,16,30,65,H1
"Park County, MT",2000-2001,15710,15651,-59,-0.376,32,-91,30,67,H1
"Park County, MT",2001-2002,15651,15676,25,0.16,-1,26,30,67,H1
"Park County, MT",2002-2003,15676,15539,-137,-0.874,1,-138,30,67,H1
"Park County, MT",2003-2004,15539,15509,-30,-0.193,7,-37,30,67,H1
"Park County, MT",2004-2005,15509,15629,120,0.774,20,100,30,67,H1
"Park County, MT",2005-2006,15629,15690,61,0.39,11,50,30,67,H1
"Park County, MT",2006-2007,15690,15828,138,0.88,34,104,30,67,H1
"Park County, MT",2007-2008,15828,15896,68,0.43,0,68,30,67,H1
"Park County, MT",2008-2009,15896,15738,-158,-0.994,35,-193,30,67,H1
"Park County, MT",2009-2010,15738,15586,-152,-0.966,37,-189,30,67,H1
"Park County, MT",2010-2011,15586,15502,-84,-0.539,20,-104,30,67,H1
"Park County, MT",2011-2012,15502,15580,78,0.503,-21,99,30,67,H1
"Park County, MT",2012-2013,15580,15660,80,0.513,13,67,30,67,H1
"Park County, MT",2013-2014,15660,15880,220,1.405,2,218,30,67,H1
"Park County, MT",2014-2015,15855,15972,117,0.738,-5,122,30,67,H1
"Park County, MT",2015-2016,15972,16098,126,0.789,13,113,30,67,H1
"Park County, MT",2016-2017,16098,16353,255,1.584,-11,266,30,67,H1
"Petroleum County, MT",2000-2001,493,490,-3,-0.609,4,-7,30,69,H1
"Petroleum County, MT",2001-2002,490,506,16,3.265,-2,18,30,69,H1
"Petroleum County, MT",2002-2003,506,506,0,0,3,-3,30,69,H1
"Petroleum County, MT",2003-2004,506,519,13,2.569,-1,14,30,69,H1
"Petroleum County, MT",2004-2005,519,492,-27,-5.202,4,-31,30,69,H1
"Petroleum County, MT",2005-2006,492,495,3,0.61,-2,5,30,69,H1
"Petroleum County, MT",2006-2007,495,470,-25,-5.051,1,-26,30,69,H1
"Petroleum County, MT",2007-2008,470,481,11,2.34,0,11,30,69,H1
"Petroleum County, MT",2008-2009,481,488,7,1.455,2,5,30,69,H1
"Petroleum County, MT",2009-2010,488,492,4,0.82,3,1,30,69,H1
"Petroleum County, MT",2010-2011,492,490,-2,-0.407,2,-4,30,69,H1
"Petroleum County, MT",2011-2012,490,509,19,3.878,-2,21,30,69,H1
"Petroleum County, MT",2012-2013,509,505,-4,-0.786,1,-5,30,69,H1
"Petroleum County, MT",2013-2014,505,485,-20,-3.96,0,-20,30,69,H1
"Petroleum County, MT",2014-2015,489,475,-14,-2.863,2,-16,30,69,H1
"Petroleum County, MT",2015-2016,475,498,23,4.842,-1,24,30,69,H1
"Petroleum County, MT",2016-2017,498,523,25,5.02,1,24,30,69,H1
"Phillips County, MT",2000-2001,4568,4498,-70,-1.532,-12,-58,30,71,H1
"Phillips County, MT",2001-2002,4498,4383,-115,-2.557,-26,-89,30,71,H1
"Phillips County, MT",2002-2003,4383,4317,-66,-1.506,-17,-49,30,71,H1
"Phillips County, MT",2003-2004,4317,4295,-22,-0.51,-8,-14,30,71,H1
"Phillips County, MT",2004-2005,4295,4228,-67,-1.56,-6,-61,30,71,H1
"Phillips County, MT",2005-2006,4228,4166,-62,-1.466,-15,-47,30,71,H1
"Phillips County, MT",2006-2007,4166,4193,27,0.648,8,19,30,71,H1
"Phillips County, MT",2007-2008,4193,4182,-11,-0.262,-3,-8,30,71,H1
"Phillips County, MT",2008-2009,4182,4242,60,1.435,-14,74,30,71,H1
"Phillips County, MT",2009-2010,4242,4266,24,0.566,-6,30,30,71,H1
"Phillips County, MT",2010-2011,4266,4206,-60,-1.406,-19,-41,30,71,H1
"Phillips County, MT",2011-2012,4206,4127,-79,-1.878,-12,-67,30,71,H1
"Phillips County, MT",2012-2013,4127,4179,52,1.26,3,49,30,71,H1
"Phillips County, MT",2013-2014,4179,4192,13,0.311,5,8,30,71,H1
"Phillips County, MT",2014-2015,4186,4169,-17,-0.406,22,-39,30,71,H1
"Phillips County, MT",2015-2016,4169,4116,-53,-1.271,24,-77,30,71,H1
"Phillips County, MT",2016-2017,4116,4119,3,0.073,16,-13,30,71,H1
"Pondera County, MT",2000-2001,6384,6360,-24,-0.376,2,-26,30,73,H1
"Pondera County, MT",2001-2002,6360,6285,-75,-1.179,-14,-61,30,73,H1
"Pondera County, MT",2002-2003,6285,6228,-57,-0.907,2,-59,30,73,H1
"Pondera County, MT",2003-2004,6228,6140,-88,-1.413,-18,-70,30,73,H1
"Pondera County, MT",2004-2005,6140,6148,8,0.13,-9,17,30,73,H1
"Pondera County, MT",2005-2006,6148,6172,24,0.39,19,5,30,73,H1
"Pondera County, MT",2006-2007,6172,6169,-3,-0.049,16,-19,30,73,H1
"Pondera County, MT",2007-2008,6169,6117,-52,-0.843,19,-71,30,73,H1
"Pondera County, MT",2008-2009,6117,6109,-8,-0.131,24,-32,30,73,H1
"Pondera County, MT",2009-2010,6109,6172,63,1.031,17,46,30,73,H1
"Pondera County, MT",2010-2011,6172,6214,42,0.68,12,30,30,73,H1
"Pondera County, MT",2011-2012,6214,6193,-21,-0.338,3,-24,30,73,H1
"Pondera County, MT",2012-2013,6193,6258,65,1.05,-3,68,30,73,H1
"Pondera County, MT",2013-2014,6258,6219,-39,-0.623,11,-50,30,73,H1
"Pondera County, MT",2014-2015,6211,6184,-27,-0.435,17,-44,30,73,H1
"Pondera County, MT",2015-2016,6184,6028,-156,-2.523,15,-171,30,73,H1
"Pondera County, MT",2016-2017,6028,5960,-68,-1.128,11,-79,30,73,H1
"Powder River County, MT",2000-2001,1847,1814,-33,-1.787,-10,-23,30,75,H1
"Powder River County, MT",2001-2002,1814,1834,20,1.103,-5,25,30,75,H1
"Powder River County, MT",2002-2003,1834,1837,3,0.164,-7,10,30,75,H1
"Powder River County, MT",2003-2004,1837,1789,-48,-2.613,-5,-43,30,75,H1
"Powder River County, MT",2004-2005,1789,1739,-50,-2.795,-13,-37,30,75,H1
"Powder River County, MT",2005-2006,1739,1794,55,3.163,-9,64,30,75,H1
"Powder River County, MT",2006-2007,1794,1761,-33,-1.839,-6,-27,30,75,H1
"Powder River County, MT",2007-2008,1761,1756,-5,-0.284,-6,1,30,75,H1
"Powder River County, MT",2008-2009,1756,1738,-18,-1.025,-2,-16,30,75,H1
"Powder River County, MT",2009-2010,1738,1728,-10,-0.575,-3,-7,30,75,H1
"Powder River County, MT",2010-2011,1728,1750,22,1.273,-20,42,30,75,H1
"Powder River County, MT",2011-2012,1750,1755,5,0.286,-13,18,30,75,H1
"Powder River County, MT",2012-2013,1755,1751,-4,-0.228,-5,1,30,75,H1
"Powder River County, MT",2013-2014,1751,1783,32,1.828,-1,33,30,75,H1
"Powder River County, MT",2014-2015,1778,1773,-5,-0.281,-3,-2,30,75,H1
"Powder River County, MT",2015-2016,1773,1752,-21,-1.184,1,-22,30,75,H1
"Powder River County, MT",2016-2017,1752,1752,0,0,4,-4,30,75,H1
"Powell County, MT",2000-2001,7203,7033,-170,-2.36,-14,-156,30,77,H1
"Powell County, MT",2001-2002,7033,6986,-47,-0.668,-11,-36,30,77,H1
"Powell County, MT",2002-2003,6986,6893,-93,-1.331,-32,-61,30,77,H1
"Powell County, MT",2003-2004,6893,6872,-21,-0.305,-24,3,30,77,H1
"Powell County, MT",2004-2005,6872,6997,125,1.819,-18,143,30,77,H1
"Powell County, MT",2005-2006,6997,7115,118,1.686,-19,137,30,77,H1
"Powell County, MT",2006-2007,7115,7117,2,0.028,8,-6,30,77,H1
"Powell County, MT",2007-2008,7117,7036,-81,-1.138,-24,-57,30,77,H1
"Powell County, MT",2008-2009,7036,7093,57,0.81,-30,87,30,77,H1
"Powell County, MT",2009-2010,7093,7017,-76,-1.071,-16,-60,30,77,H1
"Powell County, MT",2010-2011,7017,7076,59,0.841,-17,76,30,77,H1
"Powell County, MT",2011-2012,7076,7085,9,0.127,-6,15,30,77,H1
"Powell County, MT",2012-2013,7085,6965,-120,-1.694,-25,-95,30,77,H1
"Powell County, MT",2013-2014,6965,6909,-56,-0.804,-31,-25,30,77,H1
"Powell County, MT",2014-2015,6906,6840,-66,-0.956,-32,-34,30,77,H1
"Powell County, MT",2015-2016,6840,6848,8,0.117,-15,23,30,77,H1
"Powell County, MT",2016-2017,6848,6795,-53,-0.774,-27,-26,30,77,H1
"Prairie County, MT",2000-2001,1179,1208,29,2.46,-9,38,30,79,H1
"Prairie County, MT",2001-2002,1208,1173,-35,-2.897,-18,-17,30,79,H1
"Prairie County, MT",2002-2003,1173,1168,-5,-0.426,-12,7,30,79,H1
"Prairie County, MT",2003-2004,1168,1153,-15,-1.284,-6,-9,30,79,H1
"Prairie County, MT",2004-2005,1153,1098,-55,-4.77,-15,-40,30,79,H1
"Prairie County, MT",2005-2006,1098,1098,0,0,-10,10,30,79,H1
"Prairie County, MT",2006-2007,1098,1083,-15,-1.366,-3,-12,30,79,H1
"Prairie County, MT",2007-2008,1083,1123,40,3.693,-5,45,30,79,H1
"Prairie County, MT",2008-2009,1123,1139,16,1.425,0,16,30,79,H1
"Prairie County, MT",2009-2010,1139,1189,50,4.39,-1,51,30,79,H1
"Prairie County, MT",2010-2011,1189,1158,-31,-2.607,-8,-23,30,79,H1
"Prairie County, MT",2011-2012,1158,1157,-1,-0.086,0,-1,30,79,H1
"Prairie County, MT",2012-2013,1157,1176,19,1.642,-7,26,30,79,H1
"Prairie County, MT",2013-2014,1176,1148,-28,-2.381,7,-35,30,79,H1
"Prairie County, MT",2014-2015,1140,1160,20,1.754,3,17,30,79,H1
"Prairie County, MT",2015-2016,1160,1166,6,0.517,-2,8,30,79,H1
"Prairie County, MT",2016-2017,1166,1109,-57,-4.889,-2,-55,30,79,H1
"Ravalli County, MT",2000-2001,36301,36683,382,1.052,58,324,30,81,H1
"Ravalli County, MT",2001-2002,36683,37308,625,1.704,46,579,30,81,H1
"Ravalli County, MT",2002-2003,37308,38184,876,2.348,56,820,30,81,H1
"Ravalli County, MT",2003-2004,38184,38739,555,1.453,82,473,30,81,H1
"Ravalli County, MT",2004-2005,38739,39012,273,0.705,49,224,30,81,H1
"Ravalli County, MT",2005-2006,39012,39555,543,1.392,124,419,30,81,H1
"Ravalli County, MT",2006-2007,39555,40023,468,1.183,11,457,30,81,H1
"Ravalli County, MT",2007-2008,40023,40223,200,0.5,30,170,30,81,H1
"Ravalli County, MT",2008-2009,40223,39956,-267,-0.664,14,-281,30,81,H1
"Ravalli County, MT",2009-2010,39956,40325,369,0.924,1,368,30,81,H1
"Ravalli County, MT",2010-2011,40325,40385,60,0.149,-26,86,30,81,H1
"Ravalli County, MT",2011-2012,40385,40637,252,0.624,-5,257,30,81,H1
"Ravalli County, MT",2012-2013,40637,40824,187,0.46,-31,218,30,81,H1
"Ravalli County, MT",2013-2014,40824,41030,206,0.505,-52,258,30,81,H1
"Ravalli County, MT",2014-2015,40953,41373,420,1.026,-59,479,30,81,H1
"Ravalli County, MT",2015-2016,41373,41876,503,1.216,-69,572,30,81,H1
"Ravalli County, MT",2016-2017,41876,42563,687,1.641,-63,750,30,81,H1
"Richland County, MT",2000-2001,9619,9424,-195,-2.027,-1,-194,30,83,H1
"Richland County, MT",2001-2002,9424,9286,-138,-1.464,-17,-121,30,83,H1
"Richland County, MT",2002-2003,9286,9195,-91,-0.98,-12,-79,30,83,H1
"Richland County, MT",2003-2004,9195,9096,-99,-1.077,-23,-76,30,83,H1
"Richland County, MT",2004-2005,9096,9207,111,1.22,16,95,30,83,H1
"Richland County, MT",2005-2006,9207,9267,60,0.652,-4,64,30,83,H1
"Richland County, MT",2006-2007,9267,9356,89,0.96,2,87,30,83,H1
"Richland County, MT",2007-2008,9356,9430,74,0.791,20,54,30,83,H1
"Richland County, MT",2008-2009,9430,9679,249,2.641,16,233,30,83,H1
"Richland County, MT",2009-2010,9679,9738,59,0.61,30,29,30,83,H1
"Richland County, MT",2010-2011,9738,10133,395,4.056,47,348,30,83,H1
"Richland County, MT",2011-2012,10133,10794,661,6.523,29,632,30,83,H1
"Richland County, MT",2012-2013,10794,11187,393,3.641,63,330,30,83,H1
"Richland County, MT",2013-2014,11187,11576,389,3.477,74,315,30,83,H1
"Richland County, MT",2014-2015,11573,11960,387,3.344,95,292,30,83,H1
"Richland County, MT",2015-2016,11960,11408,-552,-4.615,89,-641,30,83,H1
"Richland County, MT",2016-2017,11408,11039,-369,-3.235,76,-445,30,83,H1
"Roosevelt County, MT",2000-2001,10623,10558,-65,-0.612,84,-149,30,85,H1
"Roosevelt County, MT",2001-2002,10558,10389,-169,-1.601,89,-258,30,85,H1
"Roosevelt County, MT",2002-2003,10389,10344,-45,-0.433,72,-117,30,85,H1
"Roosevelt County, MT",2003-2004,10344,10459,115,1.112,80,35,30,85,H1
"Roosevelt County, MT",2004-2005,10459,10437,-22,-0.21,127,-149,30,85,H1
"Roosevelt County, MT",2005-2006,10437,10285,-152,-1.456,112,-264,30,85,H1
"Roosevelt County, MT",2006-2007,10285,10166,-119,-1.157,101,-220,30,85,H1
"Roosevelt County, MT",2007-2008,10166,10129,-37,-0.364,132,-169,30,85,H1
"Roosevelt County, MT",2008-2009,10129,10334,205,2.024,97,108,30,85,H1
"Roosevelt County, MT",2009-2010,10334,10438,104,1.006,121,-17,30,85,H1
"Roosevelt County, MT",2010-2011,10438,10525,87,0.833,82,5,30,85,H1
"Roosevelt County, MT",2011-2012,10525,10885,360,3.42,109,251,30,85,H1
"Roosevelt County, MT",2012-2013,10885,11124,239,2.196,107,132,30,85,H1
"Roosevelt County, MT",2013-2014,11124,11332,208,1.87,75,133,30,85,H1
"Roosevelt County, MT",2014-2015,11340,11476,136,1.199,59,77,30,85,H1
"Roosevelt County, MT",2015-2016,11476,11219,-257,-2.239,131,-388,30,85,H1
"Roosevelt County, MT",2016-2017,11219,11098,-121,-1.079,66,-187,30,85,H1
"Rosebud County, MT",2000-2001,9399,9248,-151,-1.607,83,-234,30,87,H1
"Rosebud County, MT",2001-2002,9248,9196,-52,-0.562,94,-146,30,87,H1
"Rosebud County, MT",2002-2003,9196,9210,14,0.152,104,-90,30,87,H1
"Rosebud County, MT",2003-2004,9210,9136,-74,-0.803,103,-177,30,87,H1
"Rosebud County, MT",2004-2005,9136,9131,-5,-0.055,85,-90,30,87,H1
"Rosebud County, MT",2005-2006,9131,9057,-74,-0.81,88,-162,30,87,H1
"Rosebud County, MT",2006-2007,9057,9089,32,0.353,113,-81,30,87,H1
"Rosebud County, MT",2007-2008,9089,9095,6,0.066,117,-111,30,87,H1
"Rosebud County, MT",2008-2009,9095,9174,79,0.869,104,-25,30,87,H1
"Rosebud County, MT",2009-2010,9174,9266,92,1.003,113,-21,30,87,H1
"Rosebud County, MT",2010-2011,9266,9364,98,1.058,54,44,30,87,H1
"Rosebud County, MT",2011-2012,9364,9382,18,0.192,103,-85,30,87,H1
"Rosebud County, MT",2012-2013,9382,9336,-46,-0.49,95,-141,30,87,H1
"Rosebud County, MT",2013-2014,9336,9326,-10,-0.107,74,-84,30,87,H1
"Rosebud County, MT",2014-2015,9335,9398,63,0.675,89,-26,30,87,H1
"Rosebud County, MT",2015-2016,9398,9265,-133,-1.415,101,-234,30,87,H1
"Rosebud County, MT",2016-2017,9265,9248,-17,-0.183,60,-77,30,87,H1
"Sanders County, MT",2000-2001,10287,10489,202,1.964,9,193,30,89,H1
"Sanders County, MT",2001-2002,10489,10466,-23,-0.219,-18,-5,30,89,H1
"Sanders County, MT",2002-2003,10466,10554,88,0.841,-11,99,30,89,H1
"Sanders County, MT",2003-2004,10554,10895,341,3.231,-35,376,30,89,H1
"Sanders County, MT",2004-2005,10895,11002,107,0.982,-33,140,30,89,H1
"Sanders County, MT",2005-2006,11002,11178,176,1.6,-9,185,30,89,H1
"Sanders County, MT",2006-2007,11178,11364,186,1.664,-6,192,30,89,H1
"Sanders County, MT",2007-2008,11364,11433,69,0.607,-6,75,30,89,H1
"Sanders County, MT",2008-2009,11433,11471,38,0.332,-16,54,30,89,H1
"Sanders County, MT",2009-2010,11471,11395,-76,-0.663,-20,-56,30,89,H1
"Sanders County, MT",2010-2011,11395,11374,-21,-0.184,-50,29,30,89,H1
"Sanders County, MT",2011-2012,11374,11383,9,0.079,-35,44,30,89,H1
"Sanders County, MT",2012-2013,11383,11348,-35,-0.307,-14,-21,30,89,H1
"Sanders County, MT",2013-2014,11348,11364,16,0.141,-10,26,30,89,H1
"Sanders County, MT",2014-2015,11329,11336,7,0.062,7,0,30,89,H1
"Sanders County, MT",2015-2016,11336,11466,130,1.147,-27,157,30,89,H1
"Sanders County, MT",2016-2017,11466,11711,245,2.137,-12,257,30,89,H1
"Sheridan County, MT",2000-2001,4078,3952,-126,-3.09,-41,-85,30,91,H1
"Sheridan County, MT",2001-2002,3952,3825,-127,-3.214,-46,-81,30,91,H1
"Sheridan County, MT",2002-2003,3825,3697,-128,-3.346,-41,-87,30,91,H1
"Sheridan County, MT",2003-2004,3697,3683,-14,-0.379,-25,11,30,91,H1
"Sheridan County, MT",2004-2005,3683,3573,-110,-2.987,-34,-76,30,91,H1
"Sheridan County, MT",2005-2006,3573,3507,-66,-1.847,-41,-25,30,91,H1
"Sheridan County, MT",2006-2007,3507,3469,-38,-1.084,-51,13,30,91,H1
"Sheridan County, MT",2007-2008,3469,3385,-84,-2.421,-25,-59,30,91,H1
"Sheridan County, MT",2008-2009,3385,3387,2,0.059,-28,30,30,91,H1
"Sheridan County, MT",2009-2010,3387,3373,-14,-0.413,-10,-4,30,91,H1
"Sheridan County, MT",2010-2011,3373,3441,68,2.016,-35,103,30,91,H1
"Sheridan County, MT",2011-2012,3441,3580,139,4.04,-8,147,30,91,H1
"Sheridan County, MT",2012-2013,3580,3658,78,2.179,-10,88,30,91,H1
"Sheridan County, MT",2013-2014,3658,3696,38,1.039,-16,54,30,91,H1
"Sheridan County, MT",2014-2015,3679,3687,8,0.217,-6,14,30,91,H1
"Sheridan County, MT",2015-2016,3687,3596,-91,-2.468,-6,-85,30,91,H1
"Sheridan County, MT",2016-2017,3596,3469,-127,-3.532,3,-130,30,91,H1
"Silver Bow County, MT",2000-2001,34571,33882,-689,-1.993,-74,-615,30,93,H6
"Silver Bow County, MT",2001-2002,33882,33636,-246,-0.726,-62,-184,30,93,H6
"Silver Bow County, MT",2002-2003,33636,33474,-162,-0.482,-14,-148,30,93,H6
"Silver Bow County, MT",2003-2004,33474,33416,-58,-0.173,-44,-14,30,93,H6
"Silver Bow County, MT",2004-2005,33416,33414,-2,-0.006,-73,71,30,93,H6
"Silver Bow County, MT",2005-2006,33414,33441,27,0.081,-28,55,30,93,H6
"Silver Bow County, MT",2006-2007,33441,33489,48,0.144,-16,64,30,93,H6
"Silver Bow County, MT",2007-2008,33489,33812,323,0.964,-5,328,30,93,H6
"Silver Bow County, MT",2008-2009,33812,34008,196,0.58,-3,199,30,93,H6
"Silver Bow County, MT",2009-2010,34008,34239,231,0.679,12,219,30,93,H6
"Silver Bow County, MT",2010-2011,34239,34388,149,0.435,-5,154,30,93,H6
"Silver Bow County, MT",2011-2012,34388,34493,105,0.305,37,68,30,93,H6
"Silver Bow County, MT",2012-2013,34493,34512,19,0.055,-35,54,30,93,H6
"Silver Bow County, MT",2013-2014,34512,34680,168,0.487,-22,190,30,93,H6
"Silver Bow County, MT",2014-2015,34730,34622,-108,-0.311,1,-109,30,93,H6
"Silver Bow County, MT",2015-2016,34622,34467,-155,-0.448,-33,-122,30,93,H6
"Silver Bow County, MT",2016-2017,34467,34602,135,0.392,-19,154,30,93,H6
"Stillwater County, MT",2000-2001,8247,8392,145,1.758,21,124,30,95,H1
"Stillwater County, MT",2001-2002,8392,8441,49,0.584,27,22,30,95,H1
"Stillwater County, MT",2002-2003,8441,8451,10,0.118,22,-12,30,95,H1
"Stillwater County, MT",2003-2004,8451,8435,-16,-0.189,32,-48,30,95,H1
"Stillwater County, MT",2004-2005,8435,8481,46,0.545,25,21,30,95,H1
"Stillwater County, MT",2005-2006,8481,8659,178,2.099,27,151,30,95,H1
"Stillwater County, MT",2006-2007,8659,8867,208,2.402,28,180,30,95,H1
"Stillwater County, MT",2007-2008,8867,8945,78,0.88,30,48,30,95,H1
"Stillwater County, MT",2008-2009,8945,9077,132,1.476,19,113,30,95,H1
"Stillwater County, MT",2009-2010,9077,9111,34,0.375,16,18,30,95,H1
"Stillwater County, MT",2010-2011,9111,9162,51,0.56,-4,55,30,95,H1
"Stillwater County, MT",2011-2012,9162,9195,33,0.36,-1,34,30,95,H1
"Stillwater County, MT",2012-2013,9195,9310,115,1.251,10,105,30,95,H1
"Stillwater County, MT",2013-2014,9310,9290,-20,-0.215,4,-24,30,95,H1
"Stillwater County, MT",2014-2015,9287,9486,199,2.143,9,190,30,95,H1
"Stillwater County, MT",2015-2016,9486,9367,-119,-1.254,-11,-108,30,95,H1
"Stillwater County, MT",2016-2017,9367,9419,52,0.555,-8,60,30,95,H1
"Sweet Grass County, MT",2000-2001,3633,3594,-39,-1.073,-15,-24,30,97,H1
"Sweet Grass County, MT",2001-2002,3594,3617,23,0.64,4,19,30,97,H1
"Sweet Grass County, MT",2002-2003,3617,3591,-26,-0.719,-3,-23,30,97,H1
"Sweet Grass County, MT",2003-2004,3591,3676,85,2.367,12,73,30,97,H1
"Sweet Grass County, MT",2004-2005,3676,3675,-1,-0.027,7,-8,30,97,H1
"Sweet Grass County, MT",2005-2006,3675,3697,22,0.599,0,22,30,97,H1
"Sweet Grass County, MT",2006-2007,3697,3778,81,2.191,-1,82,30,97,H1
"Sweet Grass County, MT",2007-2008,3778,3755,-23,-0.609,-1,-22,30,97,H1
"Sweet Grass County, MT",2008-2009,3755,3731,-24,-0.639,13,-37,30,97,H1
"Sweet Grass County, MT",2009-2010,3731,3613,-118,-3.163,7,-125,30,97,H1
"Sweet Grass County, MT",2010-2011,3613,3583,-30,-0.83,-24,-6,30,97,H1
"Sweet Grass County, MT",2011-2012,3583,3587,4,0.112,-8,12,30,97,H1
"Sweet Grass County, MT",2012-2013,3587,3662,75,2.091,6,69,30,97,H1
"Sweet Grass County, MT",2013-2014,3662,3665,3,0.082,1,2,30,97,H1
"Sweet Grass County, MT",2014-2015,3666,3634,-32,-0.873,-2,-30,30,97,H1
"Sweet Grass County, MT",2015-2016,3634,3628,-6,-0.165,4,-10,30,97,H1
"Sweet Grass County, MT",2016-2017,3628,3691,63,1.736,0,63,30,97,H1
"Teton County, MT",2000-2001,6436,6373,-63,-0.979,4,-67,30,99,H1
"Teton County, MT",2001-2002,6373,6286,-87,-1.365,-8,-79,30,99,H1
"Teton County, MT",2002-2003,6286,6314,28,0.445,-3,31,30,99,H1
"Teton County, MT",2003-2004,6314,6209,-105,-1.663,8,-113,30,99,H1
"Teton County, MT",2004-2005,6209,6105,-104,-1.675,-20,-84,30,99,H1
"Teton County, MT",2005-2006,6105,6110,5,0.082,13,-8,30,99,H1
"Teton County, MT",2006-2007,6110,6143,33,0.54,6,27,30,99,H1
"Teton County, MT",2007-2008,6143,6143,0,0,8,-8,30,99,H1
"Teton County, MT",2008-2009,6143,6050,-93,-1.514,3,-96,30,99,H1
"Teton County, MT",2009-2010,6050,6078,28,0.463,-4,32,30,99,H1
"Teton County, MT",2010-2011,6078,6084,6,0.099,7,-1,30,99,H1
"Teton County, MT",2011-2012,6084,6072,-12,-0.197,14,-26,30,99,H1
"Teton County, MT",2012-2013,6072,6075,3,0.049,11,-8,30,99,H1
"Teton County, MT",2013-2014,6075,6064,-11,-0.181,17,-28,30,99,H1
"Teton County, MT",2014-2015,6046,6104,58,0.959,22,36,30,99,H1
"Teton County, MT",2015-2016,6104,6012,-92,-1.507,27,-119,30,99,H1
"Teton County, MT",2016-2017,6012,6085,73,1.214,14,59,30,99,H1
"Toole County, MT",2000-2001,5261,5228,-33,-0.627,8,-41,30,101,H1
"Toole County, MT",2001-2002,5228,5184,-44,-0.842,-2,-42,30,101,H1
"Toole County, MT",2002-2003,5184,5006,-178,-3.434,-15,-163,30,101,H1
"Toole County, MT",2003-2004,5006,5069,63,1.258,-23,86,30,101,H1
"Toole County, MT",2004-2005,5069,5130,61,1.203,-5,66,30,101,H1
"Toole County, MT",2005-2006,5130,5085,-45,-0.877,-8,-37,30,101,H1
"Toole County, MT",2006-2007,5085,4969,-116,-2.281,-17,-99,30,101,H1
"Toole County, MT",2007-2008,4969,5079,110,2.214,7,103,30,101,H1
"Toole County, MT",2008-2009,5079,5245,166,3.268,-1,167,30,101,H1
"Toole County, MT",2009-2010,5245,5342,97,1.849,-2,99,30,101,H1
"Toole County, MT",2010-2011,5342,5170,-172,-3.22,9,-181,30,101,H1
"Toole County, MT",2011-2012,5170,5231,61,1.18,11,50,30,101,H1
"Toole County, MT",2012-2013,5231,5149,-82,-1.568,19,-101,30,101,H1
"Toole County, MT",2013-2014,5149,5150,1,0.019,6,-5,30,101,H1
"Toole County, MT",2014-2015,5135,5087,-48,-0.935,21,-69,30,101,H1
"Toole County, MT",2015-2016,5087,4961,-126,-2.477,15,-141,30,101,H1
"Toole County, MT",2016-2017,4961,4886,-75,-1.512,21,-96,30,101,H1
"Treasure County, MT",2000-2001,854,836,-18,-2.108,0,-18,30,103,H1
"Treasure County, MT",2001-2002,836,793,-43,-5.144,-1,-42,30,103,H1
"Treasure County, MT",2002-2003,793,784,-9,-1.135,-9,0,30,103,H1
"Treasure County, MT",2003-2004,784,799,15,1.913,2,13,30,103,H1
"Treasure County, MT",2004-2005,799,766,-33,-4.13,-2,-31,30,103,H1
"Treasure County, MT",2005-2006,766,759,-7,-0.914,1,-8,30,103,H1
"Treasure County, MT",2006-2007,759,748,-11,-1.449,-4,-7,30,103,H1
"Treasure County, MT",2007-2008,748,754,6,0.802,1,5,30,103,H1
"Treasure County, MT",2008-2009,754,720,-34,-4.509,4,-38,30,103,H1
"Treasure County, MT",2009-2010,720,719,-1,-0.139,2,-3,30,103,H1
"Treasure County, MT",2010-2011,719,720,1,0.139,1,0,30,103,H1
"Treasure County, MT",2011-2012,720,730,10,1.389,-3,13,30,103,H1
"Treasure County, MT",2012-2013,730,699,-31,-4.247,3,-34,30,103,H1
"Treasure County, MT",2013-2014,699,692,-7,-1.001,2,-9,30,103,H1
"Treasure County, MT",2014-2015,696,697,1,0.144,2,-1,30,103,H1
"Treasure County, MT",2015-2016,697,685,-12,-1.722,2,-14,30,103,H1
"Treasure County, MT",2016-2017,685,679,-6,-0.876,5,-11,30,103,H1
"Valley County, MT",2000-2001,7653,7587,-66,-0.862,11,-77,30,105,H1
"Valley County, MT",2001-2002,7587,7512,-75,-0.989,-26,-49,30,105,H1
"Valley County, MT",2002-2003,7512,7427,-85,-1.132,-15,-70,30,105,H1
"Valley County, MT",2003-2004,7427,7422,-5,-0.067,-24,19,30,105,H1
"Valley County, MT",2004-2005,7422,7367,-55,-0.741,-19,-36,30,105,H1
"Valley County, MT",2005-2006,7367,7272,-95,-1.29,-5,-90,30,105,H1
"Valley County, MT",2006-2007,7272,7332,60,0.825,6,54,30,105,H1
"Valley County, MT",2007-2008,7332,7415,83,1.132,-7,90,30,105,H1
"Valley County, MT",2008-2009,7415,7349,-66,-0.89,-19,-47,30,105,H1
"Valley County, MT",2009-2010,7349,7367,18,0.245,-19,37,30,105,H1
"Valley County, MT",2010-2011,7367,7472,105,1.425,-7,112,30,105,H1
"Valley County, MT",2011-2012,7472,7494,22,0.294,-7,29,30,105,H1
"Valley County, MT",2012-2013,7494,7619,125,1.668,12,113,30,105,H1
"Valley County, MT",2013-2014,7619,7640,21,0.276,17,4,30,105,H1
"Valley County, MT",2014-2015,7624,7659,35,0.459,31,4,30,105,H1
"Valley County, MT",2015-2016,7659,7537,-122,-1.593,25,-147,30,105,H1
"Valley County, MT",2016-2017,7537,7433,-104,-1.38,24,-128,30,105,H1
"Wheatland County, MT",2000-2001,2243,2174,-69,-3.076,-8,-61,30,107,H1
"Wheatland County, MT",2001-2002,2174,2193,19,0.874,-2,21,30,107,H1
"Wheatland County, MT",2002-2003,2193,2131,-62,-2.827,-13,-49,30,107,H1
"Wheatland County, MT",2003-2004,2131,2113,-18,-0.845,-16,-2,30,107,H1
"Wheatland County, MT",2004-2005,2113,2086,-27,-1.278,-5,-22,30,107,H1
"Wheatland County, MT",2005-2006,2086,2035,-51,-2.445,-1,-50,30,107,H1
"Wheatland County, MT",2006-2007,2035,2080,45,2.211,-2,47,30,107,H1
"Wheatland County, MT",2007-2008,2080,2151,71,3.413,-1,72,30,107,H1
"Wheatland County, MT",2008-2009,2151,2158,7,0.325,9,-2,30,107,H1
"Wheatland County, MT",2009-2010,2158,2158,0,0,7,-7,30,107,H1
"Wheatland County, MT",2010-2011,2158,2139,-19,-0.88,5,-24,30,107,H1
"Wheatland County, MT",2011-2012,2139,2099,-40,-1.87,-4,-36,30,107,H1
"Wheatland County, MT",2012-2013,2099,2131,32,1.525,6,26,30,107,H1
"Wheatland County, MT",2013-2014,2131,2102,-29,-1.361,11,-40,30,107,H1
"Wheatland County, MT",2014-2015,2096,2110,14,0.668,5,9,30,107,H1
"Wheatland County, MT",2015-2016,2110,2111,1,0.047,6,-5,30,107,H1
"Wheatland County, MT",2016-2017,2111,2140,29,1.374,5,24,30,107,H1
"Wibaux County, MT",2000-2001,1072,1032,-40,-3.731,-17,-23,30,109,H1
"Wibaux County, MT",2001-2002,1032,1028,-4,-0.388,-8,4,30,109,H1
"Wibaux County, MT",2002-2003,1028,1020,-8,-0.778,-14,6,30,109,H1
"Wibaux County, MT",2003-2004,1020,1019,-1,-0.098,-5,4,30,109,H1
"Wibaux County, MT",2004-2005,1019,995,-24,-2.355,-20,-4,30,109,H1
"Wibaux County, MT",2005-2006,995,984,-11,-1.106,-12,1,30,109,H1
"Wibaux County, MT",2006-2007,984,1014,30,3.049,-15,45,30,109,H1
"Wibaux County, MT",2007-2008,1014,986,-28,-2.761,-9,-19,30,109,H1
"Wibaux County, MT",2008-2009,986,1030,44,4.462,-7,51,30,109,H1
"Wibaux County, MT",2009-2010,1030,1006,-24,-2.33,2,-26,30,109,H1
"Wibaux County, MT",2010-2011,1006,990,-16,-1.59,-11,-5,30,109,H1
"Wibaux County, MT",2011-2012,990,1057,67,6.768,-9,76,30,109,H1
"Wibaux County, MT",2012-2013,1057,1126,69,6.528,3,66,30,109,H1
"Wibaux County, MT",2013-2014,1126,1121,-5,-0.444,4,-9,30,109,H1
"Wibaux County, MT",2014-2015,1125,1130,5,0.444,8,-3,30,109,H1
"Wibaux County, MT",2015-2016,1130,1047,-83,-7.345,-4,-79,30,109,H1
"Wibaux County, MT",2016-2017,1047,1020,-27,-2.579,-4,-23,30,109,H1
"Yellowstone County, MT",2000-2001,129570,130801,1231,0.95,604,627,30,111,H1
"Yellowstone County, MT",2001-2002,130801,132165,1364,1.043,538,826,30,111,H1
"Yellowstone County, MT",2002-2003,132165,133715,1550,1.173,586,964,30,111,H1
"Yellowstone County, MT",2003-2004,133715,135441,1726,1.291,681,1045,30,111,H1
"Yellowstone County, MT",2004-2005,135441,137623,2182,1.611,679,1503,30,111,H1
"Yellowstone County, MT",2005-2006,137623,139582,1959,1.423,702,1257,30,111,H1
"Yellowstone County, MT",2006-2007,139582,141518,1936,1.387,739,1197,30,111,H1
"Yellowstone County, MT",2007-2008,141518,144255,2737,1.934,705,2032,30,111,H1
"Yellowstone County, MT",2008-2009,144255,146465,2210,1.532,729,1481,30,111,H1
"Yellowstone County, MT",2009-2010,146465,148398,1933,1.32,780,1153,30,111,H1
"Yellowstone County, MT",2010-2011,148398,149845,1447,0.975,616,831,30,111,H1
"Yellowstone County, MT",2011-2012,149845,151888,2043,1.363,677,1366,30,111,H1
"Yellowstone County, MT",2012-2013,151888,154060,2172,1.43,601,1571,30,111,H1
"Yellowstone County, MT",2013-2014,154060,155634,1574,1.022,672,902,30,111,H1
"Yellowstone County, MT",2014-2015,155588,157048,1460,0.938,619,841,30,111,H1
"Yellowstone County, MT",2015-2016,157048,157648,600,0.382,488,112,30,111,H1
"Yellowstone County, MT",2016-2017,157648,158980,1332,0.845,520,812,30,111,H1
Nebraska,2000-2001,1713820,1719836,6016,0.351,9601,-3585,31,0,STATE
Nebraska,2001-2002,1719836,1728292,8456,0.492,9306,-850,31,0,STATE
Nebraska,2002-2003,1728292,1738643,10351,0.599,10260,91,31,0,STATE
Nebraska,2003-2004,1738643,1749370,10727,0.617,11073,-346,31,0,STATE
Nebraska,2004-2005,1749370,1761497,12127,0.693,11395,732,31,0,STATE
Nebraska,2005-2006,1761497,1772693,11196,0.636,11184,12,31,0,STATE
Nebraska,2006-2007,1772693,1783440,10747,0.606,11993,-1246,31,0,STATE
Nebraska,2007-2008,1783440,1796378,12938,0.725,12151,787,31,0,STATE
Nebraska,2008-2009,1796378,1812683,16305,0.908,12540,3765,31,0,STATE
Nebraska,2009-2010,1812683,1830025,17342,0.957,12570,4772,31,0,STATE
Nebraska,2010-2011,1830025,1842383,12358,0.675,10110,2248,31,0,STATE
Nebraska,2011-2012,1842383,1855973,13590,0.738,10549,3041,31,0,STATE
Nebraska,2012-2013,1855973,1869300,13327,0.718,9848,3479,31,0,STATE
Nebraska,2013-2014,1869300,1882980,13680,0.732,11477,2203,31,0,STATE
Nebraska,2014-2015,1882980,1896190,13210,0.702,11559,1651,31,0,STATE
Nebraska,2015-2016,1896190,1907603,11413,0.602,10936,477,31,0,STATE
Nebraska,2016-2017,1907603,1920076,12473,0.654,11160,1313,31,0,STATE
"Adams County, NE",2000-2001,31154,31021,-133,-0.427,92,-225,31,1,H1
"Adams County, NE",2001-2002,31021,30716,-305,-0.983,87,-392,31,1,H1
"Adams County, NE",2002-2003,30716,30693,-23,-0.075,112,-135,31,1,H1
"Adams County, NE",2003-2004,30693,30740,47,0.153,138,-91,31,1,H1
"Adams County, NE",2004-2005,30740,30987,247,0.804,134,113,31,1,H1
"Adams County, NE",2005-2006,30987,30910,-77,-0.248,130,-207,31,1,H1
"Adams County, NE",2006-2007,30910,30892,-18,-0.058,156,-174,31,1,H1
"Adams County, NE",2007-2008,30892,31160,268,0.868,99,169,31,1,H1
"Adams County, NE",2008-2009,31160,31280,120,0.385,146,-26,31,1,H1
"Adams County, NE",2009-2010,31280,31333,53,0.169,149,-96,31,1,H1
"Adams County, NE",2010-2011,31333,31224,-109,-0.348,106,-215,31,1,H1
"Adams County, NE",2011-2012,31224,31384,160,0.512,111,49,31,1,H1
"Adams County, NE",2012-2013,31384,31581,197,0.628,115,82,31,1,H1
"Adams County, NE",2013-2014,31581,31457,-124,-0.393,108,-232,31,1,H1
"Adams County, NE",2014-2015,31419,31587,168,0.535,84,84,31,1,H1
"Adams County, NE",2015-2016,31587,31657,70,0.222,93,-23,31,1,H1
"Adams County, NE",2016-2017,31657,31678,21,0.066,93,-72,31,1,H1
"Antelope County, NE",2000-2001,7435,7242,-193,-2.596,-23,-170,31,3,H1
"Antelope County, NE",2001-2002,7242,7229,-13,-0.18,-4,-9,31,3,H1
"Antelope County, NE",2002-2003,7229,7172,-57,-0.788,-20,-37,31,3,H1
"Antelope County, NE",2003-2004,7172,7063,-109,-1.52,-14,-95,31,3,H1
"Antelope County, NE",2004-2005,7063,6994,-69,-0.977,7,-76,31,3,H1
"Antelope County, NE",2005-2006,6994,6836,-158,-2.259,11,-169,31,3,H1
"Antelope County, NE",2006-2007,6836,6767,-69,-1.009,-4,-65,31,3,H1
"Antelope County, NE",2007-2008,6767,6704,-63,-0.931,11,-74,31,3,H1
"Antelope County, NE",2008-2009,6704,6739,35,0.522,16,19,31,3,H1
"Antelope County, NE",2009-2010,6739,6658,-81,-1.202,21,-102,31,3,H1
"Antelope County, NE",2010-2011,6658,6622,-36,-0.541,-6,-30,31,3,H1
"Antelope County, NE",2011-2012,6622,6520,-102,-1.54,4,-106,31,3,H1
"Antelope County, NE",2012-2013,6520,6456,-64,-0.982,19,-83,31,3,H1
"Antelope County, NE",2013-2014,6456,6398,-58,-0.898,21,-79,31,3,H1
"Antelope County, NE",2014-2015,6403,6414,11,0.172,29,-18,31,3,H1
"Antelope County, NE",2015-2016,6414,6356,-58,-0.904,1,-59,31,3,H1
"Antelope County, NE",2016-2017,6356,6362,6,0.094,10,-4,31,3,H1
"Arthur County, NE",2000-2001,445,423,-22,-4.944,2,-24,31,5,H1
"Arthur County, NE",2001-2002,423,421,-2,-0.473,1,-3,31,5,H1
"Arthur County, NE",2002-2003,421,439,18,4.276,-1,19,31,5,H1
"Arthur County, NE",2003-2004,439,433,-6,-1.367,4,-10,31,5,H1
"Arthur County, NE",2004-2005,433,428,-5,-1.155,1,-6,31,5,H1
"Arthur County, NE",2005-2006,428,450,22,5.14,-1,23,31,5,H1
"Arthur County, NE",2006-2007,450,457,7,1.556,1,6,31,5,H1
"Arthur County, NE",2007-2008,457,453,-4,-0.875,2,-6,31,5,H1
"Arthur County, NE",2008-2009,453,442,-11,-2.428,3,-14,31,5,H1
"Arthur County, NE",2009-2010,442,464,22,4.977,6,16,31,5,H1
"Arthur County, NE",2010-2011,464,469,5,1.078,2,3,31,5,H1
"Arthur County, NE",2011-2012,469,482,13,2.772,3,10,31,5,H1
"Arthur County, NE",2012-2013,482,451,-31,-6.432,-2,-29,31,5,H1
"Arthur County, NE",2013-2014,451,453,2,0.443,-3,5,31,5,H1
"Arthur County, NE",2014-2015,454,456,2,0.441,4,-2,31,5,H1
"Arthur County, NE",2015-2016,456,470,14,3.07,2,12,31,5,H1
"Arthur County, NE",2016-2017,470,457,-13,-2.766,0,-13,31,5,H1
"Banner County, NE",2000-2001,819,808,-11,-1.343,2,-13,31,7,H1
"Banner County, NE",2001-2002,808,769,-39,-4.827,-2,-37,31,7,H1
"Banner County, NE",2002-2003,769,763,-6,-0.78,0,-6,31,7,H1
"Banner County, NE",2003-2004,763,749,-14,-1.835,1,-15,31,7,H1
"Banner County, NE",2004-2005,749,731,-18,-2.403,1,-19,31,7,H1
"Banner County, NE",2005-2006,731,733,2,0.274,0,2,31,7,H1
"Banner County, NE",2006-2007,733,715,-18,-2.456,1,-19,31,7,H1
"Banner County, NE",2007-2008,715,677,-38,-5.315,0,-38,31,7,H1
"Banner County, NE",2008-2009,677,686,9,1.329,3,6,31,7,H1
"Banner County, NE",2009-2010,686,698,12,1.749,5,7,31,7,H1
"Banner County, NE",2010-2011,698,741,43,6.16,-2,45,31,7,H1
"Banner County, NE",2011-2012,741,773,32,4.318,6,26,31,7,H1
"Banner County, NE",2012-2013,773,777,4,0.517,3,1,31,7,H1
"Banner County, NE",2013-2014,777,764,-13,-1.673,3,-16,31,7,H1
"Banner County, NE",2014-2015,748,788,40,5.348,-1,41,31,7,H1
"Banner County, NE",2015-2016,788,724,-64,-8.122,8,-72,31,7,H1
"Banner County, NE",2016-2017,724,742,18,2.486,6,12,31,7,H1
"Blaine County, NE",2000-2001,583,564,-19,-3.259,2,-21,31,9,H1
"Blaine County, NE",2001-2002,564,551,-13,-2.305,2,-15,31,9,H1
"Blaine County, NE",2002-2003,551,545,-6,-1.089,4,-10,31,9,H1
"Blaine County, NE",2003-2004,545,515,-30,-5.505,3,-33,31,9,H1
"Blaine County, NE",2004-2005,515,492,-23,-4.466,-4,-19,31,9,H1
"Blaine County, NE",2005-2006,492,493,1,0.203,-1,2,31,9,H1
"Blaine County, NE",2006-2007,493,463,-30,-6.085,0,-30,31,9,H1
"Blaine County, NE",2007-2008,463,456,-7,-1.512,4,-11,31,9,H1
"Blaine County, NE",2008-2009,456,477,21,4.605,4,17,31,9,H1
"Blaine County, NE",2009-2010,477,472,-5,-1.048,8,-13,31,9,H1
"Blaine County, NE",2010-2011,472,496,24,5.085,5,19,31,9,H1
"Blaine County, NE",2011-2012,496,512,16,3.226,-3,19,31,9,H1
"Blaine County, NE",2012-2013,512,481,-31,-6.055,1,-32,31,9,H1
"Blaine County, NE",2013-2014,481,504,23,4.782,1,22,31,9,H1
"Blaine County, NE",2014-2015,501,487,-14,-2.794,-1,-13,31,9,H1
"Blaine County, NE",2015-2016,487,469,-18,-3.696,8,-26,31,9,H1
"Blaine County, NE",2016-2017,469,482,13,2.772,3,10,31,9,H1
"Boone County, NE",2000-2001,6214,6146,-68,-1.094,9,-77,31,11,H1
"Boone County, NE",2001-2002,6146,6053,-93,-1.513,-18,-75,31,11,H1
"Boone County, NE",2002-2003,6053,5888,-165,-2.726,-8,-157,31,11,H1
"Boone County, NE",2003-2004,5888,5813,-75,-1.274,-16,-59,31,11,H1
"Boone County, NE",2004-2005,5813,5746,-67,-1.153,-34,-33,31,11,H1
"Boone County, NE",2005-2006,5746,5623,-123,-2.141,-31,-92,31,11,H1
"Boone County, NE",2006-2007,5623,5582,-41,-0.729,-21,-20,31,11,H1
"Boone County, NE",2007-2008,5582,5548,-34,-0.609,20,-54,31,11,H1
"Boone County, NE",2008-2009,5548,5514,-34,-0.613,12,-46,31,11,H1
"Boone County, NE",2009-2010,5514,5496,-18,-0.326,8,-26,31,11,H1
"Boone County, NE",2010-2011,5496,5389,-107,-1.947,-12,-95,31,11,H1
"Boone County, NE",2011-2012,5389,5407,18,0.334,-12,30,31,11,H1
"Boone County, NE",2012-2013,5407,5375,-32,-0.592,13,-45,31,11,H1
"Boone County, NE",2013-2014,5375,5353,-22,-0.409,-6,-16,31,11,H1
"Boone County, NE",2014-2015,5351,5315,-36,-0.673,-3,-33,31,11,H1
"Boone County, NE",2015-2016,5315,5358,43,0.809,9,34,31,11,H1
"Boone County, NE",2016-2017,5358,5352,-6,-0.112,4,-10,31,11,H1
"Box Butte County, NE",2000-2001,12235,11985,-250,-2.043,-3,-247,31,13,H1
"Box Butte County, NE",2001-2002,11985,11951,-34,-0.284,40,-74,31,13,H1
"Box Butte County, NE",2002-2003,11951,11719,-232,-1.941,53,-285,31,13,H1
"Box Butte County, NE",2003-2004,11719,11528,-191,-1.63,22,-213,31,13,H1
"Box Butte County, NE",2004-2005,11528,11422,-106,-0.92,-3,-103,31,13,H1
"Box Butte County, NE",2005-2006,11422,11338,-84,-0.735,25,-109,31,13,H1
"Box Butte County, NE",2006-2007,11338,11409,71,0.626,39,32,31,13,H1
"Box Butte County, NE",2007-2008,11409,11482,73,0.64,50,23,31,13,H1
"Box Butte County, NE",2008-2009,11482,11347,-135,-1.176,51,-186,31,13,H1
"Box Butte County, NE",2009-2010,11347,11293,-54,-0.476,47,-101,31,13,H1
"Box Butte County, NE",2010-2011,11293,11308,15,0.133,22,-7,31,13,H1
"Box Butte County, NE",2011-2012,11308,11291,-17,-0.15,11,-28,31,13,H1
"Box Butte County, NE",2012-2013,11291,11310,19,0.168,64,-45,31,13,H1
"Box Butte County, NE",2013-2014,11310,11340,30,0.265,52,-22,31,13,H1
"Box Butte County, NE",2014-2015,11334,11337,3,0.026,66,-63,31,13,H1
"Box Butte County, NE",2015-2016,11337,11192,-145,-1.279,45,-190,31,13,H1
"Box Butte County, NE",2016-2017,11192,10886,-306,-2.734,53,-359,31,13,H1
"Boyd County, NE",2000-2001,2431,2390,-41,-1.687,-4,-37,31,15,H1
"Boyd County, NE",2001-2002,2390,2352,-38,-1.59,-21,-17,31,15,H1
"Boyd County, NE",2002-2003,2352,2304,-48,-2.041,-19,-29,31,15,H1
"Boyd County, NE",2003-2004,2304,2246,-58,-2.517,-23,-35,31,15,H1
"Boyd County, NE",2004-2005,2246,2219,-27,-1.202,-22,-5,31,15,H1
"Boyd County, NE",2005-2006,2219,2143,-76,-3.425,-28,-48,31,15,H1
"Boyd County, NE",2006-2007,2143,2109,-34,-1.587,-23,-11,31,15,H1
"Boyd County, NE",2007-2008,2109,2102,-7,-0.332,11,-18,31,15,H1
"Boyd County, NE",2008-2009,2102,2075,-27,-1.284,5,-32,31,15,H1
"Boyd County, NE",2009-2010,2075,2100,25,1.205,-3,28,31,15,H1
"Boyd County, NE",2010-2011,2100,2083,-17,-0.81,0,-17,31,15,H1
"Boyd County, NE",2011-2012,2083,2059,-24,-1.152,-10,-14,31,15,H1
"Boyd County, NE",2012-2013,2059,2019,-40,-1.943,-16,-24,31,15,H1
"Boyd County, NE",2013-2014,2019,2033,14,0.693,-7,21,31,15,H1
"Boyd County, NE",2014-2015,2027,2006,-21,-1.036,-8,-13,31,15,H1
"Boyd County, NE",2015-2016,2006,1980,-26,-1.296,-11,-15,31,15,H1
"Boyd County, NE",2016-2017,1980,1977,-3,-0.152,-6,3,31,15,H1
"Brown County, NE",2000-2001,3534,3510,-24,-0.679,-16,-8,31,17,H1
"Brown County, NE",2001-2002,3510,3497,-13,-0.37,-13,0,31,17,H1
"Brown County, NE",2002-2003,3497,3478,-19,-0.543,-5,-14,31,17,H1
"Brown County, NE",2003-2004,3478,3441,-37,-1.064,-10,-27,31,17,H1
"Brown County, NE",2004-2005,3441,3329,-112,-3.255,-3,-109,31,17,H1
"Brown County, NE",2005-2006,3329,3319,-10,-0.3,-10,0,31,17,H1
"Brown County, NE",2006-2007,3319,3225,-94,-2.832,-14,-80,31,17,H1
"Brown County, NE",2007-2008,3225,3149,-76,-2.357,-9,-67,31,17,H1
"Brown County, NE",2008-2009,3149,3115,-34,-1.08,-13,-21,31,17,H1
"Brown County, NE",2009-2010,3115,3144,29,0.931,-8,37,31,17,H1
"Brown County, NE",2010-2011,3144,3076,-68,-2.163,-18,-50,31,17,H1
"Brown County, NE",2011-2012,3076,3021,-55,-1.788,-9,-46,31,17,H1
"Brown County, NE",2012-2013,3021,2924,-97,-3.211,-8,-89,31,17,H1
"Brown County, NE",2013-2014,2924,2941,17,0.581,0,17,31,17,H1
"Brown County, NE",2014-2015,2941,2946,5,0.17,-6,11,31,17,H1
"Brown County, NE",2015-2016,2946,2984,38,1.29,5,33,31,17,H1
"Brown County, NE",2016-2017,2984,3014,30,1.005,-3,33,31,17,H1
"Buffalo County, NE",2000-2001,42310,42418,108,0.255,245,-137,31,19,H1
"Buffalo County, NE",2001-2002,42418,42949,531,1.252,275,256,31,19,H1
"Buffalo County, NE",2002-2003,42949,43251,302,0.703,313,-11,31,19,H1
"Buffalo County, NE",2003-2004,43251,43753,502,1.161,274,228,31,19,H1
"Buffalo County, NE",2004-2005,43753,44131,378,0.864,332,46,31,19,H1
"Buffalo County, NE",2005-2006,44131,44645,514,1.165,312,202,31,19,H1
"Buffalo County, NE",2006-2007,44645,45060,415,0.93,358,57,31,19,H1
"Buffalo County, NE",2007-2008,45060,45343,283,0.628,316,-33,31,19,H1
"Buffalo County, NE",2008-2009,45343,45970,627,1.383,360,267,31,19,H1
"Buffalo County, NE",2009-2010,45970,46174,204,0.444,344,-140,31,19,H1
"Buffalo County, NE",2010-2011,46174,46839,665,1.44,308,357,31,19,H1
"Buffalo County, NE",2011-2012,46839,47644,805,1.719,384,421,31,19,H1
"Buffalo County, NE",2012-2013,47644,48058,414,0.869,353,61,31,19,H1
"Buffalo County, NE",2013-2014,48058,48224,166,0.345,357,-191,31,19,H1
"Buffalo County, NE",2014-2015,48348,48863,515,1.065,380,135,31,19,H1
"Buffalo County, NE",2015-2016,48863,49382,519,1.062,385,134,31,19,H1
"Buffalo County, NE",2016-2017,49382,49732,350,0.709,352,-2,31,19,H1
"Burt County, NE",2000-2001,7786,7659,-127,-1.631,-21,-106,31,21,H1
"Burt County, NE",2001-2002,7659,7486,-173,-2.259,-23,-150,31,21,H1
"Burt County, NE",2002-2003,7486,7366,-120,-1.603,-41,-79,31,21,H1
"Burt County, NE",2003-2004,7366,7399,33,0.448,-28,61,31,21,H1
"Burt County, NE",2004-2005,7399,7225,-174,-2.352,-22,-152,31,21,H1
"Burt County, NE",2005-2006,7225,7122,-103,-1.426,-23,-80,31,21,H1
"Burt County, NE",2006-2007,7122,6999,-123,-1.727,-7,-116,31,21,H1
"Burt County, NE",2007-2008,6999,6967,-32,-0.457,-33,1,31,21,H1
"Burt County, NE",2008-2009,6967,6885,-82,-1.177,-37,-45,31,21,H1
"Burt County, NE",2009-2010,6885,6838,-47,-0.683,-27,-20,31,21,H1
"Burt County, NE",2010-2011,6838,6782,-56,-0.819,-48,-8,31,21,H1
"Burt County, NE",2011-2012,6782,6672,-110,-1.622,-5,-105,31,21,H1
"Burt County, NE",2012-2013,6672,6583,-89,-1.334,-30,-59,31,21,H1
"Burt County, NE",2013-2014,6583,6573,-10,-0.152,-27,17,31,21,H1
"Burt County, NE",2014-2015,6590,6585,-5,-0.076,-26,21,31,21,H1
"Burt County, NE",2015-2016,6585,6547,-38,-0.577,-22,-16,31,21,H1
"Burt County, NE",2016-2017,6547,6535,-12,-0.183,-23,11,31,21,H1
"Butler County, NE",2000-2001,8826,8878,52,0.589,21,31,31,23,H1
"Butler County, NE",2001-2002,8878,8817,-61,-0.687,-21,-40,31,23,H1
"Butler County, NE",2002-2003,8817,8716,-101,-1.146,-7,-94,31,23,H1
"Butler County, NE",2003-2004,8716,8631,-85,-0.975,19,-104,31,23,H1
"Butler County, NE",2004-2005,8631,8479,-152,-1.761,-18,-134,31,23,H1
"Butler County, NE",2005-2006,8479,8396,-83,-0.979,-24,-59,31,23,H1
"Butler County, NE",2006-2007,8396,8375,-21,-0.25,-23,2,31,23,H1
"Butler County, NE",2007-2008,8375,8355,-20,-0.239,13,-33,31,23,H1
"Butler County, NE",2008-2009,8355,8387,32,0.383,-6,38,31,23,H1
"Butler County, NE",2009-2010,8387,8370,-17,-0.203,-4,-13,31,23,H1
"Butler County, NE",2010-2011,8370,8307,-63,-0.753,-5,-58,31,23,H1
"Butler County, NE",2011-2012,8307,8308,1,0.012,1,0,31,23,H1
"Butler County, NE",2012-2013,8308,8324,16,0.193,2,14,31,23,H1
"Butler County, NE",2013-2014,8324,8249,-75,-0.901,13,-88,31,23,H1
"Butler County, NE",2014-2015,8238,8115,-123,-1.493,5,-128,31,23,H1
"Butler County, NE",2015-2016,8115,8005,-110,-1.356,-19,-91,31,23,H1
"Butler County, NE",2016-2017,8005,8053,48,0.6,-8,56,31,23,H1
"Cass County, NE",2000-2001,24365,24460,95,0.39,91,4,31,25,H1
"Cass County, NE",2001-2002,24460,24602,142,0.581,111,31,31,25,H1
"Cass County, NE",2002-2003,24602,24868,266,1.081,118,148,31,25,H1
"Cass County, NE",2003-2004,24868,25074,206,0.828,74,132,31,25,H1
"Cass County, NE",2004-2005,25074,25170,96,0.383,134,-38,31,25,H1
"Cass County, NE",2005-2006,25170,25240,70,0.278,103,-33,31,25,H1
"Cass County, NE",2006-2007,25240,25256,16,0.063,87,-71,31,25,H1
"Cass County, NE",2007-2008,25256,25322,66,0.261,112,-46,31,25,H1
"Cass County, NE",2008-2009,25322,25122,-200,-0.79,126,-326,31,25,H1
"Cass County, NE",2009-2010,25122,25254,132,0.525,71,61,31,25,H1
"Cass County, NE",2010-2011,25254,25256,2,0.008,90,-88,31,25,H1
"Cass County, NE",2011-2012,25256,25159,-97,-0.384,42,-139,31,25,H1
"Cass County, NE",2012-2013,25159,25381,222,0.882,87,135,31,25,H1
"Cass County, NE",2013-2014,25381,25524,143,0.563,65,78,31,25,H1
"Cass County, NE",2014-2015,25496,25512,16,0.063,37,-21,31,25,H1
"Cass County, NE",2015-2016,25512,25594,82,0.321,30,52,31,25,H1
"Cass County, NE",2016-2017,25594,25889,295,1.153,51,244,31,25,H1
"Cedar County, NE",2000-2001,9604,9470,-134,-1.395,-13,-121,31,27,H1
"Cedar County, NE",2001-2002,9470,9391,-79,-0.834,-7,-72,31,27,H1
"Cedar County, NE",2002-2003,9391,9291,-100,-1.065,-40,-60,31,27,H1
"Cedar County, NE",2003-2004,9291,9246,-45,-0.484,5,-50,31,27,H1
"Cedar County, NE",2004-2005,9246,9240,-6,-0.065,15,-21,31,27,H1
"Cedar County, NE",2005-2006,9240,9060,-180,-1.948,26,-206,31,27,H1
"Cedar County, NE",2006-2007,9060,8941,-119,-1.313,15,-134,31,27,H1
"Cedar County, NE",2007-2008,8941,8839,-102,-1.141,-2,-100,31,27,H1
"Cedar County, NE",2008-2009,8839,8854,15,0.17,18,-3,31,27,H1
"Cedar County, NE",2009-2010,8854,8829,-25,-0.282,12,-37,31,27,H1
"Cedar County, NE",2010-2011,8829,8786,-43,-0.487,0,-43,31,27,H1
"Cedar County, NE",2011-2012,8786,8770,-16,-0.182,2,-18,31,27,H1
"Cedar County, NE",2012-2013,8770,8686,-84,-0.958,9,-93,31,27,H1
"Cedar County, NE",2013-2014,8686,8610,-76,-0.875,-1,-75,31,27,H1
"Cedar County, NE",2014-2015,8606,8564,-42,-0.488,17,-59,31,27,H1
"Cedar County, NE",2015-2016,8564,8595,31,0.362,6,25,31,27,H1
"Cedar County, NE",2016-2017,8595,8530,-65,-0.756,17,-82,31,27,H1
"Chase County, NE",2000-2001,4053,4003,-50,-1.234,-11,-39,31,29,H1
"Chase County, NE",2001-2002,4003,4045,42,1.049,-9,51,31,29,H1
"Chase County, NE",2002-2003,4045,4090,45,1.112,3,42,31,29,H1
"Chase County, NE",2003-2004,4090,4018,-72,-1.76,-24,-48,31,29,H1
"Chase County, NE",2004-2005,4018,3983,-35,-0.871,-8,-27,31,29,H1
"Chase County, NE",2005-2006,3983,3965,-18,-0.452,11,-29,31,29,H1
"Chase County, NE",2006-2007,3965,3913,-52,-1.311,1,-53,31,29,H1
"Chase County, NE",2007-2008,3913,3865,-48,-1.227,5,-53,31,29,H1
"Chase County, NE",2008-2009,3865,3921,56,1.449,-15,71,31,29,H1
"Chase County, NE",2009-2010,3921,3963,42,1.071,2,40,31,29,H1
"Chase County, NE",2010-2011,3963,3999,36,0.908,-4,40,31,29,H1
"Chase County, NE",2011-2012,3999,4033,34,0.85,0,34,31,29,H1
"Chase County, NE",2012-2013,4033,3977,-56,-1.389,6,-62,31,29,H1
"Chase County, NE",2013-2014,3977,3978,1,0.025,-7,8,31,29,H1
"Chase County, NE",2014-2015,3973,3956,-17,-0.428,-11,-6,31,29,H1
"Chase County, NE",2015-2016,3956,3954,-2,-0.051,9,-11,31,29,H1
"Chase County, NE",2016-2017,3954,3971,17,0.43,1,16,31,29,H1
"Cherry County, NE",2000-2001,6152,6060,-92,-1.495,-5,-87,31,31,H1
"Cherry County, NE",2001-2002,6060,6054,-6,-0.099,5,-11,31,31,H1
"Cherry County, NE",2002-2003,6054,6031,-23,-0.38,0,-23,31,31,H1
"Cherry County, NE",2003-2004,6031,6064,33,0.547,14,19,31,31,H1
"Cherry County, NE",2004-2005,6064,6039,-25,-0.412,5,-30,31,31,H1
"Cherry County, NE",2005-2006,6039,5927,-112,-1.855,12,-124,31,31,H1
"Cherry County, NE",2006-2007,5927,5834,-93,-1.569,17,-110,31,31,H1
"Cherry County, NE",2007-2008,5834,5752,-82,-1.406,3,-85,31,31,H1
"Cherry County, NE",2008-2009,5752,5683,-69,-1.2,-3,-66,31,31,H1
"Cherry County, NE",2009-2010,5683,5715,32,0.563,0,32,31,31,H1
"Cherry County, NE",2010-2011,5715,5749,34,0.595,16,18,31,31,H1
"Cherry County, NE",2011-2012,5749,5738,-11,-0.191,3,-14,31,31,H1
"Cherry County, NE",2012-2013,5738,5779,41,0.715,23,18,31,31,H1
"Cherry County, NE",2013-2014,5779,5762,-17,-0.294,11,-28,31,31,H1
"Cherry County, NE",2014-2015,5760,5848,88,1.528,20,68,31,31,H1
"Cherry County, NE",2015-2016,5848,5829,-19,-0.325,22,-41,31,31,H1
"Cherry County, NE",2016-2017,5829,5818,-11,-0.189,22,-33,31,31,H1
"Cheyenne County, NE",2000-2001,9832,9943,111,1.129,-6,117,31,33,H1
"Cheyenne County, NE",2001-2002,9943,9973,30,0.302,-10,40,31,33,H1
"Cheyenne County, NE",2002-2003,9973,9935,-38,-0.381,-3,-35,31,33,H1
"Cheyenne County, NE",2003-2004,9935,9970,35,0.352,43,-8,31,33,H1
"Cheyenne County, NE",2004-2005,9970,10125,155,1.555,37,118,31,33,H1
"Cheyenne County, NE",2005-2006,10125,9943,-182,-1.798,18,-200,31,33,H1
"Cheyenne County, NE",2006-2007,9943,10139,196,1.971,41,155,31,33,H1
"Cheyenne County, NE",2007-2008,10139,10150,11,0.108,35,-24,31,33,H1
"Cheyenne County, NE",2008-2009,10150,10032,-118,-1.163,47,-165,31,33,H1
"Cheyenne County, NE",2009-2010,10032,9961,-71,-0.708,20,-91,31,33,H1
"Cheyenne County, NE",2010-2011,9961,9968,7,0.07,44,-37,31,33,H1
"Cheyenne County, NE",2011-2012,9968,10062,94,0.943,29,65,31,33,H1
"Cheyenne County, NE",2012-2013,10062,10079,17,0.169,46,-29,31,33,H1
"Cheyenne County, NE",2013-2014,10079,10148,69,0.685,60,9,31,33,H1
"Cheyenne County, NE",2014-2015,10120,10167,47,0.464,58,-11,31,33,H1
"Cheyenne County, NE",2015-2016,10167,10066,-101,-0.993,52,-153,31,33,H1
"Cheyenne County, NE",2016-2017,10066,9676,-390,-3.874,33,-423,31,33,H1
"Clay County, NE",2000-2001,7029,6944,-85,-1.209,1,-86,31,35,H1
"Clay County, NE",2001-2002,6944,6899,-45,-0.648,2,-47,31,35,H1
"Clay County, NE",2002-2003,6899,6859,-40,-0.58,-13,-27,31,35,H1
"Clay County, NE",2003-2004,6859,6795,-64,-0.933,-8,-56,31,35,H1
"Clay County, NE",2004-2005,6795,6669,-126,-1.854,0,-126,31,35,H1
"Clay County, NE",2005-2006,6669,6609,-60,-0.9,4,-64,31,35,H1
"Clay County, NE",2006-2007,6609,6564,-45,-0.681,-14,-31,31,35,H1
"Clay County, NE",2007-2008,6564,6543,-21,-0.32,5,-26,31,35,H1
"Clay County, NE",2008-2009,6543,6512,-31,-0.474,-9,-22,31,35,H1
"Clay County, NE",2009-2010,6512,6542,30,0.461,-4,34,31,35,H1
"Clay County, NE",2010-2011,6542,6476,-66,-1.009,-6,-60,31,35,H1
"Clay County, NE",2011-2012,6476,6407,-69,-1.065,-2,-67,31,35,H1
"Clay County, NE",2012-2013,6407,6383,-24,-0.375,24,-48,31,35,H1
"Clay County, NE",2013-2014,6383,6315,-68,-1.065,6,-74,31,35,H1
"Clay County, NE",2014-2015,6326,6309,-17,-0.269,0,-17,31,35,H1
"Clay County, NE",2015-2016,6309,6149,-160,-2.536,26,-186,31,35,H1
"Clay County, NE",2016-2017,6149,6205,56,0.911,17,39,31,35,H1
"Colfax County, NE",2000-2001,10452,10440,-12,-0.115,58,-70,31,37,H1
"Colfax County, NE",2001-2002,10440,10478,38,0.364,90,-52,31,37,H1
"Colfax County, NE",2002-2003,10478,10433,-45,-0.429,104,-149,31,37,H1
"Colfax County, NE",2003-2004,10433,10457,24,0.23,116,-92,31,37,H1
"Colfax County, NE",2004-2005,10457,10238,-219,-2.094,96,-315,31,37,H1
"Colfax County, NE",2005-2006,10238,9993,-245,-2.393,70,-315,31,37,H1
"Colfax County, NE",2006-2007,9993,9993,0,0,128,-128,31,37,H1
"Colfax County, NE",2007-2008,9993,10083,90,0.901,126,-36,31,37,H1
"Colfax County, NE",2008-2009,10083,10380,297,2.946,155,142,31,37,H1
"Colfax County, NE",2009-2010,10380,10539,159,1.532,184,-25,31,37,H1
"Colfax County, NE",2010-2011,10539,10569,30,0.285,101,-71,31,37,H1
"Colfax County, NE",2011-2012,10569,10541,-28,-0.265,82,-110,31,37,H1
"Colfax County, NE",2012-2013,10541,10406,-135,-1.281,93,-228,31,37,H1
"Colfax County, NE",2013-2014,10406,10504,98,0.942,87,11,31,37,H1
"Colfax County, NE",2014-2015,10546,10520,-26,-0.247,119,-145,31,37,H1
"Colfax County, NE",2015-2016,10520,10659,139,1.321,134,5,31,37,H1
"Colfax County, NE",2016-2017,10659,10585,-74,-0.694,123,-197,31,37,H1
"Cuming County, NE",2000-2001,10169,10054,-115,-1.131,15,-130,31,39,H1
"Cuming County, NE",2001-2002,10054,9962,-92,-0.915,12,-104,31,39,H1
"Cuming County, NE",2002-2003,9962,9832,-130,-1.305,23,-153,31,39,H1
"Cuming County, NE",2003-2004,9832,9709,-123,-1.251,16,-139,31,39,H1
"Cuming County, NE",2004-2005,9709,9642,-67,-0.69,23,-90,31,39,H1
"Cuming County, NE",2005-2006,9642,9440,-202,-2.095,-50,-152,31,39,H1
"Cuming County, NE",2006-2007,9440,9286,-154,-1.631,-7,-147,31,39,H1
"Cuming County, NE",2007-2008,9286,9215,-71,-0.765,2,-73,31,39,H1
"Cuming County, NE",2008-2009,9215,9132,-83,-0.901,21,-104,31,39,H1
"Cuming County, NE",2009-2010,9132,9144,12,0.131,14,-2,31,39,H1
"Cuming County, NE",2010-2011,9144,9137,-7,-0.077,-9,2,31,39,H1
"Cuming County, NE",2011-2012,9137,9090,-47,-0.514,17,-64,31,39,H1
"Cuming County, NE",2012-2013,9090,9005,-85,-0.935,1,-86,31,39,H1
"Cuming County, NE",2013-2014,9005,9027,22,0.244,28,-6,31,39,H1
"Cuming County, NE",2014-2015,9023,9125,102,1.13,29,73,31,39,H1
"Cuming County, NE",2015-2016,9125,9001,-124,-1.359,18,-142,31,39,H1
"Cuming County, NE",2016-2017,9001,9042,41,0.456,28,13,31,39,H1
"Custer County, NE",2000-2001,11784,11593,-191,-1.621,-25,-166,31,41,H1
"Custer County, NE",2001-2002,11593,11508,-85,-0.733,-39,-46,31,41,H1
"Custer County, NE",2002-2003,11508,11388,-120,-1.043,-26,-94,31,41,H1
"Custer County, NE",2003-2004,11388,11328,-60,-0.527,-15,-45,31,41,H1
"Custer County, NE",2004-2005,11328,11248,-80,-0.706,-48,-32,31,41,H1
"Custer County, NE",2005-2006,11248,11090,-158,-1.405,5,-163,31,41,H1
"Custer County, NE",2006-2007,11090,11005,-85,-0.766,-22,-63,31,41,H1
"Custer County, NE",2007-2008,11005,11001,-4,-0.036,-34,30,31,41,H1
"Custer County, NE",2008-2009,11001,10999,-2,-0.018,-32,30,31,41,H1
"Custer County, NE",2009-2010,10999,10913,-86,-0.782,-28,-58,31,41,H1
"Custer County, NE",2010-2011,10913,10874,-39,-0.357,-52,13,31,41,H1
"Custer County, NE",2011-2012,10874,10788,-86,-0.791,-10,-76,31,41,H1
"Custer County, NE",2012-2013,10788,10796,8,0.074,1,7,31,41,H1
"Custer County, NE",2013-2014,10796,10728,-68,-0.63,-2,-66,31,41,H1
"Custer County, NE",2014-2015,10743,10806,63,0.586,8,55,31,41,H1
"Custer County, NE",2015-2016,10806,10837,31,0.287,15,16,31,41,H1
"Custer County, NE",2016-2017,10837,10897,60,0.554,19,41,31,41,H1
"Dakota County, NE",2000-2001,20296,20331,35,0.172,216,-181,31,43,H1
"Dakota County, NE",2001-2002,20331,20374,43,0.211,238,-195,31,43,H1
"Dakota County, NE",2002-2003,20374,20488,114,0.56,247,-133,31,43,H1
"Dakota County, NE",2003-2004,20488,20410,-78,-0.381,275,-353,31,43,H1
"Dakota County, NE",2004-2005,20410,20191,-219,-1.073,250,-469,31,43,H1
"Dakota County, NE",2005-2006,20191,20295,104,0.515,197,-93,31,43,H1
"Dakota County, NE",2006-2007,20295,20564,269,1.325,234,35,31,43,H1
"Dakota County, NE",2007-2008,20564,20559,-5,-0.024,243,-248,31,43,H1
"Dakota County, NE",2008-2009,20559,20924,365,1.775,209,156,31,43,H1
"Dakota County, NE",2009-2010,20924,21029,105,0.502,225,-120,31,43,H1
"Dakota County, NE",2010-2011,21029,20851,-178,-0.846,184,-362,31,43,H1
"Dakota County, NE",2011-2012,20851,20837,-14,-0.067,248,-262,31,43,H1
"Dakota County, NE",2012-2013,20837,20944,107,0.514,227,-120,31,43,H1
"Dakota County, NE",2013-2014,20944,20850,-94,-0.449,265,-359,31,43,H1
"Dakota County, NE",2014-2015,20717,20781,64,0.309,227,-163,31,43,H1
"Dakota County, NE",2015-2016,20781,20401,-380,-1.829,197,-577,31,43,H1
"Dakota County, NE",2016-2017,20401,20186,-215,-1.054,198,-413,31,43,H1
"Dawes County, NE",2000-2001,9054,9162,108,1.193,18,90,31,45,H1
"Dawes County, NE",2001-2002,9162,9227,65,0.709,1,64,31,45,H1
"Dawes County, NE",2002-2003,9227,9306,79,0.856,4,75,31,45,H1
"Dawes County, NE",2003-2004,9306,9127,-179,-1.923,14,-193,31,45,H1
"Dawes County, NE",2004-2005,9127,9087,-40,-0.438,3,-43,31,45,H1
"Dawes County, NE",2005-2006,9087,9040,-47,-0.517,19,-66,31,45,H1
"Dawes County, NE",2006-2007,9040,9181,141,1.56,10,131,31,45,H1
"Dawes County, NE",2007-2008,9181,9134,-47,-0.512,38,-85,31,45,H1
"Dawes County, NE",2008-2009,9134,9218,84,0.92,21,63,31,45,H1
"Dawes County, NE",2009-2010,9218,9172,-46,-0.499,14,-60,31,45,H1
"Dawes County, NE",2010-2011,9172,9230,58,0.632,19,39,31,45,H1
"Dawes County, NE",2011-2012,9230,9167,-63,-0.683,28,-91,31,45,H1
"Dawes County, NE",2012-2013,9167,9093,-74,-0.807,11,-85,31,45,H1
"Dawes County, NE",2013-2014,9093,9042,-51,-0.561,10,-61,31,45,H1
"Dawes County, NE",2014-2015,9089,9055,-34,-0.374,21,-55,31,45,H1
"Dawes County, NE",2015-2016,9055,8912,-143,-1.579,-4,-139,31,45,H1
"Dawes County, NE",2016-2017,8912,8890,-22,-0.247,1,-23,31,45,H1
"Dawson County, NE",2000-2001,24410,24359,-51,-0.209,222,-273,31,47,H1
"Dawson County, NE",2001-2002,24359,24149,-210,-0.862,195,-405,31,47,H1
"Dawson County, NE",2002-2003,24149,24175,26,0.108,197,-171,31,47,H1
"Dawson County, NE",2003-2004,24175,24112,-63,-0.261,271,-334,31,47,H1
"Dawson County, NE",2004-2005,24112,24085,-27,-0.112,250,-277,31,47,H1
"Dawson County, NE",2005-2006,24085,24291,206,0.855,141,65,31,47,H1
"Dawson County, NE",2006-2007,24291,24178,-113,-0.465,212,-325,31,47,H1
"Dawson County, NE",2007-2008,24178,24160,-18,-0.074,172,-190,31,47,H1
"Dawson County, NE",2008-2009,24160,24212,52,0.215,239,-187,31,47,H1
"Dawson County, NE",2009-2010,24212,24354,142,0.586,281,-139,31,47,H1
"Dawson County, NE",2010-2011,24354,24324,-30,-0.123,149,-179,31,47,H1
"Dawson County, NE",2011-2012,24324,24100,-224,-0.921,177,-401,31,47,H1
"Dawson County, NE",2012-2013,24100,24152,52,0.216,157,-105,31,47,H1
"Dawson County, NE",2013-2014,24152,24096,-56,-0.232,186,-242,31,47,H1
"Dawson County, NE",2014-2015,24024,23886,-138,-0.574,209,-347,31,47,H1
"Dawson County, NE",2015-2016,23886,23823,-63,-0.264,223,-286,31,47,H1
"Dawson County, NE",2016-2017,23823,23709,-114,-0.479,218,-332,31,47,H1
"Deuel County, NE",2000-2001,2086,2085,-1,-0.048,-9,8,31,49,H1
"Deuel County, NE",2001-2002,2085,2029,-56,-2.686,-12,-44,31,49,H1
"Deuel County, NE",2002-2003,2029,2027,-2,-0.099,-29,27,31,49,H1
"Deuel County, NE",2003-2004,2027,2025,-2,-0.099,-5,3,31,49,H1
"Deuel County, NE",2004-2005,2025,1999,-26,-1.284,-10,-16,31,49,H1
"Deuel County, NE",2005-2006,1999,1969,-30,-1.501,-4,-26,31,49,H1
"Deuel County, NE",2006-2007,1969,1982,13,0.66,1,12,31,49,H1
"Deuel County, NE",2007-2008,1982,1986,4,0.202,0,4,31,49,H1
"Deuel County, NE",2008-2009,1986,1941,-45,-2.266,-7,-38,31,49,H1
"Deuel County, NE",2009-2010,1941,1937,-4,-0.206,-7,3,31,49,H1
"Deuel County, NE",2010-2011,1937,1970,33,1.704,-11,44,31,49,H1
"Deuel County, NE",2011-2012,1970,1973,3,0.152,-7,10,31,49,H1
"Deuel County, NE",2012-2013,1973,1934,-39,-1.977,4,-43,31,49,H1
"Deuel County, NE",2013-2014,1934,1940,6,0.31,-5,11,31,49,H1
"Deuel County, NE",2014-2015,1936,1921,-15,-0.775,2,-17,31,49,H1
"Deuel County, NE",2015-2016,1921,1868,-53,-2.759,-1,-52,31,49,H1
"Deuel County, NE",2016-2017,1868,1883,15,0.803,-4,19,31,49,H1
"Dixon County, NE",2000-2001,6246,6156,-90,-1.441,4,-94,31,51,H1
"Dixon County, NE",2001-2002,6156,6064,-92,-1.494,-7,-85,31,51,H1
"Dixon County, NE",2002-2003,6064,5984,-80,-1.319,16,-96,31,51,H1
"Dixon County, NE",2003-2004,5984,5908,-76,-1.27,8,-84,31,51,H1
"Dixon County, NE",2004-2005,5908,5961,53,0.897,-7,60,31,51,H1
"Dixon County, NE",2005-2006,5961,5987,26,0.436,30,-4,31,51,H1
"Dixon County, NE",2006-2007,5987,5993,6,0.1,15,-9,31,51,H1
"Dixon County, NE",2007-2008,5993,6004,11,0.184,21,-10,31,51,H1
"Dixon County, NE",2008-2009,6004,6013,9,0.15,15,-6,31,51,H1
"Dixon County, NE",2009-2010,6013,5970,-43,-0.715,10,-53,31,51,H1
"Dixon County, NE",2010-2011,5970,6007,37,0.62,-2,39,31,51,H1
"Dixon County, NE",2011-2012,6007,5907,-100,-1.665,-4,-96,31,51,H1
"Dixon County, NE",2012-2013,5907,5835,-72,-1.219,17,-89,31,51,H1
"Dixon County, NE",2013-2014,5835,5782,-53,-0.908,18,-71,31,51,H1
"Dixon County, NE",2014-2015,5783,5797,14,0.242,25,-11,31,51,H1
"Dixon County, NE",2015-2016,5797,5744,-53,-0.914,20,-73,31,51,H1
"Dixon County, NE",2016-2017,5744,5754,10,0.174,20,-10,31,51,H1
"Dodge County, NE",2000-2001,36231,36143,-88,-0.243,65,-153,31,53,H1
"Dodge County, NE",2001-2002,36143,36060,-83,-0.23,48,-131,31,53,H1
"Dodge County, NE",2002-2003,36060,36184,124,0.344,81,43,31,53,H1
"Dodge County, NE",2003-2004,36184,36267,83,0.229,105,-22,31,53,H1
"Dodge County, NE",2004-2005,36267,36442,175,0.483,117,58,31,53,H1
"Dodge County, NE",2005-2006,36442,36597,155,0.425,114,41,31,53,H1
"Dodge County, NE",2006-2007,36597,36647,50,0.137,68,-18,31,53,H1
"Dodge County, NE",2007-2008,36647,36548,-99,-0.27,72,-171,31,53,H1
"Dodge County, NE",2008-2009,36548,36604,56,0.153,138,-82,31,53,H1
"Dodge County, NE",2009-2010,36604,36701,97,0.265,152,-55,31,53,H1
"Dodge County, NE",2010-2011,36701,36979,278,0.757,58,220,31,53,H1
"Dodge County, NE",2011-2012,36979,36670,-309,-0.836,-19,-290,31,53,H1
"Dodge County, NE",2012-2013,36670,36617,-53,-0.145,67,-120,31,53,H1
"Dodge County, NE",2013-2014,36617,36744,127,0.347,82,45,31,53,H1
"Dodge County, NE",2014-2015,36725,36706,-19,-0.052,92,-111,31,53,H1
"Dodge County, NE",2015-2016,36706,36567,-139,-0.379,91,-230,31,53,H1
"Dodge County, NE",2016-2017,36567,36707,140,0.383,98,42,31,53,H1
"Douglas County, NE",2000-2001,464701,468125,3424,0.737,4038,-614,31,55,H1
"Douglas County, NE",2001-2002,468125,471866,3741,0.799,4033,-292,31,55,H1
"Douglas County, NE",2002-2003,471866,476701,4835,1.025,4406,429,31,55,H1
"Douglas County, NE",2003-2004,476701,482075,5374,1.127,4584,790,31,55,H1
"Douglas County, NE",2004-2005,482075,488114,6039,1.253,4771,1268,31,55,H1
"Douglas County, NE",2005-2006,488114,493757,5643,1.156,4780,863,31,55,H1
"Douglas County, NE",2006-2007,493757,498743,4986,1.01,5078,-92,31,55,H1
"Douglas County, NE",2007-2008,498743,504547,5804,1.164,5037,767,31,55,H1
"Douglas County, NE",2008-2009,504547,511902,7355,1.458,4937,2418,31,55,H1
"Douglas County, NE",2009-2010,511902,518594,6692,1.307,5117,1575,31,55,H1
"Douglas County, NE",2010-2011,518594,524611,6017,1.16,4394,1623,31,55,H1
"Douglas County, NE",2011-2012,524611,531309,6698,1.277,4612,2086,31,55,H1
"Douglas County, NE",2012-2013,531309,537529,6220,1.171,4584,1636,31,55,H1
"Douglas County, NE",2013-2014,537529,543244,5715,1.063,4768,947,31,55,H1
"Douglas County, NE",2014-2015,543985,550064,6079,1.117,4784,1295,31,55,H1
"Douglas County, NE",2015-2016,550064,555894,5830,1.06,4713,1117,31,55,H1
"Douglas County, NE",2016-2017,555894,561620,5726,1.03,4869,857,31,55,H1
"Dundy County, NE",2000-2001,2268,2179,-89,-3.924,-7,-82,31,57,H1
"Dundy County, NE",2001-2002,2179,2159,-20,-0.918,-6,-14,31,57,H1
"Dundy County, NE",2002-2003,2159,2170,11,0.509,-11,22,31,57,H1
"Dundy County, NE",2003-2004,2170,2154,-16,-0.737,-13,-3,31,57,H1
"Dundy County, NE",2004-2005,2154,2091,-63,-2.925,-18,-45,31,57,H1
"Dundy County, NE",2005-2006,2091,2051,-40,-1.913,-16,-24,31,57,H1
"Dundy County, NE",2006-2007,2051,2010,-41,-1.999,-15,-26,31,57,H1
"Dundy County, NE",2007-2008,2010,1973,-37,-1.841,-3,-34,31,57,H1
"Dundy County, NE",2008-2009,1973,1997,24,1.216,-1,25,31,57,H1
"Dundy County, NE",2009-2010,1997,2008,11,0.551,9,2,31,57,H1
"Dundy County, NE",2010-2011,2008,1976,-32,-1.594,-6,-26,31,57,H1
"Dundy County, NE",2011-2012,1976,1991,15,0.759,-33,48,31,57,H1
"Dundy County, NE",2012-2013,1991,1969,-22,-1.105,-11,-11,31,57,H1
"Dundy County, NE",2013-2014,1969,1886,-83,-4.215,-11,-72,31,57,H1
"Dundy County, NE",2014-2015,1889,1799,-90,-4.764,-12,-78,31,57,H1
"Dundy County, NE",2015-2016,1799,1815,16,0.889,9,7,31,57,H1
"Dundy County, NE",2016-2017,1815,1801,-14,-0.771,-7,-7,31,57,H1
"Fillmore County, NE",2000-2001,6607,6493,-114,-1.725,-24,-90,31,59,H1
"Fillmore County, NE",2001-2002,6493,6376,-117,-1.802,-38,-79,31,59,H1
"Fillmore County, NE",2002-2003,6376,6371,-5,-0.078,-6,1,31,59,H1
"Fillmore County, NE",2003-2004,6371,6281,-90,-1.413,-21,-69,31,59,H1
"Fillmore County, NE",2004-2005,6281,6126,-155,-2.468,-50,-105,31,59,H1
"Fillmore County, NE",2005-2006,6126,6053,-73,-1.192,-34,-39,31,59,H1
"Fillmore County, NE",2006-2007,6053,5985,-68,-1.123,-6,-62,31,59,H1
"Fillmore County, NE",2007-2008,5985,5940,-45,-0.752,-30,-15,31,59,H1
"Fillmore County, NE",2008-2009,5940,5898,-42,-0.707,-13,-29,31,59,H1
"Fillmore County, NE",2009-2010,5898,5889,-9,-0.153,-11,2,31,59,H1
"Fillmore County, NE",2010-2011,5889,5852,-37,-0.628,-22,-15,31,59,H1
"Fillmore County, NE",2011-2012,5852,5748,-104,-1.777,-37,-67,31,59,H1
"Fillmore County, NE",2012-2013,5748,5685,-63,-1.096,-37,-26,31,59,H1
"Fillmore County, NE",2013-2014,5685,5661,-24,-0.422,-23,-1,31,59,H1
"Fillmore County, NE",2014-2015,5634,5619,-15,-0.266,-32,17,31,59,H1
"Fillmore County, NE",2015-2016,5619,5640,21,0.374,1,20,31,59,H1
"Fillmore County, NE",2016-2017,5640,5582,-58,-1.028,-12,-46,31,59,H1
"Franklin County, NE",2000-2001,3544,3467,-77,-2.173,-42,-35,31,61,H1
"Franklin County, NE",2001-2002,3467,3484,17,0.49,-13,30,31,61,H1
"Franklin County, NE",2002-2003,3484,3440,-44,-1.263,-36,-8,31,61,H1
"Franklin County, NE",2003-2004,3440,3411,-29,-0.843,-15,-14,31,61,H1
"Franklin County, NE",2004-2005,3411,3425,14,0.41,-17,31,31,61,H1
"Franklin County, NE",2005-2006,3425,3352,-73,-2.131,-15,-58,31,61,H1
"Franklin County, NE",2006-2007,3352,3207,-145,-4.326,-12,-133,31,61,H1
"Franklin County, NE",2007-2008,3207,3167,-40,-1.247,-11,-29,31,61,H1
"Franklin County, NE",2008-2009,3167,3186,19,0.6,-13,32,31,61,H1
"Franklin County, NE",2009-2010,3186,3231,45,1.412,-19,64,31,61,H1
"Franklin County, NE",2010-2011,3231,3216,-15,-0.464,-18,3,31,61,H1
"Franklin County, NE",2011-2012,3216,3190,-26,-0.808,-19,-7,31,61,H1
"Franklin County, NE",2012-2013,3190,3091,-99,-3.103,-5,-94,31,61,H1
"Franklin County, NE",2013-2014,3091,3076,-15,-0.485,-2,-13,31,61,H1
"Franklin County, NE",2014-2015,3050,2985,-65,-2.131,-2,-63,31,61,H1
"Franklin County, NE",2015-2016,2985,3012,27,0.905,4,23,31,61,H1
"Franklin County, NE",2016-2017,3012,2990,-22,-0.73,-2,-20,31,61,H1
"Frontier County, NE",2000-2001,3085,3069,-16,-0.519,-6,-10,31,63,H1
"Frontier County, NE",2001-2002,3069,3037,-32,-1.043,-2,-30,31,63,H1
"Frontier County, NE",2002-2003,3037,2981,-56,-1.844,-7,-49,31,63,H1
"Frontier County, NE",2003-2004,2981,2990,9,0.302,3,6,31,63,H1
"Frontier County, NE",2004-2005,2990,2944,-46,-1.538,13,-59,31,63,H1
"Frontier County, NE",2005-2006,2944,2879,-65,-2.208,0,-65,31,63,H1
"Frontier County, NE",2006-2007,2879,2860,-19,-0.66,3,-22,31,63,H1
"Frontier County, NE",2007-2008,2860,2786,-74,-2.587,6,-80,31,63,H1
"Frontier County, NE",2008-2009,2786,2772,-14,-0.503,9,-23,31,63,H1
"Frontier County, NE",2009-2010,2772,2753,-19,-0.685,4,-23,31,63,H1
"Frontier County, NE",2010-2011,2753,2729,-24,-0.872,13,-37,31,63,H1
"Frontier County, NE",2011-2012,2729,2731,2,0.073,-4,6,31,63,H1
"Frontier County, NE",2012-2013,2731,2712,-19,-0.696,8,-27,31,63,H1
"Frontier County, NE",2013-2014,2712,2705,-7,-0.258,7,-14,31,63,H1
"Frontier County, NE",2014-2015,2714,2624,-90,-3.316,10,-100,31,63,H1
"Frontier County, NE",2015-2016,2624,2650,26,0.991,10,16,31,63,H1
"Frontier County, NE",2016-2017,2650,2631,-19,-0.717,12,-31,31,63,H1
"Furnas County, NE",2000-2001,5299,5232,-67,-1.264,-23,-44,31,65,H1
"Furnas County, NE",2001-2002,5232,5261,29,0.554,-36,65,31,65,H1
"Furnas County, NE",2002-2003,5261,5207,-54,-1.026,-40,-14,31,65,H1
"Furnas County, NE",2003-2004,5207,5112,-95,-1.824,-19,-76,31,65,H1
"Furnas County, NE",2004-2005,5112,5051,-61,-1.193,-24,-37,31,65,H1
"Furnas County, NE",2005-2006,5051,5016,-35,-0.693,-37,2,31,65,H1
"Furnas County, NE",2006-2007,5016,4929,-87,-1.734,-30,-57,31,65,H1
"Furnas County, NE",2007-2008,4929,4873,-56,-1.136,-18,-38,31,65,H1
"Furnas County, NE",2008-2009,4873,4934,61,1.252,-29,90,31,65,H1
"Furnas County, NE",2009-2010,4934,4954,20,0.405,-16,36,31,65,H1
"Furnas County, NE",2010-2011,4954,4937,-17,-0.343,-35,18,31,65,H1
"Furnas County, NE",2011-2012,4937,4903,-34,-0.689,-15,-19,31,65,H1
"Furnas County, NE",2012-2013,4903,4856,-47,-0.959,-11,-36,31,65,H1
"Furnas County, NE",2013-2014,4856,4888,32,0.659,-10,42,31,65,H1
"Furnas County, NE",2014-2015,4883,4862,-21,-0.43,-12,-9,31,65,H1
"Furnas County, NE",2015-2016,4862,4771,-91,-1.872,0,-91,31,65,H1
"Furnas County, NE",2016-2017,4771,4780,9,0.189,1,8,31,65,H1
"Gage County, NE",2000-2001,22955,23039,84,0.366,-13,97,31,67,H1
"Gage County, NE",2001-2002,23039,23031,-8,-0.035,-1,-7,31,67,H1
"Gage County, NE",2002-2003,23031,23056,25,0.109,0,25,31,67,H1
"Gage County, NE",2003-2004,23056,23052,-4,-0.017,3,-7,31,67,H1
"Gage County, NE",2004-2005,23052,22866,-186,-0.807,-13,-173,31,67,H1
"Gage County, NE",2005-2006,22866,22875,9,0.039,-9,18,31,67,H1
"Gage County, NE",2006-2007,22875,22843,-32,-0.14,6,-38,31,67,H1
"Gage County, NE",2007-2008,22843,22574,-269,-1.178,5,-274,31,67,H1
"Gage County, NE",2008-2009,22574,22364,-210,-0.93,4,-214,31,67,H1
"Gage County, NE",2009-2010,22364,22286,-78,-0.349,6,-84,31,67,H1
"Gage County, NE",2010-2011,22286,21946,-340,-1.526,-56,-284,31,67,H1
"Gage County, NE",2011-2012,21946,21735,-211,-0.961,-37,-174,31,67,H1
"Gage County, NE",2012-2013,21735,21816,81,0.373,-4,85,31,67,H1
"Gage County, NE",2013-2014,21816,21663,-153,-0.701,-14,-139,31,67,H1
"Gage County, NE",2014-2015,21662,21900,238,1.099,-17,255,31,67,H1
"Gage County, NE",2015-2016,21900,21609,-291,-1.329,-48,-243,31,67,H1
"Gage County, NE",2016-2017,21609,21601,-8,-0.037,-42,34,31,67,H1
"Garden County, NE",2000-2001,2289,2306,17,0.743,-20,37,31,69,H1
"Garden County, NE",2001-2002,2306,2284,-22,-0.954,-24,2,31,69,H1
"Garden County, NE",2002-2003,2284,2304,20,0.876,-17,37,31,69,H1
"Garden County, NE",2003-2004,2304,2245,-59,-2.561,-17,-42,31,69,H1
"Garden County, NE",2004-2005,2245,2111,-134,-5.969,-29,-105,31,69,H1
"Garden County, NE",2005-2006,2111,2120,9,0.426,-13,22,31,69,H1
"Garden County, NE",2006-2007,2120,2046,-74,-3.491,-15,-59,31,69,H1
"Garden County, NE",2007-2008,2046,2004,-42,-2.053,-9,-33,31,69,H1
"Garden County, NE",2008-2009,2004,2010,6,0.299,-6,12,31,69,H1
"Garden County, NE",2009-2010,2010,2078,68,3.383,-11,79,31,69,H1
"Garden County, NE",2010-2011,2078,2044,-34,-1.636,-14,-20,31,69,H1
"Garden County, NE",2011-2012,2044,1962,-82,-4.012,-15,-67,31,69,H1
"Garden County, NE",2012-2013,1962,1904,-58,-2.956,-8,-50,31,69,H1
"Garden County, NE",2013-2014,1904,1911,7,0.368,1,6,31,69,H1
"Garden County, NE",2014-2015,1912,1918,6,0.314,1,5,31,69,H1
"Garden County, NE",2015-2016,1918,1911,-7,-0.365,-4,-3,31,69,H1
"Garden County, NE",2016-2017,1911,1906,-5,-0.262,-1,-4,31,69,H1
"Garfield County, NE",2000-2001,1899,1913,14,0.737,-16,30,31,71,H1
"Garfield County, NE",2001-2002,1913,1945,32,1.673,-23,55,31,71,H1
"Garfield County, NE",2002-2003,1945,1936,-9,-0.463,-20,11,31,71,H1
"Garfield County, NE",2003-2004,1936,1955,19,0.981,-27,46,31,71,H1
"Garfield County, NE",2004-2005,1955,1969,14,0.716,-10,24,31,71,H1
"Garfield County, NE",2005-2006,1969,1984,15,0.762,-15,30,31,71,H1
"Garfield County, NE",2006-2007,1984,1977,-7,-0.353,-14,7,31,71,H1
"Garfield County, NE",2007-2008,1977,2001,24,1.214,-2,26,31,71,H1
"Garfield County, NE",2008-2009,2001,2029,28,1.399,-5,33,31,71,H1
"Garfield County, NE",2009-2010,2029,2041,12,0.591,-13,25,31,71,H1
"Garfield County, NE",2010-2011,2041,1993,-48,-2.352,-15,-33,31,71,H1
"Garfield County, NE",2011-2012,1993,1991,-2,-0.1,-21,19,31,71,H1
"Garfield County, NE",2012-2013,1991,2033,42,2.109,-18,60,31,71,H1
"Garfield County, NE",2013-2014,2033,2003,-30,-1.476,-13,-17,31,71,H1
"Garfield County, NE",2014-2015,1995,2028,33,1.654,2,31,31,71,H1
"Garfield County, NE",2015-2016,2028,2001,-27,-1.331,-11,-16,31,71,H1
"Garfield County, NE",2016-2017,2001,2016,15,0.75,-12,27,31,71,H1
"Gosper County, NE",2000-2001,2146,2096,-50,-2.33,-4,-46,31,73,H1
"Gosper County, NE",2001-2002,2096,2100,4,0.191,0,4,31,73,H1
"Gosper County, NE",2002-2003,2100,2136,36,1.714,-2,38,31,73,H1
"Gosper County, NE",2003-2004,2136,2112,-24,-1.124,-14,-10,31,73,H1
"Gosper County, NE",2004-2005,2112,2110,-2,-0.095,0,-2,31,73,H1
"Gosper County, NE",2005-2006,2110,2075,-35,-1.659,0,-35,31,73,H1
"Gosper County, NE",2006-2007,2075,2101,26,1.253,-3,29,31,73,H1
"Gosper County, NE",2007-2008,2101,2049,-52,-2.475,-6,-46,31,73,H1
"Gosper County, NE",2008-2009,2049,2020,-29,-1.415,-11,-18,31,73,H1
"Gosper County, NE",2009-2010,2020,2048,28,1.386,-1,29,31,73,H1
"Gosper County, NE",2010-2011,2048,1953,-95,-4.639,-3,-92,31,73,H1
"Gosper County, NE",2011-2012,1953,2038,85,4.352,9,76,31,73,H1
"Gosper County, NE",2012-2013,2038,1974,-64,-3.14,0,-64,31,73,H1
"Gosper County, NE",2013-2014,1974,1970,-4,-0.203,3,-7,31,73,H1
"Gosper County, NE",2014-2015,1961,1973,12,0.612,5,7,31,73,H1
"Gosper County, NE",2015-2016,1973,2023,50,2.534,-2,52,31,73,H1
"Gosper County, NE",2016-2017,2023,2028,5,0.247,-1,6,31,73,H1
"Grant County, NE",2000-2001,736,743,7,0.951,3,4,31,75,H1
"Grant County, NE",2001-2002,743,726,-17,-2.288,-1,-16,31,75,H1
"Grant County, NE",2002-2003,726,697,-29,-3.994,-1,-28,31,75,H1
"Grant County, NE",2003-2004,697,680,-17,-2.439,0,-17,31,75,H1
"Grant County, NE",2004-2005,680,676,-4,-0.588,3,-7,31,75,H1
"Grant County, NE",2005-2006,676,677,1,0.148,-1,2,31,75,H1
"Grant County, NE",2006-2007,677,660,-17,-2.511,5,-22,31,75,H1
"Grant County, NE",2007-2008,660,653,-7,-1.061,4,-11,31,75,H1
"Grant County, NE",2008-2009,653,619,-34,-5.207,6,-40,31,75,H1
"Grant County, NE",2009-2010,619,612,-7,-1.131,2,-9,31,75,H1
"Grant County, NE",2010-2011,612,630,18,2.941,9,9,31,75,H1
"Grant County, NE",2011-2012,630,615,-15,-2.381,-1,-14,31,75,H1
"Grant County, NE",2012-2013,615,625,10,1.626,4,6,31,75,H1
"Grant County, NE",2013-2014,625,619,-6,-0.96,5,-11,31,75,H1
"Grant County, NE",2014-2015,620,641,21,3.387,6,15,31,75,H1
"Grant County, NE",2015-2016,641,664,23,3.588,8,15,31,75,H1
"Grant County, NE",2016-2017,664,649,-15,-2.259,7,-22,31,75,H1
"Greeley County, NE",2000-2001,2712,2700,-12,-0.442,1,-13,31,77,H1
"Greeley County, NE",2001-2002,2700,2696,-4,-0.148,-6,2,31,77,H1
"Greeley County, NE",2002-2003,2696,2662,-34,-1.261,-13,-21,31,77,H1
"Greeley County, NE",2003-2004,2662,2643,-19,-0.714,3,-22,31,77,H1
"Greeley County, NE",2004-2005,2643,2577,-66,-2.497,-9,-57,31,77,H1
"Greeley County, NE",2005-2006,2577,2578,1,0.039,-4,5,31,77,H1
"Greeley County, NE",2006-2007,2578,2538,-40,-1.552,2,-42,31,77,H1
"Greeley County, NE",2007-2008,2538,2548,10,0.394,3,7,31,77,H1
"Greeley County, NE",2008-2009,2548,2502,-46,-1.805,10,-56,31,77,H1
"Greeley County, NE",2009-2010,2502,2544,42,1.679,6,36,31,77,H1
"Greeley County, NE",2010-2011,2544,2534,-10,-0.393,-5,-5,31,77,H1
"Greeley County, NE",2011-2012,2534,2457,-77,-3.039,-2,-75,31,77,H1
"Greeley County, NE",2012-2013,2457,2483,26,1.058,6,20,31,77,H1
"Greeley County, NE",2013-2014,2483,2482,-1,-0.04,3,-4,31,77,H1
"Greeley County, NE",2014-2015,2481,2429,-52,-2.096,0,-52,31,77,H1
"Greeley County, NE",2015-2016,2429,2405,-24,-0.988,4,-28,31,77,H1
"Greeley County, NE",2016-2017,2405,2374,-31,-1.289,-2,-29,31,77,H1
"Hall County, NE",2000-2001,53569,53508,-61,-0.114,405,-466,31,79,H1
"Hall County, NE",2001-2002,53508,53722,214,0.4,408,-194,31,79,H1
"Hall County, NE",2002-2003,53722,54050,328,0.611,469,-141,31,79,H1
"Hall County, NE",2003-2004,54050,54413,363,0.672,407,-44,31,79,H1
"Hall County, NE",2004-2005,54413,54535,122,0.224,451,-329,31,79,H1
"Hall County, NE",2005-2006,54535,55190,655,1.201,447,208,31,79,H1
"Hall County, NE",2006-2007,55190,55742,552,1,480,72,31,79,H1
"Hall County, NE",2007-2008,55742,56795,1053,1.889,488,565,31,79,H1
"Hall County, NE",2008-2009,56795,57955,1160,2.042,524,636,31,79,H1
"Hall County, NE",2009-2010,57955,58797,842,1.453,526,316,31,79,H1
"Hall County, NE",2010-2011,58797,59568,771,1.311,364,407,31,79,H1
"Hall County, NE",2011-2012,59568,60335,767,1.288,385,382,31,79,H1
"Hall County, NE",2012-2013,60335,60923,588,0.975,440,148,31,79,H1
"Hall County, NE",2013-2014,60923,61492,569,0.934,422,147,31,79,H1
"Hall County, NE",2014-2015,61509,61680,171,0.278,484,-313,31,79,H1
"Hall County, NE",2015-2016,61680,61530,-150,-0.243,411,-561,31,79,H1
"Hall County, NE",2016-2017,61530,61519,-11,-0.018,424,-435,31,79,H1
"Hamilton County, NE",2000-2001,9377,9307,-70,-0.747,7,-77,31,81,H1
"Hamilton County, NE",2001-2002,9307,9323,16,0.172,26,-10,31,81,H1
"Hamilton County, NE",2002-2003,9323,9349,26,0.279,13,13,31,81,H1
"Hamilton County, NE",2003-2004,9349,9319,-30,-0.321,27,-57,31,81,H1
"Hamilton County, NE",2004-2005,9319,9269,-50,-0.537,3,-53,31,81,H1
"Hamilton County, NE",2005-2006,9269,9196,-73,-0.788,-3,-70,31,81,H1
"Hamilton County, NE",2006-2007,9196,9204,8,0.087,9,-1,31,81,H1
"Hamilton County, NE",2007-2008,9204,9157,-47,-0.511,8,-55,31,81,H1
"Hamilton County, NE",2008-2009,9157,9113,-44,-0.481,16,-60,31,81,H1
"Hamilton County, NE",2009-2010,9113,9127,14,0.154,2,12,31,81,H1
"Hamilton County, NE",2010-2011,9127,9079,-48,-0.526,8,-56,31,81,H1
"Hamilton County, NE",2011-2012,9079,9025,-54,-0.595,24,-78,31,81,H1
"Hamilton County, NE",2012-2013,9025,9122,97,1.075,39,58,31,81,H1
"Hamilton County, NE",2013-2014,9122,9135,13,0.143,29,-16,31,81,H1
"Hamilton County, NE",2014-2015,9109,9190,81,0.889,26,55,31,81,H1
"Hamilton County, NE",2015-2016,9190,9170,-20,-0.218,45,-65,31,81,H1
"Hamilton County, NE",2016-2017,9170,9207,37,0.403,44,-7,31,81,H1
"Harlan County, NE",2000-2001,3764,3732,-32,-0.85,-13,-19,31,83,H1
"Harlan County, NE",2001-2002,3732,3677,-55,-1.474,-5,-50,31,83,H1
"Harlan County, NE",2002-2003,3677,3717,40,1.088,-6,46,31,83,H1
"Harlan County, NE",2003-2004,3717,3633,-84,-2.26,-28,-56,31,83,H1
"Harlan County, NE",2004-2005,3633,3558,-75,-2.064,-15,-60,31,83,H1
"Harlan County, NE",2005-2006,3558,3522,-36,-1.012,-5,-31,31,83,H1
"Harlan County, NE",2006-2007,3522,3511,-11,-0.312,-17,6,31,83,H1
"Harlan County, NE",2007-2008,3511,3435,-76,-2.165,-10,-66,31,83,H1
"Harlan County, NE",2008-2009,3435,3406,-29,-0.844,-1,-28,31,83,H1
"Harlan County, NE",2009-2010,3406,3427,21,0.617,3,18,31,83,H1
"Harlan County, NE",2010-2011,3427,3452,25,0.73,-1,26,31,83,H1
"Harlan County, NE",2011-2012,3452,3426,-26,-0.753,-22,-4,31,83,H1
"Harlan County, NE",2012-2013,3426,3513,87,2.539,-5,92,31,83,H1
"Harlan County, NE",2013-2014,3513,3492,-21,-0.598,11,-32,31,83,H1
"Harlan County, NE",2014-2015,3478,3452,-26,-0.748,15,-41,31,83,H1
"Harlan County, NE",2015-2016,3452,3462,10,0.29,-4,14,31,83,H1
"Harlan County, NE",2016-2017,3462,3443,-19,-0.549,-1,-18,31,83,H1
"Hayes County, NE",2000-2001,1070,1088,18,1.682,-4,22,31,85,H1
"Hayes County, NE",2001-2002,1088,1098,10,0.919,4,6,31,85,H1
"Hayes County, NE",2002-2003,1098,1092,-6,-0.546,6,-12,31,85,H1
"Hayes County, NE",2003-2004,1092,1063,-29,-2.656,-4,-25,31,85,H1
"Hayes County, NE",2004-2005,1063,1051,-12,-1.129,2,-14,31,85,H1
"Hayes County, NE",2005-2006,1051,994,-57,-5.423,-3,-54,31,85,H1
"Hayes County, NE",2006-2007,994,977,-17,-1.71,7,-24,31,85,H1
"Hayes County, NE",2007-2008,977,986,9,0.921,0,9,31,85,H1
"Hayes County, NE",2008-2009,986,987,1,0.101,5,-4,31,85,H1
"Hayes County, NE",2009-2010,987,960,-27,-2.736,4,-31,31,85,H1
"Hayes County, NE",2010-2011,960,983,23,2.396,7,16,31,85,H1
"Hayes County, NE",2011-2012,983,947,-36,-3.662,1,-37,31,85,H1
"Hayes County, NE",2012-2013,947,973,26,2.746,12,14,31,85,H1
"Hayes County, NE",2013-2014,973,933,-40,-4.111,12,-52,31,85,H1
"Hayes County, NE",2014-2015,932,932,0,0,6,-6,31,85,H1
"Hayes County, NE",2015-2016,932,891,-41,-4.399,11,-52,31,85,H1
"Hayes County, NE",2016-2017,891,893,2,0.224,9,-7,31,85,H1
"Hitchcock County, NE",2000-2001,3103,3095,-8,-0.258,-12,4,31,87,H1
"Hitchcock County, NE",2001-2002,3095,3056,-39,-1.26,-13,-26,31,87,H1
"Hitchcock County, NE",2002-2003,3056,3047,-9,-0.295,-16,7,31,87,H1
"Hitchcock County, NE",2003-2004,3047,3055,8,0.263,-2,10,31,87,H1
"Hitchcock County, NE",2004-2005,3055,2954,-101,-3.306,-18,-83,31,87,H1
"Hitchcock County, NE",2005-2006,2954,2956,2,0.068,-5,7,31,87,H1
"Hitchcock County, NE",2006-2007,2956,2931,-25,-0.846,-18,-7,31,87,H1
"Hitchcock County, NE",2007-2008,2931,2927,-4,-0.136,1,-5,31,87,H1
"Hitchcock County, NE",2008-2009,2927,2906,-21,-0.717,-9,-12,31,87,H1
"Hitchcock County, NE",2009-2010,2906,2893,-13,-0.447,-10,-3,31,87,H1
"Hitchcock County, NE",2010-2011,2893,2871,-22,-0.76,1,-23,31,87,H1
"Hitchcock County, NE",2011-2012,2871,2883,12,0.418,-4,16,31,87,H1
"Hitchcock County, NE",2012-2013,2883,2873,-10,-0.347,-1,-9,31,87,H1
"Hitchcock County, NE",2013-2014,2873,2901,28,0.975,-4,32,31,87,H1
"Hitchcock County, NE",2014-2015,2890,2883,-7,-0.242,-5,-2,31,87,H1
"Hitchcock County, NE",2015-2016,2883,2844,-39,-1.353,-2,-37,31,87,H1
"Hitchcock County, NE",2016-2017,2844,2834,-10,-0.352,-7,-3,31,87,H1
"Holt County, NE",2000-2001,11487,11346,-141,-1.227,4,-145,31,89,H1
"Holt County, NE",2001-2002,11346,11210,-136,-1.199,-7,-129,31,89,H1
"Holt County, NE",2002-2003,11210,11042,-168,-1.499,-22,-146,31,89,H1
"Holt County, NE",2003-2004,11042,10868,-174,-1.576,-9,-165,31,89,H1
"Holt County, NE",2004-2005,10868,10839,-29,-0.267,-16,-13,31,89,H1
"Holt County, NE",2005-2006,10839,10613,-226,-2.085,-17,-209,31,89,H1
"Holt County, NE",2006-2007,10613,10541,-72,-0.678,18,-90,31,89,H1
"Holt County, NE",2007-2008,10541,10399,-142,-1.347,-27,-115,31,89,H1
"Holt County, NE",2008-2009,10399,10406,7,0.067,3,4,31,89,H1
"Holt County, NE",2009-2010,10406,10451,45,0.432,13,32,31,89,H1
"Holt County, NE",2010-2011,10451,10460,9,0.086,21,-12,31,89,H1
"Holt County, NE",2011-2012,10460,10409,-51,-0.488,16,-67,31,89,H1
"Holt County, NE",2012-2013,10409,10438,29,0.279,23,6,31,89,H1
"Holt County, NE",2013-2014,10438,10403,-35,-0.335,13,-48,31,89,H1
"Holt County, NE",2014-2015,10390,10313,-77,-0.741,34,-111,31,89,H1
"Holt County, NE",2015-2016,10313,10235,-78,-0.756,18,-96,31,89,H1
"Holt County, NE",2016-2017,10235,10202,-33,-0.322,21,-54,31,89,H1
"Hooker County, NE",2000-2001,773,745,-28,-3.622,0,-28,31,91,H1
"Hooker County, NE",2001-2002,745,731,-14,-1.879,-7,-7,31,91,H1
"Hooker County, NE",2002-2003,731,737,6,0.821,-4,10,31,91,H1
"Hooker County, NE",2003-2004,737,748,11,1.493,-3,14,31,91,H1
"Hooker County, NE",2004-2005,748,744,-4,-0.535,-10,6,31,91,H1
"Hooker County, NE",2005-2006,744,751,7,0.941,-4,11,31,91,H1
"Hooker County, NE",2006-2007,751,732,-19,-2.53,-13,-6,31,91,H1
"Hooker County, NE",2007-2008,732,734,2,0.273,2,0,31,91,H1
"Hooker County, NE",2008-2009,734,733,-1,-0.136,3,-4,31,91,H1
"Hooker County, NE",2009-2010,733,734,1,0.136,-1,2,31,91,H1
"Hooker County, NE",2010-2011,734,742,8,1.09,0,8,31,91,H1
"Hooker County, NE",2011-2012,742,711,-31,-4.178,-9,-22,31,91,H1
"Hooker County, NE",2012-2013,711,732,21,2.954,-2,23,31,91,H1
"Hooker County, NE",2013-2014,732,728,-4,-0.546,0,-4,31,91,H1
"Hooker County, NE",2014-2015,726,732,6,0.826,0,6,31,91,H1
"Hooker County, NE",2015-2016,732,691,-41,-5.601,-9,-32,31,91,H1
"Hooker County, NE",2016-2017,691,674,-17,-2.46,-3,-14,31,91,H1
"Howard County, NE",2000-2001,6523,6448,-75,-1.15,-1,-74,31,93,H1
"Howard County, NE",2001-2002,6448,6427,-21,-0.326,0,-21,31,93,H1
"Howard County, NE",2002-2003,6427,6509,82,1.276,28,54,31,93,H1
"Howard County, NE",2003-2004,6509,6465,-44,-0.676,11,-55,31,93,H1
"Howard County, NE",2004-2005,6465,6432,-33,-0.51,34,-67,31,93,H1
"Howard County, NE",2005-2006,6432,6357,-75,-1.166,-11,-64,31,93,H1
"Howard County, NE",2006-2007,6357,6333,-24,-0.378,2,-26,31,93,H1
"Howard County, NE",2007-2008,6333,6261,-72,-1.137,-13,-59,31,93,H1
"Howard County, NE",2008-2009,6261,6288,27,0.431,11,16,31,93,H1
"Howard County, NE",2009-2010,6288,6265,-23,-0.366,30,-53,31,93,H1
"Howard County, NE",2010-2011,6265,6302,37,0.591,3,34,31,93,H1
"Howard County, NE",2011-2012,6302,6305,3,0.048,8,-5,31,93,H1
"Howard County, NE",2012-2013,6305,6341,36,0.571,4,32,31,93,H1
"Howard County, NE",2013-2014,6341,6362,21,0.331,17,4,31,93,H1
"Howard County, NE",2014-2015,6366,6409,43,0.675,31,12,31,93,H1
"Howard County, NE",2015-2016,6409,6419,10,0.156,21,-11,31,93,H1
"Howard County, NE",2016-2017,6419,6437,18,0.28,23,-5,31,93,H1
"Jefferson County, NE",2000-2001,8324,8288,-36,-0.432,-18,-18,31,95,H1
"Jefferson County, NE",2001-2002,8288,8253,-35,-0.422,-31,-4,31,95,H1
"Jefferson County, NE",2002-2003,8253,8157,-96,-1.163,-16,-80,31,95,H1
"Jefferson County, NE",2003-2004,8157,8117,-40,-0.49,-20,-20,31,95,H1
"Jefferson County, NE",2004-2005,8117,8025,-92,-1.133,-16,-76,31,95,H1
"Jefferson County, NE",2005-2006,8025,7970,-55,-0.685,-25,-30,31,95,H1
"Jefferson County, NE",2006-2007,7970,7765,-205,-2.572,-34,-171,31,95,H1
"Jefferson County, NE",2007-2008,7765,7684,-81,-1.043,-43,-38,31,95,H1
"Jefferson County, NE",2008-2009,7684,7602,-82,-1.067,-30,-52,31,95,H1
"Jefferson County, NE",2009-2010,7602,7534,-68,-0.895,-10,-58,31,95,H1
"Jefferson County, NE",2010-2011,7534,7557,23,0.305,-22,45,31,95,H1
"Jefferson County, NE",2011-2012,7557,7551,-6,-0.079,-47,41,31,95,H1
"Jefferson County, NE",2012-2013,7551,7547,-4,-0.053,-35,31,31,95,H1
"Jefferson County, NE",2013-2014,7547,7335,-212,-2.809,-6,-206,31,95,H1
"Jefferson County, NE",2014-2015,7303,7263,-40,-0.548,-10,-30,31,95,H1
"Jefferson County, NE",2015-2016,7263,7178,-85,-1.17,-10,-75,31,95,H1
"Jefferson County, NE",2016-2017,7178,7178,0,0,2,-2,31,95,H1
"Johnson County, NE",2000-2001,4506,4491,-15,-0.333,-7,-8,31,97,H1
"Johnson County, NE",2001-2002,4491,4927,436,9.708,-32,468,31,97,H1
"Johnson County, NE",2002-2003,4927,5102,175,3.552,5,170,31,97,H1
"Johnson County, NE",2003-2004,5102,5372,270,5.292,-11,281,31,97,H1
"Johnson County, NE",2004-2005,5372,5257,-115,-2.141,17,-132,31,97,H1
"Johnson County, NE",2005-2006,5257,5257,0,0,-13,13,31,97,H1
"Johnson County, NE",2006-2007,5257,5163,-94,-1.788,3,-97,31,97,H1
"Johnson County, NE",2007-2008,5163,5203,40,0.775,6,34,31,97,H1
"Johnson County, NE",2008-2009,5203,5199,-4,-0.077,-14,10,31,97,H1
"Johnson County, NE",2009-2010,5199,5216,17,0.327,20,-3,31,97,H1
"Johnson County, NE",2010-2011,5216,5194,-22,-0.422,-14,-8,31,97,H1
"Johnson County, NE",2011-2012,5194,5164,-30,-0.578,3,-33,31,97,H1
"Johnson County, NE",2012-2013,5164,5129,-35,-0.678,-23,-12,31,97,H1
"Johnson County, NE",2013-2014,5129,5185,56,1.092,-11,67,31,97,H1
"Johnson County, NE",2014-2015,5174,5173,-1,-0.019,-11,10,31,97,H1
"Johnson County, NE",2015-2016,5173,5208,35,0.677,-19,54,31,97,H1
"Johnson County, NE",2016-2017,5208,5185,-23,-0.442,-9,-14,31,97,H1
"Kearney County, NE",2000-2001,6889,6842,-47,-0.682,-7,-40,31,99,H1
"Kearney County, NE",2001-2002,6842,6785,-57,-0.833,-7,-50,31,99,H1
"Kearney County, NE",2002-2003,6785,6800,15,0.221,6,9,31,99,H1
"Kearney County, NE",2003-2004,6800,6776,-24,-0.353,5,-29,31,99,H1
"Kearney County, NE",2004-2005,6776,6698,-78,-1.151,17,-95,31,99,H1
"Kearney County, NE",2005-2006,6698,6614,-84,-1.254,-12,-72,31,99,H1
"Kearney County, NE",2006-2007,6614,6624,10,0.151,9,1,31,99,H1
"Kearney County, NE",2007-2008,6624,6554,-70,-1.057,43,-113,31,99,H1
"Kearney County, NE",2008-2009,6554,6476,-78,-1.19,31,-109,31,99,H1
"Kearney County, NE",2009-2010,6476,6497,21,0.324,1,20,31,99,H1
"Kearney County, NE",2010-2011,6497,6573,76,1.17,-4,80,31,99,H1
"Kearney County, NE",2011-2012,6573,6534,-39,-0.593,29,-68,31,99,H1
"Kearney County, NE",2012-2013,6534,6553,19,0.291,19,0,31,99,H1
"Kearney County, NE",2013-2014,6553,6644,91,1.389,30,61,31,99,H1
"Kearney County, NE",2014-2015,6588,6585,-3,-0.046,13,-16,31,99,H1
"Kearney County, NE",2015-2016,6585,6569,-16,-0.243,8,-24,31,99,H1
"Kearney County, NE",2016-2017,6569,6530,-39,-0.594,17,-56,31,99,H1
"Keith County, NE",2000-2001,8839,8767,-72,-0.815,-20,-52,31,101,H1
"Keith County, NE",2001-2002,8767,8757,-10,-0.114,11,-21,31,101,H1
"Keith County, NE",2002-2003,8757,8514,-243,-2.775,-1,-242,31,101,H1
"Keith County, NE",2003-2004,8514,8444,-70,-0.822,-16,-54,31,101,H1
"Keith County, NE",2004-2005,8444,8418,-26,-0.308,-3,-23,31,101,H1
"Keith County, NE",2005-2006,8418,8381,-37,-0.44,-12,-25,31,101,H1
"Keith County, NE",2006-2007,8381,8423,42,0.501,6,36,31,101,H1
"Keith County, NE",2007-2008,8423,8290,-133,-1.579,-7,-126,31,101,H1
"Keith County, NE",2008-2009,8290,8320,30,0.362,-18,48,31,101,H1
"Keith County, NE",2009-2010,8320,8359,39,0.469,-1,40,31,101,H1
"Keith County, NE",2010-2011,8359,8219,-140,-1.675,-13,-127,31,101,H1
"Keith County, NE",2011-2012,8219,8210,-9,-0.11,1,-10,31,101,H1
"Keith County, NE",2012-2013,8210,8121,-89,-1.084,-32,-57,31,101,H1
"Keith County, NE",2013-2014,8121,8121,0,0,-6,6,31,101,H1
"Keith County, NE",2014-2015,8109,8063,-46,-0.567,-2,-44,31,101,H1
"Keith County, NE",2015-2016,8063,8106,43,0.533,-12,55,31,101,H1
"Keith County, NE",2016-2017,8106,8072,-34,-0.419,0,-34,31,101,H1
"Keya Paha County, NE",2000-2001,981,966,-15,-1.529,6,-21,31,103,H1
"Keya Paha County, NE",2001-2002,966,957,-9,-0.932,1,-10,31,103,H1
"Keya Paha County, NE",2002-2003,957,964,7,0.731,4,3,31,103,H1
"Keya Paha County, NE",2003-2004,964,942,-22,-2.282,11,-33,31,103,H1
"Keya Paha County, NE",2004-2005,942,904,-38,-4.034,0,-38,31,103,H1
"Keya Paha County, NE",2005-2006,904,892,-12,-1.327,9,-21,31,103,H1
"Keya Paha County, NE",2006-2007,892,857,-35,-3.924,-6,-29,31,103,H1
"Keya Paha County, NE",2007-2008,857,836,-21,-2.45,-3,-18,31,103,H1
"Keya Paha County, NE",2008-2009,836,820,-16,-1.914,5,-21,31,103,H1
"Keya Paha County, NE",2009-2010,820,821,1,0.122,7,-6,31,103,H1
"Keya Paha County, NE",2010-2011,821,824,3,0.365,0,3,31,103,H1
"Keya Paha County, NE",2011-2012,824,799,-25,-3.034,-8,-17,31,103,H1
"Keya Paha County, NE",2012-2013,799,797,-2,-0.25,6,-8,31,103,H1
"Keya Paha County, NE",2013-2014,797,810,13,1.631,6,7,31,103,H1
"Keya Paha County, NE",2014-2015,804,804,0,0,7,-7,31,103,H1
"Keya Paha County, NE",2015-2016,804,795,-9,-1.119,3,-12,31,103,H1
"Keya Paha County, NE",2016-2017,795,793,-2,-0.252,2,-4,31,103,H1
"Kimball County, NE",2000-2001,4060,4055,-5,-0.123,1,-6,31,105,H1
"Kimball County, NE",2001-2002,4055,4046,-9,-0.222,-19,10,31,105,H1
"Kimball County, NE",2002-2003,4046,3960,-86,-2.126,-26,-60,31,105,H1
"Kimball County, NE",2003-2004,3960,3921,-39,-0.985,-36,-3,31,105,H1
"Kimball County, NE",2004-2005,3921,3925,4,0.102,-12,16,31,105,H1
"Kimball County, NE",2005-2006,3925,3879,-46,-1.172,-5,-41,31,105,H1
"Kimball County, NE",2006-2007,3879,3809,-70,-1.805,-14,-56,31,105,H1
"Kimball County, NE",2007-2008,3809,3761,-48,-1.26,-10,-38,31,105,H1
"Kimball County, NE",2008-2009,3761,3799,38,1.01,-7,45,31,105,H1
"Kimball County, NE",2009-2010,3799,3827,28,0.737,-10,38,31,105,H1
"Kimball County, NE",2010-2011,3827,3787,-40,-1.045,-13,-27,31,105,H1
"Kimball County, NE",2011-2012,3787,3785,-2,-0.053,-23,21,31,105,H1
"Kimball County, NE",2012-2013,3785,3687,-98,-2.589,2,-100,31,105,H1
"Kimball County, NE",2013-2014,3687,3713,26,0.705,4,22,31,105,H1
"Kimball County, NE",2014-2015,3690,3689,-1,-0.027,6,-7,31,105,H1
"Kimball County, NE",2015-2016,3689,3684,-5,-0.136,4,-9,31,105,H1
"Kimball County, NE",2016-2017,3684,3619,-65,-1.764,4,-69,31,105,H1
"Knox County, NE",2000-2001,9336,9177,-159,-1.703,-21,-138,31,107,H1
"Knox County, NE",2001-2002,9177,9108,-69,-0.752,-38,-31,31,107,H1
"Knox County, NE",2002-2003,9108,9065,-43,-0.472,-39,-4,31,107,H1
"Knox County, NE",2003-2004,9065,9025,-40,-0.441,-29,-11,31,107,H1
"Knox County, NE",2004-2005,9025,8897,-128,-1.418,-35,-93,31,107,H1
"Knox County, NE",2005-2006,8897,8846,-51,-0.573,-34,-17,31,107,H1
"Knox County, NE",2006-2007,8846,8862,16,0.181,-26,42,31,107,H1
"Knox County, NE",2007-2008,8862,8708,-154,-1.738,-30,-124,31,107,H1
"Knox County, NE",2008-2009,8708,8700,-8,-0.092,-3,-5,31,107,H1
"Knox County, NE",2009-2010,8700,8668,-32,-0.368,-9,-23,31,107,H1
"Knox County, NE",2010-2011,8668,8581,-87,-1.004,-29,-58,31,107,H1
"Knox County, NE",2011-2012,8581,8579,-2,-0.023,-3,1,31,107,H1
"Knox County, NE",2012-2013,8579,8557,-22,-0.256,-15,-7,31,107,H1
"Knox County, NE",2013-2014,8557,8482,-75,-0.876,-11,-64,31,107,H1
"Knox County, NE",2014-2015,8498,8543,45,0.53,19,26,31,107,H1
"Knox County, NE",2015-2016,8543,8501,-42,-0.492,4,-46,31,107,H1
"Knox County, NE",2016-2017,8501,8472,-29,-0.341,0,-29,31,107,H1
"Lancaster County, NE",2000-2001,251523,254630,3107,1.235,2027,1080,31,109,H1
"Lancaster County, NE",2001-2002,254630,258398,3768,1.48,1991,1777,31,109,H1
"Lancaster County, NE",2002-2003,258398,262667,4269,1.652,2246,2023,31,109,H1
"Lancaster County, NE",2003-2004,262667,265087,2420,0.921,2352,68,31,109,H1
"Lancaster County, NE",2004-2005,265087,268868,3781,1.426,2478,1303,31,109,H1
"Lancaster County, NE",2005-2006,268868,272286,3418,1.271,2379,1039,31,109,H1
"Lancaster County, NE",2006-2007,272286,276012,3726,1.368,2470,1256,31,109,H1
"Lancaster County, NE",2007-2008,276012,279605,3593,1.302,2443,1150,31,109,H1
"Lancaster County, NE",2008-2009,279605,283097,3492,1.249,2558,934,31,109,H1
"Lancaster County, NE",2009-2010,283097,286134,3037,1.073,2468,569,31,109,H1
"Lancaster County, NE",2010-2011,286134,289945,3811,1.332,2061,1750,31,109,H1
"Lancaster County, NE",2011-2012,289945,293469,3524,1.215,2098,1426,31,109,H1
"Lancaster County, NE",2012-2013,293469,297285,3816,1.3,2199,1617,31,109,H1
"Lancaster County, NE",2013-2014,297285,301795,4510,1.517,2171,2339,31,109,H1
"Lancaster County, NE",2014-2015,302742,306468,3726,1.231,2129,1597,31,109,H1
"Lancaster County, NE",2015-2016,306468,310548,4080,1.331,1925,2155,31,109,H1
"Lancaster County, NE",2016-2017,310548,314358,3810,1.227,1974,1836,31,109,H1
"Lincoln County, NE",2000-2001,34660,34669,9,0.026,168,-159,31,111,H1
"Lincoln County, NE",2001-2002,34669,34525,-144,-0.415,91,-235,31,111,H1
"Lincoln County, NE",2002-2003,34525,34776,251,0.727,121,130,31,111,H1
"Lincoln County, NE",2003-2004,34776,35177,401,1.153,169,232,31,111,H1
"Lincoln County, NE",2004-2005,35177,35577,400,1.137,123,277,31,111,H1
"Lincoln County, NE",2005-2006,35577,35973,396,1.113,174,222,31,111,H1
"Lincoln County, NE",2006-2007,35973,36011,38,0.106,148,-110,31,111,H1
"Lincoln County, NE",2007-2008,36011,36301,290,0.805,205,85,31,111,H1
"Lincoln County, NE",2008-2009,36301,36280,-21,-0.058,182,-203,31,111,H1
"Lincoln County, NE",2009-2010,36280,36267,-13,-0.036,152,-165,31,111,H1
"Lincoln County, NE",2010-2011,36267,36069,-198,-0.546,73,-271,31,111,H1
"Lincoln County, NE",2011-2012,36069,36029,-40,-0.111,108,-148,31,111,H1
"Lincoln County, NE",2012-2013,36029,36092,63,0.175,92,-29,31,111,H1
"Lincoln County, NE",2013-2014,36092,35815,-277,-0.767,97,-374,31,111,H1
"Lincoln County, NE",2014-2015,35723,35656,-67,-0.188,69,-136,31,111,H1
"Lincoln County, NE",2015-2016,35656,35474,-182,-0.51,74,-256,31,111,H1
"Lincoln County, NE",2016-2017,35474,35280,-194,-0.547,67,-261,31,111,H1
"Logan County, NE",2000-2001,773,780,7,0.906,2,5,31,113,H1
"Logan County, NE",2001-2002,780,764,-16,-2.051,-3,-13,31,113,H1
"Logan County, NE",2002-2003,764,737,-27,-3.534,-2,-25,31,113,H1
"Logan County, NE",2003-2004,737,738,1,0.136,1,0,31,113,H1
"Logan County, NE",2004-2005,738,747,9,1.22,0,9,31,113,H1
"Logan County, NE",2005-2006,747,756,9,1.205,7,2,31,113,H1
"Logan County, NE",2006-2007,756,751,-5,-0.661,7,-12,31,113,H1
"Logan County, NE",2007-2008,751,730,-21,-2.796,2,-23,31,113,H1
"Logan County, NE",2008-2009,730,738,8,1.096,7,1,31,113,H1
"Logan County, NE",2009-2010,738,768,30,4.065,6,24,31,113,H1
"Logan County, NE",2010-2011,768,767,-1,-0.13,3,-4,31,113,H1
"Logan County, NE",2011-2012,767,771,4,0.522,4,0,31,113,H1
"Logan County, NE",2012-2013,771,764,-7,-0.908,12,-19,31,113,H1
"Logan County, NE",2013-2014,764,750,-14,-1.832,3,-17,31,113,H1
"Logan County, NE",2014-2015,752,777,25,3.324,4,21,31,113,H1
"Logan County, NE",2015-2016,777,797,20,2.574,6,14,31,113,H1
"Logan County, NE",2016-2017,797,768,-29,-3.639,2,-31,31,113,H1
"Loup County, NE",2000-2001,709,715,6,0.846,2,4,31,115,H1
"Loup County, NE",2001-2002,715,736,21,2.937,2,19,31,115,H1
"Loup County, NE",2002-2003,736,722,-14,-1.902,1,-15,31,115,H1
"Loup County, NE",2003-2004,722,669,-53,-7.341,-9,-44,31,115,H1
"Loup County, NE",2004-2005,669,652,-17,-2.541,-2,-15,31,115,H1
"Loup County, NE",2005-2006,652,635,-17,-2.607,-1,-16,31,115,H1
"Loup County, NE",2006-2007,635,649,14,2.205,3,11,31,115,H1
"Loup County, NE",2007-2008,649,630,-19,-2.928,3,-22,31,115,H1
"Loup County, NE",2008-2009,630,629,-1,-0.159,2,-3,31,115,H1
"Loup County, NE",2009-2010,629,626,-3,-0.477,0,-3,31,115,H1
"Loup County, NE",2010-2011,626,614,-12,-1.917,1,-13,31,115,H1
"Loup County, NE",2011-2012,614,600,-14,-2.28,3,-17,31,115,H1
"Loup County, NE",2012-2013,600,581,-19,-3.167,1,-20,31,115,H1
"Loup County, NE",2013-2014,581,588,7,1.205,3,4,31,115,H1
"Loup County, NE",2014-2015,587,585,-2,-0.341,0,-2,31,115,H1
"Loup County, NE",2015-2016,585,616,31,5.299,0,31,31,115,H1
"Loup County, NE",2016-2017,616,609,-7,-1.136,2,-9,31,115,H1
"McPherson County, NE",2000-2001,532,534,2,0.376,3,-1,31,117,H1
"McPherson County, NE",2001-2002,534,549,15,2.809,5,10,31,117,H1
"McPherson County, NE",2002-2003,549,538,-11,-2.004,-3,-8,31,117,H1
"McPherson County, NE",2003-2004,538,531,-7,-1.301,3,-10,31,117,H1
"McPherson County, NE",2004-2005,531,522,-9,-1.695,0,-9,31,117,H1
"McPherson County, NE",2005-2006,522,518,-4,-0.766,2,-6,31,117,H1
"McPherson County, NE",2006-2007,518,545,27,5.212,5,22,31,117,H1
"McPherson County, NE",2007-2008,545,558,13,2.385,6,7,31,117,H1
"McPherson County, NE",2008-2009,558,537,-21,-3.763,5,-26,31,117,H1
"McPherson County, NE",2009-2010,537,538,1,0.186,5,-4,31,117,H1
"McPherson County, NE",2010-2011,538,546,8,1.487,-3,11,31,117,H1
"McPherson County, NE",2011-2012,546,505,-41,-7.509,1,-42,31,117,H1
"McPherson County, NE",2012-2013,505,523,18,3.564,-1,19,31,117,H1
"McPherson County, NE",2013-2014,523,498,-25,-4.78,-1,-24,31,117,H1
"McPherson County, NE",2014-2015,501,475,-26,-5.19,0,-26,31,117,H1
"McPherson County, NE",2015-2016,475,505,30,6.316,-1,31,31,117,H1
"McPherson County, NE",2016-2017,505,499,-6,-1.188,0,-6,31,117,H1
"Madison County, NE",2000-2001,35230,35601,371,1.053,237,134,31,119,H1
"Madison County, NE",2001-2002,35601,35862,261,0.733,178,83,31,119,H1
"Madison County, NE",2002-2003,35862,35858,-4,-0.011,237,-241,31,119,H1
"Madison County, NE",2003-2004,35858,35722,-136,-0.379,237,-373,31,119,H1
"Madison County, NE",2004-2005,35722,35631,-91,-0.255,236,-327,31,119,H1
"Madison County, NE",2005-2006,35631,35415,-216,-0.606,197,-413,31,119,H1
"Madison County, NE",2006-2007,35415,34298,-1117,-3.154,184,-1301,31,119,H1
"Madison County, NE",2007-2008,34298,34319,21,0.061,191,-170,31,119,H1
"Madison County, NE",2008-2009,34319,34609,290,0.845,175,115,31,119,H1
"Madison County, NE",2009-2010,34609,34950,341,0.985,195,146,31,119,H1
"Madison County, NE",2010-2011,34950,35016,66,0.189,237,-171,31,119,H1
"Madison County, NE",2011-2012,35016,35122,106,0.303,184,-78,31,119,H1
"Madison County, NE",2012-2013,35122,35251,129,0.367,141,-12,31,119,H1
"Madison County, NE",2013-2014,35251,35174,-77,-0.218,130,-207,31,119,H1
"Madison County, NE",2014-2015,35169,35039,-130,-0.37,151,-281,31,119,H1
"Madison County, NE",2015-2016,35039,34935,-104,-0.297,176,-280,31,119,H1
"Madison County, NE",2016-2017,34935,35144,209,0.598,168,41,31,119,H1
"Merrick County, NE",2000-2001,8152,8045,-107,-1.313,8,-115,31,121,H1
"Merrick County, NE",2001-2002,8045,8054,9,0.112,-1,10,31,121,H1
"Merrick County, NE",2002-2003,8054,8033,-21,-0.261,5,-26,31,121,H1
"Merrick County, NE",2003-2004,8033,8018,-15,-0.187,5,-20,31,121,H1
"Merrick County, NE",2004-2005,8018,7904,-114,-1.422,-4,-110,31,121,H1
"Merrick County, NE",2005-2006,7904,7813,-91,-1.151,0,-91,31,121,H1
"Merrick County, NE",2006-2007,7813,7709,-104,-1.331,-4,-100,31,121,H1
"Merrick County, NE",2007-2008,7709,7734,25,0.324,5,20,31,121,H1
"Merrick County, NE",2008-2009,7734,7813,79,1.021,9,70,31,121,H1
"Merrick County, NE",2009-2010,7813,7854,41,0.525,8,33,31,121,H1
"Merrick County, NE",2010-2011,7854,7734,-120,-1.528,3,-123,31,121,H1
"Merrick County, NE",2011-2012,7734,7797,63,0.815,-5,68,31,121,H1
"Merrick County, NE",2012-2013,7797,7801,4,0.051,24,-20,31,121,H1
"Merrick County, NE",2013-2014,7801,7766,-35,-0.449,15,-50,31,121,H1
"Merrick County, NE",2014-2015,7767,7787,20,0.257,21,-1,31,121,H1
"Merrick County, NE",2015-2016,7787,7849,62,0.796,33,29,31,121,H1
"Merrick County, NE",2016-2017,7849,7882,33,0.42,30,3,31,121,H1
"Morrill County, NE",2000-2001,5420,5344,-76,-1.402,5,-81,31,123,H1
"Morrill County, NE",2001-2002,5344,5225,-119,-2.227,-6,-113,31,123,H1
"Morrill County, NE",2002-2003,5225,5202,-23,-0.44,11,-34,31,123,H1
"Morrill County, NE",2003-2004,5202,5147,-55,-1.057,-14,-41,31,123,H1
"Morrill County, NE",2004-2005,5147,5110,-37,-0.719,11,-48,31,123,H1
"Morrill County, NE",2005-2006,5110,5090,-20,-0.391,6,-26,31,123,H1
"Morrill County, NE",2006-2007,5090,5122,32,0.629,-4,36,31,123,H1
"Morrill County, NE",2007-2008,5122,5079,-43,-0.84,15,-58,31,123,H1
"Morrill County, NE",2008-2009,5079,5019,-60,-1.181,21,-81,31,123,H1
"Morrill County, NE",2009-2010,5019,5040,21,0.418,8,13,31,123,H1
"Morrill County, NE",2010-2011,5040,4930,-110,-2.183,-6,-104,31,123,H1
"Morrill County, NE",2011-2012,4930,4875,-55,-1.116,-1,-54,31,123,H1
"Morrill County, NE",2012-2013,4875,4882,7,0.144,10,-3,31,123,H1
"Morrill County, NE",2013-2014,4882,4862,-20,-0.41,8,-28,31,123,H1
"Morrill County, NE",2014-2015,4850,4854,4,0.082,9,-5,31,123,H1
"Morrill County, NE",2015-2016,4854,4892,38,0.783,1,37,31,123,H1
"Morrill County, NE",2016-2017,4892,4836,-56,-1.145,5,-61,31,123,H1
"Nance County, NE",2000-2001,4054,4039,-15,-0.37,5,-20,31,125,H1
"Nance County, NE",2001-2002,4039,3948,-91,-2.253,-17,-74,31,125,H1
"Nance County, NE",2002-2003,3948,3842,-106,-2.685,-25,-81,31,125,H1
"Nance County, NE",2003-2004,3842,3787,-55,-1.432,-18,-37,31,125,H1
"Nance County, NE",2004-2005,3787,3831,44,1.162,-19,63,31,125,H1
"Nance County, NE",2005-2006,3831,3807,-24,-0.626,-21,-3,31,125,H1
"Nance County, NE",2006-2007,3807,3766,-41,-1.077,-4,-37,31,125,H1
"Nance County, NE",2007-2008,3766,3745,-21,-0.558,-14,-7,31,125,H1
"Nance County, NE",2008-2009,3745,3729,-16,-0.427,-9,-7,31,125,H1
"Nance County, NE",2009-2010,3729,3729,0,0,-1,1,31,125,H1
"Nance County, NE",2010-2011,3729,3732,3,0.08,-14,17,31,125,H1
"Nance County, NE",2011-2012,3732,3703,-29,-0.777,-10,-19,31,125,H1
"Nance County, NE",2012-2013,3703,3600,-103,-2.782,6,-109,31,125,H1
"Nance County, NE",2013-2014,3600,3570,-30,-0.833,6,-36,31,125,H1
"Nance County, NE",2014-2015,3555,3595,40,1.125,2,38,31,125,H1
"Nance County, NE",2015-2016,3595,3577,-18,-0.501,7,-25,31,125,H1
"Nance County, NE",2016-2017,3577,3607,30,0.839,15,15,31,125,H1
"Nemaha County, NE",2000-2001,7578,7446,-132,-1.742,-25,-107,31,127,H1
"Nemaha County, NE",2001-2002,7446,7330,-116,-1.558,-20,-96,31,127,H1
"Nemaha County, NE",2002-2003,7330,7215,-115,-1.569,-24,-91,31,127,H1
"Nemaha County, NE",2003-2004,7215,7182,-33,-0.457,-3,-30,31,127,H1
"Nemaha County, NE",2004-2005,7182,7252,70,0.975,24,46,31,127,H1
"Nemaha County, NE",2005-2006,7252,7311,59,0.814,-16,75,31,127,H1
"Nemaha County, NE",2006-2007,7311,7220,-91,-1.245,-6,-85,31,127,H1
"Nemaha County, NE",2007-2008,7220,7280,60,0.831,5,55,31,127,H1
"Nemaha County, NE",2008-2009,7280,7178,-102,-1.401,2,-104,31,127,H1
"Nemaha County, NE",2009-2010,7178,7247,69,0.961,9,60,31,127,H1
"Nemaha County, NE",2010-2011,7247,7273,26,0.359,-21,47,31,127,H1
"Nemaha County, NE",2011-2012,7273,7197,-76,-1.045,-16,-60,31,127,H1
"Nemaha County, NE",2012-2013,7197,7178,-19,-0.264,15,-34,31,127,H1
"Nemaha County, NE",2013-2014,7178,7175,-3,-0.042,19,-22,31,127,H1
"Nemaha County, NE",2014-2015,7154,7046,-108,-1.51,20,-128,31,127,H1
"Nemaha County, NE",2015-2016,7046,6981,-65,-0.923,-2,-63,31,127,H1
"Nemaha County, NE",2016-2017,6981,6949,-32,-0.458,4,-36,31,127,H1
"Nuckolls County, NE",2000-2001,5032,4947,-85,-1.689,-32,-53,31,129,H1
"Nuckolls County, NE",2001-2002,4947,4844,-103,-2.082,-22,-81,31,129,H1
"Nuckolls County, NE",2002-2003,4844,4873,29,0.599,-15,44,31,129,H1
"Nuckolls County, NE",2003-2004,4873,4872,-1,-0.021,-25,24,31,129,H1
"Nuckolls County, NE",2004-2005,4872,4796,-76,-1.56,-20,-56,31,129,H1
"Nuckolls County, NE",2005-2006,4796,4709,-87,-1.814,-10,-77,31,129,H1
"Nuckolls County, NE",2006-2007,4709,4642,-67,-1.423,-22,-45,31,129,H1
"Nuckolls County, NE",2007-2008,4642,4571,-71,-1.53,-29,-42,31,129,H1
"Nuckolls County, NE",2008-2009,4571,4495,-76,-1.663,-24,-52,31,129,H1
"Nuckolls County, NE",2009-2010,4495,4507,12,0.267,-10,22,31,129,H1
"Nuckolls County, NE",2010-2011,4507,4451,-56,-1.243,-25,-31,31,129,H1
"Nuckolls County, NE",2011-2012,4451,4431,-20,-0.449,-25,5,31,129,H1
"Nuckolls County, NE",2012-2013,4431,4395,-36,-0.812,-14,-22,31,129,H1
"Nuckolls County, NE",2013-2014,4395,4369,-26,-0.592,-24,-2,31,129,H1
"Nuckolls County, NE",2014-2015,4366,4329,-37,-0.847,-13,-24,31,129,H1
"Nuckolls County, NE",2015-2016,4329,4268,-61,-1.409,-10,-51,31,129,H1
"Nuckolls County, NE",2016-2017,4268,4275,7,0.164,-10,17,31,129,H1
"Otoe County, NE",2000-2001,15494,15554,60,0.387,15,45,31,131,H1
"Otoe County, NE",2001-2002,15554,15524,-30,-0.193,6,-36,31,131,H1
"Otoe County, NE",2002-2003,15524,15478,-46,-0.296,-8,-38,31,131,H1
"Otoe County, NE",2003-2004,15478,15525,47,0.304,-11,58,31,131,H1
"Otoe County, NE",2004-2005,15525,15607,82,0.528,42,40,31,131,H1
"Otoe County, NE",2005-2006,15607,15753,146,0.935,10,136,31,131,H1
"Otoe County, NE",2006-2007,15753,15841,88,0.559,31,57,31,131,H1
"Otoe County, NE",2007-2008,15841,15728,-113,-0.713,-4,-109,31,131,H1
"Otoe County, NE",2008-2009,15728,15608,-120,-0.763,4,-124,31,131,H1
"Otoe County, NE",2009-2010,15608,15758,150,0.961,10,140,31,131,H1
"Otoe County, NE",2010-2011,15758,15772,14,0.089,-2,16,31,131,H1
"Otoe County, NE",2011-2012,15772,15704,-68,-0.431,-7,-61,31,131,H1
"Otoe County, NE",2012-2013,15704,15717,13,0.083,24,-11,31,131,H1
"Otoe County, NE",2013-2014,15717,15797,80,0.509,16,64,31,131,H1
"Otoe County, NE",2014-2015,15888,15984,96,0.604,21,75,31,131,H1
"Otoe County, NE",2015-2016,15984,15984,0,0,38,-38,31,131,H1
"Otoe County, NE",2016-2017,15984,16027,43,0.269,47,-4,31,131,H1
"Pawnee County, NE",2000-2001,3088,3020,-68,-2.202,-26,-42,31,133,H1
"Pawnee County, NE",2001-2002,3020,3020,0,0,-22,22,31,133,H1
"Pawnee County, NE",2002-2003,3020,2907,-113,-3.742,-46,-67,31,133,H1
"Pawnee County, NE",2003-2004,2907,2907,0,0,-7,7,31,133,H1
"Pawnee County, NE",2004-2005,2907,2884,-23,-0.791,-21,-2,31,133,H1
"Pawnee County, NE",2005-2006,2884,2802,-82,-2.843,-18,-64,31,133,H1
"Pawnee County, NE",2006-2007,2802,2791,-11,-0.393,-20,9,31,133,H1
"Pawnee County, NE",2007-2008,2791,2711,-80,-2.866,-14,-66,31,133,H1
"Pawnee County, NE",2008-2009,2711,2752,41,1.512,-11,52,31,133,H1
"Pawnee County, NE",2009-2010,2752,2775,23,0.836,-16,39,31,133,H1
"Pawnee County, NE",2010-2011,2775,2785,10,0.36,-13,23,31,133,H1
"Pawnee County, NE",2011-2012,2785,2782,-3,-0.108,-14,11,31,133,H1
"Pawnee County, NE",2012-2013,2782,2726,-56,-2.013,3,-59,31,133,H1
"Pawnee County, NE",2013-2014,2726,2702,-24,-0.88,-1,-23,31,133,H1
"Pawnee County, NE",2014-2015,2692,2659,-33,-1.226,13,-46,31,133,H1
"Pawnee County, NE",2015-2016,2659,2711,52,1.956,11,41,31,133,H1
"Pawnee County, NE",2016-2017,2711,2641,-70,-2.582,14,-84,31,133,H1
"Perkins County, NE",2000-2001,3181,3125,-56,-1.76,2,-58,31,135,H1
"Perkins County, NE",2001-2002,3125,3119,-6,-0.192,-10,4,31,135,H1
"Perkins County, NE",2002-2003,3119,3082,-37,-1.186,-20,-17,31,135,H1
"Perkins County, NE",2003-2004,3082,3134,52,1.687,3,49,31,135,H1
"Perkins County, NE",2004-2005,3134,3145,11,0.351,1,10,31,135,H1
"Perkins County, NE",2005-2006,3145,3041,-104,-3.307,-5,-99,31,135,H1
"Perkins County, NE",2006-2007,3041,3013,-28,-0.921,-1,-27,31,135,H1
"Perkins County, NE",2007-2008,3013,2949,-64,-2.124,-1,-63,31,135,H1
"Perkins County, NE",2008-2009,2949,2937,-12,-0.407,3,-15,31,135,H1
"Perkins County, NE",2009-2010,2937,2987,50,1.702,12,38,31,135,H1
"Perkins County, NE",2010-2011,2987,2956,-31,-1.038,1,-32,31,135,H1
"Perkins County, NE",2011-2012,2956,2947,-9,-0.304,1,-10,31,135,H1
"Perkins County, NE",2012-2013,2947,2910,-37,-1.256,10,-47,31,135,H1
"Perkins County, NE",2013-2014,2910,2891,-19,-0.653,12,-31,31,135,H1
"Perkins County, NE",2014-2015,2892,2944,52,1.798,15,37,31,135,H1
"Perkins County, NE",2015-2016,2944,2906,-38,-1.291,20,-58,31,135,H1
"Perkins County, NE",2016-2017,2906,2903,-3,-0.103,14,-17,31,135,H1
"Phelps County, NE",2000-2001,9733,9704,-29,-0.298,17,-46,31,137,H1
"Phelps County, NE",2001-2002,9704,9684,-20,-0.206,-2,-18,31,137,H1
"Phelps County, NE",2002-2003,9684,9576,-108,-1.115,2,-110,31,137,H1
"Phelps County, NE",2003-2004,9576,9535,-41,-0.428,-2,-39,31,137,H1
"Phelps County, NE",2004-2005,9535,9402,-133,-1.395,-9,-124,31,137,H1
"Phelps County, NE",2005-2006,9402,9405,3,0.032,-11,14,31,137,H1
"Phelps County, NE",2006-2007,9405,9222,-183,-1.946,15,-198,31,137,H1
"Phelps County, NE",2007-2008,9222,9195,-27,-0.293,17,-44,31,137,H1
"Phelps County, NE",2008-2009,9195,9148,-47,-0.511,23,-70,31,137,H1
"Phelps County, NE",2009-2010,9148,9185,37,0.404,13,24,31,137,H1
"Phelps County, NE",2010-2011,9185,9159,-26,-0.283,-17,-9,31,137,H1
"Phelps County, NE",2011-2012,9159,9216,57,0.622,21,36,31,137,H1
"Phelps County, NE",2012-2013,9216,9197,-19,-0.206,6,-25,31,137,H1
"Phelps County, NE",2013-2014,9197,9187,-10,-0.109,14,-24,31,137,H1
"Phelps County, NE",2014-2015,9201,9296,95,1.032,28,67,31,137,H1
"Phelps County, NE",2015-2016,9296,9184,-112,-1.205,-16,-96,31,137,H1
"Phelps County, NE",2016-2017,9184,9060,-124,-1.35,8,-132,31,137,H1
"Pierce County, NE",2000-2001,7824,7731,-93,-1.189,-21,-72,31,139,H1
"Pierce County, NE",2001-2002,7731,7627,-104,-1.345,-18,-86,31,139,H1
"Pierce County, NE",2002-2003,7627,7615,-12,-0.157,25,-37,31,139,H1
"Pierce County, NE",2003-2004,7615,7477,-138,-1.812,-14,-124,31,139,H1
"Pierce County, NE",2004-2005,7477,7508,31,0.415,-4,35,31,139,H1
"Pierce County, NE",2005-2006,7508,7416,-92,-1.225,23,-115,31,139,H1
"Pierce County, NE",2006-2007,7416,7314,-102,-1.375,0,-102,31,139,H1
"Pierce County, NE",2007-2008,7314,7286,-28,-0.383,23,-51,31,139,H1
"Pierce County, NE",2008-2009,7286,7260,-26,-0.357,27,-53,31,139,H1
"Pierce County, NE",2009-2010,7260,7261,1,0.014,15,-14,31,139,H1
"Pierce County, NE",2010-2011,7261,7196,-65,-0.895,17,-82,31,139,H1
"Pierce County, NE",2011-2012,7196,7180,-16,-0.222,9,-25,31,139,H1
"Pierce County, NE",2012-2013,7180,7164,-16,-0.223,16,-32,31,139,H1
"Pierce County, NE",2013-2014,7164,7202,38,0.53,17,21,31,139,H1
"Pierce County, NE",2014-2015,7196,7208,12,0.167,21,-9,31,139,H1
"Pierce County, NE",2015-2016,7208,7156,-52,-0.721,41,-93,31,139,H1
"Pierce County, NE",2016-2017,7156,7138,-18,-0.252,30,-48,31,139,H1
"Platte County, NE",2000-2001,31500,31319,-181,-0.575,214,-395,31,141,H1
"Platte County, NE",2001-2002,31319,30939,-380,-1.213,155,-535,31,141,H1
"Platte County, NE",2002-2003,30939,30756,-183,-0.591,194,-377,31,141,H1
"Platte County, NE",2003-2004,30756,30658,-98,-0.319,204,-302,31,141,H1
"Platte County, NE",2004-2005,30658,30865,207,0.675,234,-27,31,141,H1
"Platte County, NE",2005-2006,30865,31100,235,0.761,246,-11,31,141,H1
"Platte County, NE",2006-2007,31100,31408,308,0.99,246,62,31,141,H1
"Platte County, NE",2007-2008,31408,31527,119,0.379,250,-131,31,141,H1
"Platte County, NE",2008-2009,31527,32017,490,1.554,204,286,31,141,H1
"Platte County, NE",2009-2010,32017,32268,251,0.784,194,57,31,141,H1
"Platte County, NE",2010-2011,32268,32420,152,0.471,167,-15,31,141,H1
"Platte County, NE",2011-2012,32420,32558,138,0.426,242,-104,31,141,H1
"Platte County, NE",2012-2013,32558,32513,-45,-0.138,236,-281,31,141,H1
"Platte County, NE",2013-2014,32513,32666,153,0.471,209,-56,31,141,H1
"Platte County, NE",2014-2015,32734,32847,113,0.345,213,-100,31,141,H1
"Platte County, NE",2015-2016,32847,32946,99,0.301,214,-115,31,141,H1
"Platte County, NE",2016-2017,32946,33175,229,0.695,232,-3,31,141,H1
"Polk County, NE",2000-2001,5610,5533,-77,-1.373,3,-80,31,143,H1
"Polk County, NE",2001-2002,5533,5556,23,0.416,-2,25,31,143,H1
"Polk County, NE",2002-2003,5556,5529,-27,-0.486,-15,-12,31,143,H1
"Polk County, NE",2003-2004,5529,5466,-63,-1.139,0,-63,31,143,H1
"Polk County, NE",2004-2005,5466,5473,7,0.128,-9,16,31,143,H1
"Polk County, NE",2005-2006,5473,5409,-64,-1.169,-2,-62,31,143,H1
"Polk County, NE",2006-2007,5409,5447,38,0.703,13,25,31,143,H1
"Polk County, NE",2007-2008,5447,5402,-45,-0.826,4,-49,31,143,H1
"Polk County, NE",2008-2009,5402,5409,7,0.13,-5,12,31,143,H1
"Polk County, NE",2009-2010,5409,5389,-20,-0.37,-3,-17,31,143,H1
"Polk County, NE",2010-2011,5389,5341,-48,-0.891,-12,-36,31,143,H1
"Polk County, NE",2011-2012,5341,5282,-59,-1.105,-30,-29,31,143,H1
"Polk County, NE",2012-2013,5282,5250,-32,-0.606,-4,-28,31,143,H1
"Polk County, NE",2013-2014,5250,5271,21,0.4,-5,26,31,143,H1
"Polk County, NE",2014-2015,5277,5202,-75,-1.421,2,-77,31,143,H1
"Polk County, NE",2015-2016,5202,5202,0,0,11,-11,31,143,H1
"Polk County, NE",2016-2017,5202,5328,126,2.422,1,125,31,143,H1
"Red Willow County, NE",2000-2001,11487,11483,-4,-0.035,16,-20,31,145,H1
"Red Willow County, NE",2001-2002,11483,11436,-47,-0.409,21,-68,31,145,H1
"Red Willow County, NE",2002-2003,11436,11336,-100,-0.874,-11,-89,31,145,H1
"Red Willow County, NE",2003-2004,11336,11351,15,0.132,24,-9,31,145,H1
"Red Willow County, NE",2004-2005,11351,11219,-132,-1.163,-7,-125,31,145,H1
"Red Willow County, NE",2005-2006,11219,11194,-25,-0.223,25,-50,31,145,H1
"Red Willow County, NE",2006-2007,11194,11053,-141,-1.26,-35,-106,31,145,H1
"Red Willow County, NE",2007-2008,11053,11034,-19,-0.172,8,-27,31,145,H1
"Red Willow County, NE",2008-2009,11034,11018,-16,-0.145,20,-36,31,145,H1
"Red Willow County, NE",2009-2010,11018,11052,34,0.309,14,20,31,145,H1
"Red Willow County, NE",2010-2011,11052,11011,-41,-0.371,14,-55,31,145,H1
"Red Willow County, NE",2011-2012,11011,11013,2,0.018,9,-7,31,145,H1
"Red Willow County, NE",2012-2013,11013,11023,10,0.091,27,-17,31,145,H1
"Red Willow County, NE",2013-2014,11023,10867,-156,-1.415,4,-160,31,145,H1
"Red Willow County, NE",2014-2015,10860,10829,-31,-0.285,-4,-27,31,145,H1
"Red Willow County, NE",2015-2016,10829,10783,-46,-0.425,3,-49,31,145,H1
"Red Willow County, NE",2016-2017,10783,10728,-55,-0.51,-8,-47,31,145,H1
"Richardson County, NE",2000-2001,9507,9260,-247,-2.598,-79,-168,31,147,H1
"Richardson County, NE",2001-2002,9260,9125,-135,-1.458,-65,-70,31,147,H1
"Richardson County, NE",2002-2003,9125,8949,-176,-1.929,-56,-120,31,147,H1
"Richardson County, NE",2003-2004,8949,8879,-70,-0.782,-51,-19,31,147,H1
"Richardson County, NE",2004-2005,8879,8799,-80,-0.901,-57,-23,31,147,H1
"Richardson County, NE",2005-2006,8799,8642,-157,-1.784,-63,-94,31,147,H1
"Richardson County, NE",2006-2007,8642,8480,-162,-1.875,-50,-112,31,147,H1
"Richardson County, NE",2007-2008,8480,8413,-67,-0.79,-53,-14,31,147,H1
"Richardson County, NE",2008-2009,8413,8383,-30,-0.357,-48,18,31,147,H1
"Richardson County, NE",2009-2010,8383,8343,-40,-0.477,-31,-9,31,147,H1
"Richardson County, NE",2010-2011,8343,8322,-21,-0.252,-22,1,31,147,H1
"Richardson County, NE",2011-2012,8322,8267,-55,-0.661,-32,-23,31,147,H1
"Richardson County, NE",2012-2013,8267,8125,-142,-1.718,-20,-122,31,147,H1
"Richardson County, NE",2013-2014,8125,8128,3,0.037,-20,23,31,147,H1
"Richardson County, NE",2014-2015,8151,8094,-57,-0.699,-15,-42,31,147,H1
"Richardson County, NE",2015-2016,8094,7998,-96,-1.186,-31,-65,31,147,H1
"Richardson County, NE",2016-2017,7998,7969,-29,-0.363,-39,10,31,147,H1
"Rock County, NE",2000-2001,1743,1709,-34,-1.951,-10,-24,31,149,H1
"Rock County, NE",2001-2002,1709,1674,-35,-2.048,-8,-27,31,149,H1
"Rock County, NE",2002-2003,1674,1600,-74,-4.421,-17,-57,31,149,H1
"Rock County, NE",2003-2004,1600,1597,-3,-0.188,4,-7,31,149,H1
"Rock County, NE",2004-2005,1597,1557,-40,-2.505,-11,-29,31,149,H1
"Rock County, NE",2005-2006,1557,1552,-5,-0.321,0,-5,31,149,H1
"Rock County, NE",2006-2007,1552,1551,-1,-0.064,-5,4,31,149,H1
"Rock County, NE",2007-2008,1551,1554,3,0.193,-3,6,31,149,H1
"Rock County, NE",2008-2009,1554,1550,-4,-0.257,-1,-3,31,149,H1
"Rock County, NE",2009-2010,1550,1524,-26,-1.677,1,-27,31,149,H1
"Rock County, NE",2010-2011,1524,1445,-79,-5.184,-4,-75,31,149,H1
"Rock County, NE",2011-2012,1445,1393,-52,-3.599,-15,-37,31,149,H1
"Rock County, NE",2012-2013,1393,1417,24,1.723,-2,26,31,149,H1
"Rock County, NE",2013-2014,1417,1443,26,1.835,8,18,31,149,H1
"Rock County, NE",2014-2015,1413,1381,-32,-2.265,-2,-30,31,149,H1
"Rock County, NE",2015-2016,1381,1412,31,2.245,-1,32,31,149,H1
"Rock County, NE",2016-2017,1412,1436,24,1.7,2,22,31,149,H1
"Saline County, NE",2000-2001,13880,14004,124,0.893,5,119,31,151,H1
"Saline County, NE",2001-2002,14004,14110,106,0.757,19,87,31,151,H1
"Saline County, NE",2002-2003,14110,14232,122,0.865,-11,133,31,151,H1
"Saline County, NE",2003-2004,14232,14206,-26,-0.183,44,-70,31,151,H1
"Saline County, NE",2004-2005,14206,14136,-70,-0.493,52,-122,31,151,H1
"Saline County, NE",2005-2006,14136,13987,-149,-1.054,56,-205,31,151,H1
"Saline County, NE",2006-2007,13987,14069,82,0.586,85,-3,31,151,H1
"Saline County, NE",2007-2008,14069,14048,-21,-0.149,52,-73,31,151,H1
"Saline County, NE",2008-2009,14048,14166,118,0.84,50,68,31,151,H1
"Saline County, NE",2009-2010,14166,14231,65,0.459,62,3,31,151,H1
"Saline County, NE",2010-2011,14231,14355,124,0.871,73,51,31,151,H1
"Saline County, NE",2011-2012,14355,14447,92,0.641,37,55,31,151,H1
"Saline County, NE",2012-2013,14447,14298,-149,-1.031,42,-191,31,151,H1
"Saline County, NE",2013-2014,14298,14252,-46,-0.322,60,-106,31,151,H1
"Saline County, NE",2014-2015,14338,14282,-56,-0.391,59,-115,31,151,H1
"Saline County, NE",2015-2016,14282,14295,13,0.091,40,-27,31,151,H1
"Saline County, NE",2016-2017,14295,14441,146,1.021,58,88,31,151,H1
"Sarpy County, NE",2000-2001,123309,126442,3133,2.541,1543,1590,31,153,H1
"Sarpy County, NE",2001-2002,126442,129496,3054,2.415,1689,1365,31,153,H1
"Sarpy County, NE",2002-2003,129496,132017,2521,1.947,1701,820,31,153,H1
"Sarpy County, NE",2003-2004,132017,136339,4322,3.274,1762,2560,31,153,H1
"Sarpy County, NE",2004-2005,136339,140239,3900,2.861,1797,2103,31,153,H1
"Sarpy County, NE",2005-2006,140239,144070,3831,2.732,1793,2038,31,153,H1
"Sarpy County, NE",2006-2007,144070,148214,4144,2.876,1868,2276,31,153,H1
"Sarpy County, NE",2007-2008,148214,152762,4548,3.069,1934,2614,31,153,H1
"Sarpy County, NE",2008-2009,152762,156147,3385,2.216,2013,1372,31,153,H1
"Sarpy County, NE",2009-2010,156147,159748,3601,2.306,1897,1704,31,153,H1
"Sarpy County, NE",2010-2011,159748,162655,2907,1.82,1806,1101,31,153,H1
"Sarpy County, NE",2011-2012,162655,165822,3167,1.947,1814,1353,31,153,H1
"Sarpy County, NE",2012-2013,165822,169358,3536,2.132,1711,1825,31,153,H1
"Sarpy County, NE",2013-2014,169358,172193,2835,1.674,1676,1159,31,153,H1
"Sarpy County, NE",2014-2015,172291,175692,3401,1.974,1646,1755,31,153,H1
"Sarpy County, NE",2015-2016,175692,178328,2636,1.5,1586,1050,31,153,H1
"Sarpy County, NE",2016-2017,178328,181439,3111,1.745,1506,1605,31,153,H1
"Saunders County, NE",2000-2001,19852,19962,110,0.554,84,26,31,155,H1
"Saunders County, NE",2001-2002,19962,19925,-37,-0.185,46,-83,31,155,H1
"Saunders County, NE",2002-2003,19925,20104,179,0.898,80,99,31,155,H1
"Saunders County, NE",2003-2004,20104,20248,144,0.716,45,99,31,155,H1
"Saunders County, NE",2004-2005,20248,20460,212,1.047,73,139,31,155,H1
"Saunders County, NE",2005-2006,20460,20411,-49,-0.239,76,-125,31,155,H1
"Saunders County, NE",2006-2007,20411,20483,72,0.353,34,38,31,155,H1
"Saunders County, NE",2007-2008,20483,20446,-37,-0.181,70,-107,31,155,H1
"Saunders County, NE",2008-2009,20446,20515,69,0.337,76,-7,31,155,H1
"Saunders County, NE",2009-2010,20515,20858,343,1.672,87,256,31,155,H1
"Saunders County, NE",2010-2011,20858,20872,14,0.067,76,-62,31,155,H1
"Saunders County, NE",2011-2012,20872,20807,-65,-0.311,60,-125,31,155,H1
"Saunders County, NE",2012-2013,20807,20881,74,0.356,36,38,31,155,H1
"Saunders County, NE",2013-2014,20881,20919,38,0.182,60,-22,31,155,H1
"Saunders County, NE",2014-2015,20932,21016,84,0.401,47,37,31,155,H1
"Saunders County, NE",2015-2016,21016,20995,-21,-0.1,14,-35,31,155,H1
"Saunders County, NE",2016-2017,20995,21057,62,0.295,56,6,31,155,H1
"Scotts Bluff County, NE",2000-2001,37012,36561,-451,-1.219,120,-571,31,157,H1
"Scotts Bluff County, NE",2001-2002,36561,36572,11,0.03,82,-71,31,157,H1
"Scotts Bluff County, NE",2002-2003,36572,36468,-104,-0.284,66,-170,31,157,H1
"Scotts Bluff County, NE",2003-2004,36468,36278,-190,-0.521,99,-289,31,157,H1
"Scotts Bluff County, NE",2004-2005,36278,36277,-1,-0.003,116,-117,31,157,H1
"Scotts Bluff County, NE",2005-2006,36277,36223,-54,-0.149,119,-173,31,157,H1
"Scotts Bluff County, NE",2006-2007,36223,36338,115,0.317,110,5,31,157,H1
"Scotts Bluff County, NE",2007-2008,36338,36536,198,0.545,121,77,31,157,H1
"Scotts Bluff County, NE",2008-2009,36536,36677,141,0.386,139,2,31,157,H1
"Scotts Bluff County, NE",2009-2010,36677,37060,383,1.044,134,249,31,157,H1
"Scotts Bluff County, NE",2010-2011,37060,36924,-136,-0.367,90,-226,31,157,H1
"Scotts Bluff County, NE",2011-2012,36924,36902,-22,-0.06,49,-71,31,157,H1
"Scotts Bluff County, NE",2012-2013,36902,36870,-32,-0.087,127,-159,31,157,H1
"Scotts Bluff County, NE",2013-2014,36870,36465,-405,-1.098,84,-489,31,157,H1
"Scotts Bluff County, NE",2014-2015,36463,36261,-202,-0.554,108,-310,31,157,H1
"Scotts Bluff County, NE",2015-2016,36261,36553,292,0.805,98,194,31,157,H1
"Scotts Bluff County, NE",2016-2017,36553,36363,-190,-0.52,121,-311,31,157,H1
"Seward County, NE",2000-2001,16519,16607,88,0.533,46,42,31,159,H1
"Seward County, NE",2001-2002,16607,16574,-33,-0.199,30,-63,31,159,H1
"Seward County, NE",2002-2003,16574,16527,-47,-0.284,18,-65,31,159,H1
"Seward County, NE",2003-2004,16527,16681,154,0.932,40,114,31,159,H1
"Seward County, NE",2004-2005,16681,16601,-80,-0.48,2,-82,31,159,H1
"Seward County, NE",2005-2006,16601,16654,53,0.319,15,38,31,159,H1
"Seward County, NE",2006-2007,16654,16490,-164,-0.985,26,-190,31,159,H1
"Seward County, NE",2007-2008,16490,16653,163,0.988,37,126,31,159,H1
"Seward County, NE",2008-2009,16653,16536,-117,-0.703,47,-164,31,159,H1
"Seward County, NE",2009-2010,16536,16788,252,1.524,37,215,31,159,H1
"Seward County, NE",2010-2011,16788,16728,-60,-0.357,31,-91,31,159,H1
"Seward County, NE",2011-2012,16728,16965,237,1.417,53,184,31,159,H1
"Seward County, NE",2012-2013,16965,17064,99,0.584,32,67,31,159,H1
"Seward County, NE",2013-2014,17064,17150,86,0.504,44,42,31,159,H1
"Seward County, NE",2014-2015,17098,17110,12,0.07,43,-31,31,159,H1
"Seward County, NE",2015-2016,17110,17085,-25,-0.146,-1,-24,31,159,H1
"Seward County, NE",2016-2017,17085,17161,76,0.445,12,64,31,159,H1
"Sheridan County, NE",2000-2001,6165,5995,-170,-2.758,-12,-158,31,161,H1
"Sheridan County, NE",2001-2002,5995,5995,0,0,-13,13,31,161,H1
"Sheridan County, NE",2002-2003,5995,5842,-153,-2.552,-32,-121,31,161,H1
"Sheridan County, NE",2003-2004,5842,5851,9,0.154,10,-1,31,161,H1
"Sheridan County, NE",2004-2005,5851,5726,-125,-2.136,-10,-115,31,161,H1
"Sheridan County, NE",2005-2006,5726,5649,-77,-1.345,-11,-66,31,161,H1
"Sheridan County, NE",2006-2007,5649,5592,-57,-1.009,-16,-41,31,161,H1
"Sheridan County, NE",2007-2008,5592,5500,-92,-1.645,-12,-80,31,161,H1
"Sheridan County, NE",2008-2009,5500,5498,-2,-0.036,-11,9,31,161,H1
"Sheridan County, NE",2009-2010,5498,5457,-41,-0.746,-22,-19,31,161,H1
"Sheridan County, NE",2010-2011,5457,5389,-68,-1.246,-11,-57,31,161,H1
"Sheridan County, NE",2011-2012,5389,5355,-34,-0.631,-5,-29,31,161,H1
"Sheridan County, NE",2012-2013,5355,5252,-103,-1.923,-17,-86,31,161,H1
"Sheridan County, NE",2013-2014,5252,5259,7,0.133,-5,12,31,161,H1
"Sheridan County, NE",2014-2015,5268,5220,-48,-0.911,-5,-43,31,161,H1
"Sheridan County, NE",2015-2016,5220,5239,19,0.364,2,17,31,161,H1
"Sheridan County, NE",2016-2017,5239,5289,50,0.954,2,48,31,161,H1
"Sherman County, NE",2000-2001,3298,3289,-9,-0.273,-17,8,31,163,H1
"Sherman County, NE",2001-2002,3289,3228,-61,-1.855,-12,-49,31,163,H1
"Sherman County, NE",2002-2003,3228,3222,-6,-0.186,-12,6,31,163,H1
"Sherman County, NE",2003-2004,3222,3255,33,1.024,-1,34,31,163,H1
"Sherman County, NE",2004-2005,3255,3239,-16,-0.492,-10,-6,31,163,H1
"Sherman County, NE",2005-2006,3239,3148,-91,-2.81,-21,-70,31,163,H1
"Sherman County, NE",2006-2007,3148,3145,-3,-0.095,-7,4,31,163,H1
"Sherman County, NE",2007-2008,3145,3147,2,0.064,-7,9,31,163,H1
"Sherman County, NE",2008-2009,3147,3129,-18,-0.572,5,-23,31,163,H1
"Sherman County, NE",2009-2010,3129,3149,20,0.639,-3,23,31,163,H1
"Sherman County, NE",2010-2011,3149,3141,-8,-0.254,-15,7,31,163,H1
"Sherman County, NE",2011-2012,3141,3124,-17,-0.541,-6,-11,31,163,H1
"Sherman County, NE",2012-2013,3124,3110,-14,-0.448,-1,-13,31,163,H1
"Sherman County, NE",2013-2014,3110,3074,-36,-1.158,-7,-29,31,163,H1
"Sherman County, NE",2014-2015,3072,3091,19,0.618,-5,24,31,163,H1
"Sherman County, NE",2015-2016,3091,3025,-66,-2.135,-5,-61,31,163,H1
"Sherman County, NE",2016-2017,3025,3086,61,2.017,-4,65,31,163,H1
"Sioux County, NE",2000-2001,1471,1406,-65,-4.419,1,-66,31,165,H1
"Sioux County, NE",2001-2002,1406,1443,37,2.632,1,36,31,165,H1
"Sioux County, NE",2002-2003,1443,1489,46,3.188,4,42,31,165,H1
"Sioux County, NE",2003-2004,1489,1438,-51,-3.425,2,-53,31,165,H1
"Sioux County, NE",2004-2005,1438,1437,-1,-0.07,0,-1,31,165,H1
"Sioux County, NE",2005-2006,1437,1409,-28,-1.949,0,-28,31,165,H1
"Sioux County, NE",2006-2007,1409,1404,-5,-0.355,7,-12,31,165,H1
"Sioux County, NE",2007-2008,1404,1360,-44,-3.134,5,-49,31,165,H1
"Sioux County, NE",2008-2009,1360,1324,-36,-2.647,8,-44,31,165,H1
"Sioux County, NE",2009-2010,1324,1312,-12,-0.906,7,-19,31,165,H1
"Sioux County, NE",2010-2011,1312,1326,14,1.067,2,12,31,165,H1
"Sioux County, NE",2011-2012,1326,1321,-5,-0.377,4,-9,31,165,H1
"Sioux County, NE",2012-2013,1321,1319,-2,-0.151,4,-6,31,165,H1
"Sioux County, NE",2013-2014,1319,1303,-16,-1.213,2,-18,31,165,H1
"Sioux County, NE",2014-2015,1309,1260,-49,-3.743,4,-53,31,165,H1
"Sioux County, NE",2015-2016,1260,1262,2,0.159,3,-1,31,165,H1
"Sioux County, NE",2016-2017,1262,1203,-59,-4.675,1,-60,31,165,H1
"Stanton County, NE",2000-2001,6416,6374,-42,-0.655,16,-58,31,167,H1
"Stanton County, NE",2001-2002,6374,6453,79,1.239,47,32,31,167,H1
"Stanton County, NE",2002-2003,6453,6437,-16,-0.248,19,-35,31,167,H1
"Stanton County, NE",2003-2004,6437,6426,-11,-0.171,41,-52,31,167,H1
"Stanton County, NE",2004-2005,6426,6376,-50,-0.778,25,-75,31,167,H1
"Stanton County, NE",2005-2006,6376,6363,-13,-0.204,33,-46,31,167,H1
"Stanton County, NE",2006-2007,6363,6248,-115,-1.807,33,-148,31,167,H1
"Stanton County, NE",2007-2008,6248,6145,-103,-1.649,36,-139,31,167,H1
"Stanton County, NE",2008-2009,6145,6157,12,0.195,32,-20,31,167,H1
"Stanton County, NE",2009-2010,6157,6128,-29,-0.471,31,-60,31,167,H1
"Stanton County, NE",2010-2011,6128,6181,53,0.865,36,17,31,167,H1
"Stanton County, NE",2011-2012,6181,6093,-88,-1.424,28,-116,31,167,H1
"Stanton County, NE",2012-2013,6093,6084,-9,-0.148,20,-29,31,167,H1
"Stanton County, NE",2013-2014,6084,6069,-15,-0.247,30,-45,31,167,H1
"Stanton County, NE",2014-2015,6081,5937,-144,-2.368,47,-191,31,167,H1
"Stanton County, NE",2015-2016,5937,5987,50,0.842,32,18,31,167,H1
"Stanton County, NE",2016-2017,5987,5988,1,0.017,33,-32,31,167,H1
"Thayer County, NE",2000-2001,6030,5884,-146,-2.421,-24,-122,31,169,H1
"Thayer County, NE",2001-2002,5884,5723,-161,-2.736,-56,-105,31,169,H1
"Thayer County, NE",2002-2003,5723,5625,-98,-1.712,-47,-51,31,169,H1
"Thayer County, NE",2003-2004,5625,5495,-130,-2.311,-46,-84,31,169,H1
"Thayer County, NE",2004-2005,5495,5454,-41,-0.746,-24,-17,31,169,H1
"Thayer County, NE",2005-2006,5454,5312,-142,-2.604,-29,-113,31,169,H1
"Thayer County, NE",2006-2007,5312,5308,-4,-0.075,-1,-3,31,169,H1
"Thayer County, NE",2007-2008,5308,5253,-55,-1.036,-19,-36,31,169,H1
"Thayer County, NE",2008-2009,5253,5210,-43,-0.819,-31,-12,31,169,H1
"Thayer County, NE",2009-2010,5210,5218,8,0.154,-21,29,31,169,H1
"Thayer County, NE",2010-2011,5218,5171,-47,-0.901,-24,-23,31,169,H1
"Thayer County, NE",2011-2012,5171,5154,-17,-0.329,-22,5,31,169,H1
"Thayer County, NE",2012-2013,5154,5196,42,0.815,-20,62,31,169,H1
"Thayer County, NE",2013-2014,5196,5230,34,0.654,-21,55,31,169,H1
"Thayer County, NE",2014-2015,5228,5163,-65,-1.243,-12,-53,31,169,H1
"Thayer County, NE",2015-2016,5163,5099,-64,-1.24,-5,-59,31,169,H1
"Thayer County, NE",2016-2017,5099,5045,-54,-1.059,-29,-25,31,169,H1
"Thomas County, NE",2000-2001,733,717,-16,-2.183,-2,-14,31,171,H1
"Thomas County, NE",2001-2002,717,691,-26,-3.626,-8,-18,31,171,H1
"Thomas County, NE",2002-2003,691,689,-2,-0.289,2,-4,31,171,H1
"Thomas County, NE",2003-2004,689,664,-25,-3.628,3,-28,31,171,H1
"Thomas County, NE",2004-2005,664,661,-3,-0.452,-2,-1,31,171,H1
"Thomas County, NE",2005-2006,661,659,-2,-0.303,-2,0,31,171,H1
"Thomas County, NE",2006-2007,659,667,8,1.214,5,3,31,171,H1
"Thomas County, NE",2007-2008,667,661,-6,-0.9,1,-7,31,171,H1
"Thomas County, NE",2008-2009,661,655,-6,-0.908,5,-11,31,171,H1
"Thomas County, NE",2009-2010,655,650,-5,-0.763,-1,-4,31,171,H1
"Thomas County, NE",2010-2011,650,689,39,6,4,35,31,171,H1
"Thomas County, NE",2011-2012,689,691,2,0.29,-3,5,31,171,H1
"Thomas County, NE",2012-2013,691,696,5,0.724,7,-2,31,171,H1
"Thomas County, NE",2013-2014,696,687,-9,-1.293,6,-15,31,171,H1
"Thomas County, NE",2014-2015,687,684,-3,-0.437,4,-7,31,171,H1
"Thomas County, NE",2015-2016,684,722,38,5.556,4,34,31,171,H1
"Thomas County, NE",2016-2017,722,725,3,0.416,3,0,31,171,H1
"Thurston County, NE",2000-2001,7139,7085,-54,-0.756,92,-146,31,173,H1
"Thurston County, NE",2001-2002,7085,6989,-96,-1.355,67,-163,31,173,H1
"Thurston County, NE",2002-2003,6989,6987,-2,-0.029,77,-79,31,173,H1
"Thurston County, NE",2003-2004,6987,6943,-44,-0.63,96,-140,31,173,H1
"Thurston County, NE",2004-2005,6943,7009,66,0.951,85,-19,31,173,H1
"Thurston County, NE",2005-2006,7009,6947,-62,-0.885,77,-139,31,173,H1
"Thurston County, NE",2006-2007,6947,6925,-22,-0.317,103,-125,31,173,H1
"Thurston County, NE",2007-2008,6925,6821,-104,-1.502,100,-204,31,173,H1
"Thurston County, NE",2008-2009,6821,6866,45,0.66,99,-54,31,173,H1
"Thurston County, NE",2009-2010,6866,6973,107,1.558,101,6,31,173,H1
"Thurston County, NE",2010-2011,6973,6909,-64,-0.918,58,-122,31,173,H1
"Thurston County, NE",2011-2012,6909,6923,14,0.203,81,-67,31,173,H1
"Thurston County, NE",2012-2013,6923,6897,-26,-0.376,67,-93,31,173,H1
"Thurston County, NE",2013-2014,6897,6969,72,1.044,56,16,31,173,H1
"Thurston County, NE",2014-2015,6961,7064,103,1.48,67,36,31,173,H1
"Thurston County, NE",2015-2016,7064,7140,76,1.076,78,-2,31,173,H1
"Thurston County, NE",2016-2017,7140,7223,83,1.162,79,4,31,173,H1
"Valley County, NE",2000-2001,4649,4623,-26,-0.559,-11,-15,31,175,H1
"Valley County, NE",2001-2002,4623,4541,-82,-1.774,-27,-55,31,175,H1
"Valley County, NE",2002-2003,4541,4581,40,0.881,-7,47,31,175,H1
"Valley County, NE",2003-2004,4581,4482,-99,-2.161,-24,-75,31,175,H1
"Valley County, NE",2004-2005,4482,4395,-87,-1.941,-11,-76,31,175,H1
"Valley County, NE",2005-2006,4395,4367,-28,-0.637,-3,-25,31,175,H1
"Valley County, NE",2006-2007,4367,4327,-40,-0.916,-12,-28,31,175,H1
"Valley County, NE",2007-2008,4327,4228,-99,-2.288,4,-103,31,175,H1
"Valley County, NE",2008-2009,4228,4228,0,0,-22,22,31,175,H1
"Valley County, NE",2009-2010,4228,4258,30,0.71,-8,38,31,175,H1
"Valley County, NE",2010-2011,4258,4243,-15,-0.352,-1,-14,31,175,H1
"Valley County, NE",2011-2012,4243,4229,-14,-0.33,-10,-4,31,175,H1
"Valley County, NE",2012-2013,4229,4197,-32,-0.757,-5,-27,31,175,H1
"Valley County, NE",2013-2014,4197,4204,7,0.167,-6,13,31,175,H1
"Valley County, NE",2014-2015,4211,4154,-57,-1.354,2,-59,31,175,H1
"Valley County, NE",2015-2016,4154,4181,27,0.65,3,24,31,175,H1
"Valley County, NE",2016-2017,4181,4209,28,0.67,-4,32,31,175,H1
"Washington County, NE",2000-2001,18803,19134,331,1.76,70,261,31,177,H1
"Washington County, NE",2001-2002,19134,19264,130,0.679,82,48,31,177,H1
"Washington County, NE",2002-2003,19264,19510,246,1.277,32,214,31,177,H1
"Washington County, NE",2003-2004,19510,19589,79,0.405,59,20,31,177,H1
"Washington County, NE",2004-2005,19589,19861,272,1.389,63,209,31,177,H1
"Washington County, NE",2005-2006,19861,20056,195,0.982,90,105,31,177,H1
"Washington County, NE",2006-2007,20056,20203,147,0.733,66,81,31,177,H1
"Washington County, NE",2007-2008,20203,20101,-102,-0.505,45,-147,31,177,H1
"Washington County, NE",2008-2009,20101,20124,23,0.114,64,-41,31,177,H1
"Washington County, NE",2009-2010,20124,20276,152,0.755,22,130,31,177,H1
"Washington County, NE",2010-2011,20276,20263,-13,-0.064,34,-47,31,177,H1
"Washington County, NE",2011-2012,20263,20291,28,0.138,56,-28,31,177,H1
"Washington County, NE",2012-2013,20291,20231,-60,-0.296,39,-99,31,177,H1
"Washington County, NE",2013-2014,20231,20258,27,0.133,42,-15,31,177,H1
"Washington County, NE",2014-2015,20265,20248,-17,-0.084,65,-82,31,177,H1
"Washington County, NE",2015-2016,20248,20568,320,1.58,32,288,31,177,H1
"Washington County, NE",2016-2017,20568,20721,153,0.744,53,100,31,177,H1
"Wayne County, NE",2000-2001,9854,9788,-66,-0.67,31,-97,31,179,H1
"Wayne County, NE",2001-2002,9788,9664,-124,-1.267,31,-155,31,179,H1
"Wayne County, NE",2002-2003,9664,9689,25,0.259,25,0,31,179,H1
"Wayne County, NE",2003-2004,9689,9612,-77,-0.795,49,-126,31,179,H1
"Wayne County, NE",2004-2005,9612,9654,42,0.437,37,5,31,179,H1
"Wayne County, NE",2005-2006,9654,9720,66,0.684,32,34,31,179,H1
"Wayne County, NE",2006-2007,9720,9506,-214,-2.202,51,-265,31,179,H1
"Wayne County, NE",2007-2008,9506,9481,-25,-0.263,53,-78,31,179,H1
"Wayne County, NE",2008-2009,9481,9552,71,0.749,38,33,31,179,H1
"Wayne County, NE",2009-2010,9552,9600,48,0.503,35,13,31,179,H1
"Wayne County, NE",2010-2011,9600,9456,-144,-1.5,42,-186,31,179,H1
"Wayne County, NE",2011-2012,9456,9514,58,0.613,18,40,31,179,H1
"Wayne County, NE",2012-2013,9514,9437,-77,-0.809,52,-129,31,179,H1
"Wayne County, NE",2013-2014,9437,9431,-6,-0.064,51,-57,31,179,H1
"Wayne County, NE",2014-2015,9391,9367,-24,-0.256,63,-87,31,179,H1
"Wayne County, NE",2015-2016,9367,9453,86,0.918,60,26,31,179,H1
"Wayne County, NE",2016-2017,9453,9318,-135,-1.428,59,-194,31,179,H1
"Webster County, NE",2000-2001,4045,4017,-28,-0.692,-16,-12,31,181,H1
"Webster County, NE",2001-2002,4017,3970,-47,-1.17,-33,-14,31,181,H1
"Webster County, NE",2002-2003,3970,3952,-18,-0.453,-20,2,31,181,H1
"Webster County, NE",2003-2004,3952,3949,-3,-0.076,-27,24,31,181,H1
"Webster County, NE",2004-2005,3949,3902,-47,-1.19,-42,-5,31,181,H1
"Webster County, NE",2005-2006,3902,3846,-56,-1.435,-40,-16,31,181,H1
"Webster County, NE",2006-2007,3846,3859,13,0.338,-19,32,31,181,H1
"Webster County, NE",2007-2008,3859,3771,-88,-2.28,-25,-63,31,181,H1
"Webster County, NE",2008-2009,3771,3788,17,0.451,-34,51,31,181,H1
"Webster County, NE",2009-2010,3788,3814,26,0.686,-24,50,31,181,H1
"Webster County, NE",2010-2011,3814,3766,-48,-1.259,-18,-30,31,181,H1
"Webster County, NE",2011-2012,3766,3753,-13,-0.345,-17,4,31,181,H1
"Webster County, NE",2012-2013,3753,3675,-78,-2.078,-15,-63,31,181,H1
"Webster County, NE",2013-2014,3675,3658,-17,-0.463,-25,8,31,181,H1
"Webster County, NE",2014-2015,3668,3625,-43,-1.172,-26,-17,31,181,H1
"Webster County, NE",2015-2016,3625,3582,-43,-1.186,-8,-35,31,181,H1
"Webster County, NE",2016-2017,3582,3524,-58,-1.619,-26,-32,31,181,H1
"Wheeler County, NE",2000-2001,885,858,-27,-3.051,0,-27,31,183,H1
"Wheeler County, NE",2001-2002,858,837,-21,-2.448,-1,-20,31,183,H1
"Wheeler County, NE",2002-2003,837,815,-22,-2.628,1,-23,31,183,H1
"Wheeler County, NE",2003-2004,815,811,-4,-0.491,-1,-3,31,183,H1
"Wheeler County, NE",2004-2005,811,832,21,2.589,-3,24,31,183,H1
"Wheeler County, NE",2005-2006,832,826,-6,-0.721,1,-7,31,183,H1
"Wheeler County, NE",2006-2007,826,837,11,1.332,-3,14,31,183,H1
"Wheeler County, NE",2007-2008,837,831,-6,-0.717,4,-10,31,183,H1
"Wheeler County, NE",2008-2009,831,809,-22,-2.647,3,-25,31,183,H1
"Wheeler County, NE",2009-2010,809,821,12,1.483,7,5,31,183,H1
"Wheeler County, NE",2010-2011,821,812,-9,-1.096,-1,-8,31,183,H1
"Wheeler County, NE",2011-2012,812,792,-20,-2.463,3,-23,31,183,H1
"Wheeler County, NE",2012-2013,792,758,-34,-4.293,2,-36,31,183,H1
"Wheeler County, NE",2013-2014,758,766,8,1.055,4,4,31,183,H1
"Wheeler County, NE",2014-2015,765,750,-15,-1.961,3,-18,31,183,H1
"Wheeler County, NE",2015-2016,750,803,53,7.067,6,47,31,183,H1
"Wheeler County, NE",2016-2017,803,818,15,1.868,6,9,31,183,H1
"York County, NE",2000-2001,14553,14438,-115,-0.79,10,-125,31,185,H1
"York County, NE",2001-2002,14438,14230,-208,-1.441,14,-222,31,185,H1
"York County, NE",2002-2003,14230,14175,-55,-0.387,47,-102,31,185,H1
"York County, NE",2003-2004,14175,13952,-223,-1.573,45,-268,31,185,H1
"York County, NE",2004-2005,13952,14021,69,0.495,19,50,31,185,H1
"York County, NE",2005-2006,14021,14130,109,0.777,77,32,31,185,H1
"York County, NE",2006-2007,14130,14078,-52,-0.368,38,-90,31,185,H1
"York County, NE",2007-2008,14078,13881,-197,-1.399,30,-227,31,185,H1
"York County, NE",2008-2009,13881,13689,-192,-1.383,44,-236,31,185,H1
"York County, NE",2009-2010,13689,13645,-44,-0.321,50,-94,31,185,H1
"York County, NE",2010-2011,13645,13744,99,0.726,18,81,31,185,H1
"York County, NE",2011-2012,13744,13815,71,0.517,24,47,31,185,H1
"York County, NE",2012-2013,13815,13863,48,0.347,46,2,31,185,H1
"York County, NE",2013-2014,13863,13917,54,0.39,36,18,31,185,H1
"York County, NE",2014-2015,13909,13806,-103,-0.741,43,-146,31,185,H1
"York County, NE",2015-2016,13806,13761,-45,-0.326,3,-48,31,185,H1
"York County, NE",2016-2017,13761,13806,45,0.327,17,28,31,185,H1
Nevada,2000-2001,2018741,2098399,79658,3.946,15438,64220,32,0,STATE
Nevada,2001-2002,2098399,2173791,75392,3.593,15182,60210,32,0,STATE
Nevada,2002-2003,2173791,2248850,75059,3.453,15978,59081,32,0,STATE
Nevada,2003-2004,2248850,2346222,97372,4.33,16573,80799,32,0,STATE
Nevada,2004-2005,2346222,2432143,85921,3.662,17567,68354,32,0,STATE
Nevada,2005-2006,2432143,2522658,90515,3.722,19706,70809,32,0,STATE
Nevada,2006-2007,2522658,2601072,78414,3.108,22066,56348,32,0,STATE
Nevada,2007-2008,2601072,2653630,52558,2.021,21469,31089,32,0,STATE
Nevada,2008-2009,2653630,2684665,31035,1.17,20404,10631,32,0,STATE
Nevada,2009-2010,2684665,2703440,18775,0.699,19698,-923,32,0,STATE
Nevada,2010-2011,2703440,2718819,15379,0.569,15654,-275,32,0,STATE
Nevada,2011-2012,2718819,2754874,36055,1.326,14307,21748,32,0,STATE
Nevada,2012-2013,2754874,2790366,35492,1.288,13838,21654,32,0,STATE
Nevada,2013-2014,2790366,2838281,47915,1.717,13297,34618,32,0,STATE
Nevada,2014-2015,2838281,2890845,52564,1.852,13691,38873,32,0,STATE
Nevada,2015-2016,2890845,2939254,48409,1.675,12588,35821,32,0,STATE
Nevada,2016-2017,2939254,2998039,58785,2,12420,46365,32,0,STATE
"Churchill County, NV",2000-2001,24024,24342,318,1.324,336,-18,32,1,H1
"Churchill County, NV",2001-2002,24342,24155,-187,-0.768,344,-531,32,1,H1
"Churchill County, NV",2002-2003,24155,24026,-129,-0.534,100,-229,32,1,H1
"Churchill County, NV",2003-2004,24026,24226,200,0.832,114,86,32,1,H1
"Churchill County, NV",2004-2005,24226,24593,367,1.515,143,224,32,1,H1
"Churchill County, NV",2005-2006,24593,24842,249,1.012,90,159,32,1,H1
"Churchill County, NV",2006-2007,24842,24961,119,0.479,112,7,32,1,H1
"Churchill County, NV",2007-2008,24961,25049,88,0.353,129,-41,32,1,H1
"Churchill County, NV",2008-2009,25049,25067,18,0.072,140,-122,32,1,H1
"Churchill County, NV",2009-2010,25067,24798,-269,-1.073,151,-420,32,1,H1
"Churchill County, NV",2010-2011,24798,24587,-211,-0.851,29,-240,32,1,H1
"Churchill County, NV",2011-2012,24587,24317,-270,-1.098,59,-329,32,1,H1
"Churchill County, NV",2012-2013,24317,24045,-272,-1.119,70,-342,32,1,H1
"Churchill County, NV",2013-2014,24045,23989,-56,-0.233,77,-133,32,1,H1
"Churchill County, NV",2014-2015,24046,24200,154,0.64,73,81,32,1,H1
"Churchill County, NV",2015-2016,24200,24016,-184,-0.76,30,-214,32,1,H1
"Churchill County, NV",2016-2017,24016,24230,214,0.891,38,176,32,1,H1
"Clark County, NV",2000-2001,1393909,1460500,66591,4.777,11845,54746,32,3,H1
"Clark County, NV",2001-2002,1460500,1522962,62462,4.277,11879,50583,32,3,H1
"Clark County, NV",2002-2003,1522962,1584166,61204,4.019,12784,48420,32,3,H1
"Clark County, NV",2003-2004,1584166,1662773,78607,4.962,13400,65207,32,3,H1
"Clark County, NV",2004-2005,1662773,1729522,66749,4.014,14460,52289,32,3,H1
"Clark County, NV",2005-2006,1729522,1803774,74252,4.293,15924,58328,32,3,H1
"Clark County, NV",2006-2007,1803774,1867817,64043,3.551,17804,46239,32,3,H1
"Clark County, NV",2007-2008,1867817,1912349,44532,2.384,17339,27193,32,3,H1
"Clark County, NV",2008-2009,1912349,1939407,27058,1.415,16566,10492,32,3,H1
"Clark County, NV",2009-2010,1939407,1953263,13856,0.714,16213,-2357,32,3,H1
"Clark County, NV",2010-2011,1953263,1967159,13896,0.711,13261,635,32,3,H1
"Clark County, NV",2011-2012,1967159,1998646,31487,1.601,12306,19181,32,3,H1
"Clark County, NV",2012-2013,1998646,2029316,30670,1.535,11583,19087,32,3,H1
"Clark County, NV",2013-2014,2029316,2069681,40365,1.989,11215,29150,32,3,H1
"Clark County, NV",2014-2015,2069146,2114801,45655,2.206,11394,34261,32,3,H1
"Clark County, NV",2015-2016,2114801,2156724,41923,1.982,10869,31054,32,3,H1
"Clark County, NV",2016-2017,2156724,2204079,47355,2.196,10582,36773,32,3,H1
"Douglas County, NV",2000-2001,41443,42327,884,2.133,4,880,32,5,H1
"Douglas County, NV",2001-2002,42327,43436,1109,2.62,76,1033,32,5,H1
"Douglas County, NV",2002-2003,43436,44524,1088,2.505,125,963,32,5,H1
"Douglas County, NV",2003-2004,44524,46388,1864,4.187,56,1808,32,5,H1
"Douglas County, NV",2004-2005,46388,46731,343,0.739,-42,385,32,5,H1
"Douglas County, NV",2005-2006,46731,46855,124,0.265,-8,132,32,5,H1
"Douglas County, NV",2006-2007,46855,47166,311,0.664,30,281,32,5,H1
"Douglas County, NV",2007-2008,47166,47270,104,0.22,32,72,32,5,H1
"Douglas County, NV",2008-2009,47270,46965,-305,-0.645,17,-322,32,5,H1
"Douglas County, NV",2009-2010,46965,47038,73,0.155,5,68,32,5,H1
"Douglas County, NV",2010-2011,47038,47028,-10,-0.021,-27,17,32,5,H1
"Douglas County, NV",2011-2012,47028,46991,-37,-0.079,-92,55,32,5,H1
"Douglas County, NV",2012-2013,46991,47081,90,0.192,-98,188,32,5,H1
"Douglas County, NV",2013-2014,47081,47536,455,0.966,-104,559,32,5,H1
"Douglas County, NV",2014-2015,47519,47710,191,0.402,-103,294,32,5,H1
"Douglas County, NV",2015-2016,47710,47947,237,0.497,-138,375,32,5,H1
"Douglas County, NV",2016-2017,47947,48309,362,0.755,-159,521,32,5,H1
"Elko County, NV",2000-2001,45233,45063,-170,-0.376,404,-574,32,7,H1
"Elko County, NV",2001-2002,45063,44173,-890,-1.975,350,-1240,32,7,H1
"Elko County, NV",2002-2003,44173,43693,-480,-1.087,340,-820,32,7,H1
"Elko County, NV",2003-2004,43693,43830,137,0.314,361,-224,32,7,H1
"Elko County, NV",2004-2005,43830,44760,930,2.122,375,555,32,7,H1
"Elko County, NV",2005-2006,44760,46108,1348,3.012,366,982,32,7,H1
"Elko County, NV",2006-2007,46108,47423,1315,2.852,494,821,32,7,H1
"Elko County, NV",2007-2008,47423,47634,211,0.445,515,-304,32,7,H1
"Elko County, NV",2008-2009,47634,48445,811,1.703,494,317,32,7,H1
"Elko County, NV",2009-2010,48445,49074,629,1.298,451,178,32,7,H1
"Elko County, NV",2010-2011,49074,49505,431,0.878,407,24,32,7,H1
"Elko County, NV",2011-2012,49505,51078,1573,3.177,384,1189,32,7,H1
"Elko County, NV",2012-2013,51078,52531,1453,2.845,424,1029,32,7,H1
"Elko County, NV",2013-2014,52531,52766,235,0.447,471,-236,32,7,H1
"Elko County, NV",2014-2015,52731,51935,-796,-1.51,517,-1313,32,7,H1
"Elko County, NV",2015-2016,51935,52283,348,0.67,486,-138,32,7,H1
"Elko County, NV",2016-2017,52283,52649,366,0.7,460,-94,32,7,H1
"Esmeralda County, NV",2000-2001,978,966,-12,-1.227,0,-12,32,9,H1
"Esmeralda County, NV",2001-2002,966,926,-40,-4.141,0,-40,32,9,H1
"Esmeralda County, NV",2002-2003,926,885,-41,-4.428,-14,-27,32,9,H1
"Esmeralda County, NV",2003-2004,885,879,-6,-0.678,-3,-3,32,9,H1
"Esmeralda County, NV",2004-2005,879,886,7,0.796,-6,13,32,9,H1
"Esmeralda County, NV",2005-2006,886,883,-3,-0.339,-14,11,32,9,H1
"Esmeralda County, NV",2006-2007,883,829,-54,-6.116,-3,-51,32,9,H1
"Esmeralda County, NV",2007-2008,829,820,-9,-1.086,-4,-5,32,9,H1
"Esmeralda County, NV",2008-2009,820,806,-14,-1.707,-2,-12,32,9,H1
"Esmeralda County, NV",2009-2010,806,777,-29,-3.598,-5,-24,32,9,H1
"Esmeralda County, NV",2010-2011,777,750,-27,-3.475,-12,-15,32,9,H1
"Esmeralda County, NV",2011-2012,750,763,13,1.733,-11,24,32,9,H1
"Esmeralda County, NV",2012-2013,763,832,69,9.043,-4,73,32,9,H1
"Esmeralda County, NV",2013-2014,832,822,-10,-1.202,5,-15,32,9,H1
"Esmeralda County, NV",2014-2015,825,829,4,0.485,13,-9,32,9,H1
"Esmeralda County, NV",2015-2016,829,828,-1,-0.121,4,-5,32,9,H1
"Esmeralda County, NV",2016-2017,828,850,22,2.657,2,20,32,9,H1
"Eureka County, NV",2000-2001,1632,1641,9,0.551,4,5,32,11,H1
"Eureka County, NV",2001-2002,1641,1629,-12,-0.731,10,-22,32,11,H1
"Eureka County, NV",2002-2003,1629,1505,-124,-7.612,-1,-123,32,11,H1
"Eureka County, NV",2003-2004,1505,1470,-35,-2.326,7,-42,32,11,H1
"Eureka County, NV",2004-2005,1470,1467,-3,-0.204,-9,6,32,11,H1
"Eureka County, NV",2005-2006,1467,1579,112,7.635,8,104,32,11,H1
"Eureka County, NV",2006-2007,1579,1683,104,6.586,15,89,32,11,H1
"Eureka County, NV",2007-2008,1683,1778,95,5.645,18,77,32,11,H1
"Eureka County, NV",2008-2009,1778,1926,148,8.324,21,127,32,11,H1
"Eureka County, NV",2009-2010,1926,1995,69,3.583,17,52,32,11,H1
"Eureka County, NV",2010-2011,1995,1984,-11,-0.551,10,-21,32,11,H1
"Eureka County, NV",2011-2012,1984,1996,12,0.605,5,7,32,11,H1
"Eureka County, NV",2012-2013,1996,2071,75,3.758,11,64,32,11,H1
"Eureka County, NV",2013-2014,2071,2018,-53,-2.559,18,-71,32,11,H1
"Eureka County, NV",2014-2015,1989,2016,27,1.357,6,21,32,11,H1
"Eureka County, NV",2015-2016,2016,1940,-76,-3.77,2,-78,32,11,H1
"Eureka County, NV",2016-2017,1940,1961,21,1.082,7,14,32,11,H1
"Humboldt County, NV",2000-2001,15868,15211,-657,-4.14,126,-783,32,13,H1
"Humboldt County, NV",2001-2002,15211,14776,-435,-2.86,123,-558,32,13,H1
"Humboldt County, NV",2002-2003,14776,14630,-146,-0.988,94,-240,32,13,H1
"Humboldt County, NV",2003-2004,14630,14912,282,1.928,106,176,32,13,H1
"Humboldt County, NV",2004-2005,14912,15046,134,0.899,115,19,32,13,H1
"Humboldt County, NV",2005-2006,15046,15420,374,2.486,118,256,32,13,H1
"Humboldt County, NV",2006-2007,15420,15658,238,1.543,140,98,32,13,H1
"Humboldt County, NV",2007-2008,15658,15958,300,1.916,161,139,32,13,H1
"Humboldt County, NV",2008-2009,15958,16290,332,2.08,166,166,32,13,H1
"Humboldt County, NV",2009-2010,16290,16603,313,1.921,158,155,32,13,H1
"Humboldt County, NV",2010-2011,16603,16661,58,0.349,141,-83,32,13,H1
"Humboldt County, NV",2011-2012,16661,17101,440,2.641,137,303,32,13,H1
"Humboldt County, NV",2012-2013,17101,17369,268,1.567,160,108,32,13,H1
"Humboldt County, NV",2013-2014,17369,17279,-90,-0.518,172,-262,32,13,H1
"Humboldt County, NV",2014-2015,17228,17019,-209,-1.213,154,-363,32,13,H1
"Humboldt County, NV",2015-2016,17019,16873,-146,-0.858,129,-275,32,13,H1
"Humboldt County, NV",2016-2017,16873,16826,-47,-0.279,128,-175,32,13,H1
"Lander County, NV",2000-2001,5702,5450,-252,-4.42,41,-293,32,15,H1
"Lander County, NV",2001-2002,5450,5180,-270,-4.954,56,-326,32,15,H1
"Lander County, NV",2002-2003,5180,5017,-163,-3.147,13,-176,32,15,H1
"Lander County, NV",2003-2004,5017,5086,69,1.375,11,58,32,15,H1
"Lander County, NV",2004-2005,5086,5117,31,0.61,8,23,32,15,H1
"Lander County, NV",2005-2006,5117,5307,190,3.713,34,156,32,15,H1
"Lander County, NV",2006-2007,5307,5439,132,2.487,19,113,32,15,H1
"Lander County, NV",2007-2008,5439,5521,82,1.508,72,10,32,15,H1
"Lander County, NV",2008-2009,5521,5660,139,2.518,41,98,32,15,H1
"Lander County, NV",2009-2010,5660,5789,129,2.279,48,81,32,15,H1
"Lander County, NV",2010-2011,5789,5848,59,1.019,49,10,32,15,H1
"Lander County, NV",2011-2012,5848,5929,81,1.385,51,30,32,15,H1
"Lander County, NV",2012-2013,5929,6074,145,2.446,67,78,32,15,H1
"Lander County, NV",2013-2014,6074,6009,-65,-1.07,73,-138,32,15,H1
"Lander County, NV",2014-2015,5987,5903,-84,-1.403,55,-139,32,15,H1
"Lander County, NV",2015-2016,5903,5765,-138,-2.338,74,-212,32,15,H1
"Lander County, NV",2016-2017,5765,5693,-72,-1.249,64,-136,32,15,H1
"Lincoln County, NV",2000-2001,4179,4194,15,0.359,1,14,32,17,H1
"Lincoln County, NV",2001-2002,4194,4294,100,2.384,-13,113,32,17,H1
"Lincoln County, NV",2002-2003,4294,4366,72,1.677,-3,75,32,17,H1
"Lincoln County, NV",2003-2004,4366,4401,35,0.802,-3,38,32,17,H1
"Lincoln County, NV",2004-2005,4401,4612,211,4.794,-16,227,32,17,H1
"Lincoln County, NV",2005-2006,4612,4729,117,2.537,-32,149,32,17,H1
"Lincoln County, NV",2006-2007,4729,4859,130,2.749,-9,139,32,17,H1
"Lincoln County, NV",2007-2008,4859,5106,247,5.083,10,237,32,17,H1
"Lincoln County, NV",2008-2009,5106,5246,140,2.742,6,134,32,17,H1
"Lincoln County, NV",2009-2010,5246,5362,116,2.211,-18,134,32,17,H1
"Lincoln County, NV",2010-2011,5362,5269,-93,-1.734,-5,-88,32,17,H1
"Lincoln County, NV",2011-2012,5269,5348,79,1.499,-23,102,32,17,H1
"Lincoln County, NV",2012-2013,5348,5248,-100,-1.87,-3,-97,32,17,H1
"Lincoln County, NV",2013-2014,5248,5184,-64,-1.22,11,-75,32,17,H1
"Lincoln County, NV",2014-2015,5120,5036,-84,-1.641,-13,-71,32,17,H1
"Lincoln County, NV",2015-2016,5036,5178,142,2.82,12,130,32,17,H1
"Lincoln County, NV",2016-2017,5178,5223,45,0.869,2,43,32,17,H1
"Lyon County, NV",2000-2001,34809,36012,1203,3.456,120,1083,32,19,H1
"Lyon County, NV",2001-2002,36012,37573,1561,4.335,47,1514,32,19,H1
"Lyon County, NV",2002-2003,37573,39646,2073,5.517,68,2005,32,19,H1
"Lyon County, NV",2003-2004,39646,42534,2888,7.284,108,2780,32,19,H1
"Lyon County, NV",2004-2005,42534,46228,3694,8.685,115,3579,32,19,H1
"Lyon County, NV",2005-2006,46228,49827,3599,7.785,215,3384,32,19,H1
"Lyon County, NV",2006-2007,49827,51725,1898,3.809,300,1598,32,19,H1
"Lyon County, NV",2007-2008,51725,52156,431,0.833,254,177,32,19,H1
"Lyon County, NV",2008-2009,52156,51819,-337,-0.646,244,-581,32,19,H1
"Lyon County, NV",2009-2010,51819,52065,246,0.475,114,132,32,19,H1
"Lyon County, NV",2010-2011,52065,51484,-581,-1.116,77,-658,32,19,H1
"Lyon County, NV",2011-2012,51484,51158,-326,-0.633,40,-366,32,19,H1
"Lyon County, NV",2012-2013,51158,51400,242,0.473,20,222,32,19,H1
"Lyon County, NV",2013-2014,51400,51789,389,0.757,-12,401,32,19,H1
"Lyon County, NV",2014-2015,51766,52585,819,1.582,34,785,32,19,H1
"Lyon County, NV",2015-2016,52585,52854,269,0.512,9,260,32,19,H1
"Lyon County, NV",2016-2017,52854,54122,1268,2.399,21,1247,32,19,H1
"Mineral County, NV",2000-2001,4999,4852,-147,-2.941,-29,-118,32,21,H1
"Mineral County, NV",2001-2002,4852,4716,-136,-2.803,-39,-97,32,21,H1
"Mineral County, NV",2002-2003,4716,4750,34,0.721,-39,73,32,21,H1
"Mineral County, NV",2003-2004,4750,4892,142,2.989,-34,176,32,21,H1
"Mineral County, NV",2004-2005,4892,4880,-12,-0.245,-40,28,32,21,H1
"Mineral County, NV",2005-2006,4880,4864,-16,-0.328,-38,22,32,21,H1
"Mineral County, NV",2006-2007,4864,4880,16,0.329,-40,56,32,21,H1
"Mineral County, NV",2007-2008,4880,4781,-99,-2.029,-28,-71,32,21,H1
"Mineral County, NV",2008-2009,4781,4769,-12,-0.251,-24,12,32,21,H1
"Mineral County, NV",2009-2010,4769,4785,16,0.336,-22,38,32,21,H1
"Mineral County, NV",2010-2011,4785,4630,-155,-3.239,-28,-127,32,21,H1
"Mineral County, NV",2011-2012,4630,4662,32,0.691,-21,53,32,21,H1
"Mineral County, NV",2012-2013,4662,4559,-103,-2.209,-26,-77,32,21,H1
"Mineral County, NV",2013-2014,4559,4500,-59,-1.294,-38,-21,32,21,H1
"Mineral County, NV",2014-2015,4506,4478,-28,-0.621,-51,23,32,21,H1
"Mineral County, NV",2015-2016,4478,4396,-82,-1.831,-47,-35,32,21,H1
"Mineral County, NV",2016-2017,4396,4457,61,1.388,-53,114,32,21,H1
"Nye County, NV",2000-2001,32914,33684,770,2.339,-91,861,32,23,H1
"Nye County, NV",2001-2002,33684,34433,749,2.224,-151,900,32,23,H1
"Nye County, NV",2002-2003,34433,35525,1092,3.171,-117,1209,32,23,H1
"Nye County, NV",2003-2004,35525,37287,1762,4.96,-198,1960,32,23,H1
"Nye County, NV",2004-2005,37287,40027,2740,7.348,-164,2904,32,23,H1
"Nye County, NV",2005-2006,40027,42530,2503,6.253,-118,2621,32,23,H1
"Nye County, NV",2006-2007,42530,44279,1749,4.112,-112,1861,32,23,H1
"Nye County, NV",2007-2008,44279,44367,88,0.199,-134,222,32,23,H1
"Nye County, NV",2008-2009,44367,44446,79,0.178,-174,253,32,23,H1
"Nye County, NV",2009-2010,44446,43864,-582,-1.309,-253,-329,32,23,H1
"Nye County, NV",2010-2011,43864,43322,-542,-1.236,-215,-327,32,23,H1
"Nye County, NV",2011-2012,43322,42923,-399,-0.921,-293,-106,32,23,H1
"Nye County, NV",2012-2013,42923,42298,-625,-1.456,-256,-369,32,23,H1
"Nye County, NV",2013-2014,42298,42282,-16,-0.038,-266,250,32,23,H1
"Nye County, NV",2014-2015,42203,42477,274,0.649,-264,538,32,23,H1
"Nye County, NV",2015-2016,42477,43399,922,2.171,-347,1269,32,23,H1
"Nye County, NV",2016-2017,43399,44202,803,1.85,-319,1122,32,23,H1
"Pershing County, NV",2000-2001,6672,6597,-75,-1.124,31,-106,32,27,H1
"Pershing County, NV",2001-2002,6597,6636,39,0.591,27,12,32,27,H1
"Pershing County, NV",2002-2003,6636,6519,-117,-1.763,19,-136,32,27,H1
"Pershing County, NV",2003-2004,6519,6533,14,0.215,-17,31,32,27,H1
"Pershing County, NV",2004-2005,6533,6580,47,0.719,11,36,32,27,H1
"Pershing County, NV",2005-2006,6580,6653,73,1.109,21,52,32,27,H1
"Pershing County, NV",2006-2007,6653,6715,62,0.932,16,46,32,27,H1
"Pershing County, NV",2007-2008,6715,6665,-50,-0.745,21,-71,32,27,H1
"Pershing County, NV",2008-2009,6665,6731,66,0.99,16,50,32,27,H1
"Pershing County, NV",2009-2010,6731,6742,11,0.163,16,-5,32,27,H1
"Pershing County, NV",2010-2011,6742,6640,-102,-1.513,-3,-99,32,27,H1
"Pershing County, NV",2011-2012,6640,6765,125,1.883,7,118,32,27,H1
"Pershing County, NV",2012-2013,6765,6862,97,1.434,30,67,32,27,H1
"Pershing County, NV",2013-2014,6862,6698,-164,-2.39,26,-190,32,27,H1
"Pershing County, NV",2014-2015,6695,6634,-61,-0.911,20,-81,32,27,H1
"Pershing County, NV",2015-2016,6634,6606,-28,-0.422,24,-52,32,27,H1
"Pershing County, NV",2016-2017,6606,6508,-98,-1.483,10,-108,32,27,H1
"Storey County, NV",2000-2001,3393,3382,-11,-0.324,-17,6,32,29,H1
"Storey County, NV",2001-2002,3382,3332,-50,-1.478,-9,-41,32,29,H1
"Storey County, NV",2002-2003,3332,3411,79,2.371,-2,81,32,29,H1
"Storey County, NV",2003-2004,3411,3531,120,3.518,0,120,32,29,H1
"Storey County, NV",2004-2005,3531,3830,299,8.468,2,297,32,29,H1
"Storey County, NV",2005-2006,3830,3913,83,2.167,24,59,32,29,H1
"Storey County, NV",2006-2007,3913,4.00E+03,87,2.223,5,82,32,29,H1
"Storey County, NV",2007-2008,4.00E+03,4099,99,2.475,5,94,32,29,H1
"Storey County, NV",2008-2009,4099,4065,-34,-0.829,21,-55,32,29,H1
"Storey County, NV",2009-2010,4065,3997,-68,-1.673,12,-80,32,29,H1
"Storey County, NV",2010-2011,3997,3956,-41,-1.026,-13,-28,32,29,H1
"Storey County, NV",2011-2012,3956,3915,-41,-1.036,-11,-30,32,29,H1
"Storey County, NV",2012-2013,3915,3889,-26,-0.664,-4,-22,32,29,H1
"Storey County, NV",2013-2014,3889,3912,23,0.591,2,21,32,29,H1
"Storey County, NV",2014-2015,3908,3987,79,2.021,4,75,32,29,H1
"Storey County, NV",2015-2016,3987,3989,2,0.05,-2,4,32,29,H1
"Storey County, NV",2016-2017,3989,4006,17,0.426,2,15,32,29,H1
"Washoe County, NV",2000-2001,341389,351959,10570,3.096,2495,8075,32,31,H1
"Washoe County, NV",2001-2002,351959,362374,10415,2.959,2423,7992,32,31,H1
"Washoe County, NV",2002-2003,362374,372302,9928,2.74,2574,7354,32,31,H1
"Washoe County, NV",2003-2004,372302,382777,10475,2.814,2576,7899,32,31,H1
"Washoe County, NV",2004-2005,382777,392716,9939,2.597,2542,7397,32,31,H1
"Washoe County, NV",2005-2006,392716,400453,7737,1.97,2940,4797,32,31,H1
"Washoe County, NV",2006-2007,400453,408724,8271,2.065,3166,5105,32,31,H1
"Washoe County, NV",2007-2008,408724,414793,6069,1.485,2925,3144,32,31,H1
"Washoe County, NV",2008-2009,414793,417722,2929,0.706,2751,178,32,31,H1
"Washoe County, NV",2009-2010,417722,422035,4313,1.033,2700,1613,32,31,H1
"Washoe County, NV",2010-2011,422035,424902,2867,0.679,1988,879,32,31,H1
"Washoe County, NV",2011-2012,424902,429086,4184,0.985,1840,2344,32,31,H1
"Washoe County, NV",2012-2013,429086,433824,4738,1.104,1889,2849,32,31,H1
"Washoe County, NV",2013-2014,433824,440078,6254,1.442,1812,4442,32,31,H1
"Washoe County, NV",2014-2015,440154,446903,6749,1.533,1873,4876,32,31,H1
"Washoe County, NV",2015-2016,446903,452429,5526,1.237,1710,3816,32,31,H1
"Washoe County, NV",2016-2017,452429,460587,8158,1.803,1716,6442,32,31,H1
"White Pine County, NV",2000-2001,9029,8747,-282,-3.123,-13,-269,32,33,H1
"White Pine County, NV",2001-2002,8747,8693,-54,-0.617,-23,-31,32,33,H1
"White Pine County, NV",2002-2003,8693,8651,-42,-0.483,-9,-33,32,33,H1
"White Pine County, NV",2003-2004,8651,8708,57,0.659,-24,81,32,33,H1
"White Pine County, NV",2004-2005,8708,9166,458,5.26,-12,470,32,33,H1
"White Pine County, NV",2005-2006,9166,9511,345,3.764,19,326,32,33,H1
"White Pine County, NV",2006-2007,9511,9626,115,1.209,19,96,32,33,H1
"White Pine County, NV",2007-2008,9626,9732,106,1.101,10,96,32,33,H1
"White Pine County, NV",2008-2009,9732,9900,168,1.726,27,141,32,33,H1
"White Pine County, NV",2009-2010,9900,10046,146,1.475,20,126,32,33,H1
"White Pine County, NV",2010-2011,10046,10114,68,0.677,25,43,32,33,H1
"White Pine County, NV",2011-2012,10114,9989,-125,-1.236,27,-152,32,33,H1
"White Pine County, NV",2012-2013,9989,10034,45,0.45,30,15,32,33,H1
"White Pine County, NV",2013-2014,10034,10034,0,0,34,-34,32,33,H1
"White Pine County, NV",2014-2015,9978,9811,-167,-1.674,27,-194,32,33,H1
"White Pine County, NV",2015-2016,9811,9744,-67,-0.683,7,-74,32,33,H1
"White Pine County, NV",2016-2017,9744,9592,-152,-1.56,4,-156,32,33,H1
"Carson City, NV",2000-2001,52568,53472,904,1.72,181,723,32,510,C7
"Carson City, NV",2001-2002,53472,54503,1031,1.928,82,949,32,510,C7
"Carson City, NV",2002-2003,54503,55234,731,1.341,46,685,32,510,C7
"Carson City, NV",2003-2004,55234,55995,761,1.378,113,648,32,510,C7
"Carson City, NV",2004-2005,55995,55982,-13,-0.023,85,-98,32,510,C7
"Carson City, NV",2005-2006,55982,55410,-572,-1.022,157,-729,32,510,C7
"Carson City, NV",2006-2007,55410,55288,-122,-0.22,110,-232,32,510,C7
"Carson City, NV",2007-2008,55288,55552,264,0.477,144,120,32,510,C7
"Carson City, NV",2008-2009,55552,55401,-151,-0.272,94,-245,32,510,C7
"Carson City, NV",2009-2010,55401,55260,-141,-0.255,91,-232,32,510,C7
"Carson City, NV",2010-2011,55260,54747,-513,-0.928,-47,-466,32,510,C7
"Carson City, NV",2011-2012,54747,54578,-169,-0.309,-109,-60,32,510,C7
"Carson City, NV",2012-2013,54578,54061,-517,-0.947,-73,-444,32,510,C7
"Carson City, NV",2013-2014,54061,54522,461,0.853,-45,506,32,510,C7
"Carson City, NV",2014-2015,54480,54521,41,0.075,-48,89,32,510,C7
"Carson City, NV",2015-2016,54521,54283,-238,-0.437,-234,-4,32,510,C7
"Carson City, NV",2016-2017,54283,54745,462,0.851,-85,547,32,510,C7
New Hampshire,2000-2001,1239882,1255517,15635,1.261,4676,10959,33,0,STATE
New Hampshire,2001-2002,1255517,1269089,13572,1.081,4798,8774,33,0,STATE
New Hampshire,2002-2003,1269089,1279840,10751,0.847,4893,5858,33,0,STATE
New Hampshire,2003-2004,1279840,1290121,10281,0.803,4636,5645,33,0,STATE
New Hampshire,2004-2005,1290121,1298492,8371,0.649,5308,3063,33,0,STATE
New Hampshire,2005-2006,1298492,1308389,9897,0.762,5410,4487,33,0,STATE
New Hampshire,2006-2007,1308389,1312540,4151,0.317,4102,49,33,0,STATE
New Hampshire,2007-2008,1312540,1315906,3366,0.256,3661,-295,33,0,STATE
New Hampshire,2008-2009,1315906,1316102,196,0.015,3587,-3391,33,0,STATE
New Hampshire,2009-2010,1316102,1316708,606,0.046,2782,-2176,33,0,STATE
New Hampshire,2010-2011,1316708,1318344,1636,0.124,2257,-621,33,0,STATE
New Hampshire,2011-2012,1318344,1321393,3049,0.231,1868,1181,33,0,STATE
New Hampshire,2012-2013,1321393,1322660,1267,0.096,1730,-463,33,0,STATE
New Hampshire,2013-2014,1322660,1327996,5336,0.403,1348,3988,33,0,STATE
New Hampshire,2014-2015,1327996,1330608,2612,0.197,1582,1030,33,0,STATE
New Hampshire,2015-2016,1330608,1335015,4407,0.331,846,3561,33,0,STATE
New Hampshire,2016-2017,1335015,1342795,7780,0.583,900,6880,33,0,STATE
"Belknap County, NH",2000-2001,56473,57597,1124,1.99,55,1069,33,1,H1
"Belknap County, NH",2001-2002,57597,58609,1012,1.757,-52,1064,33,1,H1
"Belknap County, NH",2002-2003,58609,59497,888,1.515,7,881,33,1,H1
"Belknap County, NH",2003-2004,59497,60170,673,1.131,69,604,33,1,H1
"Belknap County, NH",2004-2005,60170,60287,117,0.194,-25,142,33,1,H1
"Belknap County, NH",2005-2006,60287,60105,-182,-0.302,33,-215,33,1,H1
"Belknap County, NH",2006-2007,60105,60109,4,0.007,14,-10,33,1,H1
"Belknap County, NH",2007-2008,60109,60239,130,0.216,-11,141,33,1,H1
"Belknap County, NH",2008-2009,60239,60171,-68,-0.113,-23,-45,33,1,H1
"Belknap County, NH",2009-2010,60171,60109,-62,-0.103,-45,-17,33,1,H1
"Belknap County, NH",2010-2011,60109,60253,144,0.24,-16,160,33,1,H1
"Belknap County, NH",2011-2012,60253,60394,141,0.234,-92,233,33,1,H1
"Belknap County, NH",2012-2013,60394,60201,-193,-0.32,-119,-74,33,1,H1
"Belknap County, NH",2013-2014,60201,60305,104,0.173,-191,295,33,1,H1
"Belknap County, NH",2014-2015,60428,60641,213,0.352,-172,385,33,1,H1
"Belknap County, NH",2015-2016,60641,60606,-35,-0.058,-183,148,33,1,H1
"Belknap County, NH",2016-2017,60606,60785,179,0.295,-229,408,33,1,H1
"Carroll County, NH",2000-2001,43907,44200,293,0.667,-41,334,33,3,H1
"Carroll County, NH",2001-2002,44200,45074,874,1.977,-56,930,33,3,H1
"Carroll County, NH",2002-2003,45074,45697,623,1.382,-33,656,33,3,H1
"Carroll County, NH",2003-2004,45697,46496,799,1.748,-43,842,33,3,H1
"Carroll County, NH",2004-2005,46496,46652,156,0.336,-77,233,33,3,H1
"Carroll County, NH",2005-2006,46652,47421,769,1.648,-58,827,33,3,H1
"Carroll County, NH",2006-2007,47421,47829,408,0.86,-82,490,33,3,H1
"Carroll County, NH",2007-2008,47829,48013,184,0.385,-126,310,33,3,H1
"Carroll County, NH",2008-2009,48013,47763,-250,-0.521,-129,-121,33,3,H1
"Carroll County, NH",2009-2010,47763,47810,47,0.098,-131,178,33,3,H1
"Carroll County, NH",2010-2011,47810,47736,-74,-0.155,-130,56,33,3,H1
"Carroll County, NH",2011-2012,47736,47667,-69,-0.145,-82,13,33,3,H1
"Carroll County, NH",2012-2013,47667,47505,-162,-0.34,-133,-29,33,3,H1
"Carroll County, NH",2013-2014,47505,47399,-106,-0.223,-170,64,33,3,H1
"Carroll County, NH",2014-2015,47372,47285,-87,-0.184,-184,97,33,3,H1
"Carroll County, NH",2015-2016,47285,47399,114,0.241,-202,316,33,3,H1
"Carroll County, NH",2016-2017,47399,48064,665,1.403,-200,865,33,3,H1
"Cheshire County, NH",2000-2001,73953,74372,419,0.567,102,317,33,5,H1
"Cheshire County, NH",2001-2002,74372,75047,675,0.908,52,623,33,5,H1
"Cheshire County, NH",2002-2003,75047,76135,1088,1.45,87,1001,33,5,H1
"Cheshire County, NH",2003-2004,76135,76709,574,0.754,103,471,33,5,H1
"Cheshire County, NH",2004-2005,76709,77061,352,0.459,175,177,33,5,H1
"Cheshire County, NH",2005-2006,77061,77658,597,0.775,157,440,33,5,H1
"Cheshire County, NH",2006-2007,77658,77745,87,0.112,80,7,33,5,H1
"Cheshire County, NH",2007-2008,77745,77472,-273,-0.351,112,-385,33,5,H1
"Cheshire County, NH",2008-2009,77472,77302,-170,-0.219,80,-250,33,5,H1
"Cheshire County, NH",2009-2010,77302,76914,-388,-0.502,30,-418,33,5,H1
"Cheshire County, NH",2010-2011,76914,76792,-122,-0.159,46,-168,33,5,H1
"Cheshire County, NH",2011-2012,76792,76758,-34,-0.044,-6,-28,33,5,H1
"Cheshire County, NH",2012-2013,76758,76399,-359,-0.468,-7,-352,33,5,H1
"Cheshire County, NH",2013-2014,76399,76115,-284,-0.372,36,-320,33,5,H1
"Cheshire County, NH",2014-2015,76193,75909,-284,-0.373,-1,-283,33,5,H1
"Cheshire County, NH",2015-2016,75909,75697,-212,-0.279,-30,-182,33,5,H1
"Cheshire County, NH",2016-2017,75697,75960,263,0.347,-13,276,33,5,H1
"Coos County, NH",2000-2001,33158,33113,-45,-0.136,-120,75,33,7,H1
"Coos County, NH",2001-2002,33113,33234,121,0.365,-128,249,33,7,H1
"Coos County, NH",2002-2003,33234,33462,228,0.686,-109,337,33,7,H1
"Coos County, NH",2003-2004,33462,33589,127,0.38,-160,287,33,7,H1
"Coos County, NH",2004-2005,33589,33845,256,0.762,-102,358,33,7,H1
"Coos County, NH",2005-2006,33845,33814,-31,-0.092,-90,59,33,7,H1
"Coos County, NH",2006-2007,33814,33751,-63,-0.186,-95,32,33,7,H1
"Coos County, NH",2007-2008,33751,33488,-263,-0.779,-98,-165,33,7,H1
"Coos County, NH",2008-2009,33488,33224,-264,-0.788,-113,-151,33,7,H1
"Coos County, NH",2009-2010,33224,32957,-267,-0.804,-145,-122,33,7,H1
"Coos County, NH",2010-2011,32957,32460,-497,-1.508,-180,-317,33,7,H1
"Coos County, NH",2011-2012,32460,31977,-483,-1.488,-166,-317,33,7,H1
"Coos County, NH",2012-2013,31977,31962,-15,-0.047,-154,139,33,7,H1
"Coos County, NH",2013-2014,31962,31653,-309,-0.967,-152,-157,33,7,H1
"Coos County, NH",2014-2015,31694,31212,-482,-1.521,-144,-338,33,7,H1
"Coos County, NH",2015-2016,31212,31923,711,2.278,-201,912,33,7,H1
"Coos County, NH",2016-2017,31923,31634,-289,-0.905,-167,-122,33,7,H1
"Grafton County, NH",2000-2001,81868,82233,365,0.446,79,286,33,9,H1
"Grafton County, NH",2001-2002,82233,83152,919,1.118,151,768,33,9,H1
"Grafton County, NH",2002-2003,83152,84211,1059,1.274,164,895,33,9,H1
"Grafton County, NH",2003-2004,84211,85312,1101,1.307,103,998,33,9,H1
"Grafton County, NH",2004-2005,85312,86287,975,1.143,46,929,33,9,H1
"Grafton County, NH",2005-2006,86287,87236,949,1.1,173,776,33,9,H1
"Grafton County, NH",2006-2007,87236,87764,528,0.605,105,423,33,9,H1
"Grafton County, NH",2007-2008,87764,88745,981,1.118,131,850,33,9,H1
"Grafton County, NH",2008-2009,88745,88926,181,0.204,75,106,33,9,H1
"Grafton County, NH",2009-2010,88926,89105,179,0.201,-16,195,33,9,H1
"Grafton County, NH",2010-2011,89105,89067,-38,-0.043,4,-42,33,9,H1
"Grafton County, NH",2011-2012,89067,89342,275,0.309,30,245,33,9,H1
"Grafton County, NH",2012-2013,89342,89628,286,0.32,-72,358,33,9,H1
"Grafton County, NH",2013-2014,89628,89658,30,0.033,-8,38,33,9,H1
"Grafton County, NH",2014-2015,89575,89320,-255,-0.285,-14,-241,33,9,H1
"Grafton County, NH",2015-2016,89320,89311,-9,-0.01,-91,82,33,9,H1
"Grafton County, NH",2016-2017,89311,89386,75,0.084,-47,122,33,9,H1
"Hillsborough County, NH",2000-2001,382162,387414,5252,1.374,2254,2998,33,11,H1
"Hillsborough County, NH",2001-2002,387414,389665,2251,0.581,2255,-4,33,11,H1
"Hillsborough County, NH",2002-2003,389665,391461,1796,0.461,2256,-460,33,11,H1
"Hillsborough County, NH",2003-2004,391461,394428,2967,0.758,2233,734,33,11,H1
"Hillsborough County, NH",2004-2005,394428,396381,1953,0.495,2465,-512,33,11,H1
"Hillsborough County, NH",2005-2006,396381,398169,1788,0.451,2379,-591,33,11,H1
"Hillsborough County, NH",2006-2007,398169,398843,674,0.169,2049,-1375,33,11,H1
"Hillsborough County, NH",2007-2008,398843,399556,713,0.179,1997,-1284,33,11,H1
"Hillsborough County, NH",2008-2009,399556,400148,592,0.148,1981,-1389,33,11,H1
"Hillsborough County, NH",2009-2010,400148,400982,834,0.208,1800,-966,33,11,H1
"Hillsborough County, NH",2010-2011,400982,401716,734,0.183,1603,-869,33,11,H1
"Hillsborough County, NH",2011-2012,401716,402600,884,0.22,1337,-453,33,11,H1
"Hillsborough County, NH",2012-2013,402600,403398,798,0.198,1358,-560,33,11,H1
"Hillsborough County, NH",2013-2014,403398,405184,1786,0.443,1205,581,33,11,H1
"Hillsborough County, NH",2014-2015,405339,406678,1339,0.33,1205,134,33,11,H1
"Hillsborough County, NH",2015-2016,406678,407718,1040,0.256,1050,-10,33,11,H1
"Hillsborough County, NH",2016-2017,407718,409697,1979,0.485,999,980,33,11,H1
"Merrimack County, NH",2000-2001,136576,138309,1733,1.269,350,1383,33,13,H1
"Merrimack County, NH",2001-2002,138309,140880,2571,1.859,515,2056,33,13,H1
"Merrimack County, NH",2002-2003,140880,142548,1668,1.184,325,1343,33,13,H1
"Merrimack County, NH",2003-2004,142548,143841,1293,0.907,333,960,33,13,H1
"Merrimack County, NH",2004-2005,143841,145195,1354,0.941,285,1069,33,13,H1
"Merrimack County, NH",2005-2006,145195,146609,1414,0.974,353,1061,33,13,H1
"Merrimack County, NH",2006-2007,146609,147024,415,0.283,415,0,33,13,H1
"Merrimack County, NH",2007-2008,147024,147170,146,0.099,318,-172,33,13,H1
"Merrimack County, NH",2008-2009,147170,146723,-447,-0.304,280,-727,33,13,H1
"Merrimack County, NH",2009-2010,146723,146411,-312,-0.213,116,-428,33,13,H1
"Merrimack County, NH",2010-2011,146411,146681,270,0.184,183,87,33,13,H1
"Merrimack County, NH",2011-2012,146681,146987,306,0.209,30,276,33,13,H1
"Merrimack County, NH",2012-2013,146987,147150,163,0.111,101,62,33,13,H1
"Merrimack County, NH",2013-2014,147150,147171,21,0.014,106,-85,33,13,H1
"Merrimack County, NH",2014-2015,147461,147994,533,0.361,73,460,33,13,H1
"Merrimack County, NH",2015-2016,147994,148133,139,0.094,13,126,33,13,H1
"Merrimack County, NH",2016-2017,148133,149216,1083,0.731,45,1038,33,13,H1
"Rockingham County, NH",2000-2001,278599,282932,4333,1.555,1442,2891,33,15,H1
"Rockingham County, NH",2001-2002,282932,286218,3286,1.161,1402,1884,33,15,H1
"Rockingham County, NH",2002-2003,286218,287893,1675,0.585,1563,112,33,15,H1
"Rockingham County, NH",2003-2004,287893,289103,1210,0.42,1342,-132,33,15,H1
"Rockingham County, NH",2004-2005,289103,291190,2087,0.722,1954,133,33,15,H1
"Rockingham County, NH",2005-2006,291190,293618,2428,0.834,1753,675,33,15,H1
"Rockingham County, NH",2006-2007,293618,294132,514,0.175,1075,-561,33,15,H1
"Rockingham County, NH",2007-2008,294132,294996,864,0.294,837,27,33,15,H1
"Rockingham County, NH",2008-2009,294996,295083,87,0.029,889,-802,33,15,H1
"Rockingham County, NH",2009-2010,295083,295306,223,0.076,691,-468,33,15,H1
"Rockingham County, NH",2010-2011,295306,295999,693,0.235,383,310,33,15,H1
"Rockingham County, NH",2011-2012,295999,297841,1842,0.622,473,1369,33,15,H1
"Rockingham County, NH",2012-2013,297841,298745,904,0.304,426,478,33,15,H1
"Rockingham County, NH",2013-2014,298745,300621,1876,0.628,416,1460,33,15,H1
"Rockingham County, NH",2014-2015,300638,301777,1139,0.379,555,584,33,15,H1
"Rockingham County, NH",2015-2016,301777,303922,2145,0.711,433,1712,33,15,H1
"Rockingham County, NH",2016-2017,303922,306363,2441,0.803,323,2118,33,15,H1
"Strafford County, NH",2000-2001,112643,114382,1739,1.544,514,1225,33,17,H1
"Strafford County, NH",2001-2002,114382,115811,1429,1.249,597,832,33,17,H1
"Strafford County, NH",2002-2003,115811,116846,1035,0.894,559,476,33,17,H1
"Strafford County, NH",2003-2004,116846,117926,1080,0.924,502,578,33,17,H1
"Strafford County, NH",2004-2005,117926,118681,755,0.64,533,222,33,17,H1
"Strafford County, NH",2005-2006,118681,120363,1682,1.417,652,1030,33,17,H1
"Strafford County, NH",2006-2007,120363,121735,1372,1.14,469,903,33,17,H1
"Strafford County, NH",2007-2008,121735,122460,725,0.596,436,289,33,17,H1
"Strafford County, NH",2008-2009,122460,123034,574,0.469,479,95,33,17,H1
"Strafford County, NH",2009-2010,123034,123203,169,0.137,471,-302,33,17,H1
"Strafford County, NH",2010-2011,123203,123945,742,0.602,371,371,33,17,H1
"Strafford County, NH",2011-2012,123945,124543,598,0.482,324,274,33,17,H1
"Strafford County, NH",2012-2013,124543,124642,99,0.079,328,-229,33,17,H1
"Strafford County, NH",2013-2014,124642,125604,962,0.772,287,675,33,17,H1
"Strafford County, NH",2014-2015,126191,126825,634,0.502,280,354,33,17,H1
"Strafford County, NH",2015-2016,126825,127270,445,0.351,131,314,33,17,H1
"Strafford County, NH",2016-2017,127270,128613,1343,1.055,207,1136,33,17,H1
"Sullivan County, NH",2000-2001,40543,40965,422,1.041,41,381,33,19,H1
"Sullivan County, NH",2001-2002,40965,41399,434,1.059,62,372,33,19,H1
"Sullivan County, NH",2002-2003,41399,42090,691,1.669,74,617,33,19,H1
"Sullivan County, NH",2003-2004,42090,42547,457,1.086,154,303,33,19,H1
"Sullivan County, NH",2004-2005,42547,42913,366,0.86,54,312,33,19,H1
"Sullivan County, NH",2005-2006,42913,43396,483,1.126,58,425,33,19,H1
"Sullivan County, NH",2006-2007,43396,43608,212,0.489,72,140,33,19,H1
"Sullivan County, NH",2007-2008,43608,43767,159,0.365,65,94,33,19,H1
"Sullivan County, NH",2008-2009,43767,43728,-39,-0.089,68,-107,33,19,H1
"Sullivan County, NH",2009-2010,43728,43720,-8,-0.018,11,-19,33,19,H1
"Sullivan County, NH",2010-2011,43720,43460,-260,-0.595,-6,-254,33,19,H1
"Sullivan County, NH",2011-2012,43460,43188,-272,-0.626,18,-290,33,19,H1
"Sullivan County, NH",2012-2013,43188,42986,-202,-0.468,-62,-140,33,19,H1
"Sullivan County, NH",2013-2014,42986,43103,117,0.272,-25,142,33,19,H1
"Sullivan County, NH",2014-2015,43105,42967,-138,-0.32,-16,-122,33,19,H1
"Sullivan County, NH",2015-2016,42967,43036,69,0.161,-74,143,33,19,H1
"Sullivan County, NH",2016-2017,43036,43077,41,0.095,-18,59,33,19,H1
New Jersey,2000-2001,8430621,8492671,62050,0.736,39386,22664,34,0,STATE
New Jersey,2001-2002,8492671,8552643,59972,0.706,38025,21947,34,0,STATE
New Jersey,2002-2003,8552643,8601402,48759,0.57,42594,6165,34,0,STATE
New Jersey,2003-2004,8601402,8634561,33159,0.386,42806,-9647,34,0,STATE
New Jersey,2004-2005,8634561,8651974,17413,0.202,39859,-22446,34,0,STATE
New Jersey,2005-2006,8651974,8661679,9705,0.112,39765,-30060,34,0,STATE
New Jersey,2006-2007,8661679,8677885,16206,0.187,41516,-25310,34,0,STATE
New Jersey,2007-2008,8677885,8711090,33205,0.383,41180,-7975,34,0,STATE
New Jersey,2008-2009,8711090,8755602,44512,0.511,38795,5717,34,0,STATE
New Jersey,2009-2010,8755602,8803881,48279,0.551,38616,9663,34,0,STATE
New Jersey,2010-2011,8803881,8842934,39053,0.444,35620,3433,34,0,STATE
New Jersey,2011-2012,8842934,8874893,31959,0.361,35474,-3515,34,0,STATE
New Jersey,2012-2013,8874893,8907384,32491,0.366,31037,1454,34,0,STATE
New Jersey,2013-2014,8907384,8938844,31460,0.353,31121,339,34,0,STATE
New Jersey,2014-2015,8938844,8958013,19169,0.214,30941,-11772,34,0,STATE
New Jersey,2015-2016,8958013,8978416,20403,0.228,29203,-8800,34,0,STATE
New Jersey,2016-2017,8978416,9005644,27228,0.303,27514,-286,34,0,STATE
"Atlantic County, NJ",2000-2001,253674,255737,2063,0.813,893,1170,34,1,H1
"Atlantic County, NJ",2001-2002,255737,259263,3526,1.379,784,2742,34,1,H1
"Atlantic County, NJ",2002-2003,259263,263285,4022,1.551,701,3321,34,1,H1
"Atlantic County, NJ",2003-2004,263285,267723,4438,1.686,811,3627,34,1,H1
"Atlantic County, NJ",2004-2005,267723,270332,2609,0.975,1100,1509,34,1,H1
"Atlantic County, NJ",2005-2006,270332,271759,1427,0.528,993,434,34,1,H1
"Atlantic County, NJ",2006-2007,271759,272303,544,0.2,999,-455,34,1,H1
"Atlantic County, NJ",2007-2008,272303,273014,711,0.261,1170,-459,34,1,H1
"Atlantic County, NJ",2008-2009,273014,274049,1035,0.379,863,172,34,1,H1
"Atlantic County, NJ",2009-2010,274049,274762,713,0.26,849,-136,34,1,H1
"Atlantic County, NJ",2010-2011,274762,274923,161,0.059,846,-685,34,1,H1
"Atlantic County, NJ",2011-2012,274923,275566,643,0.234,998,-355,34,1,H1
"Atlantic County, NJ",2012-2013,275566,276167,601,0.218,798,-197,34,1,H1
"Atlantic County, NJ",2013-2014,276167,275209,-958,-0.347,678,-1636,34,1,H1
"Atlantic County, NJ",2014-2015,275499,274219,-1280,-0.465,489,-1769,34,1,H1
"Atlantic County, NJ",2015-2016,274219,270830,-3389,-1.236,93,-3482,34,1,H1
"Atlantic County, NJ",2016-2017,270830,269918,-912,-0.337,104,-1016,34,1,H1
"Bergen County, NJ",2000-2001,885180,888782,3602,0.407,2902,700,34,3,H1
"Bergen County, NJ",2001-2002,888782,890647,1865,0.21,2517,-652,34,3,H1
"Bergen County, NJ",2002-2003,890647,892214,1567,0.176,3002,-1435,34,3,H1
"Bergen County, NJ",2003-2004,892214,893378,1164,0.13,3333,-2169,34,3,H1
"Bergen County, NJ",2004-2005,893378,891446,-1932,-0.216,2404,-4336,34,3,H1
"Bergen County, NJ",2005-2006,891446,889406,-2040,-0.229,2356,-4396,34,3,H1
"Bergen County, NJ",2006-2007,889406,890817,1411,0.159,2314,-903,34,3,H1
"Bergen County, NJ",2007-2008,890817,895328,4511,0.506,2363,2148,34,3,H1
"Bergen County, NJ",2008-2009,895328,900319,4991,0.557,2339,2652,34,3,H1
"Bergen County, NJ",2009-2010,900319,906748,6429,0.714,2505,3924,34,3,H1
"Bergen County, NJ",2010-2011,906748,914087,7339,0.809,2366,4973,34,3,H1
"Bergen County, NJ",2011-2012,914087,920440,6353,0.695,2005,4348,34,3,H1
"Bergen County, NJ",2012-2013,920440,927434,6994,0.76,2019,4975,34,3,H1
"Bergen County, NJ",2013-2014,927434,933572,6138,0.662,2147,3991,34,3,H1
"Bergen County, NJ",2014-2015,932836,938506,5670,0.608,2450,3220,34,3,H1
"Bergen County, NJ",2015-2016,938506,942387,3881,0.414,2500,1381,34,3,H1
"Bergen County, NJ",2016-2017,942387,948406,6019,0.639,2296,3723,34,3,H1
"Burlington County, NJ",2000-2001,424453,429727,5274,1.243,1357,3917,34,5,H1
"Burlington County, NJ",2001-2002,429727,436445,6718,1.563,1528,5190,34,5,H1
"Burlington County, NJ",2002-2003,436445,442434,5989,1.372,1675,4314,34,5,H1
"Burlington County, NJ",2003-2004,442434,446548,4114,0.93,1755,2359,34,5,H1
"Burlington County, NJ",2004-2005,446548,447245,697,0.156,1566,-869,34,5,H1
"Burlington County, NJ",2005-2006,447245,448373,1128,0.252,1506,-378,34,5,H1
"Burlington County, NJ",2006-2007,448373,447560,-813,-0.181,1566,-2379,34,5,H1
"Burlington County, NJ",2007-2008,447560,446831,-729,-0.163,1552,-2281,34,5,H1
"Burlington County, NJ",2008-2009,446831,447391,560,0.125,1327,-767,34,5,H1
"Burlington County, NJ",2009-2010,447391,449174,1783,0.399,1080,703,34,5,H1
"Burlington County, NJ",2010-2011,449174,450531,1357,0.302,977,380,34,5,H1
"Burlington County, NJ",2011-2012,450531,451207,676,0.15,880,-204,34,5,H1
"Burlington County, NJ",2012-2013,451207,450141,-1066,-0.236,554,-1620,34,5,H1
"Burlington County, NJ",2013-2014,450141,449722,-419,-0.093,573,-992,34,5,H1
"Burlington County, NJ",2014-2015,450677,450226,-451,-0.1,630,-1081,34,5,H1
"Burlington County, NJ",2015-2016,450226,448342,-1884,-0.418,283,-2167,34,5,H1
"Burlington County, NJ",2016-2017,448342,448596,254,0.057,352,-98,34,5,H1
"Camden County, NJ",2000-2001,506707,506326,-381,-0.075,1958,-2339,34,7,H1
"Camden County, NJ",2001-2002,506326,507899,1573,0.311,2140,-567,34,7,H1
"Camden County, NJ",2002-2003,507899,508563,664,0.131,1988,-1324,34,7,H1
"Camden County, NJ",2003-2004,508563,510137,1574,0.309,2266,-692,34,7,H1
"Camden County, NJ",2004-2005,510137,511982,1845,0.362,2196,-351,34,7,H1
"Camden County, NJ",2005-2006,511982,513195,1213,0.237,2287,-1074,34,7,H1
"Camden County, NJ",2006-2007,513195,513546,351,0.068,2675,-2324,34,7,H1
"Camden County, NJ",2007-2008,513546,513853,307,0.06,2640,-2333,34,7,H1
"Camden County, NJ",2008-2009,513853,513668,-185,-0.036,2425,-2610,34,7,H1
"Camden County, NJ",2009-2010,513668,513630,-38,-0.007,2427,-2465,34,7,H1
"Camden County, NJ",2010-2011,513630,513261,-369,-0.072,2084,-2453,34,7,H1
"Camden County, NJ",2011-2012,513261,513104,-157,-0.031,2162,-2319,34,7,H1
"Camden County, NJ",2012-2013,513104,512125,-979,-0.191,1738,-2717,34,7,H1
"Camden County, NJ",2013-2014,512125,511038,-1087,-0.212,1704,-2791,34,7,H1
"Camden County, NJ",2014-2015,510967,510923,-44,-0.009,1728,-1772,34,7,H1
"Camden County, NJ",2015-2016,510923,510741,-182,-0.036,1482,-1664,34,7,H1
"Camden County, NJ",2016-2017,510741,510719,-22,-0.004,1477,-1499,34,7,H1
"Cape May County, NJ",2000-2001,102314,102023,-291,-0.284,-294,3,34,9,H1
"Cape May County, NJ",2001-2002,102023,101694,-329,-0.322,-322,-7,34,9,H1
"Cape May County, NJ",2002-2003,101694,101710,16,0.016,-224,240,34,9,H1
"Cape May County, NJ",2003-2004,101710,100482,-1228,-1.207,-392,-836,34,9,H1
"Cape May County, NJ",2004-2005,100482,99269,-1213,-1.207,-429,-784,34,9,H1
"Cape May County, NJ",2005-2006,99269,98695,-574,-0.578,-363,-211,34,9,H1
"Cape May County, NJ",2006-2007,98695,97686,-1009,-1.022,-375,-634,34,9,H1
"Cape May County, NJ",2007-2008,97686,97550,-136,-0.139,-277,141,34,9,H1
"Cape May County, NJ",2008-2009,97550,97238,-312,-0.32,-341,29,34,9,H1
"Cape May County, NJ",2009-2010,97238,97278,40,0.041,-220,260,34,9,H1
"Cape May County, NJ",2010-2011,97278,96562,-716,-0.736,-374,-342,34,9,H1
"Cape May County, NJ",2011-2012,96562,96398,-164,-0.17,-218,54,34,9,H1
"Cape May County, NJ",2012-2013,96398,95849,-549,-0.57,-356,-193,34,9,H1
"Cape May County, NJ",2013-2014,95849,95344,-505,-0.527,-381,-124,34,9,H1
"Cape May County, NJ",2014-2015,95359,94727,-632,-0.663,-439,-193,34,9,H1
"Cape May County, NJ",2015-2016,94727,93920,-807,-0.852,-424,-383,34,9,H1
"Cape May County, NJ",2016-2017,93920,93553,-367,-0.391,-410,43,34,9,H1
"Cumberland County, NJ",2000-2001,146263,146451,188,0.129,613,-425,34,11,H1
"Cumberland County, NJ",2001-2002,146451,147294,843,0.576,571,272,34,11,H1
"Cumberland County, NJ",2002-2003,147294,148437,1143,0.776,615,528,34,11,H1
"Cumberland County, NJ",2003-2004,148437,149837,1400,0.943,590,810,34,11,H1
"Cumberland County, NJ",2004-2005,149837,152022,2185,1.458,910,1275,34,11,H1
"Cumberland County, NJ",2005-2006,152022,153371,1349,0.887,879,470,34,11,H1
"Cumberland County, NJ",2006-2007,153371,154489,1118,0.729,1197,-79,34,11,H1
"Cumberland County, NJ",2007-2008,154489,155738,1249,0.808,1095,154,34,11,H1
"Cumberland County, NJ",2008-2009,155738,156531,793,0.509,1022,-229,34,11,H1
"Cumberland County, NJ",2009-2010,156531,157200,669,0.427,937,-268,34,11,H1
"Cumberland County, NJ",2010-2011,157200,157607,407,0.259,811,-404,34,11,H1
"Cumberland County, NJ",2011-2012,157607,157794,187,0.119,791,-604,34,11,H1
"Cumberland County, NJ",2012-2013,157794,157153,-641,-0.406,640,-1281,34,11,H1
"Cumberland County, NJ",2013-2014,157153,157389,236,0.15,626,-390,34,11,H1
"Cumberland County, NJ",2014-2015,157099,155854,-1245,-0.792,532,-1777,34,11,H1
"Cumberland County, NJ",2015-2016,155854,153914,-1940,-1.245,567,-2507,34,11,H1
"Cumberland County, NJ",2016-2017,153914,152538,-1376,-0.894,494,-1870,34,11,H1
"Essex County, NJ",2000-2001,792253,794312,2059,0.26,4781,-2722,34,13,H1
"Essex County, NJ",2001-2002,794312,795625,1313,0.165,4838,-3525,34,13,H1
"Essex County, NJ",2002-2003,795625,795167,-458,-0.058,5371,-5829,34,13,H1
"Essex County, NJ",2003-2004,795167,791305,-3862,-0.486,5351,-9213,34,13,H1
"Essex County, NJ",2004-2005,791305,786341,-4964,-0.627,5061,-10025,34,13,H1
"Essex County, NJ",2005-2006,786341,781027,-5314,-0.676,5087,-10401,34,13,H1
"Essex County, NJ",2006-2007,781027,778996,-2031,-0.26,5621,-7652,34,13,H1
"Essex County, NJ",2007-2008,778996,778165,-831,-0.107,5291,-6122,34,13,H1
"Essex County, NJ",2008-2009,778165,781943,3778,0.486,5014,-1236,34,13,H1
"Essex County, NJ",2009-2010,781943,784608,2665,0.341,5086,-2421,34,13,H1
"Essex County, NJ",2010-2011,784608,787232,2624,0.334,4513,-1889,34,13,H1
"Essex County, NJ",2011-2012,787232,788425,1193,0.152,4700,-3507,34,13,H1
"Essex County, NJ",2012-2013,788425,792091,3666,0.465,4794,-1128,34,13,H1
"Essex County, NJ",2013-2014,792091,795723,3632,0.459,4376,-744,34,13,H1
"Essex County, NJ",2014-2015,794962,797434,2472,0.311,4230,-1758,34,13,H1
"Essex County, NJ",2015-2016,797434,803876,6442,0.808,4183,2259,34,13,H1
"Essex County, NJ",2016-2017,803876,808285,4409,0.548,3918,491,34,13,H1
"Gloucester County, NJ",2000-2001,256524,258783,2259,0.881,847,1412,34,15,H1
"Gloucester County, NJ",2001-2002,258783,262909,4126,1.594,710,3416,34,15,H1
"Gloucester County, NJ",2002-2003,262909,267445,4536,1.725,819,3717,34,15,H1
"Gloucester County, NJ",2003-2004,267445,271714,4269,1.596,973,3296,34,15,H1
"Gloucester County, NJ",2004-2005,271714,275122,3408,1.254,796,2612,34,15,H1
"Gloucester County, NJ",2005-2006,275122,280015,4893,1.778,790,4103,34,15,H1
"Gloucester County, NJ",2006-2007,280015,284086,4071,1.454,883,3188,34,15,H1
"Gloucester County, NJ",2007-2008,284086,286072,1986,0.699,1128,858,34,15,H1
"Gloucester County, NJ",2008-2009,286072,287362,1290,0.451,981,309,34,15,H1
"Gloucester County, NJ",2009-2010,287362,288602,1240,0.432,828,412,34,15,H1
"Gloucester County, NJ",2010-2011,288602,289363,761,0.264,775,-14,34,15,H1
"Gloucester County, NJ",2011-2012,289363,289671,308,0.106,788,-480,34,15,H1
"Gloucester County, NJ",2012-2013,289671,289940,269,0.093,448,-179,34,15,H1
"Gloucester County, NJ",2013-2014,289940,290951,1011,0.349,488,523,34,15,H1
"Gloucester County, NJ",2014-2015,290898,291479,581,0.2,484,97,34,15,H1
"Gloucester County, NJ",2015-2016,291479,291703,224,0.077,335,-111,34,15,H1
"Gloucester County, NJ",2016-2017,291703,292206,503,0.172,259,244,34,15,H1
"Hudson County, NJ",2000-2001,610135,616629,6494,1.064,3813,2681,34,17,H1
"Hudson County, NJ",2001-2002,616629,615554,-1075,-0.174,3700,-4775,34,17,H1
"Hudson County, NJ",2002-2003,615554,614813,-741,-0.12,4246,-4987,34,17,H1
"Hudson County, NJ",2003-2004,614813,614607,-206,-0.034,4549,-4755,34,17,H1
"Hudson County, NJ",2004-2005,614607,614664,57,0.009,4266,-4209,34,17,H1
"Hudson County, NJ",2005-2006,614664,613577,-1087,-0.177,3967,-5054,34,17,H1
"Hudson County, NJ",2006-2007,613577,613637,60,0.01,4310,-4250,34,17,H1
"Hudson County, NJ",2007-2008,613637,619533,5896,0.961,4543,1353,34,17,H1
"Hudson County, NJ",2008-2009,619533,628572,9039,1.459,4440,4599,34,17,H1
"Hudson County, NJ",2009-2010,628572,636294,7722,1.228,5038,2684,34,17,H1
"Hudson County, NJ",2010-2011,636294,648197,11903,1.871,6458,5445,34,17,H1
"Hudson County, NJ",2011-2012,648197,656879,8682,1.339,6023,2659,34,17,H1
"Hudson County, NJ",2012-2013,656879,663906,7027,1.07,5361,1666,34,17,H1
"Hudson County, NJ",2013-2014,663906,669115,5209,0.785,5904,-695,34,17,H1
"Hudson County, NJ",2014-2015,669502,674836,5334,0.797,6208,-874,34,17,H1
"Hudson County, NJ",2015-2016,674836,686391,11555,1.712,6336,5219,34,17,H1
"Hudson County, NJ",2016-2017,686391,691643,5252,0.765,6190,-938,34,17,H1
"Hunterdon County, NJ",2000-2001,122579,124500,1921,1.567,663,1258,34,19,H1
"Hunterdon County, NJ",2001-2002,124500,125892,1392,1.118,665,727,34,19,H1
"Hunterdon County, NJ",2002-2003,125892,126935,1043,0.828,622,421,34,19,H1
"Hunterdon County, NJ",2003-2004,126935,127583,648,0.51,554,94,34,19,H1
"Hunterdon County, NJ",2004-2005,127583,128072,489,0.383,527,-38,34,19,H1
"Hunterdon County, NJ",2005-2006,128072,128535,463,0.362,461,2,34,19,H1
"Hunterdon County, NJ",2006-2007,128535,128568,33,0.026,405,-372,34,19,H1
"Hunterdon County, NJ",2007-2008,128568,128449,-119,-0.093,328,-447,34,19,H1
"Hunterdon County, NJ",2008-2009,128449,128364,-85,-0.066,379,-464,34,19,H1
"Hunterdon County, NJ",2009-2010,128364,127343,-1021,-0.795,184,-1205,34,19,H1
"Hunterdon County, NJ",2010-2011,127343,127253,-90,-0.071,146,-236,34,19,H1
"Hunterdon County, NJ",2011-2012,127253,126593,-660,-0.519,117,-777,34,19,H1
"Hunterdon County, NJ",2012-2013,126593,126473,-120,-0.095,37,-157,34,19,H1
"Hunterdon County, NJ",2013-2014,126473,126067,-406,-0.321,42,-448,34,19,H1
"Hunterdon County, NJ",2014-2015,125810,125488,-322,-0.256,-43,-279,34,19,H1
"Hunterdon County, NJ",2015-2016,125488,125061,-427,-0.34,-3,-424,34,19,H1
"Hunterdon County, NJ",2016-2017,125061,125059,-2,-0.002,-48,46,34,19,H1
"Mercer County, NJ",2000-2001,351465,353816,2351,0.669,1795,556,34,21,H1
"Mercer County, NJ",2001-2002,353816,355935,2119,0.599,1520,599,34,21,H1
"Mercer County, NJ",2002-2003,355935,358724,2789,0.784,1845,944,34,21,H1
"Mercer County, NJ",2003-2004,358724,361248,2524,0.704,1653,871,34,21,H1
"Mercer County, NJ",2004-2005,361248,362015,767,0.212,1530,-763,34,21,H1
"Mercer County, NJ",2005-2006,362015,362840,825,0.228,1727,-902,34,21,H1
"Mercer County, NJ",2006-2007,362840,363088,248,0.068,1742,-1494,34,21,H1
"Mercer County, NJ",2007-2008,363088,364119,1031,0.284,1805,-774,34,21,H1
"Mercer County, NJ",2008-2009,364119,365388,1269,0.349,1725,-456,34,21,H1
"Mercer County, NJ",2009-2010,365388,368043,2655,0.727,1788,867,34,21,H1
"Mercer County, NJ",2010-2011,368043,367941,-102,-0.028,1449,-1551,34,21,H1
"Mercer County, NJ",2011-2012,367941,369057,1116,0.303,1441,-325,34,21,H1
"Mercer County, NJ",2012-2013,369057,371052,1995,0.541,1648,347,34,21,H1
"Mercer County, NJ",2013-2014,371052,371537,485,0.131,1416,-931,34,21,H1
"Mercer County, NJ",2014-2015,371601,371398,-203,-0.055,1287,-1490,34,21,H1
"Mercer County, NJ",2015-2016,371398,373660,2262,0.609,1219,1043,34,21,H1
"Mercer County, NJ",2016-2017,373660,374733,1073,0.287,1098,-25,34,21,H1
"Middlesex County, NJ",2000-2001,752880,761770,8890,1.181,4537,4353,34,23,H1
"Middlesex County, NJ",2001-2002,761770,769280,7510,0.986,4792,2718,34,23,H1
"Middlesex County, NJ",2002-2003,769280,775973,6693,0.87,5447,1246,34,23,H1
"Middlesex County, NJ",2003-2004,775973,781582,5609,0.723,5093,516,34,23,H1
"Middlesex County, NJ",2004-2005,781582,787329,5747,0.735,4759,988,34,23,H1
"Middlesex County, NJ",2005-2006,787329,786890,-439,-0.056,4767,-5206,34,23,H1
"Middlesex County, NJ",2006-2007,786890,792137,5247,0.667,5291,-44,34,23,H1
"Middlesex County, NJ",2007-2008,792137,799191,7054,0.891,4948,2106,34,23,H1
"Middlesex County, NJ",2008-2009,799191,805204,6013,0.752,4817,1196,34,23,H1
"Middlesex County, NJ",2009-2010,805204,811272,6068,0.754,4806,1262,34,23,H1
"Middlesex County, NJ",2010-2011,811272,817400,6128,0.755,4330,1798,34,23,H1
"Middlesex County, NJ",2011-2012,817400,824447,7047,0.862,4548,2499,34,23,H1
"Middlesex County, NJ",2012-2013,824447,830815,6368,0.772,4020,2348,34,23,H1
"Middlesex County, NJ",2013-2014,830815,836297,5482,0.66,3847,1635,34,23,H1
"Middlesex County, NJ",2014-2015,837339,840900,3561,0.425,3405,156,34,23,H1
"Middlesex County, NJ",2015-2016,840900,839986,-914,-0.109,3234,-4148,34,23,H1
"Middlesex County, NJ",2016-2017,839986,842798,2812,0.335,2855,-43,34,23,H1
"Monmouth County, NJ",2000-2001,616849,620563,3714,0.602,2520,1194,34,25,H1
"Monmouth County, NJ",2001-2002,620563,624532,3969,0.64,2182,1787,34,25,H1
"Monmouth County, NJ",2002-2003,624532,627413,2881,0.461,2649,232,34,25,H1
"Monmouth County, NJ",2003-2004,627413,628605,1192,0.19,2731,-1539,34,25,H1
"Monmouth County, NJ",2004-2005,628605,627838,-767,-0.122,2171,-2938,34,25,H1
"Monmouth County, NJ",2005-2006,627838,626934,-904,-0.144,2120,-3024,34,25,H1
"Monmouth County, NJ",2006-2007,626934,626644,-290,-0.046,1894,-2184,34,25,H1
"Monmouth County, NJ",2007-2008,626644,627348,704,0.112,1640,-936,34,25,H1
"Monmouth County, NJ",2008-2009,627348,628669,1321,0.211,1800,-479,34,25,H1
"Monmouth County, NJ",2009-2010,628669,630649,1980,0.315,1426,554,34,25,H1
"Monmouth County, NJ",2010-2011,630649,629835,-814,-0.129,836,-1650,34,25,H1
"Monmouth County, NJ",2011-2012,629835,629176,-659,-0.105,1139,-1798,34,25,H1
"Monmouth County, NJ",2012-2013,629176,629569,393,0.062,783,-390,34,25,H1
"Monmouth County, NJ",2013-2014,629569,629279,-290,-0.046,727,-1017,34,25,H1
"Monmouth County, NJ",2014-2015,629018,628715,-303,-0.048,532,-835,34,25,H1
"Monmouth County, NJ",2015-2016,628715,626782,-1933,-0.307,422,-2355,34,25,H1
"Monmouth County, NJ",2016-2017,626782,626351,-431,-0.069,132,-563,34,25,H1
"Morris County, NJ",2000-2001,471326,473515,2189,0.464,2936,-747,34,27,H1
"Morris County, NJ",2001-2002,473515,477234,3719,0.785,2800,919,34,27,H1
"Morris County, NJ",2002-2003,477234,4.81E+05,3766,0.789,2979,787,34,27,H1
"Morris County, NJ",2003-2004,4.81E+05,483997,2997,0.623,2861,136,34,27,H1
"Morris County, NJ",2004-2005,483997,485472,1475,0.305,2494,-1019,34,27,H1
"Morris County, NJ",2005-2006,485472,487486,2014,0.415,2336,-322,34,27,H1
"Morris County, NJ",2006-2007,487486,488355,869,0.178,2100,-1231,34,27,H1
"Morris County, NJ",2007-2008,488355,489743,1388,0.284,1873,-485,34,27,H1
"Morris County, NJ",2008-2009,489743,490779,1036,0.212,1814,-778,34,27,H1
"Morris County, NJ",2009-2010,490779,492706,1927,0.393,1331,596,34,27,H1
"Morris County, NJ",2010-2011,492706,495782,3076,0.624,1201,1875,34,27,H1
"Morris County, NJ",2011-2012,495782,497630,1848,0.373,1029,819,34,27,H1
"Morris County, NJ",2012-2013,497630,499672,2042,0.41,1049,993,34,27,H1
"Morris County, NJ",2013-2014,499672,499727,55,0.011,964,-909,34,27,H1
"Morris County, NJ",2014-2015,499236,499509,273,0.055,909,-636,34,27,H1
"Morris County, NJ",2015-2016,499509,498844,-665,-0.133,917,-1582,34,27,H1
"Morris County, NJ",2016-2017,498844,499693,849,0.17,874,-25,34,27,H1
"Ocean County, NJ",2000-2001,513608,523357,9749,1.898,-313,10062,34,29,H1
"Ocean County, NJ",2001-2002,523357,536069,12712,2.429,-260,12972,34,29,H1
"Ocean County, NJ",2002-2003,536069,545093,9024,1.683,368,8656,34,29,H1
"Ocean County, NJ",2003-2004,545093,551262,6169,1.132,448,5721,34,29,H1
"Ocean County, NJ",2004-2005,551262,556012,4750,0.862,643,4107,34,29,H1
"Ocean County, NJ",2005-2006,556012,561302,5290,0.951,833,4457,34,29,H1
"Ocean County, NJ",2006-2007,561302,565356,4054,0.722,846,3208,34,29,H1
"Ocean County, NJ",2007-2008,565356,569485,4129,0.73,1066,3063,34,29,H1
"Ocean County, NJ",2008-2009,569485,573123,3638,0.639,733,2905,34,29,H1
"Ocean County, NJ",2009-2010,573123,577651,4528,0.79,1278,3250,34,29,H1
"Ocean County, NJ",2010-2011,577651,578990,1339,0.232,858,481,34,29,H1
"Ocean County, NJ",2011-2012,578990,580709,1719,0.297,1042,677,34,29,H1
"Ocean County, NJ",2012-2013,580709,583412,2703,0.465,1326,1377,34,29,H1
"Ocean County, NJ",2013-2014,583412,586301,2889,0.495,1191,1698,34,29,H1
"Ocean County, NJ",2014-2015,585916,588721,2805,0.479,1210,1595,34,29,H1
"Ocean County, NJ",2015-2016,588721,592944,4223,0.717,1452,2771,34,29,H1
"Ocean County, NJ",2016-2017,592944,597943,4999,0.843,1512,3487,34,29,H1
"Passaic County, NJ",2000-2001,490733,493252,2519,0.513,3773,-1254,34,31,H1
"Passaic County, NJ",2001-2002,493252,494571,1319,0.267,3606,-2287,34,31,H1
"Passaic County, NJ",2002-2003,494571,494915,344,0.07,3573,-3229,34,31,H1
"Passaic County, NJ",2003-2004,494915,493981,-934,-0.189,3638,-4572,34,31,H1
"Passaic County, NJ",2004-2005,493981,493600,-381,-0.077,3803,-4184,34,31,H1
"Passaic County, NJ",2005-2006,493600,492730,-870,-0.176,3929,-4799,34,31,H1
"Passaic County, NJ",2006-2007,492730,492886,156,0.032,3926,-3770,34,31,H1
"Passaic County, NJ",2007-2008,492886,494904,2018,0.409,3916,-1898,34,31,H1
"Passaic County, NJ",2008-2009,494904,498641,3737,0.755,3626,111,34,31,H1
"Passaic County, NJ",2009-2010,498641,502201,3560,0.714,3703,-143,34,31,H1
"Passaic County, NJ",2010-2011,502201,503946,1745,0.347,3496,-1751,34,31,H1
"Passaic County, NJ",2011-2012,503946,505013,1067,0.212,3644,-2577,34,31,H1
"Passaic County, NJ",2012-2013,505013,506998,1985,0.393,3474,-1489,34,31,H1
"Passaic County, NJ",2013-2014,506998,508856,1858,0.366,3375,-1517,34,31,H1
"Passaic County, NJ",2014-2015,509913,510916,1003,0.197,3358,-2355,34,31,H1
"Passaic County, NJ",2015-2016,510916,511265,349,0.068,3195,-2846,34,31,H1
"Passaic County, NJ",2016-2017,511265,512607,1342,0.262,3148,-1806,34,31,H1
"Salem County, NJ",2000-2001,64177,64069,-108,-0.168,36,-144,34,33,H1
"Salem County, NJ",2001-2002,64069,64434,365,0.57,91,274,34,33,H1
"Salem County, NJ",2002-2003,64434,64345,-89,-0.138,-7,-82,34,33,H1
"Salem County, NJ",2003-2004,64345,64835,490,0.762,163,327,34,33,H1
"Salem County, NJ",2004-2005,64835,65388,553,0.853,5,548,34,33,H1
"Salem County, NJ",2005-2006,65388,65831,443,0.677,0,443,34,33,H1
"Salem County, NJ",2006-2007,65831,65864,33,0.05,-107,140,34,33,H1
"Salem County, NJ",2007-2008,65864,65974,110,0.167,131,-21,34,33,H1
"Salem County, NJ",2008-2009,65974,66183,209,0.317,131,78,34,33,H1
"Salem County, NJ",2009-2010,66183,65992,-191,-0.289,95,-286,34,33,H1
"Salem County, NJ",2010-2011,65992,66028,36,0.055,32,4,34,33,H1
"Salem County, NJ",2011-2012,66028,65664,-364,-0.551,32,-396,34,33,H1
"Salem County, NJ",2012-2013,65664,65106,-558,-0.85,39,-597,34,33,H1
"Salem County, NJ",2013-2014,65106,64715,-391,-0.601,-21,-370,34,33,H1
"Salem County, NJ",2014-2015,64670,64180,-490,-0.758,-42,-448,34,33,H1
"Salem County, NJ",2015-2016,64180,63158,-1022,-1.592,-111,-911,34,33,H1
"Salem County, NJ",2016-2017,63158,62792,-366,-0.579,-125,-241,34,33,H1
"Somerset County, NJ",2000-2001,298761,301671,2910,0.974,2324,586,34,35,H1
"Somerset County, NJ",2001-2002,301671,305255,3584,1.188,2349,1235,34,35,H1
"Somerset County, NJ",2002-2003,305255,307902,2647,0.867,2392,255,34,35,H1
"Somerset County, NJ",2003-2004,307902,310424,2522,0.819,2232,290,34,35,H1
"Somerset County, NJ",2004-2005,310424,312617,2193,0.706,2096,97,34,35,H1
"Somerset County, NJ",2005-2006,312617,314993,2376,0.76,2024,352,34,35,H1
"Somerset County, NJ",2006-2007,314993,317128,2135,0.678,1901,234,34,35,H1
"Somerset County, NJ",2007-2008,317128,318856,1728,0.545,1760,-32,34,35,H1
"Somerset County, NJ",2008-2009,318856,321564,2708,0.849,1721,987,34,35,H1
"Somerset County, NJ",2009-2010,321564,324171,2607,0.811,1509,1098,34,35,H1
"Somerset County, NJ",2010-2011,324171,326795,2624,0.809,1484,1140,34,35,H1
"Somerset County, NJ",2011-2012,326795,328691,1896,0.58,1223,673,34,35,H1
"Somerset County, NJ",2012-2013,328691,331297,2606,0.793,1178,1428,34,35,H1
"Somerset County, NJ",2013-2014,331297,332568,1271,0.384,1053,218,34,35,H1
"Somerset County, NJ",2014-2015,332634,333654,1020,0.307,920,100,34,35,H1
"Somerset County, NJ",2015-2016,333654,334373,719,0.215,696,23,34,35,H1
"Somerset County, NJ",2016-2017,334373,335432,1059,0.317,703,356,34,35,H1
"Sussex County, NJ",2000-2001,144714,146004,1290,0.891,792,498,34,37,H1
"Sussex County, NJ",2001-2002,146004,147712,1708,1.17,690,1018,34,37,H1
"Sussex County, NJ",2002-2003,147712,149260,1548,1.048,701,847,34,37,H1
"Sussex County, NJ",2003-2004,149260,149906,646,0.433,643,3,34,37,H1
"Sussex County, NJ",2004-2005,149906,150192,286,0.191,537,-251,34,37,H1
"Sussex County, NJ",2005-2006,150192,150508,316,0.21,655,-339,34,37,H1
"Sussex County, NJ",2006-2007,150508,150600,92,0.061,562,-470,34,37,H1
"Sussex County, NJ",2007-2008,150600,150145,-455,-0.302,585,-1040,34,37,H1
"Sussex County, NJ",2008-2009,150145,149487,-658,-0.438,554,-1212,34,37,H1
"Sussex County, NJ",2009-2010,149487,148770,-717,-0.48,364,-1081,34,37,H1
"Sussex County, NJ",2010-2011,148770,148034,-736,-0.495,223,-959,34,37,H1
"Sussex County, NJ",2011-2012,148034,146985,-1049,-0.709,227,-1276,34,37,H1
"Sussex County, NJ",2012-2013,146985,145740,-1245,-0.847,138,-1383,34,37,H1
"Sussex County, NJ",2013-2014,145740,144909,-831,-0.57,72,-903,34,37,H1
"Sussex County, NJ",2014-2015,145004,143673,-1331,-0.918,46,-1377,34,37,H1
"Sussex County, NJ",2015-2016,143673,142288,-1385,-0.964,-14,-1371,34,37,H1
"Sussex County, NJ",2016-2017,142288,141682,-606,-0.426,-56,-550,34,37,H1
"Union County, NJ",2000-2001,523124,526183,3059,0.585,2932,127,34,39,H1
"Union County, NJ",2001-2002,526183,527625,1442,0.274,2694,-1252,34,39,H1
"Union County, NJ",2002-2003,527625,527611,-14,-0.003,3311,-3325,34,39,H1
"Union County, NJ",2003-2004,527611,526916,-695,-0.132,3236,-3931,34,39,H1
"Union County, NJ",2004-2005,526916,526161,-755,-0.143,3022,-3777,34,39,H1
"Union County, NJ",2005-2006,526161,525153,-1008,-0.192,3049,-4057,34,39,H1
"Union County, NJ",2006-2007,525153,524960,-193,-0.037,3419,-3612,34,39,H1
"Union County, NJ",2007-2008,524960,527528,2568,0.489,3324,-756,34,39,H1
"Union County, NJ",2008-2009,527528,532434,4906,0.93,3122,1784,34,39,H1
"Union County, NJ",2009-2010,532434,537810,5376,1.01,3369,2007,34,39,H1
"Union County, NJ",2010-2011,537810,540709,2899,0.539,3044,-145,34,39,H1
"Union County, NJ",2011-2012,540709,545001,4292,0.794,2931,1361,34,39,H1
"Union County, NJ",2012-2013,545001,549723,4722,0.866,3028,1694,34,39,H1
"Union County, NJ",2013-2014,549723,552939,3216,0.585,2917,299,34,39,H1
"Union County, NJ",2014-2015,553049,555786,2737,0.495,2900,-163,34,39,H1
"Union County, NJ",2015-2016,555786,561106,5320,0.957,2851,2469,34,39,H1
"Union County, NJ",2016-2017,561106,563892,2786,0.497,2720,66,34,39,H1
"Warren County, NJ",2000-2001,102902,105201,2299,2.234,521,1778,34,41,H1
"Warren County, NJ",2001-2002,105201,106774,1573,1.495,430,1143,34,41,H1
"Warren County, NJ",2002-2003,106774,108163,1389,1.301,521,868,34,41,H1
"Warren County, NJ",2003-2004,108163,108491,328,0.303,318,10,34,41,H1
"Warren County, NJ",2004-2005,108491,108855,364,0.336,402,-38,34,41,H1
"Warren County, NJ",2005-2006,108855,109059,204,0.187,362,-158,34,41,H1
"Warren County, NJ",2006-2007,109059,109179,120,0.11,347,-227,34,41,H1
"Warren County, NJ",2007-2008,109179,109264,85,0.078,299,-214,34,41,H1
"Warren County, NJ",2008-2009,109264,108693,-571,-0.523,303,-874,34,41,H1
"Warren County, NJ",2009-2010,108693,108676,-17,-0.016,233,-250,34,41,H1
"Warren County, NJ",2010-2011,108676,108138,-538,-0.495,67,-605,34,41,H1
"Warren County, NJ",2011-2012,108138,107550,-588,-0.544,28,-616,34,41,H1
"Warren County, NJ",2012-2013,107550,106839,-711,-0.661,-77,-634,34,41,H1
"Warren County, NJ",2013-2014,106839,106917,78,0.073,43,35,34,41,H1
"Warren County, NJ",2014-2015,106855,106869,14,0.013,147,-133,34,41,H1
"Warren County, NJ",2015-2016,106869,106845,-24,-0.022,-10,-14,34,41,H1
"Warren County, NJ",2016-2017,106845,106798,-47,-0.044,21,-68,34,41,H1
New Mexico,2000-2001,1821204,1831690,10486,0.576,13378,-2892,35,0,STATE
New Mexico,2001-2002,1831690,1855309,23619,1.289,13017,10602,35,0,STATE
New Mexico,2002-2003,1855309,1877574,22265,1.2,13489,8776,35,0,STATE
New Mexico,2003-2004,1877574,1903808,26234,1.397,13306,12928,35,0,STATE
New Mexico,2004-2005,1903808,1932274,28466,1.495,14211,14255,35,0,STATE
New Mexico,2005-2006,1932274,1962137,29863,1.545,13717,16146,35,0,STATE
New Mexico,2006-2007,1962137,1990070,27933,1.424,15365,12568,35,0,STATE
New Mexico,2007-2008,1990070,2010662,20592,1.035,15157,5435,35,0,STATE
New Mexico,2008-2009,2010662,2036802,26140,1.3,14544,11596,35,0,STATE
New Mexico,2009-2010,2036802,2064741,27939,1.372,13438,14501,35,0,STATE
New Mexico,2010-2011,2064741,2078226,13485,0.653,11429,2056,35,0,STATE
New Mexico,2011-2012,2078226,2084792,6566,0.316,10580,-4014,35,0,STATE
New Mexico,2012-2013,2084792,2086890,2098,0.101,9932,-7834,35,0,STATE
New Mexico,2013-2014,2086890,2085567,-1323,-0.063,9187,-10510,35,0,STATE
New Mexico,2014-2015,2085567,2085109,-458,-0.022,9236,-9694,35,0,STATE
New Mexico,2015-2016,2085109,2085432,323,0.015,7310,-6987,35,0,STATE
New Mexico,2016-2017,2085432,2088070,2638,0.126,7348,-4710,35,0,STATE
"Bernalillo County, NM",2000-2001,557601,564241,6640,1.191,4117,2523,35,1,H1
"Bernalillo County, NM",2001-2002,564241,576532,12291,2.178,3973,8318,35,1,H1
"Bernalillo County, NM",2002-2003,576532,587049,10517,1.824,4477,6040,35,1,H1
"Bernalillo County, NM",2003-2004,587049,600449,13400,2.283,4217,9183,35,1,H1
"Bernalillo County, NM",2004-2005,600449,615320,14871,2.477,4792,10079,35,1,H1
"Bernalillo County, NM",2005-2006,615320,628632,13312,2.163,4428,8884,35,1,H1
"Bernalillo County, NM",2006-2007,628632,638978,10346,1.646,5066,5280,35,1,H1
"Bernalillo County, NM",2007-2008,638978,646879,7901,1.237,4967,2934,35,1,H1
"Bernalillo County, NM",2008-2009,646879,655279,8400,1.299,4805,3595,35,1,H1
"Bernalillo County, NM",2009-2010,655279,664110,8831,1.348,4577,4254,35,1,H1
"Bernalillo County, NM",2010-2011,664110,669604,5494,0.827,3440,2054,35,1,H1
"Bernalillo County, NM",2011-2012,669604,672995,3391,0.506,3533,-142,35,1,H1
"Bernalillo County, NM",2012-2013,672995,674883,1888,0.281,2926,-1038,35,1,H1
"Bernalillo County, NM",2013-2014,674883,675551,668,0.099,2828,-2160,35,1,H1
"Bernalillo County, NM",2014-2015,675647,676685,1038,0.154,2582,-1544,35,1,H1
"Bernalillo County, NM",2015-2016,676685,675588,-1097,-0.162,2008,-3105,35,1,H1
"Bernalillo County, NM",2016-2017,675588,676773,1185,0.175,1968,-783,35,1,H1
"Catron County, NM",2000-2001,3567,3488,-79,-2.215,-11,-68,35,3,H1
"Catron County, NM",2001-2002,3488,3501,13,0.373,-17,30,35,3,H1
"Catron County, NM",2002-2003,3501,3456,-45,-1.285,-12,-33,35,3,H1
"Catron County, NM",2003-2004,3456,3468,12,0.347,-13,25,35,3,H1
"Catron County, NM",2004-2005,3468,3425,-43,-1.24,-18,-25,35,3,H1
"Catron County, NM",2005-2006,3425,3573,148,4.321,-4,152,35,3,H1
"Catron County, NM",2006-2007,3573,3638,65,1.819,-4,69,35,3,H1
"Catron County, NM",2007-2008,3638,3631,-7,-0.192,-15,8,35,3,H1
"Catron County, NM",2008-2009,3631,3689,58,1.597,-1,59,35,3,H1
"Catron County, NM",2009-2010,3689,3741,52,1.41,-8,60,35,3,H1
"Catron County, NM",2010-2011,3741,3714,-27,-0.722,-23,-4,35,3,H1
"Catron County, NM",2011-2012,3714,3652,-62,-1.669,-9,-53,35,3,H1
"Catron County, NM",2012-2013,3652,3592,-60,-1.643,-7,-53,35,3,H1
"Catron County, NM",2013-2014,3592,3556,-36,-1.002,15,-51,35,3,H1
"Catron County, NM",2014-2015,3534,3456,-78,-2.207,5,-83,35,3,H1
"Catron County, NM",2015-2016,3456,3532,76,2.199,-10,86,35,3,H1
"Catron County, NM",2016-2017,3532,3587,55,1.557,-7,62,35,3,H1
"Chaves County, NM",2000-2001,61317,60928,-389,-0.634,345,-734,35,5,H1
"Chaves County, NM",2001-2002,60928,60768,-160,-0.263,294,-454,35,5,H1
"Chaves County, NM",2002-2003,60768,61248,480,0.79,291,189,35,5,H1
"Chaves County, NM",2003-2004,61248,61478,230,0.376,333,-103,35,5,H1
"Chaves County, NM",2004-2005,61478,62172,694,1.129,396,298,35,5,H1
"Chaves County, NM",2005-2006,62172,62486,314,0.505,333,-19,35,5,H1
"Chaves County, NM",2006-2007,62486,63587,1101,1.762,504,597,35,5,H1
"Chaves County, NM",2007-2008,63587,64378,791,1.244,411,380,35,5,H1
"Chaves County, NM",2008-2009,64378,65110,732,1.137,388,344,35,5,H1
"Chaves County, NM",2009-2010,65110,65779,669,1.027,369,300,35,5,H1
"Chaves County, NM",2010-2011,65779,65726,-53,-0.081,293,-346,35,5,H1
"Chaves County, NM",2011-2012,65726,65828,102,0.155,268,-166,35,5,H1
"Chaves County, NM",2012-2013,65828,66041,213,0.324,358,-145,35,5,H1
"Chaves County, NM",2013-2014,66041,65878,-163,-0.247,341,-504,35,5,H1
"Chaves County, NM",2014-2015,65837,65764,-73,-0.111,303,-376,35,5,H1
"Chaves County, NM",2015-2016,65764,65371,-393,-0.598,284,-677,35,5,H1
"Chaves County, NM",2016-2017,65371,64866,-505,-0.773,282,-787,35,5,H1
"Cibola County, NM",2000-2001,25633,26488,855,3.336,251,604,35,6,H1
"Cibola County, NM",2001-2002,26488,26592,104,0.393,158,-54,35,6,H1
"Cibola County, NM",2002-2003,26592,26940,348,1.309,203,145,35,6,H1
"Cibola County, NM",2003-2004,26940,27167,227,0.843,222,5,35,6,H1
"Cibola County, NM",2004-2005,27167,27204,37,0.136,213,-176,35,6,H1
"Cibola County, NM",2005-2006,27204,27032,-172,-0.632,192,-364,35,6,H1
"Cibola County, NM",2006-2007,27032,27258,226,0.836,259,-33,35,6,H1
"Cibola County, NM",2007-2008,27258,27259,1,0.004,236,-235,35,6,H1
"Cibola County, NM",2008-2009,27259,27097,-162,-0.594,209,-371,35,6,H1
"Cibola County, NM",2009-2010,27097,27303,206,0.76,152,54,35,6,H1
"Cibola County, NM",2010-2011,27303,27509,206,0.754,168,38,35,6,H1
"Cibola County, NM",2011-2012,27509,27318,-191,-0.694,151,-342,35,6,H1
"Cibola County, NM",2012-2013,27318,27483,165,0.604,180,-15,35,6,H1
"Cibola County, NM",2013-2014,27483,27349,-134,-0.488,158,-292,35,6,H1
"Cibola County, NM",2014-2015,27282,27329,47,0.172,106,-59,35,6,H1
"Cibola County, NM",2015-2016,27329,26996,-333,-1.218,58,-391,35,6,H1
"Cibola County, NM",2016-2017,26996,26853,-143,-0.53,52,-195,35,6,H1
"Colfax County, NM",2000-2001,14202,14140,-62,-0.437,-1,-61,35,7,H1
"Colfax County, NM",2001-2002,14140,14215,75,0.53,24,51,35,7,H1
"Colfax County, NM",2002-2003,14215,14088,-127,-0.893,14,-141,35,7,H1
"Colfax County, NM",2003-2004,14088,14093,5,0.035,20,-15,35,7,H1
"Colfax County, NM",2004-2005,14093,14031,-62,-0.44,15,-77,35,7,H1
"Colfax County, NM",2005-2006,14031,13982,-49,-0.349,-18,-31,35,7,H1
"Colfax County, NM",2006-2007,13982,13933,-49,-0.35,3,-52,35,7,H1
"Colfax County, NM",2007-2008,13933,13764,-169,-1.213,32,-201,35,7,H1
"Colfax County, NM",2008-2009,13764,13731,-33,-0.24,-5,-28,35,7,H1
"Colfax County, NM",2009-2010,13731,13739,8,0.058,10,-2,35,7,H1
"Colfax County, NM",2010-2011,13739,13618,-121,-0.881,5,-126,35,7,H1
"Colfax County, NM",2011-2012,13618,13230,-388,-2.849,-30,-358,35,7,H1
"Colfax County, NM",2012-2013,13230,13054,-176,-1.33,-8,-168,35,7,H1
"Colfax County, NM",2013-2014,13054,12680,-374,-2.865,-27,-347,35,7,H1
"Colfax County, NM",2014-2015,12684,12414,-270,-2.129,-11,-259,35,7,H1
"Colfax County, NM",2015-2016,12414,12262,-152,-1.224,-39,-113,35,7,H1
"Colfax County, NM",2016-2017,12262,12174,-88,-0.718,-31,-57,35,7,H1
"Curry County, NM",2000-2001,44991,44964,-27,-0.06,440,-467,35,9,H1
"Curry County, NM",2001-2002,44964,45133,169,0.376,398,-229,35,9,H1
"Curry County, NM",2002-2003,45133,45385,252,0.558,494,-242,35,9,H1
"Curry County, NM",2003-2004,45385,46640,1255,2.765,527,728,35,9,H1
"Curry County, NM",2004-2005,46640,46981,341,0.731,548,-207,35,9,H1
"Curry County, NM",2005-2006,46981,47018,37,0.079,513,-476,35,9,H1
"Curry County, NM",2006-2007,47018,46588,-430,-0.915,570,-1.00E+03,35,9,H1
"Curry County, NM",2007-2008,46588,45512,-1076,-2.31,468,-1544,35,9,H1
"Curry County, NM",2008-2009,45512,46555,1043,2.292,428,615,35,9,H1
"Curry County, NM",2009-2010,46555,48962,2407,5.17,511,1896,35,9,H1
"Curry County, NM",2010-2011,48962,49681,719,1.468,581,138,35,9,H1
"Curry County, NM",2011-2012,49681,50674,993,1.999,561,432,35,9,H1
"Curry County, NM",2012-2013,50674,50580,-94,-0.185,533,-627,35,9,H1
"Curry County, NM",2013-2014,50580,50969,389,0.769,561,-172,35,9,H1
"Curry County, NM",2014-2015,51055,50398,-657,-1.287,582,-1239,35,9,H1
"Curry County, NM",2015-2016,50398,50168,-230,-0.456,488,-718,35,9,H1
"Curry County, NM",2016-2017,50168,49812,-356,-0.71,516,-872,35,9,H1
"De Baca County, NM",2000-2001,2218,2174,-44,-1.984,-7,-37,35,11,H1
"De Baca County, NM",2001-2002,2174,2158,-16,-0.736,-16,0,35,11,H1
"De Baca County, NM",2002-2003,2158,2132,-26,-1.205,-11,-15,35,11,H1
"De Baca County, NM",2003-2004,2132,2062,-70,-3.283,-9,-61,35,11,H1
"De Baca County, NM",2004-2005,2062,2098,36,1.746,0,36,35,11,H1
"De Baca County, NM",2005-2006,2098,1994,-104,-4.957,-19,-85,35,11,H1
"De Baca County, NM",2006-2007,1994,1995,1,0.05,-2,3,35,11,H1
"De Baca County, NM",2007-2008,1995,2.00E+03,5,0.251,1,4,35,11,H1
"De Baca County, NM",2008-2009,2.00E+03,2002,2,0.1,3,-1,35,11,H1
"De Baca County, NM",2009-2010,2002,2016,14,0.699,0,14,35,11,H1
"De Baca County, NM",2010-2011,2016,1967,-49,-2.431,4,-53,35,11,H1
"De Baca County, NM",2011-2012,1967,1935,-32,-1.627,-12,-20,35,11,H1
"De Baca County, NM",2012-2013,1935,1891,-44,-2.274,-17,-27,35,11,H1
"De Baca County, NM",2013-2014,1891,1825,-66,-3.49,-8,-58,35,11,H1
"De Baca County, NM",2014-2015,1827,1828,1,0.055,-11,12,35,11,H1
"De Baca County, NM",2015-2016,1828,1841,13,0.711,-9,22,35,11,H1
"De Baca County, NM",2016-2017,1841,1829,-12,-0.652,0,-12,35,11,H1
"Do̱a Ana County, NM",2000-2001,175098,176496,1398,0.798,1967,-569,35,13,H1
"Do̱a Ana County, NM",2001-2002,176496,178464,1968,1.115,1870,98,35,13,H1
"Do̱a Ana County, NM",2002-2003,178464,182045,3581,2.007,1995,1586,35,13,H1
"Do̱a Ana County, NM",2003-2004,182045,184939,2894,1.59,1895,999,35,13,H1
"Do̱a Ana County, NM",2004-2005,184939,189199,4260,2.303,2126,2134,35,13,H1
"Do̱a Ana County, NM",2005-2006,189199,193701,4502,2.38,2188,2314,35,13,H1
"Do̱a Ana County, NM",2006-2007,193701,197853,4152,2.144,2182,1970,35,13,H1
"Do̱a Ana County, NM",2007-2008,197853,200855,3002,1.517,2179,823,35,13,H1
"Do̱a Ana County, NM",2008-2009,200855,205401,4546,2.263,2211,2335,35,13,H1
"Do̱a Ana County, NM",2009-2010,205401,210237,4836,2.354,2049,2787,35,13,H1
"Do̱a Ana County, NM",2010-2011,210237,212890,2653,1.262,1854,799,35,13,H1
"Do̱a Ana County, NM",2011-2012,212890,214208,1318,0.619,1576,-258,35,13,H1
"Do̱a Ana County, NM",2012-2013,214208,213697,-511,-0.239,1509,-2020,35,13,H1
"Do̱a Ana County, NM",2013-2014,213697,213676,-21,-0.01,1444,-1465,35,13,H1
"Do̱a Ana County, NM",2014-2015,214059,214295,236,0.11,1427,-1191,35,13,H1
"Do̱a Ana County, NM",2015-2016,214295,213874,-421,-0.196,1345,-1766,35,13,H1
"Do̱a Ana County, NM",2016-2017,213874,215579,1705,0.797,1324,381,35,13,H1
"Eddy County, NM",2000-2001,51399,50765,-634,-1.233,169,-803,35,15,H1
"Eddy County, NM",2001-2002,50765,51002,237,0.467,228,9,35,15,H1
"Eddy County, NM",2002-2003,51002,51036,34,0.067,181,-147,35,15,H1
"Eddy County, NM",2003-2004,51036,51242,206,0.404,199,7,35,15,H1
"Eddy County, NM",2004-2005,51242,50732,-510,-0.995,139,-649,35,15,H1
"Eddy County, NM",2005-2006,50732,51366,634,1.25,168,466,35,15,H1
"Eddy County, NM",2006-2007,51366,51923,557,1.084,285,272,35,15,H1
"Eddy County, NM",2007-2008,51923,52566,643,1.238,269,374,35,15,H1
"Eddy County, NM",2008-2009,52566,53578,1012,1.925,205,807,35,15,H1
"Eddy County, NM",2009-2010,53578,53897,319,0.595,176,143,35,15,H1
"Eddy County, NM",2010-2011,53897,54021,124,0.23,189,-65,35,15,H1
"Eddy County, NM",2011-2012,54021,54370,349,0.646,190,159,35,15,H1
"Eddy County, NM",2012-2013,54370,55486,1116,2.053,348,768,35,15,H1
"Eddy County, NM",2013-2014,55486,56395,909,1.638,304,605,35,15,H1
"Eddy County, NM",2014-2015,56583,57578,995,1.758,392,603,35,15,H1
"Eddy County, NM",2015-2016,57578,57456,-122,-0.212,343,-465,35,15,H1
"Eddy County, NM",2016-2017,57456,56997,-459,-0.799,342,-801,35,15,H1
"Grant County, NM",2000-2001,30882,30692,-190,-0.615,84,-274,35,17,H1
"Grant County, NM",2001-2002,30692,30165,-527,-1.717,83,-610,35,17,H1
"Grant County, NM",2002-2003,30165,29485,-680,-2.254,50,-730,35,17,H1
"Grant County, NM",2003-2004,29485,29038,-447,-1.516,1,-448,35,17,H1
"Grant County, NM",2004-2005,29038,29281,243,0.837,64,179,35,17,H1
"Grant County, NM",2005-2006,29281,29503,222,0.758,85,137,35,17,H1
"Grant County, NM",2006-2007,29503,29841,338,1.146,54,284,35,17,H1
"Grant County, NM",2007-2008,29841,29921,80,0.268,50,30,35,17,H1
"Grant County, NM",2008-2009,29921,29865,-56,-0.187,42,-98,35,17,H1
"Grant County, NM",2009-2010,29865,29383,-482,-1.614,19,-501,35,17,H1
"Grant County, NM",2010-2011,29383,29385,2,0.007,-5,7,35,17,H1
"Grant County, NM",2011-2012,29385,29339,-46,-0.157,-49,3,35,17,H1
"Grant County, NM",2012-2013,29339,29310,-29,-0.099,-4,-25,35,17,H1
"Grant County, NM",2013-2014,29310,29096,-214,-0.73,1,-215,35,17,H1
"Grant County, NM",2014-2015,29002,28609,-393,-1.355,-28,-365,35,17,H1
"Grant County, NM",2015-2016,28609,28033,-576,-2.013,-52,-524,35,17,H1
"Grant County, NM",2016-2017,28033,27687,-346,-1.234,-40,-306,35,17,H1
"Guadalupe County, NM",2000-2001,4693,4791,98,2.088,10,88,35,19,H1
"Guadalupe County, NM",2001-2002,4791,4771,-20,-0.417,33,-53,35,19,H1
"Guadalupe County, NM",2002-2003,4771,4875,104,2.18,9,95,35,19,H1
"Guadalupe County, NM",2003-2004,4875,4731,-144,-2.954,-8,-136,35,19,H1
"Guadalupe County, NM",2004-2005,4731,4713,-18,-0.38,-8,-10,35,19,H1
"Guadalupe County, NM",2005-2006,4713,4701,-12,-0.255,-3,-9,35,19,H1
"Guadalupe County, NM",2006-2007,4701,4759,58,1.234,4,54,35,19,H1
"Guadalupe County, NM",2007-2008,4759,4701,-58,-1.219,4,-62,35,19,H1
"Guadalupe County, NM",2008-2009,4701,4637,-64,-1.361,5,-69,35,19,H1
"Guadalupe County, NM",2009-2010,4637,4688,51,1.1,13,38,35,19,H1
"Guadalupe County, NM",2010-2011,4688,4646,-42,-0.896,9,-51,35,19,H1
"Guadalupe County, NM",2011-2012,4646,4607,-39,-0.839,2,-41,35,19,H1
"Guadalupe County, NM",2012-2013,4607,4560,-47,-1.02,6,-53,35,19,H1
"Guadalupe County, NM",2013-2014,4560,4468,-92,-2.018,1,-93,35,19,H1
"Guadalupe County, NM",2014-2015,4443,4371,-72,-1.621,-2,-70,35,19,H1
"Guadalupe County, NM",2015-2016,4371,4372,1,0.023,17,-16,35,19,H1
"Guadalupe County, NM",2016-2017,4372,4429,57,1.304,10,47,35,19,H1
"Harding County, NM",2000-2001,801,781,-20,-2.497,-6,-14,35,21,H1
"Harding County, NM",2001-2002,781,745,-36,-4.609,-8,-28,35,21,H1
"Harding County, NM",2002-2003,745,763,18,2.416,-5,23,35,21,H1
"Harding County, NM",2003-2004,763,782,19,2.49,-4,23,35,21,H1
"Harding County, NM",2004-2005,782,756,-26,-3.325,-1,-25,35,21,H1
"Harding County, NM",2005-2006,756,749,-7,-0.926,-3,-4,35,21,H1
"Harding County, NM",2006-2007,749,732,-17,-2.27,-4,-13,35,21,H1
"Harding County, NM",2007-2008,732,690,-42,-5.738,0,-42,35,21,H1
"Harding County, NM",2008-2009,690,700,10,1.449,2,8,35,21,H1
"Harding County, NM",2009-2010,700,688,-12,-1.714,1,-13,35,21,H1
"Harding County, NM",2010-2011,688,713,25,3.634,-9,34,35,21,H1
"Harding County, NM",2011-2012,713,701,-12,-1.683,-2,-10,35,21,H1
"Harding County, NM",2012-2013,701,688,-13,-1.854,2,-15,35,21,H1
"Harding County, NM",2013-2014,688,683,-5,-0.727,-1,-4,35,21,H1
"Harding County, NM",2014-2015,677,698,21,3.102,1,20,35,21,H1
"Harding County, NM",2015-2016,698,692,-6,-0.86,-2,-4,35,21,H1
"Harding County, NM",2016-2017,692,692,0,0,-2,2,35,21,H1
"Hidalgo County, NM",2000-2001,5766,5439,-327,-5.671,30,-357,35,23,H1
"Hidalgo County, NM",2001-2002,5439,5272,-167,-3.07,11,-178,35,23,H1
"Hidalgo County, NM",2002-2003,5272,5127,-145,-2.75,13,-158,35,23,H1
"Hidalgo County, NM",2003-2004,5127,5028,-99,-1.931,8,-107,35,23,H1
"Hidalgo County, NM",2004-2005,5028,4955,-73,-1.452,13,-86,35,23,H1
"Hidalgo County, NM",2005-2006,4955,4921,-34,-0.686,-8,-26,35,23,H1
"Hidalgo County, NM",2006-2007,4921,5005,84,1.707,10,74,35,23,H1
"Hidalgo County, NM",2007-2008,5005,5022,17,0.34,33,-16,35,23,H1
"Hidalgo County, NM",2008-2009,5022,5019,-3,-0.06,29,-32,35,23,H1
"Hidalgo County, NM",2009-2010,5019,4851,-168,-3.347,27,-195,35,23,H1
"Hidalgo County, NM",2010-2011,4851,4844,-7,-0.144,22,-29,35,23,H1
"Hidalgo County, NM",2011-2012,4844,4789,-55,-1.135,9,-64,35,23,H1
"Hidalgo County, NM",2012-2013,4789,4626,-163,-3.404,20,-183,35,23,H1
"Hidalgo County, NM",2013-2014,4626,4560,-66,-1.427,-1,-65,35,23,H1
"Hidalgo County, NM",2014-2015,4547,4423,-124,-2.727,8,-132,35,23,H1
"Hidalgo County, NM",2015-2016,4423,4330,-93,-2.103,15,-108,35,23,H1
"Hidalgo County, NM",2016-2017,4330,4305,-25,-0.577,8,-33,35,23,H1
"Lea County, NM",2000-2001,55264,55377,113,0.204,422,-309,35,25,H1
"Lea County, NM",2001-2002,55377,56340,963,1.739,409,554,35,25,H1
"Lea County, NM",2002-2003,56340,56643,303,0.538,440,-137,35,25,H1
"Lea County, NM",2003-2004,56643,57471,828,1.462,505,323,35,25,H1
"Lea County, NM",2004-2005,57471,58331,860,1.496,478,382,35,25,H1
"Lea County, NM",2005-2006,58331,59541,1210,2.074,567,643,35,25,H1
"Lea County, NM",2006-2007,59541,61058,1517,2.548,673,844,35,25,H1
"Lea County, NM",2007-2008,61058,62737,1679,2.75,737,942,35,25,H1
"Lea County, NM",2008-2009,62737,64483,1746,2.783,622,1124,35,25,H1
"Lea County, NM",2009-2010,64483,64644,161,0.25,564,-403,35,25,H1
"Lea County, NM",2010-2011,64644,65103,459,0.71,537,-78,35,25,H1
"Lea County, NM",2011-2012,65103,66286,1183,1.817,611,572,35,25,H1
"Lea County, NM",2012-2013,66286,68347,2061,3.109,679,1382,35,25,H1
"Lea County, NM",2013-2014,68347,69999,1652,2.417,736,916,35,25,H1
"Lea County, NM",2014-2015,69930,71180,1250,1.788,719,531,35,25,H1
"Lea County, NM",2015-2016,71180,69850,-1330,-1.869,639,-1969,35,25,H1
"Lea County, NM",2016-2017,69850,68759,-1091,-1.562,612,-1703,35,25,H1
"Lincoln County, NM",2000-2001,19477,19333,-144,-0.739,66,-210,35,27,H1
"Lincoln County, NM",2001-2002,19333,19467,134,0.693,41,93,35,27,H1
"Lincoln County, NM",2002-2003,19467,19930,463,2.378,35,428,35,27,H1
"Lincoln County, NM",2003-2004,19930,20242,312,1.565,89,223,35,27,H1
"Lincoln County, NM",2004-2005,20242,20453,211,1.042,73,138,35,27,H1
"Lincoln County, NM",2005-2006,20453,20588,135,0.66,34,101,35,27,H1
"Lincoln County, NM",2006-2007,20588,20442,-146,-0.709,58,-204,35,27,H1
"Lincoln County, NM",2007-2008,20442,20458,16,0.078,72,-56,35,27,H1
"Lincoln County, NM",2008-2009,20458,20521,63,0.308,61,2,35,27,H1
"Lincoln County, NM",2009-2010,20521,20470,-51,-0.249,28,-79,35,27,H1
"Lincoln County, NM",2010-2011,20470,20402,-68,-0.332,21,-89,35,27,H1
"Lincoln County, NM",2011-2012,20402,20208,-194,-0.951,-2,-192,35,27,H1
"Lincoln County, NM",2012-2013,20208,20023,-185,-0.915,27,-212,35,27,H1
"Lincoln County, NM",2013-2014,20023,19706,-317,-1.583,20,-337,35,27,H1
"Lincoln County, NM",2014-2015,19663,19420,-243,-1.236,-2,-241,35,27,H1
"Lincoln County, NM",2015-2016,19420,19294,-126,-0.649,-6,-120,35,27,H1
"Lincoln County, NM",2016-2017,19294,19395,101,0.523,-5,106,35,27,H1
"Los Alamos County, NM",2000-2001,18263,17610,-653,-3.576,56,-709,35,28,H1
"Los Alamos County, NM",2001-2002,17610,18060,450,2.555,85,365,35,28,H1
"Los Alamos County, NM",2002-2003,18060,18408,348,1.927,73,275,35,28,H1
"Los Alamos County, NM",2003-2004,18408,18416,8,0.043,102,-94,35,28,H1
"Los Alamos County, NM",2004-2005,18416,18407,-9,-0.049,95,-104,35,28,H1
"Los Alamos County, NM",2005-2006,18407,18477,70,0.38,93,-23,35,28,H1
"Los Alamos County, NM",2006-2007,18477,18281,-196,-1.061,72,-268,35,28,H1
"Los Alamos County, NM",2007-2008,18281,17924,-357,-1.953,73,-430,35,28,H1
"Los Alamos County, NM",2008-2009,17924,17742,-182,-1.015,67,-249,35,28,H1
"Los Alamos County, NM",2009-2010,17742,18012,270,1.522,72,198,35,28,H1
"Los Alamos County, NM",2010-2011,18012,18181,169,0.938,77,92,35,28,H1
"Los Alamos County, NM",2011-2012,18181,18162,-19,-0.105,46,-65,35,28,H1
"Los Alamos County, NM",2012-2013,18162,17831,-331,-1.822,52,-383,35,28,H1
"Los Alamos County, NM",2013-2014,17831,17682,-149,-0.836,65,-214,35,28,H1
"Los Alamos County, NM",2014-2015,17718,17785,67,0.378,69,-2,35,28,H1
"Los Alamos County, NM",2015-2016,17785,18152,367,2.064,65,302,35,28,H1
"Los Alamos County, NM",2016-2017,18152,18738,586,3.228,72,514,35,28,H1
"Luna County, NM",2000-2001,24908,24593,-315,-1.265,141,-456,35,29,H1
"Luna County, NM",2001-2002,24593,24630,37,0.15,161,-124,35,29,H1
"Luna County, NM",2002-2003,24630,24762,132,0.536,151,-19,35,29,H1
"Luna County, NM",2003-2004,24762,24822,60,0.242,144,-84,35,29,H1
"Luna County, NM",2004-2005,24822,25102,280,1.128,170,110,35,29,H1
"Luna County, NM",2005-2006,25102,25303,201,0.801,98,103,35,29,H1
"Luna County, NM",2006-2007,25303,25328,25,0.099,125,-100,35,29,H1
"Luna County, NM",2007-2008,25328,25375,47,0.186,203,-156,35,29,H1
"Luna County, NM",2008-2009,25375,25119,-256,-1.009,150,-406,35,29,H1
"Luna County, NM",2009-2010,25119,25116,-3,-0.012,130,-133,35,29,H1
"Luna County, NM",2010-2011,25116,25147,31,0.123,86,-55,35,29,H1
"Luna County, NM",2011-2012,25147,25019,-128,-0.509,104,-232,35,29,H1
"Luna County, NM",2012-2013,25019,24778,-241,-0.963,143,-384,35,29,H1
"Luna County, NM",2013-2014,24778,24673,-105,-0.424,147,-252,35,29,H1
"Luna County, NM",2014-2015,24586,24518,-68,-0.277,130,-198,35,29,H1
"Luna County, NM",2015-2016,24518,24288,-230,-0.938,126,-356,35,29,H1
"Luna County, NM",2016-2017,24288,24078,-210,-0.865,135,-345,35,29,H1
"McKinley County, NM",2000-2001,74563,74387,-176,-0.236,858,-1034,35,31,H1
"McKinley County, NM",2001-2002,74387,72868,-1519,-2.042,921,-2440,35,31,H1
"McKinley County, NM",2002-2003,72868,71545,-1323,-1.816,898,-2221,35,31,H1
"McKinley County, NM",2003-2004,71545,71500,-45,-0.063,914,-959,35,31,H1
"McKinley County, NM",2004-2005,71500,70666,-834,-1.166,867,-1701,35,31,H1
"McKinley County, NM",2005-2006,70666,70541,-125,-0.177,896,-1021,35,31,H1
"McKinley County, NM",2006-2007,70541,69959,-582,-0.825,940,-1522,35,31,H1
"McKinley County, NM",2007-2008,69959,70449,490,0.7,912,-422,35,31,H1
"McKinley County, NM",2008-2009,70449,70567,118,0.167,921,-803,35,31,H1
"McKinley County, NM",2009-2010,70567,71766,1199,1.699,893,306,35,31,H1
"McKinley County, NM",2010-2011,71766,73497,1731,2.412,792,939,35,31,H1
"McKinley County, NM",2011-2012,73497,72716,-781,-1.063,703,-1484,35,31,H1
"McKinley County, NM",2012-2013,72716,73332,616,0.847,792,-176,35,31,H1
"McKinley County, NM",2013-2014,73332,74098,766,1.045,787,-21,35,31,H1
"McKinley County, NM",2014-2015,73846,76708,2862,3.876,643,2219,35,31,H1
"McKinley County, NM",2015-2016,76708,72958,-3750,-4.889,336,-4086,35,31,H1
"McKinley County, NM",2016-2017,72958,72564,-394,-0.54,321,-715,35,31,H1
"Mora County, NM",2000-2001,5196,5166,-30,-0.577,1,-31,35,33,H1
"Mora County, NM",2001-2002,5166,5151,-15,-0.29,-4,-11,35,33,H1
"Mora County, NM",2002-2003,5151,5145,-6,-0.116,5,-11,35,33,H1
"Mora County, NM",2003-2004,5145,5061,-84,-1.633,7,-91,35,33,H1
"Mora County, NM",2004-2005,5061,5002,-59,-1.166,3,-62,35,33,H1
"Mora County, NM",2005-2006,5002,4992,-10,-0.2,-2,-8,35,33,H1
"Mora County, NM",2006-2007,4992,4964,-28,-0.561,-1,-27,35,33,H1
"Mora County, NM",2007-2008,4964,4909,-55,-1.108,9,-64,35,33,H1
"Mora County, NM",2008-2009,4909,4859,-50,-1.019,22,-72,35,33,H1
"Mora County, NM",2009-2010,4859,4883,24,0.494,16,8,35,33,H1
"Mora County, NM",2010-2011,4883,4783,-100,-2.048,-2,-98,35,33,H1
"Mora County, NM",2011-2012,4783,4679,-104,-2.174,-5,-99,35,33,H1
"Mora County, NM",2012-2013,4679,4673,-6,-0.128,-7,1,35,33,H1
"Mora County, NM",2013-2014,4673,4592,-81,-1.733,13,-94,35,33,H1
"Mora County, NM",2014-2015,4582,4596,14,0.306,13,1,35,33,H1
"Mora County, NM",2015-2016,4596,4547,-49,-1.066,0,-49,35,33,H1
"Mora County, NM",2016-2017,4547,4551,4,0.088,17,-13,35,33,H1
"Otero County, NM",2000-2001,62151,61277,-874,-1.406,406,-1280,35,35,H1
"Otero County, NM",2001-2002,61277,61194,-83,-0.135,423,-506,35,35,H1
"Otero County, NM",2002-2003,61194,61371,177,0.289,374,-197,35,35,H1
"Otero County, NM",2003-2004,61371,62662,1291,2.104,369,922,35,35,H1
"Otero County, NM",2004-2005,62662,62533,-129,-0.206,335,-464,35,35,H1
"Otero County, NM",2005-2006,62533,62200,-333,-0.533,320,-653,35,35,H1
"Otero County, NM",2006-2007,62200,62466,266,0.428,427,-161,35,35,H1
"Otero County, NM",2007-2008,62466,62498,32,0.051,348,-316,35,35,H1
"Otero County, NM",2008-2009,62498,62462,-36,-0.058,302,-338,35,35,H1
"Otero County, NM",2009-2010,62462,64396,1934,3.096,321,1613,35,35,H1
"Otero County, NM",2010-2011,64396,65597,1201,1.865,412,789,35,35,H1
"Otero County, NM",2011-2012,65597,66102,505,0.77,490,15,35,35,H1
"Otero County, NM",2012-2013,66102,65900,-202,-0.306,382,-584,35,35,H1
"Otero County, NM",2013-2014,65900,65082,-818,-1.241,391,-1209,35,35,H1
"Otero County, NM",2014-2015,64966,64362,-604,-0.93,312,-916,35,35,H1
"Otero County, NM",2015-2016,64362,65184,822,1.277,338,484,35,35,H1
"Otero County, NM",2016-2017,65184,65817,633,0.971,375,258,35,35,H1
"Quay County, NM",2000-2001,10012,9791,-221,-2.207,-28,-193,35,37,H1
"Quay County, NM",2001-2002,9791,9638,-153,-1.563,-32,-121,35,37,H1
"Quay County, NM",2002-2003,9638,9541,-97,-1.006,-15,-82,35,37,H1
"Quay County, NM",2003-2004,9541,9306,-235,-2.463,-24,-211,35,37,H1
"Quay County, NM",2004-2005,9306,9131,-175,-1.881,-20,-155,35,37,H1
"Quay County, NM",2005-2006,9131,9036,-95,-1.04,-9,-86,35,37,H1
"Quay County, NM",2006-2007,9036,8996,-40,-0.443,1,-41,35,37,H1
"Quay County, NM",2007-2008,8996,8978,-18,-0.2,8,-26,35,37,H1
"Quay County, NM",2008-2009,8978,8920,-58,-0.646,-4,-54,35,37,H1
"Quay County, NM",2009-2010,8920,9050,130,1.457,-13,143,35,37,H1
"Quay County, NM",2010-2011,9050,9064,14,0.155,-7,21,35,37,H1
"Quay County, NM",2011-2012,9064,8798,-266,-2.935,3,-269,35,37,H1
"Quay County, NM",2012-2013,8798,8697,-101,-1.148,4,-105,35,37,H1
"Quay County, NM",2013-2014,8697,8501,-196,-2.254,17,-213,35,37,H1
"Quay County, NM",2014-2015,8462,8455,-7,-0.083,-13,6,35,37,H1
"Quay County, NM",2015-2016,8455,8381,-74,-0.875,-11,-63,35,37,H1
"Quay County, NM",2016-2017,8381,8306,-75,-0.895,-10,-65,35,37,H1
"Rio Arriba County, NM",2000-2001,41197,40870,-327,-0.794,385,-712,35,39,H1
"Rio Arriba County, NM",2001-2002,40870,40717,-153,-0.374,354,-507,35,39,H1
"Rio Arriba County, NM",2002-2003,40717,40416,-301,-0.739,330,-631,35,39,H1
"Rio Arriba County, NM",2003-2004,40416,40342,-74,-0.183,368,-442,35,39,H1
"Rio Arriba County, NM",2004-2005,40342,40198,-144,-0.357,317,-461,35,39,H1
"Rio Arriba County, NM",2005-2006,40198,40335,137,0.341,347,-210,35,39,H1
"Rio Arriba County, NM",2006-2007,40335,40268,-67,-0.166,343,-410,35,39,H1
"Rio Arriba County, NM",2007-2008,40268,40008,-260,-0.646,360,-620,35,39,H1
"Rio Arriba County, NM",2008-2009,40008,40023,15,0.037,377,-362,35,39,H1
"Rio Arriba County, NM",2009-2010,40023,40318,295,0.737,358,-63,35,39,H1
"Rio Arriba County, NM",2010-2011,40318,40333,15,0.037,237,-222,35,39,H1
"Rio Arriba County, NM",2011-2012,40333,40260,-73,-0.181,170,-243,35,39,H1
"Rio Arriba County, NM",2012-2013,40260,40088,-172,-0.427,228,-400,35,39,H1
"Rio Arriba County, NM",2013-2014,40088,39777,-311,-0.776,180,-491,35,39,H1
"Rio Arriba County, NM",2014-2015,39686,39465,-221,-0.557,120,-341,35,39,H1
"Rio Arriba County, NM",2015-2016,39465,39158,-307,-0.778,73,-380,35,39,H1
"Rio Arriba County, NM",2016-2017,39158,39159,1,0.003,75,-74,35,39,H1
"Roosevelt County, NM",2000-2001,18007,18377,370,2.055,149,221,35,41,H1
"Roosevelt County, NM",2001-2002,18377,18627,250,1.36,174,76,35,41,H1
"Roosevelt County, NM",2002-2003,18627,18722,95,0.51,147,-52,35,41,H1
"Roosevelt County, NM",2003-2004,18722,18856,134,0.716,161,-27,35,41,H1
"Roosevelt County, NM",2004-2005,18856,19093,237,1.257,189,48,35,41,H1
"Roosevelt County, NM",2005-2006,19093,19186,93,0.487,127,-34,35,41,H1
"Roosevelt County, NM",2006-2007,19186,19359,173,0.902,182,-9,35,41,H1
"Roosevelt County, NM",2007-2008,19359,19074,-285,-1.472,207,-492,35,41,H1
"Roosevelt County, NM",2008-2009,19074,19192,118,0.619,204,-86,35,41,H1
"Roosevelt County, NM",2009-2010,19192,20011,819,4.267,221,598,35,41,H1
"Roosevelt County, NM",2010-2011,20011,20459,448,2.239,126,322,35,41,H1
"Roosevelt County, NM",2011-2012,20459,20336,-123,-0.601,134,-257,35,41,H1
"Roosevelt County, NM",2012-2013,20336,19983,-353,-1.736,99,-452,35,41,H1
"Roosevelt County, NM",2013-2014,19983,19536,-447,-2.237,103,-550,35,41,H1
"Roosevelt County, NM",2014-2015,19626,19120,-506,-2.578,173,-679,35,41,H1
"Roosevelt County, NM",2015-2016,19120,19082,-38,-0.199,148,-186,35,41,H1
"Roosevelt County, NM",2016-2017,19082,18847,-235,-1.232,131,-366,35,41,H1
"Sandoval County, NM",2000-2001,91251,93440,2189,2.399,679,1510,35,43,H1
"Sandoval County, NM",2001-2002,93440,96263,2823,3.021,674,2149,35,43,H1
"Sandoval County, NM",2002-2003,96263,99350,3087,3.207,711,2376,35,43,H1
"Sandoval County, NM",2003-2004,99350,102583,3233,3.254,572,2661,35,43,H1
"Sandoval County, NM",2004-2005,102583,107436,4853,4.731,652,4201,35,43,H1
"Sandoval County, NM",2005-2006,107436,114231,6795,6.325,681,6114,35,43,H1
"Sandoval County, NM",2006-2007,114231,120401,6170,5.401,741,5429,35,43,H1
"Sandoval County, NM",2007-2008,120401,125368,4967,4.125,856,4111,35,43,H1
"Sandoval County, NM",2008-2009,125368,128985,3617,2.885,957,2660,35,43,H1
"Sandoval County, NM",2009-2010,128985,132367,3382,2.622,776,2606,35,43,H1
"Sandoval County, NM",2010-2011,132367,134183,1816,1.372,615,1201,35,43,H1
"Sandoval County, NM",2011-2012,134183,135319,1136,0.847,555,581,35,43,H1
"Sandoval County, NM",2012-2013,135319,136479,1160,0.857,519,641,35,43,H1
"Sandoval County, NM",2013-2014,136479,137608,1129,0.827,498,631,35,43,H1
"Sandoval County, NM",2014-2015,137654,139394,1740,1.264,425,1315,35,43,H1
"Sandoval County, NM",2015-2016,139394,140224,830,0.595,365,465,35,43,H1
"Sandoval County, NM",2016-2017,140224,142507,2283,1.628,392,1891,35,43,H1
"San Juan County, NM",2000-2001,114131,115745,1614,1.414,1185,429,35,45,H1
"San Juan County, NM",2001-2002,115745,119430,3685,3.184,1217,2468,35,45,H1
"San Juan County, NM",2002-2003,119430,121553,2123,1.778,1124,999,35,45,H1
"San Juan County, NM",2003-2004,121553,123179,1626,1.338,1224,402,35,45,H1
"San Juan County, NM",2004-2005,123179,124809,1630,1.323,1278,352,35,45,H1
"San Juan County, NM",2005-2006,124809,125028,219,0.175,1319,-1100,35,45,H1
"San Juan County, NM",2006-2007,125028,126149,1121,0.897,1373,-252,35,45,H1
"San Juan County, NM",2007-2008,126149,126905,756,0.599,1253,-497,35,45,H1
"San Juan County, NM",2008-2009,126905,129359,2454,1.934,1091,1363,35,45,H1
"San Juan County, NM",2009-2010,129359,130155,796,0.615,1039,-243,35,45,H1
"San Juan County, NM",2010-2011,130155,128035,-2120,-1.629,1041,-3161,35,45,H1
"San Juan County, NM",2011-2012,128035,128367,332,0.259,972,-640,35,45,H1
"San Juan County, NM",2012-2013,128367,126448,-1919,-1.495,868,-2787,35,45,H1
"San Juan County, NM",2013-2014,126448,123785,-2663,-2.106,796,-3459,35,45,H1
"San Juan County, NM",2014-2015,123990,118737,-5253,-4.237,840,-6093,35,45,H1
"San Juan County, NM",2015-2016,118737,127772,9035,7.609,680,8355,35,45,H1
"San Juan County, NM",2016-2017,127772,126926,-846,-0.662,657,-1503,35,45,H1
"San Miguel County, NM",2000-2001,30052,29788,-264,-0.878,100,-364,35,47,H1
"San Miguel County, NM",2001-2002,29788,29707,-81,-0.272,149,-230,35,47,H1
"San Miguel County, NM",2002-2003,29707,29530,-177,-0.596,83,-260,35,47,H1
"San Miguel County, NM",2003-2004,29530,29547,17,0.058,113,-96,35,47,H1
"San Miguel County, NM",2004-2005,29547,29621,74,0.25,106,-32,35,47,H1
"San Miguel County, NM",2005-2006,29621,29388,-233,-0.787,110,-343,35,47,H1
"San Miguel County, NM",2006-2007,29388,29259,-129,-0.439,90,-219,35,47,H1
"San Miguel County, NM",2007-2008,29259,29234,-25,-0.085,102,-127,35,47,H1
"San Miguel County, NM",2008-2009,29234,29336,102,0.349,85,17,35,47,H1
"San Miguel County, NM",2009-2010,29336,29377,41,0.14,43,-2,35,47,H1
"San Miguel County, NM",2010-2011,29377,29305,-72,-0.245,41,-113,35,47,H1
"San Miguel County, NM",2011-2012,29305,28953,-352,-1.201,67,-419,35,47,H1
"San Miguel County, NM",2012-2013,28953,28623,-330,-1.14,81,-411,35,47,H1
"San Miguel County, NM",2013-2014,28623,28239,-384,-1.342,73,-457,35,47,H1
"San Miguel County, NM",2014-2015,28303,27967,-336,-1.187,35,-371,35,47,H1
"San Miguel County, NM",2015-2016,27967,27956,-11,-0.039,-43,32,35,47,H1
"San Miguel County, NM",2016-2017,27956,27748,-208,-0.744,3,-211,35,47,H1
"Santa Fe County, NM",2000-2001,129713,131057,1344,1.036,826,518,35,49,H1
"Santa Fe County, NM",2001-2002,131057,133555,2498,1.906,727,1771,35,49,H1
"Santa Fe County, NM",2002-2003,133555,135213,1658,1.241,827,831,35,49,H1
"Santa Fe County, NM",2003-2004,135213,136391,1178,0.871,766,412,35,49,H1
"Santa Fe County, NM",2004-2005,136391,137610,1219,0.894,769,450,35,49,H1
"Santa Fe County, NM",2005-2006,137610,138786,1176,0.855,793,383,35,49,H1
"Santa Fe County, NM",2006-2007,138786,140210,1424,1.026,756,668,35,49,H1
"Santa Fe County, NM",2007-2008,140210,141704,1494,1.066,708,786,35,49,H1
"Santa Fe County, NM",2008-2009,141704,143205,1501,1.059,681,820,35,49,H1
"Santa Fe County, NM",2009-2010,143205,144503,1298,0.906,554,744,35,49,H1
"Santa Fe County, NM",2010-2011,144503,145447,944,0.653,449,495,35,49,H1
"Santa Fe County, NM",2011-2012,145447,146385,938,0.645,317,621,35,49,H1
"Santa Fe County, NM",2012-2013,146385,147306,921,0.629,252,669,35,49,H1
"Santa Fe County, NM",2013-2014,147306,148164,858,0.582,315,543,35,49,H1
"Santa Fe County, NM",2014-2015,147977,148686,709,0.479,259,450,35,49,H1
"Santa Fe County, NM",2015-2016,148686,147943,-743,-0.5,44,-787,35,49,H1
"Santa Fe County, NM",2016-2017,147943,148750,807,0.545,114,693,35,49,H1
"Sierra County, NM",2000-2001,13209,12960,-249,-1.885,-110,-139,35,51,H1
"Sierra County, NM",2001-2002,12960,12672,-288,-2.222,-102,-186,35,51,H1
"Sierra County, NM",2002-2003,12672,12703,31,0.245,-129,160,35,51,H1
"Sierra County, NM",2003-2004,12703,12382,-321,-2.527,-132,-189,35,51,H1
"Sierra County, NM",2004-2005,12382,12120,-262,-2.116,-83,-179,35,51,H1
"Sierra County, NM",2005-2006,12120,11997,-123,-1.015,-117,-6,35,51,H1
"Sierra County, NM",2006-2007,11997,11812,-185,-1.542,-99,-86,35,51,H1
"Sierra County, NM",2007-2008,11812,11914,102,0.864,-100,202,35,51,H1
"Sierra County, NM",2008-2009,11914,11940,26,0.218,-106,132,35,51,H1
"Sierra County, NM",2009-2010,11940,12039,99,0.829,-115,214,35,51,H1
"Sierra County, NM",2010-2011,12039,12040,1,0.008,-139,140,35,51,H1
"Sierra County, NM",2011-2012,12040,11893,-147,-1.221,-156,9,35,51,H1
"Sierra County, NM",2012-2013,11893,11571,-322,-2.707,-128,-194,35,51,H1
"Sierra County, NM",2013-2014,11571,11325,-246,-2.126,-143,-103,35,51,H1
"Sierra County, NM",2014-2015,11332,11282,-50,-0.441,-105,55,35,51,H1
"Sierra County, NM",2015-2016,11282,11134,-148,-1.312,-147,-1,35,51,H1
"Sierra County, NM",2016-2017,11134,11116,-18,-0.162,-137,119,35,51,H1
"Socorro County, NM",2000-2001,18002,17907,-95,-0.528,152,-247,35,53,H1
"Socorro County, NM",2001-2002,17907,17769,-138,-0.771,82,-220,35,53,H1
"Socorro County, NM",2002-2003,17769,17997,228,1.283,72,156,35,53,H1
"Socorro County, NM",2003-2004,17997,17944,-53,-0.294,79,-132,35,53,H1
"Socorro County, NM",2004-2005,17944,18052,108,0.602,141,-33,35,53,H1
"Socorro County, NM",2005-2006,18052,18081,29,0.161,139,-110,35,53,H1
"Socorro County, NM",2006-2007,18081,17995,-86,-0.476,105,-191,35,53,H1
"Socorro County, NM",2007-2008,17995,17966,-29,-0.161,110,-139,35,53,H1
"Socorro County, NM",2008-2009,17966,17927,-39,-0.217,105,-144,35,53,H1
"Socorro County, NM",2009-2010,17927,17830,-97,-0.541,72,-169,35,53,H1
"Socorro County, NM",2010-2011,17830,17840,10,0.056,98,-88,35,53,H1
"Socorro County, NM",2011-2012,17840,17527,-313,-1.754,30,-343,35,53,H1
"Socorro County, NM",2012-2013,17527,17531,4,0.023,65,-61,35,53,H1
"Socorro County, NM",2013-2014,17531,17310,-221,-1.261,52,-273,35,53,H1
"Socorro County, NM",2014-2015,17340,17256,-84,-0.484,58,-142,35,53,H1
"Socorro County, NM",2015-2016,17256,16919,-337,-1.953,68,-405,35,53,H1
"Socorro County, NM",2016-2017,16919,16798,-121,-0.715,24,-145,35,53,H1
"Taos County, NM",2000-2001,30080,30236,156,0.519,119,37,35,55,H1
"Taos County, NM",2001-2002,30236,30844,608,2.011,152,456,35,55,H1
"Taos County, NM",2002-2003,30844,31307,463,1.501,149,314,35,55,H1
"Taos County, NM",2003-2004,31307,31675,368,1.175,138,230,35,55,H1
"Taos County, NM",2004-2005,31675,31850,175,0.552,130,45,35,55,H1
"Taos County, NM",2005-2006,31850,32170,320,1.005,72,248,35,55,H1
"Taos County, NM",2006-2007,32170,32485,315,0.979,155,160,35,55,H1
"Taos County, NM",2007-2008,32485,32467,-18,-0.055,114,-132,35,55,H1
"Taos County, NM",2008-2009,32467,32792,325,1.001,101,224,35,55,H1
"Taos County, NM",2009-2010,32792,32906,114,0.348,99,15,35,55,H1
"Taos County, NM",2010-2011,32906,32941,35,0.106,84,-49,35,55,H1
"Taos County, NM",2011-2012,32941,32817,-124,-0.376,42,-166,35,55,H1
"Taos County, NM",2012-2013,32817,33030,213,0.649,39,174,35,55,H1
"Taos County, NM",2013-2014,33030,33084,54,0.163,33,21,35,55,H1
"Taos County, NM",2014-2015,33041,32907,-134,-0.406,25,-159,35,55,H1
"Taos County, NM",2015-2016,32907,32857,-50,-0.152,-38,-12,35,55,H1
"Taos County, NM",2016-2017,32857,32795,-62,-0.189,-20,-42,35,55,H1
"Torrance County, NM",2000-2001,16915,16660,-255,-1.508,92,-347,35,57,H1
"Torrance County, NM",2001-2002,16660,16520,-140,-0.84,67,-207,35,57,H1
"Torrance County, NM",2002-2003,16520,16879,359,2.173,42,317,35,57,H1
"Torrance County, NM",2003-2004,16879,17184,305,1.807,83,222,35,57,H1
"Torrance County, NM",2004-2005,17184,16702,-482,-2.805,57,-539,35,57,H1
"Torrance County, NM",2005-2006,16702,16728,26,0.156,26,0,35,57,H1
"Torrance County, NM",2006-2007,16728,16559,-169,-1.01,24,-193,35,57,H1
"Torrance County, NM",2007-2008,16559,16257,-302,-1.824,96,-398,35,57,H1
"Torrance County, NM",2008-2009,16257,16414,157,0.966,59,98,35,57,H1
"Torrance County, NM",2009-2010,16414,16380,-34,-0.207,42,-76,35,57,H1
"Torrance County, NM",2010-2011,16380,16411,31,0.189,32,-1,35,57,H1
"Torrance County, NM",2011-2012,16411,16072,-339,-2.066,7,-346,35,57,H1
"Torrance County, NM",2012-2013,16072,15713,-359,-2.234,14,-373,35,57,H1
"Torrance County, NM",2013-2014,15713,15611,-102,-0.649,10,-112,35,57,H1
"Torrance County, NM",2014-2015,15586,15485,-101,-0.648,-14,-87,35,57,H1
"Torrance County, NM",2015-2016,15485,15426,-59,-0.381,18,-77,35,57,H1
"Torrance County, NM",2016-2017,15426,15506,80,0.519,14,66,35,57,H1
"Union County, NM",2000-2001,4192,4138,-54,-1.288,-8,-46,35,59,H1
"Union County, NM",2001-2002,4138,4138,0,0,-25,25,35,59,H1
"Union County, NM",2002-2003,4138,4080,-58,-1.402,7,-65,35,59,H1
"Union County, NM",2003-2004,4080,4107,27,0.662,-6,33,35,59,H1
"Union County, NM",2004-2005,4107,4198,91,2.216,-6,97,35,59,H1
"Union County, NM",2005-2006,4198,4210,12,0.286,-24,36,35,59,H1
"Union County, NM",2006-2007,4210,4286,76,1.805,-8,84,35,59,H1
"Union County, NM",2007-2008,4286,4380,94,2.193,28,66,35,59,H1
"Union County, NM",2008-2009,4380,4523,143,3.265,16,127,35,59,H1
"Union County, NM",2009-2010,4523,4541,18,0.398,16,2,35,59,H1
"Union County, NM",2010-2011,4541,4428,-113,-2.488,-5,-108,35,59,H1
"Union County, NM",2011-2012,4428,4419,-9,-0.203,-21,12,35,59,H1
"Union County, NM",2012-2013,4419,4381,-38,-0.86,31,-69,35,59,H1
"Union County, NM",2013-2014,4381,4297,-84,-1.917,9,-93,35,59,H1
"Union County, NM",2014-2015,4269,4201,-68,-1.593,0,-68,35,59,H1
"Union County, NM",2015-2016,4201,4153,-48,-1.143,2,-50,35,59,H1
"Union County, NM",2016-2017,4153,4187,34,0.819,3,31,35,59,H1
"Valencia County, NM",2000-2001,66453,67591,1138,1.712,499,639,35,61,H1
"Valencia County, NM",2001-2002,67591,68401,810,1.198,513,297,35,61,H1
"Valencia County, NM",2002-2003,68401,68850,449,0.656,466,-17,35,61,H1
"Valencia County, NM",2003-2004,68850,69021,171,0.248,446,-275,35,61,H1
"Valencia County, NM",2004-2005,69021,70093,1072,1.553,381,691,35,61,H1
"Valencia County, NM",2005-2006,70093,71661,1568,2.237,395,1173,35,61,H1
"Valencia County, NM",2006-2007,71661,73703,2042,2.85,481,1561,35,61,H1
"Valencia County, NM",2007-2008,73703,74879,1176,1.596,426,750,35,61,H1
"Valencia County, NM",2008-2009,74879,75770,891,1.19,512,379,35,61,H1
"Valencia County, NM",2009-2010,75770,76792,1022,1.349,426,596,35,61,H1
"Valencia County, NM",2010-2011,76792,76893,101,0.132,374,-273,35,61,H1
"Valencia County, NM",2011-2012,76893,76630,-263,-0.342,309,-572,35,61,H1
"Valencia County, NM",2012-2013,76630,76270,-360,-0.47,236,-596,35,61,H1
"Valencia County, NM",2013-2014,76270,75817,-453,-0.594,224,-677,35,61,H1
"Valencia County, NM",2014-2015,75833,75737,-96,-0.127,195,-291,35,61,H1
"Valencia County, NM",2015-2016,75737,75639,-98,-0.129,207,-305,35,61,H1
"Valencia County, NM",2016-2017,75639,75940,301,0.398,153,148,35,61,H1
New York,2000-2001,19001780,19082838,81058,0.427,99145,-18087,36,0,STATE
New York,2001-2002,19082838,19137800,54962,0.288,93236,-38274,36,0,STATE
New York,2002-2003,19137800,19175939,38139,0.199,96301,-58162,36,0,STATE
New York,2003-2004,19175939,19171567,-4372,-0.023,98042,-102414,36,0,STATE
New York,2004-2005,19171567,19132610,-38957,-0.203,94496,-133453,36,0,STATE
New York,2005-2006,19132610,19104631,-27979,-0.146,99067,-127046,36,0,STATE
New York,2006-2007,19104631,19132335,27704,0.145,103378,-75674,36,0,STATE
New York,2007-2008,19132335,19212436,80101,0.419,100464,-20363,36,0,STATE
New York,2008-2009,19212436,19307066,94630,0.493,95016,-386,36,0,STATE
New York,2009-2010,19307066,19402920,95854,0.496,83864,11990,36,0,STATE
New York,2010-2011,19402920,19523202,120282,0.62,93379,26903,36,0,STATE
New York,2011-2012,19523202,19606981,83779,0.429,93029,-9250,36,0,STATE
New York,2012-2013,19606981,19691032,84051,0.429,87293,-3242,36,0,STATE
New York,2013-2014,19691032,19748858,57826,0.294,84045,-26219,36,0,STATE
New York,2014-2015,19748858,19795791,46933,0.238,83857,-36924,36,0,STATE
New York,2015-2016,19795791,19836286,40495,0.205,78611,-38116,36,0,STATE
New York,2016-2017,19836286,19849399,13113,0.066,73090,-59977,36,0,STATE
"Albany County, NY",2000-2001,295106,296232,1126,0.382,295,831,36,1,H1
"Albany County, NY",2001-2002,296232,298283,2051,0.692,416,1635,36,1,H1
"Albany County, NY",2002-2003,298283,301085,2802,0.939,406,2396,36,1,H1
"Albany County, NY",2003-2004,301085,302173,1088,0.361,319,769,36,1,H1
"Albany County, NY",2004-2005,302173,302791,618,0.205,261,357,36,1,H1
"Albany County, NY",2005-2006,302791,303997,1206,0.398,524,682,36,1,H1
"Albany County, NY",2006-2007,303997,303858,-139,-0.046,480,-619,36,1,H1
"Albany County, NY",2007-2008,303858,303739,-119,-0.039,561,-680,36,1,H1
"Albany County, NY",2008-2009,303739,304733,994,0.327,564,430,36,1,H1
"Albany County, NY",2009-2010,304733,304005,-728,-0.239,361,-1089,36,1,H1
"Albany County, NY",2010-2011,304005,304840,835,0.275,406,429,36,1,H1
"Albany County, NY",2011-2012,304840,306186,1346,0.442,323,1023,36,1,H1
"Albany County, NY",2012-2013,306186,307418,1232,0.402,566,666,36,1,H1
"Albany County, NY",2013-2014,307418,308171,753,0.245,465,288,36,1,H1
"Albany County, NY",2014-2015,308729,309381,652,0.211,421,231,36,1,H1
"Albany County, NY",2015-2016,309381,309080,-301,-0.097,393,-694,36,1,H1
"Albany County, NY",2016-2017,309080,309612,532,0.172,351,181,36,1,H1
"Allegany County, NY",2000-2001,49819,50079,260,0.522,109,151,36,3,H1
"Allegany County, NY",2001-2002,50079,50014,-65,-0.13,48,-113,36,3,H1
"Allegany County, NY",2002-2003,50014,50165,151,0.302,27,124,36,3,H1
"Allegany County, NY",2003-2004,50165,50311,146,0.291,74,72,36,3,H1
"Allegany County, NY",2004-2005,50311,49768,-543,-1.079,61,-604,36,3,H1
"Allegany County, NY",2005-2006,49768,49359,-409,-0.822,31,-440,36,3,H1
"Allegany County, NY",2006-2007,49359,49079,-280,-0.567,76,-356,36,3,H1
"Allegany County, NY",2007-2008,49079,49177,98,0.2,80,18,36,3,H1
"Allegany County, NY",2008-2009,49177,48969,-208,-0.423,102,-310,36,3,H1
"Allegany County, NY",2009-2010,48969,48986,17,0.035,-3,20,36,3,H1
"Allegany County, NY",2010-2011,48986,48862,-124,-0.253,70,-194,36,3,H1
"Allegany County, NY",2011-2012,48862,48289,-573,-1.173,-7,-566,36,3,H1
"Allegany County, NY",2012-2013,48289,48060,-229,-0.474,21,-250,36,3,H1
"Allegany County, NY",2013-2014,48060,47736,-324,-0.674,1,-325,36,3,H1
"Allegany County, NY",2014-2015,47781,47462,-319,-0.668,18,-337,36,3,H1
"Allegany County, NY",2015-2016,47462,47110,-352,-0.742,51,-403,36,3,H1
"Allegany County, NY",2016-2017,47110,46894,-216,-0.459,46,-262,36,3,H1
"Bronx County, NY",2000-2001,1334319,1346555,12236,0.917,12927,-691,36,5,H6
"Bronx County, NY",2001-2002,1346555,1358739,12184,0.905,12491,-307,36,5,H6
"Bronx County, NY",2002-2003,1358739,1362373,3634,0.267,12561,-8927,36,5,H6
"Bronx County, NY",2003-2004,1362373,1358963,-3410,-0.25,12670,-16080,36,5,H6
"Bronx County, NY",2004-2005,1358963,1351736,-7227,-0.532,12563,-19790,36,5,H6
"Bronx County, NY",2005-2006,1351736,1348164,-3572,-0.264,12641,-16213,36,5,H6
"Bronx County, NY",2006-2007,1348164,1354056,5892,0.437,13609,-7717,36,5,H6
"Bronx County, NY",2007-2008,1354056,1363488,9432,0.697,13389,-3957,36,5,H6
"Bronx County, NY",2008-2009,1363488,1376261,12773,0.937,12805,-32,36,5,H6
"Bronx County, NY",2009-2010,1376261,1388314,12053,0.876,11784,269,36,5,H6
"Bronx County, NY",2010-2011,1388314,1399815,11501,0.828,13197,-1696,36,5,H6
"Bronx County, NY",2011-2012,1399815,1414225,14410,1.029,12788,1622,36,5,H6
"Bronx County, NY",2012-2013,1414225,1427317,13092,0.926,11550,1542,36,5,H6
"Bronx County, NY",2013-2014,1427317,1438159,10842,0.76,11364,-522,36,5,H6
"Bronx County, NY",2014-2015,1441757,1455444,13687,0.949,11488,2199,36,5,H6
"Bronx County, NY",2015-2016,1455444,1468976,13532,0.93,11001,2531,36,5,H6
"Bronx County, NY",2016-2017,1468976,1471160,2184,0.149,10480,-8296,36,5,H6
"Broome County, NY",2000-2001,200351,200868,517,0.258,-50,567,36,7,H1
"Broome County, NY",2001-2002,200868,201438,570,0.284,74,496,36,7,H1
"Broome County, NY",2002-2003,201438,201037,-401,-0.199,-71,-330,36,7,H1
"Broome County, NY",2003-2004,201037,200974,-63,-0.031,27,-90,36,7,H1
"Broome County, NY",2004-2005,200974,200477,-497,-0.247,-61,-436,36,7,H1
"Broome County, NY",2005-2006,200477,200905,428,0.213,4,424,36,7,H1
"Broome County, NY",2006-2007,200905,200877,-28,-0.014,-21,-7,36,7,H1
"Broome County, NY",2007-2008,200877,201029,152,0.076,163,-11,36,7,H1
"Broome County, NY",2008-2009,201029,200935,-94,-0.047,230,-324,36,7,H1
"Broome County, NY",2009-2010,200935,200428,-507,-0.252,-85,-422,36,7,H1
"Broome County, NY",2010-2011,200428,199335,-1093,-0.545,-108,-985,36,7,H1
"Broome County, NY",2011-2012,199335,198670,-665,-0.334,61,-726,36,7,H1
"Broome County, NY",2012-2013,198670,198203,-467,-0.235,-11,-456,36,7,H1
"Broome County, NY",2013-2014,198203,197349,-854,-0.431,-26,-828,36,7,H1
"Broome County, NY",2014-2015,197516,196567,-949,-0.48,-29,-920,36,7,H1
"Broome County, NY",2015-2016,196567,194830,-1737,-0.884,-127,-1610,36,7,H1
"Broome County, NY",2016-2017,194830,193639,-1191,-0.611,-188,-1003,36,7,H1
"Cattaraugus County, NY",2000-2001,83927,83346,-581,-0.692,187,-768,36,9,H1
"Cattaraugus County, NY",2001-2002,83346,83301,-45,-0.054,111,-156,36,9,H1
"Cattaraugus County, NY",2002-2003,83301,83335,34,0.041,191,-157,36,9,H1
"Cattaraugus County, NY",2003-2004,83335,82864,-471,-0.565,68,-539,36,9,H1
"Cattaraugus County, NY",2004-2005,82864,82039,-825,-0.996,108,-933,36,9,H1
"Cattaraugus County, NY",2005-2006,82039,81342,-697,-0.85,178,-875,36,9,H1
"Cattaraugus County, NY",2006-2007,81342,81056,-286,-0.352,229,-515,36,9,H1
"Cattaraugus County, NY",2007-2008,81056,80761,-295,-0.364,169,-464,36,9,H1
"Cattaraugus County, NY",2008-2009,80761,80491,-270,-0.334,198,-468,36,9,H1
"Cattaraugus County, NY",2009-2010,80491,80227,-264,-0.328,51,-315,36,9,H1
"Cattaraugus County, NY",2010-2011,80227,79820,-407,-0.507,102,-509,36,9,H1
"Cattaraugus County, NY",2011-2012,79820,79342,-478,-0.599,122,-600,36,9,H1
"Cattaraugus County, NY",2012-2013,79342,78996,-346,-0.436,102,-448,36,9,H1
"Cattaraugus County, NY",2013-2014,78996,78600,-396,-0.501,80,-476,36,9,H1
"Cattaraugus County, NY",2014-2015,78638,77922,-716,-0.911,84,-800,36,9,H1
"Cattaraugus County, NY",2015-2016,77922,77761,-161,-0.207,13,-174,36,9,H1
"Cattaraugus County, NY",2016-2017,77761,77348,-413,-0.531,22,-435,36,9,H1
"Cayuga County, NY",2000-2001,81871,81313,-558,-0.682,181,-739,36,11,H1
"Cayuga County, NY",2001-2002,81313,81401,88,0.108,190,-102,36,11,H1
"Cayuga County, NY",2002-2003,81401,81395,-6,-0.007,65,-71,36,11,H1
"Cayuga County, NY",2003-2004,81395,81284,-111,-0.136,87,-198,36,11,H1
"Cayuga County, NY",2004-2005,81284,81104,-180,-0.221,53,-233,36,11,H1
"Cayuga County, NY",2005-2006,81104,80892,-212,-0.261,79,-291,36,11,H1
"Cayuga County, NY",2006-2007,80892,80629,-263,-0.325,81,-344,36,11,H1
"Cayuga County, NY",2007-2008,80629,80482,-147,-0.182,108,-255,36,11,H1
"Cayuga County, NY",2008-2009,80482,80172,-310,-0.385,121,-431,36,11,H1
"Cayuga County, NY",2009-2010,80172,79826,-346,-0.432,19,-365,36,11,H1
"Cayuga County, NY",2010-2011,79826,79803,-23,-0.029,79,-102,36,11,H1
"Cayuga County, NY",2011-2012,79803,79617,-186,-0.233,55,-241,36,11,H1
"Cayuga County, NY",2012-2013,79617,79335,-282,-0.354,51,-333,36,11,H1
"Cayuga County, NY",2013-2014,79335,78823,-512,-0.645,100,-612,36,11,H1
"Cayuga County, NY",2014-2015,78836,78288,-548,-0.695,47,-595,36,11,H1
"Cayuga County, NY",2015-2016,78288,77757,-531,-0.678,-54,-477,36,11,H1
"Cayuga County, NY",2016-2017,77757,77603,-154,-0.198,10,-164,36,11,H1
"Chautauqua County, NY",2000-2001,139593,138730,-863,-0.618,70,-933,36,13,H1
"Chautauqua County, NY",2001-2002,138730,138346,-384,-0.277,14,-398,36,13,H1
"Chautauqua County, NY",2002-2003,138346,137587,-759,-0.549,-62,-697,36,13,H1
"Chautauqua County, NY",2003-2004,137587,137174,-413,-0.3,39,-452,36,13,H1
"Chautauqua County, NY",2004-2005,137174,136139,-1035,-0.755,-23,-1012,36,13,H1
"Chautauqua County, NY",2005-2006,136139,135640,-499,-0.367,117,-616,36,13,H1
"Chautauqua County, NY",2006-2007,135640,135481,-159,-0.117,121,-280,36,13,H1
"Chautauqua County, NY",2007-2008,135481,135229,-252,-0.186,73,-325,36,13,H1
"Chautauqua County, NY",2008-2009,135229,135197,-32,-0.024,142,-174,36,13,H1
"Chautauqua County, NY",2009-2010,135197,134839,-358,-0.265,-78,-280,36,13,H1
"Chautauqua County, NY",2010-2011,134839,134316,-523,-0.388,-111,-412,36,13,H1
"Chautauqua County, NY",2011-2012,134316,133458,-858,-0.639,-1,-857,36,13,H1
"Chautauqua County, NY",2012-2013,133458,133115,-343,-0.257,23,-366,36,13,H1
"Chautauqua County, NY",2013-2014,133115,132053,-1062,-0.798,39,-1101,36,13,H1
"Chautauqua County, NY",2014-2015,131773,130779,-994,-0.754,-18,-976,36,13,H1
"Chautauqua County, NY",2015-2016,130779,129638,-1141,-0.872,48,-1189,36,13,H1
"Chautauqua County, NY",2016-2017,129638,129046,-592,-0.457,6,-598,36,13,H1
"Chemung County, NY",2000-2001,91094,90780,-314,-0.345,220,-534,36,15,H1
"Chemung County, NY",2001-2002,90780,90613,-167,-0.184,167,-334,36,15,H1
"Chemung County, NY",2002-2003,90613,90154,-459,-0.507,112,-571,36,15,H1
"Chemung County, NY",2003-2004,90154,89777,-377,-0.418,110,-487,36,15,H1
"Chemung County, NY",2004-2005,89777,88860,-917,-1.021,38,-955,36,15,H1
"Chemung County, NY",2005-2006,88860,88732,-128,-0.144,20,-148,36,15,H1
"Chemung County, NY",2006-2007,88732,88634,-98,-0.11,215,-313,36,15,H1
"Chemung County, NY",2007-2008,88634,88503,-131,-0.148,133,-264,36,15,H1
"Chemung County, NY",2008-2009,88503,88849,346,0.391,151,195,36,15,H1
"Chemung County, NY",2009-2010,88849,88947,98,0.11,46,52,36,15,H1
"Chemung County, NY",2010-2011,88947,88973,26,0.029,55,-29,36,15,H1
"Chemung County, NY",2011-2012,88973,89231,258,0.29,133,125,36,15,H1
"Chemung County, NY",2012-2013,89231,88485,-746,-0.836,93,-839,36,15,H1
"Chemung County, NY",2013-2014,88485,87770,-715,-0.808,80,-795,36,15,H1
"Chemung County, NY",2014-2015,87469,87071,-398,-0.455,-1,-397,36,15,H1
"Chemung County, NY",2015-2016,87071,86040,-1031,-1.184,-44,-987,36,15,H1
"Chemung County, NY",2016-2017,86040,85557,-483,-0.561,5,-488,36,15,H1
"Chenango County, NY",2000-2001,51325,51109,-216,-0.421,49,-265,36,17,H1
"Chenango County, NY",2001-2002,51109,51205,96,0.188,21,75,36,17,H1
"Chenango County, NY",2002-2003,51205,51393,188,0.367,-19,207,36,17,H1
"Chenango County, NY",2003-2004,51393,51297,-96,-0.187,-40,-56,36,17,H1
"Chenango County, NY",2004-2005,51297,51154,-143,-0.279,4,-147,36,17,H1
"Chenango County, NY",2005-2006,51154,51391,237,0.463,47,190,36,17,H1
"Chenango County, NY",2006-2007,51391,51463,72,0.14,14,58,36,17,H1
"Chenango County, NY",2007-2008,51463,51326,-137,-0.266,15,-152,36,17,H1
"Chenango County, NY",2008-2009,51326,50639,-687,-1.339,42,-729,36,17,H1
"Chenango County, NY",2009-2010,50639,50332,-307,-0.606,-56,-251,36,17,H1
"Chenango County, NY",2010-2011,50332,50214,-118,-0.234,8,-126,36,17,H1
"Chenango County, NY",2011-2012,50214,49849,-365,-0.727,-41,-324,36,17,H1
"Chenango County, NY",2012-2013,49849,49518,-331,-0.664,26,-357,36,17,H1
"Chenango County, NY",2013-2014,49518,49426,-92,-0.186,-1,-91,36,17,H1
"Chenango County, NY",2014-2015,49333,48844,-489,-0.991,-42,-447,36,17,H1
"Chenango County, NY",2015-2016,48844,48323,-521,-1.067,-90,-431,36,17,H1
"Chenango County, NY",2016-2017,48323,47863,-460,-0.952,-69,-391,36,17,H1
"Clinton County, NY",2000-2001,79891,80320,429,0.537,112,317,36,19,H1
"Clinton County, NY",2001-2002,80320,80707,387,0.482,102,285,36,19,H1
"Clinton County, NY",2002-2003,80707,81396,689,0.854,83,606,36,19,H1
"Clinton County, NY",2003-2004,81396,81803,407,0.5,204,203,36,19,H1
"Clinton County, NY",2004-2005,81803,82233,430,0.526,130,300,36,19,H1
"Clinton County, NY",2005-2006,82233,82547,314,0.382,132,182,36,19,H1
"Clinton County, NY",2006-2007,82547,82556,9,0.011,173,-164,36,19,H1
"Clinton County, NY",2007-2008,82556,82401,-155,-0.188,190,-345,36,19,H1
"Clinton County, NY",2008-2009,82401,82280,-121,-0.147,158,-279,36,19,H1
"Clinton County, NY",2009-2010,82280,82066,-214,-0.26,25,-239,36,19,H1
"Clinton County, NY",2010-2011,82066,81849,-217,-0.264,91,-308,36,19,H1
"Clinton County, NY",2011-2012,81849,81826,-23,-0.028,98,-121,36,19,H1
"Clinton County, NY",2012-2013,81826,81773,-53,-0.065,80,-133,36,19,H1
"Clinton County, NY",2013-2014,81773,81632,-141,-0.172,83,-224,36,19,H1
"Clinton County, NY",2014-2015,81702,81251,-451,-0.552,44,-495,36,19,H1
"Clinton County, NY",2015-2016,81251,80973,-278,-0.342,60,-338,36,19,H1
"Clinton County, NY",2016-2017,80973,80980,7,0.009,49,-42,36,19,H1
"Columbia County, NY",2000-2001,63046,62953,-93,-0.148,-104,11,36,21,H1
"Columbia County, NY",2001-2002,62953,63182,229,0.364,-90,319,36,21,H1
"Columbia County, NY",2002-2003,63182,63304,122,0.193,-53,175,36,21,H1
"Columbia County, NY",2003-2004,63304,63646,342,0.54,-98,440,36,21,H1
"Columbia County, NY",2004-2005,63646,63717,71,0.112,-86,157,36,21,H1
"Columbia County, NY",2005-2006,63717,63427,-290,-0.455,-28,-262,36,21,H1
"Columbia County, NY",2006-2007,63427,63430,3,0.005,-33,36,36,21,H1
"Columbia County, NY",2007-2008,63430,63253,-177,-0.279,-81,-96,36,21,H1
"Columbia County, NY",2008-2009,63253,63023,-230,-0.364,-49,-181,36,21,H1
"Columbia County, NY",2009-2010,63023,63015,-8,-0.013,-127,119,36,21,H1
"Columbia County, NY",2010-2011,63015,62644,-371,-0.589,-126,-245,36,21,H1
"Columbia County, NY",2011-2012,62644,62554,-90,-0.144,-108,18,36,21,H1
"Columbia County, NY",2012-2013,62554,62289,-265,-0.424,-103,-162,36,21,H1
"Columbia County, NY",2013-2014,62289,62122,-167,-0.268,-104,-63,36,21,H1
"Columbia County, NY",2014-2015,61979,61509,-470,-0.758,-109,-361,36,21,H1
"Columbia County, NY",2015-2016,61509,61010,-499,-0.811,-150,-349,36,21,H1
"Columbia County, NY",2016-2017,61010,60604,-406,-0.665,-148,-258,36,21,H1
"Cortland County, NY",2000-2001,48693,48903,210,0.431,94,116,36,23,H1
"Cortland County, NY",2001-2002,48903,48891,-12,-0.025,140,-152,36,23,H1
"Cortland County, NY",2002-2003,48891,49475,584,1.194,104,480,36,23,H1
"Cortland County, NY",2003-2004,49475,49628,153,0.309,111,42,36,23,H1
"Cortland County, NY",2004-2005,49628,49330,-298,-0.6,88,-386,36,23,H1
"Cortland County, NY",2005-2006,49330,49449,119,0.241,112,7,36,23,H1
"Cortland County, NY",2006-2007,49449,49624,175,0.354,91,84,36,23,H1
"Cortland County, NY",2007-2008,49624,49537,-87,-0.175,127,-214,36,23,H1
"Cortland County, NY",2008-2009,49537,49358,-179,-0.361,135,-314,36,23,H1
"Cortland County, NY",2009-2010,49358,49257,-101,-0.205,66,-167,36,23,H1
"Cortland County, NY",2010-2011,49257,49520,263,0.534,46,217,36,23,H1
"Cortland County, NY",2011-2012,49520,49203,-317,-0.64,8,-325,36,23,H1
"Cortland County, NY",2012-2013,49203,49149,-54,-0.11,31,-85,36,23,H1
"Cortland County, NY",2013-2014,49149,49024,-125,-0.254,41,-166,36,23,H1
"Cortland County, NY",2014-2015,48929,48494,-435,-0.889,67,-502,36,23,H1
"Cortland County, NY",2015-2016,48494,47934,-560,-1.155,34,-594,36,23,H1
"Cortland County, NY",2016-2017,47934,47786,-148,-0.309,38,-186,36,23,H1
"Delaware County, NY",2000-2001,47864,47771,-93,-0.194,-67,-26,36,25,H1
"Delaware County, NY",2001-2002,47771,47666,-105,-0.22,-177,72,36,25,H1
"Delaware County, NY",2002-2003,47666,47930,264,0.554,-124,388,36,25,H1
"Delaware County, NY",2003-2004,47930,48283,353,0.736,-94,447,36,25,H1
"Delaware County, NY",2004-2005,48283,48377,94,0.195,-144,238,36,25,H1
"Delaware County, NY",2005-2006,48377,48271,-106,-0.219,-69,-37,36,25,H1
"Delaware County, NY",2006-2007,48271,48450,179,0.371,-87,266,36,25,H1
"Delaware County, NY",2007-2008,48450,48363,-87,-0.18,-73,-14,36,25,H1
"Delaware County, NY",2008-2009,48363,48182,-181,-0.374,-59,-122,36,25,H1
"Delaware County, NY",2009-2010,48182,47856,-326,-0.677,-155,-171,36,25,H1
"Delaware County, NY",2010-2011,47856,47625,-231,-0.483,-83,-148,36,25,H1
"Delaware County, NY",2011-2012,47625,47166,-459,-0.964,-119,-340,36,25,H1
"Delaware County, NY",2012-2013,47166,46885,-281,-0.596,-129,-152,36,25,H1
"Delaware County, NY",2013-2014,46885,46581,-304,-0.648,-106,-198,36,25,H1
"Delaware County, NY",2014-2015,46597,46053,-544,-1.167,-171,-373,36,25,H1
"Delaware County, NY",2015-2016,46053,45425,-628,-1.364,-197,-431,36,25,H1
"Delaware County, NY",2016-2017,45425,45001,-424,-0.933,-222,-202,36,25,H1
"Dutchess County, NY",2000-2001,280914,284712,3798,1.352,1105,2693,36,27,H1
"Dutchess County, NY",2001-2002,284712,287700,2988,1.049,897,2091,36,27,H1
"Dutchess County, NY",2002-2003,287700,290781,3081,1.071,978,2103,36,27,H1
"Dutchess County, NY",2003-2004,290781,292859,2078,0.715,1041,1037,36,27,H1
"Dutchess County, NY",2004-2005,292859,294362,1503,0.513,962,541,36,27,H1
"Dutchess County, NY",2005-2006,294362,294712,350,0.119,957,-607,36,27,H1
"Dutchess County, NY",2006-2007,294712,295319,607,0.206,873,-266,36,27,H1
"Dutchess County, NY",2007-2008,295319,296267,948,0.321,860,88,36,27,H1
"Dutchess County, NY",2008-2009,296267,296887,620,0.209,867,-247,36,27,H1
"Dutchess County, NY",2009-2010,296887,297687,800,0.269,413,387,36,27,H1
"Dutchess County, NY",2010-2011,297687,298272,585,0.197,472,113,36,27,H1
"Dutchess County, NY",2011-2012,298272,297340,-932,-0.312,294,-1226,36,27,H1
"Dutchess County, NY",2012-2013,297340,297063,-277,-0.093,304,-581,36,27,H1
"Dutchess County, NY",2013-2014,297063,296579,-484,-0.163,224,-708,36,27,H1
"Dutchess County, NY",2014-2015,296380,295754,-626,-0.211,105,-731,36,27,H1
"Dutchess County, NY",2015-2016,295754,294567,-1187,-0.401,96,-1283,36,27,H1
"Dutchess County, NY",2016-2017,294567,295568,1001,0.34,-35,1036,36,27,H1
"Erie County, NY",2000-2001,949440,946515,-2925,-0.308,806,-3731,36,29,H1
"Erie County, NY",2001-2002,946515,943551,-2964,-0.313,642,-3606,36,29,H1
"Erie County, NY",2002-2003,943551,941846,-1705,-0.181,654,-2359,36,29,H1
"Erie County, NY",2003-2004,941846,938333,-3513,-0.373,575,-4088,36,29,H1
"Erie County, NY",2004-2005,938333,931745,-6588,-0.702,-30,-6558,36,29,H1
"Erie County, NY",2005-2006,931745,925564,-6181,-0.663,528,-6709,36,29,H1
"Erie County, NY",2006-2007,925564,921887,-3677,-0.397,417,-4094,36,29,H1
"Erie County, NY",2007-2008,921887,920571,-1316,-0.143,701,-2017,36,29,H1
"Erie County, NY",2008-2009,920571,919334,-1237,-0.134,657,-1894,36,29,H1
"Erie County, NY",2009-2010,919334,918836,-498,-0.054,166,-664,36,29,H1
"Erie County, NY",2010-2011,918836,919709,873,0.095,24,849,36,29,H1
"Erie County, NY",2011-2012,919709,920205,496,0.054,429,67,36,29,H1
"Erie County, NY",2012-2013,920205,921883,1678,0.182,587,1091,36,29,H1
"Erie County, NY",2013-2014,921883,922835,952,0.103,518,434,36,29,H1
"Erie County, NY",2014-2015,923193,922578,-615,-0.067,560,-1175,36,29,H1
"Erie County, NY",2015-2016,922578,923116,538,0.058,328,210,36,29,H1
"Erie County, NY",2016-2017,923116,925528,2412,0.261,442,1970,36,29,H1
"Essex County, NY",2000-2001,38911,38893,-18,-0.046,-86,68,36,31,H1
"Essex County, NY",2001-2002,38893,39195,302,0.776,-62,364,36,31,H1
"Essex County, NY",2002-2003,39195,39334,139,0.355,-48,187,36,31,H1
"Essex County, NY",2003-2004,39334,39295,-39,-0.099,-58,19,36,31,H1
"Essex County, NY",2004-2005,39295,39321,26,0.066,-11,37,36,31,H1
"Essex County, NY",2005-2006,39321,39490,169,0.43,-8,177,36,31,H1
"Essex County, NY",2006-2007,39490,39373,-117,-0.296,-72,-45,36,31,H1
"Essex County, NY",2007-2008,39373,39435,62,0.157,-17,79,36,31,H1
"Essex County, NY",2008-2009,39435,39478,43,0.109,2,41,36,31,H1
"Essex County, NY",2009-2010,39478,39289,-189,-0.479,-59,-130,36,31,H1
"Essex County, NY",2010-2011,39289,39468,179,0.456,-47,226,36,31,H1
"Essex County, NY",2011-2012,39468,39066,-402,-1.019,-74,-328,36,31,H1
"Essex County, NY",2012-2013,39066,38857,-209,-0.535,-95,-114,36,31,H1
"Essex County, NY",2013-2014,38857,38679,-178,-0.458,-73,-105,36,31,H1
"Essex County, NY",2014-2015,38632,38478,-154,-0.399,-103,-51,36,31,H1
"Essex County, NY",2015-2016,38478,38014,-464,-1.206,-76,-388,36,31,H1
"Essex County, NY",2016-2017,38014,37956,-58,-0.153,-93,35,36,31,H1
"Franklin County, NY",2000-2001,51044,50925,-119,-0.233,1,-120,36,33,H1
"Franklin County, NY",2001-2002,50925,50924,-1,-0.002,36,-37,36,33,H1
"Franklin County, NY",2002-2003,50924,51228,304,0.597,37,267,36,33,H1
"Franklin County, NY",2003-2004,51228,51197,-31,-0.061,30,-61,36,33,H1
"Franklin County, NY",2004-2005,51197,51257,60,0.117,62,-2,36,33,H1
"Franklin County, NY",2005-2006,51257,51511,254,0.496,116,138,36,33,H1
"Franklin County, NY",2006-2007,51511,51782,271,0.526,90,181,36,33,H1
"Franklin County, NY",2007-2008,51782,51907,125,0.241,110,15,36,33,H1
"Franklin County, NY",2008-2009,51907,51706,-201,-0.387,97,-298,36,33,H1
"Franklin County, NY",2009-2010,51706,51582,-124,-0.24,38,-162,36,33,H1
"Franklin County, NY",2010-2011,51582,51547,-35,-0.068,95,-130,36,33,H1
"Franklin County, NY",2011-2012,51547,51813,266,0.516,21,245,36,33,H1
"Franklin County, NY",2012-2013,51813,51335,-478,-0.923,83,-561,36,33,H1
"Franklin County, NY",2013-2014,51335,51262,-73,-0.142,58,-131,36,33,H1
"Franklin County, NY",2014-2015,51133,50660,-473,-0.925,25,-498,36,33,H1
"Franklin County, NY",2015-2016,50660,51139,479,0.946,-26,505,36,33,H1
"Franklin County, NY",2016-2017,51139,51116,-23,-0.045,-16,-7,36,33,H1
"Fulton County, NY",2000-2001,54976,54904,-72,-0.131,1,-73,36,35,H1
"Fulton County, NY",2001-2002,54904,54988,84,0.153,41,43,36,35,H1
"Fulton County, NY",2002-2003,54988,55081,93,0.169,-18,111,36,35,H1
"Fulton County, NY",2003-2004,55081,55233,152,0.276,-6,158,36,35,H1
"Fulton County, NY",2004-2005,55233,55301,68,0.123,-68,136,36,35,H1
"Fulton County, NY",2005-2006,55301,55328,27,0.049,-15,42,36,35,H1
"Fulton County, NY",2006-2007,55328,55489,161,0.291,57,104,36,35,H1
"Fulton County, NY",2007-2008,55489,55584,95,0.171,22,73,36,35,H1
"Fulton County, NY",2008-2009,55584,55558,-26,-0.047,14,-40,36,35,H1
"Fulton County, NY",2009-2010,55558,55451,-107,-0.193,-50,-57,36,35,H1
"Fulton County, NY",2010-2011,55451,55255,-196,-0.353,-43,-153,36,35,H1
"Fulton County, NY",2011-2012,55255,55013,-242,-0.438,-68,-174,36,35,H1
"Fulton County, NY",2012-2013,55013,54528,-485,-0.882,-74,-411,36,35,H1
"Fulton County, NY",2013-2014,54528,54105,-423,-0.776,-62,-361,36,35,H1
"Fulton County, NY",2014-2015,54173,53992,-181,-0.334,-55,-126,36,35,H1
"Fulton County, NY",2015-2016,53992,53696,-296,-0.548,-80,-216,36,35,H1
"Fulton County, NY",2016-2017,53696,53877,181,0.337,-62,243,36,35,H1
"Genesee County, NY",2000-2001,60539,60321,-218,-0.36,161,-379,36,37,H1
"Genesee County, NY",2001-2002,60321,60289,-32,-0.053,65,-97,36,37,H1
"Genesee County, NY",2002-2003,60289,60412,123,0.204,78,45,36,37,H1
"Genesee County, NY",2003-2004,60412,60224,-188,-0.311,15,-203,36,37,H1
"Genesee County, NY",2004-2005,60224,60068,-156,-0.259,117,-273,36,37,H1
"Genesee County, NY",2005-2006,60068,59919,-149,-0.248,91,-240,36,37,H1
"Genesee County, NY",2006-2007,59919,59930,11,0.018,124,-113,36,37,H1
"Genesee County, NY",2007-2008,59930,59895,-35,-0.058,95,-130,36,37,H1
"Genesee County, NY",2008-2009,59895,59932,37,0.062,73,-36,36,37,H1
"Genesee County, NY",2009-2010,59932,60032,100,0.167,35,65,36,37,H1
"Genesee County, NY",2010-2011,60032,60019,-13,-0.022,20,-33,36,37,H1
"Genesee County, NY",2011-2012,60019,59874,-145,-0.242,10,-155,36,37,H1
"Genesee County, NY",2012-2013,59874,59422,-452,-0.755,-19,-433,36,37,H1
"Genesee County, NY",2013-2014,59422,59162,-260,-0.438,-11,-249,36,37,H1
"Genesee County, NY",2014-2015,59099,58937,-162,-0.274,-37,-125,36,37,H1
"Genesee County, NY",2015-2016,58937,58163,-774,-1.313,-70,-704,36,37,H1
"Genesee County, NY",2016-2017,58163,57956,-207,-0.356,-65,-142,36,37,H1
"Greene County, NY",2000-2001,47986,47976,-10,-0.021,-96,86,36,39,H1
"Greene County, NY",2001-2002,47976,48177,201,0.419,-81,282,36,39,H1
"Greene County, NY",2002-2003,48177,48416,239,0.496,-94,333,36,39,H1
"Greene County, NY",2003-2004,48416,48755,339,0.7,-96,435,36,39,H1
"Greene County, NY",2004-2005,48755,49142,387,0.794,-93,480,36,39,H1
"Greene County, NY",2005-2006,49142,49513,371,0.755,-32,403,36,39,H1
"Greene County, NY",2006-2007,49513,49537,24,0.048,-115,139,36,39,H1
"Greene County, NY",2007-2008,49537,49467,-70,-0.141,-39,-31,36,39,H1
"Greene County, NY",2008-2009,49467,49372,-95,-0.192,-37,-58,36,39,H1
"Greene County, NY",2009-2010,49372,49115,-257,-0.521,-118,-139,36,39,H1
"Greene County, NY",2010-2011,49115,48992,-123,-0.25,-90,-33,36,39,H1
"Greene County, NY",2011-2012,48992,48656,-336,-0.686,-64,-272,36,39,H1
"Greene County, NY",2012-2013,48656,48359,-297,-0.61,-62,-235,36,39,H1
"Greene County, NY",2013-2014,48359,47967,-392,-0.811,-93,-299,36,39,H1
"Greene County, NY",2014-2015,47919,47625,-294,-0.614,-81,-213,36,39,H1
"Greene County, NY",2015-2016,47625,47516,-109,-0.229,-156,47,36,39,H1
"Greene County, NY",2016-2017,47516,47470,-46,-0.097,-147,101,36,39,H1
"Hamilton County, NY",2000-2001,5377,5312,-65,-1.209,-29,-36,36,41,H1
"Hamilton County, NY",2001-2002,5312,5232,-80,-1.506,-25,-55,36,41,H1
"Hamilton County, NY",2002-2003,5232,5181,-51,-0.975,-26,-25,36,41,H1
"Hamilton County, NY",2003-2004,5181,5158,-23,-0.444,-20,-3,36,41,H1
"Hamilton County, NY",2004-2005,5158,5093,-65,-1.26,-29,-36,36,41,H1
"Hamilton County, NY",2005-2006,5093,4987,-106,-2.081,-30,-76,36,41,H1
"Hamilton County, NY",2006-2007,4987,4969,-18,-0.361,-28,10,36,41,H1
"Hamilton County, NY",2007-2008,4969,4893,-76,-1.529,-22,-54,36,41,H1
"Hamilton County, NY",2008-2009,4893,4858,-35,-0.715,-22,-13,36,41,H1
"Hamilton County, NY",2009-2010,4858,4828,-30,-0.618,-33,3,36,41,H1
"Hamilton County, NY",2010-2011,4828,4822,-6,-0.124,-12,6,36,41,H1
"Hamilton County, NY",2011-2012,4822,4787,-35,-0.726,-32,-3,36,41,H1
"Hamilton County, NY",2012-2013,4787,4759,-28,-0.585,-19,-9,36,41,H1
"Hamilton County, NY",2013-2014,4759,4715,-44,-0.925,-34,-10,36,41,H1
"Hamilton County, NY",2014-2015,4706,4712,6,0.127,-35,41,36,41,H1
"Hamilton County, NY",2015-2016,4712,4566,-146,-3.098,-22,-124,36,41,H1
"Hamilton County, NY",2016-2017,4566,4485,-81,-1.774,-38,-43,36,41,H1
"Herkimer County, NY",2000-2001,64451,64274,-177,-0.275,-77,-100,36,43,H1
"Herkimer County, NY",2001-2002,64274,63971,-303,-0.471,-57,-246,36,43,H1
"Herkimer County, NY",2002-2003,63971,64080,109,0.17,-29,138,36,43,H1
"Herkimer County, NY",2003-2004,64080,64332,252,0.393,-91,343,36,43,H1
"Herkimer County, NY",2004-2005,64332,64292,-40,-0.062,-23,-17,36,43,H1
"Herkimer County, NY",2005-2006,64292,64029,-263,-0.409,-53,-210,36,43,H1
"Herkimer County, NY",2006-2007,64029,64343,314,0.49,20,294,36,43,H1
"Herkimer County, NY",2007-2008,64343,64404,61,0.095,33,28,36,43,H1
"Herkimer County, NY",2008-2009,64404,64381,-23,-0.036,54,-77,36,43,H1
"Herkimer County, NY",2009-2010,64381,64442,61,0.095,-57,118,36,43,H1
"Herkimer County, NY",2010-2011,64442,64639,197,0.306,13,184,36,43,H1
"Herkimer County, NY",2011-2012,64639,64572,-67,-0.104,5,-72,36,43,H1
"Herkimer County, NY",2012-2013,64572,64246,-326,-0.505,-8,-318,36,43,H1
"Herkimer County, NY",2013-2014,64246,63744,-502,-0.781,-24,-478,36,43,H1
"Herkimer County, NY",2014-2015,63715,63100,-615,-0.965,0,-615,36,43,H1
"Herkimer County, NY",2015-2016,63100,62479,-621,-0.984,-94,-527,36,43,H1
"Herkimer County, NY",2016-2017,62479,62240,-239,-0.383,-57,-182,36,43,H1
"Jefferson County, NY",2000-2001,111790,111422,-368,-0.329,789,-1157,36,45,H1
"Jefferson County, NY",2001-2002,111422,111112,-310,-0.278,791,-1101,36,45,H1
"Jefferson County, NY",2002-2003,111112,110246,-866,-0.779,730,-1596,36,45,H1
"Jefferson County, NY",2003-2004,110246,109924,-322,-0.292,767,-1089,36,45,H1
"Jefferson County, NY",2004-2005,109924,113486,3562,3.24,693,2869,36,45,H1
"Jefferson County, NY",2005-2006,113486,113650,164,0.145,951,-787,36,45,H1
"Jefferson County, NY",2006-2007,113650,115059,1409,1.24,850,559,36,45,H1
"Jefferson County, NY",2007-2008,115059,115033,-26,-0.023,1016,-1042,36,45,H1
"Jefferson County, NY",2008-2009,115033,115023,-10,-0.009,1022,-1032,36,45,H1
"Jefferson County, NY",2009-2010,115023,116595,1572,1.367,804,768,36,45,H1
"Jefferson County, NY",2010-2011,116595,118273,1678,1.439,1251,427,36,45,H1
"Jefferson County, NY",2011-2012,118273,120916,2643,2.235,1323,1320,36,45,H1
"Jefferson County, NY",2012-2013,120916,119536,-1380,-1.141,1367,-2747,36,45,H1
"Jefferson County, NY",2013-2014,119536,119103,-433,-0.362,1268,-1701,36,45,H1
"Jefferson County, NY",2014-2015,118964,117635,-1329,-1.117,1276,-2605,36,45,H1
"Jefferson County, NY",2015-2016,117635,114084,-3551,-3.019,1082,-4633,36,45,H1
"Jefferson County, NY",2016-2017,114084,114187,103,0.09,933,-830,36,45,H1
"Kings County, NY",2000-2001,2467006,2477252,10246,0.415,21942,-11696,36,47,H6
"Kings County, NY",2001-2002,2477252,2480559,3307,0.133,21377,-18070,36,47,H6
"Kings County, NY",2002-2003,2480559,2472999,-7560,-0.305,21398,-28958,36,47,H6
"Kings County, NY",2003-2004,2472999,2459094,-13905,-0.562,22028,-35933,36,47,H6
"Kings County, NY",2004-2005,2459094,2445809,-13285,-0.54,22273,-35558,36,47,H6
"Kings County, NY",2005-2006,2445809,2436132,-9677,-0.396,23116,-32793,36,47,H6
"Kings County, NY",2006-2007,2436132,2441324,5192,0.213,25023,-19831,36,47,H6
"Kings County, NY",2007-2008,2441324,2460361,19037,0.78,24061,-5024,36,47,H6
"Kings County, NY",2008-2009,2460361,2487751,27390,1.113,22528,4862,36,47,H6
"Kings County, NY",2009-2010,2487751,2510073,22322,0.897,23561,-1239,36,47,H6
"Kings County, NY",2010-2011,2510073,2544903,34830,1.388,26092,8738,36,47,H6
"Kings County, NY",2011-2012,2544903,2574864,29961,1.177,26429,3532,36,47,H6
"Kings County, NY",2012-2013,2574864,2602373,27509,1.068,26766,743,36,47,H6
"Kings County, NY",2013-2014,2602373,2621793,19420,0.746,26174,-6754,36,47,H6
"Kings County, NY",2014-2015,2620720,2636735,16015,0.611,24836,-8821,36,47,H6
"Kings County, NY",2015-2016,2636735,2650859,14124,0.536,24250,-10126,36,47,H6
"Kings County, NY",2016-2017,2650859,2648771,-2088,-0.079,23354,-25442,36,47,H6
"Lewis County, NY",2000-2001,26989,26951,-38,-0.141,95,-133,36,49,H1
"Lewis County, NY",2001-2002,26951,26618,-333,-1.236,91,-424,36,49,H1
"Lewis County, NY",2002-2003,26618,26692,74,0.278,130,-56,36,49,H1
"Lewis County, NY",2003-2004,26692,26661,-31,-0.116,27,-58,36,49,H1
"Lewis County, NY",2004-2005,26661,26773,112,0.42,97,15,36,49,H1
"Lewis County, NY",2005-2006,26773,27001,228,0.852,113,115,36,49,H1
"Lewis County, NY",2006-2007,27001,27086,85,0.315,90,-5,36,49,H1
"Lewis County, NY",2007-2008,27086,26878,-208,-0.768,80,-288,36,49,H1
"Lewis County, NY",2008-2009,26878,27047,169,0.629,113,56,36,49,H1
"Lewis County, NY",2009-2010,27047,27067,20,0.074,52,-32,36,49,H1
"Lewis County, NY",2010-2011,27067,27088,21,0.078,50,-29,36,49,H1
"Lewis County, NY",2011-2012,27088,27259,171,0.631,110,61,36,49,H1
"Lewis County, NY",2012-2013,27259,27186,-73,-0.268,102,-175,36,49,H1
"Lewis County, NY",2013-2014,27186,27220,34,0.125,83,-49,36,49,H1
"Lewis County, NY",2014-2015,27172,26957,-215,-0.791,53,-268,36,49,H1
"Lewis County, NY",2015-2016,26957,26646,-311,-1.154,64,-375,36,49,H1
"Lewis County, NY",2016-2017,26646,26551,-95,-0.357,34,-129,36,49,H1
"Livingston County, NY",2000-2001,64705,65088,383,0.592,129,254,36,51,H1
"Livingston County, NY",2001-2002,65088,65118,30,0.046,153,-123,36,51,H1
"Livingston County, NY",2002-2003,65118,65130,12,0.018,162,-150,36,51,H1
"Livingston County, NY",2003-2004,65130,65484,354,0.544,110,244,36,51,H1
"Livingston County, NY",2004-2005,65484,65322,-162,-0.247,145,-307,36,51,H1
"Livingston County, NY",2005-2006,65322,65357,35,0.054,147,-112,36,51,H1
"Livingston County, NY",2006-2007,65357,65460,103,0.158,113,-10,36,51,H1
"Livingston County, NY",2007-2008,65460,65637,177,0.27,127,50,36,51,H1
"Livingston County, NY",2008-2009,65637,65420,-217,-0.331,119,-336,36,51,H1
"Livingston County, NY",2009-2010,65420,65261,-159,-0.243,45,-204,36,51,H1
"Livingston County, NY",2010-2011,65261,64896,-365,-0.559,9,-374,36,51,H1
"Livingston County, NY",2011-2012,64896,64862,-34,-0.052,35,-69,36,51,H1
"Livingston County, NY",2012-2013,64862,64731,-131,-0.202,-27,-104,36,51,H1
"Livingston County, NY",2013-2014,64731,64586,-145,-0.224,-23,-122,36,51,H1
"Livingston County, NY",2014-2015,64763,64717,-46,-0.071,21,-67,36,51,H1
"Livingston County, NY",2015-2016,64717,64202,-515,-0.796,-13,-502,36,51,H1
"Livingston County, NY",2016-2017,64202,63799,-403,-0.628,-31,-372,36,51,H1
"Madison County, NY",2000-2001,69450,69852,402,0.579,211,191,36,53,H1
"Madison County, NY",2001-2002,69852,70261,409,0.586,207,202,36,53,H1
"Madison County, NY",2002-2003,70261,71010,749,1.066,102,647,36,53,H1
"Madison County, NY",2003-2004,71010,71397,387,0.545,105,282,36,53,H1
"Madison County, NY",2004-2005,71397,71471,74,0.104,171,-97,36,53,H1
"Madison County, NY",2005-2006,71471,72042,571,0.799,183,388,36,53,H1
"Madison County, NY",2006-2007,72042,72709,667,0.926,205,462,36,53,H1
"Madison County, NY",2007-2008,72709,73075,366,0.503,189,177,36,53,H1
"Madison County, NY",2008-2009,73075,73169,94,0.129,170,-76,36,53,H1
"Madison County, NY",2009-2010,73169,73400,231,0.316,74,157,36,53,H1
"Madison County, NY",2010-2011,73400,72946,-454,-0.619,55,-509,36,53,H1
"Madison County, NY",2011-2012,72946,72420,-526,-0.721,115,-641,36,53,H1
"Madison County, NY",2012-2013,72420,72521,101,0.139,116,-15,36,53,H1
"Madison County, NY",2013-2014,72521,72369,-152,-0.21,144,-296,36,53,H1
"Madison County, NY",2014-2015,72257,71849,-408,-0.565,91,-499,36,53,H1
"Madison County, NY",2015-2016,71849,71389,-460,-0.64,30,-490,36,53,H1
"Madison County, NY",2016-2017,71389,70965,-424,-0.594,36,-460,36,53,H1
"Monroe County, NY",2000-2001,738979,739891,912,0.123,2811,-1899,36,55,H1
"Monroe County, NY",2001-2002,739891,741391,1500,0.203,2674,-1174,36,55,H1
"Monroe County, NY",2002-2003,741391,741671,280,0.038,2673,-2393,36,55,H1
"Monroe County, NY",2003-2004,741671,741075,-596,-0.08,2404,-3.00E+03,36,55,H1
"Monroe County, NY",2004-2005,741075,738506,-2569,-0.347,2046,-4615,36,55,H1
"Monroe County, NY",2005-2006,738506,738329,-177,-0.024,2703,-2880,36,55,H1
"Monroe County, NY",2006-2007,738329,739249,920,0.125,2553,-1633,36,55,H1
"Monroe County, NY",2007-2008,739249,741018,1769,0.239,2383,-614,36,55,H1
"Monroe County, NY",2008-2009,741018,743386,2368,0.32,2300,68,36,55,H1
"Monroe County, NY",2009-2010,743386,744647,1261,0.17,2010,-749,36,55,H1
"Monroe County, NY",2010-2011,744647,747225,2578,0.346,2181,397,36,55,H1
"Monroe County, NY",2011-2012,747225,748582,1357,0.182,1785,-428,36,55,H1
"Monroe County, NY",2012-2013,748582,750071,1489,0.199,1895,-406,36,55,H1
"Monroe County, NY",2013-2014,750071,749857,-214,-0.029,1912,-2126,36,55,H1
"Monroe County, NY",2014-2015,750362,749600,-762,-0.102,1999,-2761,36,55,H1
"Monroe County, NY",2015-2016,749600,747326,-2274,-0.303,1465,-3739,36,55,H1
"Monroe County, NY",2016-2017,747326,747642,316,0.042,1408,-1092,36,55,H1
"Montgomery County, NY",2000-2001,49605,49472,-133,-0.268,-41,-92,36,57,H1
"Montgomery County, NY",2001-2002,49472,49298,-174,-0.352,-63,-111,36,57,H1
"Montgomery County, NY",2002-2003,49298,49449,151,0.306,-51,202,36,57,H1
"Montgomery County, NY",2003-2004,49449,49460,11,0.022,-88,99,36,57,H1
"Montgomery County, NY",2004-2005,49460,49505,45,0.091,27,18,36,57,H1
"Montgomery County, NY",2005-2006,49505,49724,219,0.442,-5,224,36,57,H1
"Montgomery County, NY",2006-2007,49724,49798,74,0.149,-8,82,36,57,H1
"Montgomery County, NY",2007-2008,49798,49951,153,0.307,10,143,36,57,H1
"Montgomery County, NY",2008-2009,49951,50001,50,0.1,35,15,36,57,H1
"Montgomery County, NY",2009-2010,50001,50288,287,0.574,-20,307,36,57,H1
"Montgomery County, NY",2010-2011,50288,49965,-323,-0.642,-29,-294,36,57,H1
"Montgomery County, NY",2011-2012,49965,49891,-74,-0.148,-11,-63,36,57,H1
"Montgomery County, NY",2012-2013,49891,49830,-61,-0.122,19,-80,36,57,H1
"Montgomery County, NY",2013-2014,49830,49779,-51,-0.102,25,-76,36,57,H1
"Montgomery County, NY",2014-2015,49729,49642,-87,-0.175,66,-153,36,57,H1
"Montgomery County, NY",2015-2016,49642,49266,-376,-0.757,115,-491,36,57,H1
"Montgomery County, NY",2016-2017,49266,49258,-8,-0.016,78,-86,36,57,H1
"Nassau County, NY",2000-2001,1336713,1337086,373,0.028,5388,-5015,36,59,H1
"Nassau County, NY",2001-2002,1337086,1339572,2486,0.186,4502,-2016,36,59,H1
"Nassau County, NY",2002-2003,1339572,1339761,189,0.014,4986,-4797,36,59,H1
"Nassau County, NY",2003-2004,1339761,1337964,-1797,-0.134,5030,-6827,36,59,H1
"Nassau County, NY",2004-2005,1337964,1332318,-5646,-0.422,4604,-10250,36,59,H1
"Nassau County, NY",2005-2006,1332318,1324905,-7413,-0.556,4796,-12209,36,59,H1
"Nassau County, NY",2006-2007,1324905,1322048,-2857,-0.216,4698,-7555,36,59,H1
"Nassau County, NY",2007-2008,1322048,1325129,3081,0.233,3778,-697,36,59,H1
"Nassau County, NY",2008-2009,1325129,1332088,6959,0.525,2832,4127,36,59,H1
"Nassau County, NY",2009-2010,1332088,1341500,9412,0.707,3486,5926,36,59,H1
"Nassau County, NY",2010-2011,1341500,1346857,5357,0.399,3401,1956,36,59,H1
"Nassau County, NY",2011-2012,1346857,1350923,4066,0.302,3432,634,36,59,H1
"Nassau County, NY",2012-2013,1350923,1355099,4176,0.309,2826,1350,36,59,H1
"Nassau County, NY",2013-2014,1355099,1358627,3528,0.26,3108,420,36,59,H1
"Nassau County, NY",2014-2015,1358673,1361350,2677,0.197,3122,-445,36,59,H1
"Nassau County, NY",2015-2016,1361350,1365857,4507,0.331,3333,1174,36,59,H1
"Nassau County, NY",2016-2017,1365857,1369514,3657,0.268,2958,699,36,59,H1
"New York County, NY",2000-2001,1540547,1555729,15182,0.985,8812,6370,36,61,H6
"New York County, NY",2001-2002,1555729,1555382,-347,-0.022,8254,-8601,36,61,H6
"New York County, NY",2002-2003,1555382,1562154,6772,0.435,9095,-2323,36,61,H6
"New York County, NY",2003-2004,1562154,1569947,7793,0.499,9962,-2169,36,61,H6
"New York County, NY",2004-2005,1569947,1573573,3626,0.231,9521,-5895,36,61,H6
"New York County, NY",2005-2006,1573573,1578171,4598,0.292,9774,-5176,36,61,H6
"New York County, NY",2006-2007,1578171,1581402,3231,0.205,10190,-6959,36,61,H6
"New York County, NY",2007-2008,1581402,1587022,5620,0.355,10260,-4640,36,61,H6
"New York County, NY",2008-2009,1587022,1583431,-3591,-0.226,9591,-13182,36,61,H6
"New York County, NY",2009-2010,1583431,1588494,5063,0.32,8387,-3324,36,61,H6
"New York County, NY",2010-2011,1588494,1610027,21533,1.356,9628,11905,36,61,H6
"New York County, NY",2011-2012,1610027,1625198,15171,0.942,9953,5218,36,61,H6
"New York County, NY",2012-2013,1625198,1632005,6807,0.419,8929,-2122,36,61,H6
"New York County, NY",2013-2014,1632005,1636268,4263,0.261,8505,-4242,36,61,H6
"New York County, NY",2014-2015,1636966,1644518,7552,0.461,7745,-193,36,61,H6
"New York County, NY",2015-2016,1644518,1662164,17646,1.073,7016,10630,36,61,H6
"New York County, NY",2016-2017,1662164,1664727,2563,0.154,6344,-3781,36,61,H6
"Niagara County, NY",2000-2001,219620,218552,-1068,-0.486,207,-1275,36,63,H1
"Niagara County, NY",2001-2002,218552,218127,-425,-0.194,55,-480,36,63,H1
"Niagara County, NY",2002-2003,218127,218072,-55,-0.025,32,-87,36,63,H1
"Niagara County, NY",2003-2004,218072,217737,-335,-0.154,24,-359,36,63,H1
"Niagara County, NY",2004-2005,217737,216818,-919,-0.422,-49,-870,36,63,H1
"Niagara County, NY",2005-2006,216818,216148,-670,-0.309,-65,-605,36,63,H1
"Niagara County, NY",2006-2007,216148,215791,-357,-0.165,-1,-356,36,63,H1
"Niagara County, NY",2007-2008,215791,215793,2,0.001,25,-23,36,63,H1
"Niagara County, NY",2008-2009,215793,216043,250,0.116,169,81,36,63,H1
"Niagara County, NY",2009-2010,216043,216506,463,0.214,-70,533,36,63,H1
"Niagara County, NY",2010-2011,216506,215702,-804,-0.371,-209,-595,36,63,H1
"Niagara County, NY",2011-2012,215702,214862,-840,-0.389,-136,-704,36,63,H1
"Niagara County, NY",2012-2013,214862,214270,-592,-0.276,-141,-451,36,63,H1
"Niagara County, NY",2013-2014,214270,213525,-745,-0.348,-210,-535,36,63,H1
"Niagara County, NY",2014-2015,213449,212652,-797,-0.373,-119,-678,36,63,H1
"Niagara County, NY",2015-2016,212652,211798,-854,-0.402,-249,-605,36,63,H1
"Niagara County, NY",2016-2017,211798,211328,-470,-0.222,-219,-251,36,63,H1
"Oneida County, NY",2000-2001,235146,234247,-899,-0.382,-178,-721,36,65,H1
"Oneida County, NY",2001-2002,234247,234078,-169,-0.072,-194,25,36,65,H1
"Oneida County, NY",2002-2003,234078,234243,165,0.07,78,87,36,65,H1
"Oneida County, NY",2003-2004,234243,234654,411,0.175,68,343,36,65,H1
"Oneida County, NY",2004-2005,234654,234282,-372,-0.159,89,-461,36,65,H1
"Oneida County, NY",2005-2006,234282,234229,-53,-0.023,149,-202,36,65,H1
"Oneida County, NY",2006-2007,234229,234488,259,0.111,165,94,36,65,H1
"Oneida County, NY",2007-2008,234488,234482,-6,-0.003,127,-133,36,65,H1
"Oneida County, NY",2008-2009,234482,234619,137,0.058,246,-109,36,65,H1
"Oneida County, NY",2009-2010,234619,234859,240,0.102,22,218,36,65,H1
"Oneida County, NY",2010-2011,234859,234207,-652,-0.278,103,-755,36,65,H1
"Oneida County, NY",2011-2012,234207,233981,-226,-0.096,233,-459,36,65,H1
"Oneida County, NY",2012-2013,233981,233801,-180,-0.077,139,-319,36,65,H1
"Oneida County, NY",2013-2014,233801,232871,-930,-0.398,131,-1061,36,65,H1
"Oneida County, NY",2014-2015,233272,232500,-772,-0.331,205,-977,36,65,H1
"Oneida County, NY",2015-2016,232500,231273,-1227,-0.528,-8,-1219,36,65,H1
"Oneida County, NY",2016-2017,231273,231332,59,0.026,-11,70,36,65,H1
"Onondaga County, NY",2000-2001,458034,458576,542,0.118,1855,-1313,36,67,H1
"Onondaga County, NY",2001-2002,458576,459484,908,0.198,1524,-616,36,67,H1
"Onondaga County, NY",2002-2003,459484,460961,1477,0.321,1623,-146,36,67,H1
"Onondaga County, NY",2003-2004,460961,461412,451,0.098,1636,-1185,36,67,H1
"Onondaga County, NY",2004-2005,461412,460910,-502,-0.109,1457,-1959,36,67,H1
"Onondaga County, NY",2005-2006,460910,460925,15,0.003,1377,-1362,36,67,H1
"Onondaga County, NY",2006-2007,460925,461287,362,0.079,1545,-1183,36,67,H1
"Onondaga County, NY",2007-2008,461287,463472,2185,0.474,1604,581,36,67,H1
"Onondaga County, NY",2008-2009,463472,465633,2161,0.466,1628,533,36,67,H1
"Onondaga County, NY",2009-2010,465633,467422,1789,0.384,1129,660,36,67,H1
"Onondaga County, NY",2010-2011,467422,467586,164,0.035,1145,-981,36,67,H1
"Onondaga County, NY",2011-2012,467586,467182,-404,-0.086,1307,-1711,36,67,H1
"Onondaga County, NY",2012-2013,467182,468843,1661,0.356,1266,395,36,67,H1
"Onondaga County, NY",2013-2014,468843,468196,-647,-0.138,1281,-1928,36,67,H1
"Onondaga County, NY",2014-2015,468659,468463,-196,-0.042,1189,-1385,36,67,H1
"Onondaga County, NY",2015-2016,468463,466635,-1828,-0.39,994,-2822,36,67,H1
"Onondaga County, NY",2016-2017,466635,465398,-1237,-0.265,969,-2206,36,67,H1
"Ontario County, NY",2000-2001,100106,100819,713,0.712,300,413,36,69,H1
"Ontario County, NY",2001-2002,100819,101763,944,0.936,194,750,36,69,H1
"Ontario County, NY",2002-2003,101763,102625,862,0.847,218,644,36,69,H1
"Ontario County, NY",2003-2004,102625,103385,760,0.741,183,577,36,69,H1
"Ontario County, NY",2004-2005,103385,104259,874,0.845,138,736,36,69,H1
"Ontario County, NY",2005-2006,104259,104644,385,0.369,198,187,36,69,H1
"Ontario County, NY",2006-2007,104644,105216,572,0.547,195,377,36,69,H1
"Ontario County, NY",2007-2008,105216,106302,1086,1.032,258,828,36,69,H1
"Ontario County, NY",2008-2009,106302,107214,912,0.858,263,649,36,69,H1
"Ontario County, NY",2009-2010,107214,108233,1019,0.95,41,978,36,69,H1
"Ontario County, NY",2010-2011,108233,108762,529,0.489,4,525,36,69,H1
"Ontario County, NY",2011-2012,108762,108824,62,0.057,14,48,36,69,H1
"Ontario County, NY",2012-2013,108824,109351,527,0.484,13,514,36,69,H1
"Ontario County, NY",2013-2014,109351,109707,356,0.326,54,302,36,69,H1
"Ontario County, NY",2014-2015,109583,109561,-22,-0.02,20,-42,36,69,H1
"Ontario County, NY",2015-2016,109561,109586,25,0.023,-13,38,36,69,H1
"Ontario County, NY",2016-2017,109586,109899,313,0.286,-44,357,36,69,H1
"Orange County, NY",2000-2001,342892,347674,4782,1.395,2420,2362,36,71,H1
"Orange County, NY",2001-2002,347674,352975,5301,1.525,2373,2928,36,71,H1
"Orange County, NY",2002-2003,352975,358727,5752,1.63,2578,3174,36,71,H1
"Orange County, NY",2003-2004,358727,362934,4207,1.173,2645,1562,36,71,H1
"Orange County, NY",2004-2005,362934,364522,1588,0.438,2778,-1190,36,71,H1
"Orange County, NY",2005-2006,364522,366908,2386,0.655,2941,-555,36,71,H1
"Orange County, NY",2006-2007,366908,368464,1556,0.424,2858,-1302,36,71,H1
"Orange County, NY",2007-2008,368464,370201,1737,0.471,2952,-1215,36,71,H1
"Orange County, NY",2008-2009,370201,372079,1878,0.507,3021,-1143,36,71,H1
"Orange County, NY",2009-2010,372079,373402,1323,0.356,2129,-806,36,71,H1
"Orange County, NY",2010-2011,373402,374228,826,0.221,2328,-1502,36,71,H1
"Orange County, NY",2011-2012,374228,373936,-292,-0.078,2447,-2739,36,71,H1
"Orange County, NY",2012-2013,373936,374926,990,0.265,2233,-1243,36,71,H1
"Orange County, NY",2013-2014,374926,376099,1173,0.313,2346,-1173,36,71,H1
"Orange County, NY",2014-2015,375994,377647,1653,0.44,2332,-679,36,71,H1
"Orange County, NY",2015-2016,377647,379915,2268,0.601,2166,102,36,71,H1
"Orange County, NY",2016-2017,379915,382226,2311,0.608,2100,211,36,71,H1
"Orleans County, NY",2000-2001,44178,43898,-280,-0.634,61,-341,36,73,H1
"Orleans County, NY",2001-2002,43898,43660,-238,-0.542,87,-325,36,73,H1
"Orleans County, NY",2002-2003,43660,43593,-67,-0.153,86,-153,36,73,H1
"Orleans County, NY",2003-2004,43593,43682,89,0.204,84,5,36,73,H1
"Orleans County, NY",2004-2005,43682,43475,-207,-0.474,60,-267,36,73,H1
"Orleans County, NY",2005-2006,43475,43420,-55,-0.127,89,-144,36,73,H1
"Orleans County, NY",2006-2007,43420,43342,-78,-0.18,91,-169,36,73,H1
"Orleans County, NY",2007-2008,43342,43254,-88,-0.203,94,-182,36,73,H1
"Orleans County, NY",2008-2009,43254,42975,-279,-0.645,82,-361,36,73,H1
"Orleans County, NY",2009-2010,42975,42847,-128,-0.298,16,-144,36,73,H1
"Orleans County, NY",2010-2011,42847,42730,-117,-0.273,20,-137,36,73,H1
"Orleans County, NY",2011-2012,42730,42517,-213,-0.498,-21,-192,36,73,H1
"Orleans County, NY",2012-2013,42517,42384,-133,-0.313,11,-144,36,73,H1
"Orleans County, NY",2013-2014,42384,41984,-400,-0.944,-16,-384,36,73,H1
"Orleans County, NY",2014-2015,41944,41582,-362,-0.863,11,-373,36,73,H1
"Orleans County, NY",2015-2016,41582,41292,-290,-0.697,51,-341,36,73,H1
"Orleans County, NY",2016-2017,41292,40983,-309,-0.748,20,-329,36,73,H1
"Oswego County, NY",2000-2001,122477,122269,-208,-0.17,357,-565,36,75,H1
"Oswego County, NY",2001-2002,122269,122496,227,0.186,390,-163,36,75,H1
"Oswego County, NY",2002-2003,122496,123120,624,0.509,292,332,36,75,H1
"Oswego County, NY",2003-2004,123120,123340,220,0.179,336,-116,36,75,H1
"Oswego County, NY",2004-2005,123340,122640,-700,-0.568,335,-1035,36,75,H1
"Oswego County, NY",2005-2006,122640,122354,-286,-0.233,316,-602,36,75,H1
"Oswego County, NY",2006-2007,122354,122213,-141,-0.115,322,-463,36,75,H1
"Oswego County, NY",2007-2008,122213,122366,153,0.125,353,-200,36,75,H1
"Oswego County, NY",2008-2009,122366,122055,-311,-0.254,386,-697,36,75,H1
"Oswego County, NY",2009-2010,122055,122154,99,0.081,168,-69,36,75,H1
"Oswego County, NY",2010-2011,122154,122077,-77,-0.063,269,-346,36,75,H1
"Oswego County, NY",2011-2012,122077,121654,-423,-0.347,334,-757,36,75,H1
"Oswego County, NY",2012-2013,121654,121497,-157,-0.129,295,-452,36,75,H1
"Oswego County, NY",2013-2014,121497,120913,-584,-0.481,276,-860,36,75,H1
"Oswego County, NY",2014-2015,120835,120146,-689,-0.57,289,-978,36,75,H1
"Oswego County, NY",2015-2016,120146,118907,-1239,-1.031,127,-1366,36,75,H1
"Oswego County, NY",2016-2017,118907,118478,-429,-0.361,90,-519,36,75,H1
"Otsego County, NY",2000-2001,61860,61924,64,0.103,-12,76,36,77,H1
"Otsego County, NY",2001-2002,61924,62093,169,0.273,-36,205,36,77,H1
"Otsego County, NY",2002-2003,62093,62567,474,0.763,-74,548,36,77,H1
"Otsego County, NY",2003-2004,62567,62934,367,0.587,-97,464,36,77,H1
"Otsego County, NY",2004-2005,62934,63069,135,0.215,-10,145,36,77,H1
"Otsego County, NY",2005-2006,63069,63032,-37,-0.059,-87,50,36,77,H1
"Otsego County, NY",2006-2007,63032,62914,-118,-0.187,0,-118,36,77,H1
"Otsego County, NY",2007-2008,62914,62561,-353,-0.561,-32,-321,36,77,H1
"Otsego County, NY",2008-2009,62561,62280,-281,-0.449,-15,-266,36,77,H1
"Otsego County, NY",2009-2010,62280,62225,-55,-0.088,-133,78,36,77,H1
"Otsego County, NY",2010-2011,62225,62015,-210,-0.337,-83,-127,36,77,H1
"Otsego County, NY",2011-2012,62015,61880,-135,-0.218,-84,-51,36,77,H1
"Otsego County, NY",2012-2013,61880,61644,-236,-0.381,-81,-155,36,77,H1
"Otsego County, NY",2013-2014,61644,61128,-516,-0.837,-96,-420,36,77,H1
"Otsego County, NY",2014-2015,60948,60636,-312,-0.512,-90,-222,36,77,H1
"Otsego County, NY",2015-2016,60636,60343,-293,-0.483,-81,-212,36,77,H1
"Otsego County, NY",2016-2017,60343,60094,-249,-0.413,-116,-133,36,77,H1
"Putnam County, NY",2000-2001,96049,97055,1006,1.047,592,414,36,79,H1
"Putnam County, NY",2001-2002,97055,98263,1208,1.245,626,582,36,79,H1
"Putnam County, NY",2002-2003,98263,98964,701,0.713,560,141,36,79,H1
"Putnam County, NY",2003-2004,98964,99468,504,0.509,554,-50,36,79,H1
"Putnam County, NY",2004-2005,99468,99575,107,0.108,516,-409,36,79,H1
"Putnam County, NY",2005-2006,99575,99357,-218,-0.219,464,-682,36,79,H1
"Putnam County, NY",2006-2007,99357,99454,97,0.098,441,-344,36,79,H1
"Putnam County, NY",2007-2008,99454,99537,83,0.083,408,-325,36,79,H1
"Putnam County, NY",2008-2009,99537,99666,129,0.13,393,-264,36,79,H1
"Putnam County, NY",2009-2010,99666,99775,109,0.109,281,-172,36,79,H1
"Putnam County, NY",2010-2011,99775,99924,149,0.149,234,-85,36,79,H1
"Putnam County, NY",2011-2012,99924,99657,-267,-0.267,211,-478,36,79,H1
"Putnam County, NY",2012-2013,99657,99643,-14,-0.014,145,-159,36,79,H1
"Putnam County, NY",2013-2014,99643,99487,-156,-0.157,148,-304,36,79,H1
"Putnam County, NY",2014-2015,99252,99042,-210,-0.212,136,-346,36,79,H1
"Putnam County, NY",2015-2016,99042,99107,65,0.066,77,-12,36,79,H1
"Putnam County, NY",2016-2017,99107,99323,216,0.218,80,136,36,79,H1
"Queens County, NY",2000-2001,2230501,2231316,815,0.037,15506,-14691,36,81,H6
"Queens County, NY",2001-2002,2231316,2224507,-6809,-0.305,14601,-21410,36,81,H6
"Queens County, NY",2002-2003,2224507,2214608,-9899,-0.445,15011,-24910,36,81,H6
"Queens County, NY",2003-2004,2214608,2198516,-16092,-0.727,15516,-31608,36,81,H6
"Queens County, NY",2004-2005,2198516,2185222,-13294,-0.605,14900,-28194,36,81,H6
"Queens County, NY",2005-2006,2185222,2173862,-11360,-0.52,15398,-26758,36,81,H6
"Queens County, NY",2006-2007,2173862,2177351,3489,0.16,16395,-12906,36,81,H6
"Queens County, NY",2007-2008,2177351,2193623,16272,0.747,15834,438,36,81,H6
"Queens County, NY",2008-2009,2193623,2217166,23543,1.073,14353,9190,36,81,H6
"Queens County, NY",2009-2010,2217166,2235370,18204,0.821,14644,3560,36,81,H6
"Queens County, NY",2010-2011,2235370,2261430,26060,1.166,16912,9148,36,81,H6
"Queens County, NY",2011-2012,2261430,2280639,19209,0.849,16299,2910,36,81,H6
"Queens County, NY",2012-2013,2280639,2303993,23354,1.024,15942,7412,36,81,H6
"Queens County, NY",2013-2014,2303993,2321580,17587,0.763,15425,2162,36,81,H6
"Queens County, NY",2014-2015,2322450,2339150,16700,0.719,15307,1393,36,81,H6
"Queens County, NY",2015-2016,2339150,2356044,16894,0.722,14999,1895,36,81,H6
"Queens County, NY",2016-2017,2356044,2358582,2538,0.108,14068,-11530,36,81,H6
"Rensselaer County, NY",2000-2001,152684,152700,16,0.01,256,-240,36,83,H1
"Rensselaer County, NY",2001-2002,152700,153040,340,0.223,154,186,36,83,H1
"Rensselaer County, NY",2002-2003,153040,154201,1161,0.759,259,902,36,83,H1
"Rensselaer County, NY",2003-2004,154201,155523,1322,0.857,291,1031,36,83,H1
"Rensselaer County, NY",2004-2005,155523,156104,581,0.374,343,238,36,83,H1
"Rensselaer County, NY",2005-2006,156104,157312,1208,0.774,345,863,36,83,H1
"Rensselaer County, NY",2006-2007,157312,158243,931,0.592,325,606,36,83,H1
"Rensselaer County, NY",2007-2008,158243,159011,768,0.485,393,375,36,83,H1
"Rensselaer County, NY",2008-2009,159011,159150,139,0.087,381,-242,36,83,H1
"Rensselaer County, NY",2009-2010,159150,159346,196,0.123,220,-24,36,83,H1
"Rensselaer County, NY",2010-2011,159346,159654,308,0.193,234,74,36,83,H1
"Rensselaer County, NY",2011-2012,159654,159572,-82,-0.051,221,-303,36,83,H1
"Rensselaer County, NY",2012-2013,159572,159653,81,0.051,66,15,36,83,H1
"Rensselaer County, NY",2013-2014,159653,159774,121,0.076,94,27,36,83,H1
"Rensselaer County, NY",2014-2015,160083,160266,183,0.114,266,-83,36,83,H1
"Rensselaer County, NY",2015-2016,160266,159736,-530,-0.331,115,-645,36,83,H1
"Rensselaer County, NY",2016-2017,159736,159722,-14,-0.009,33,-47,36,83,H1
"Richmond County, NY",2000-2001,445235,448961,3726,0.837,2200,1526,36,85,H6
"Richmond County, NY",2001-2002,448961,452813,3852,0.858,1992,1860,36,85,H6
"Richmond County, NY",2002-2003,452813,455939,3126,0.69,2280,846,36,85,H6
"Richmond County, NY",2003-2004,455939,456846,907,0.199,2408,-1501,36,85,H6
"Richmond County, NY",2004-2005,456846,457028,182,0.04,2097,-1915,36,85,H6
"Richmond County, NY",2005-2006,457028,457577,549,0.12,2297,-1748,36,85,H6
"Richmond County, NY",2006-2007,457577,459642,2065,0.451,2377,-312,36,85,H6
"Richmond County, NY",2007-2008,459642,463701,4059,0.883,2375,1684,36,85,H6
"Richmond County, NY",2008-2009,463701,466965,3264,0.704,2264,1.00E+03,36,85,H6
"Richmond County, NY",2009-2010,466965,469602,2637,0.565,1722,915,36,85,H6
"Richmond County, NY",2010-2011,469602,471063,1461,0.311,2373,-912,36,85,H6
"Richmond County, NY",2011-2012,471063,470977,-86,-0.018,2211,-2297,36,85,H6
"Richmond County, NY",2012-2013,470977,472691,1714,0.364,1665,49,36,85,H6
"Richmond County, NY",2013-2014,472691,473279,588,0.124,1570,-982,36,85,H6
"Richmond County, NY",2014-2015,473301,474558,1257,0.266,1567,-310,36,85,H6
"Richmond County, NY",2015-2016,474558,477383,2825,0.595,1555,1270,36,85,H6
"Richmond County, NY",2016-2017,477383,479458,2075,0.435,1355,720,36,85,H6
"Rockland County, NY",2000-2001,287720,290613,2893,1.005,2481,412,36,87,H1
"Rockland County, NY",2001-2002,290613,293728,3115,1.072,2366,749,36,87,H1
"Rockland County, NY",2002-2003,293728,296224,2496,0.85,2460,36,36,87,H1
"Rockland County, NY",2003-2004,296224,297562,1338,0.452,2473,-1135,36,87,H1
"Rockland County, NY",2004-2005,297562,298737,1175,0.395,2736,-1561,36,87,H1
"Rockland County, NY",2005-2006,298737,299390,653,0.219,2565,-1912,36,87,H1
"Rockland County, NY",2006-2007,299390,301668,2278,0.761,2847,-569,36,87,H1
"Rockland County, NY",2007-2008,301668,305413,3745,1.241,2624,1121,36,87,H1
"Rockland County, NY",2008-2009,305413,308652,3239,1.061,2513,726,36,87,H1
"Rockland County, NY",2009-2010,308652,312475,3823,1.239,2229,1594,36,87,H1
"Rockland County, NY",2010-2011,312475,315783,3308,1.059,2588,720,36,87,H1
"Rockland County, NY",2011-2012,315783,317825,2042,0.647,2660,-618,36,87,H1
"Rockland County, NY",2012-2013,317825,320983,3158,0.994,2655,503,36,87,H1
"Rockland County, NY",2013-2014,320983,323866,2883,0.898,2872,11,36,87,H1
"Rockland County, NY",2014-2015,323323,326037,2714,0.839,2917,-203,36,87,H1
"Rockland County, NY",2015-2016,326037,326875,838,0.257,3029,-2191,36,87,H1
"Rockland County, NY",2016-2017,326875,328868,1993,0.61,2834,-841,36,87,H1
"St. Lawrence County, NY",2000-2001,111864,111497,-367,-0.328,203,-570,36,89,H1
"St. Lawrence County, NY",2001-2002,111497,111292,-205,-0.184,107,-312,36,89,H1
"St. Lawrence County, NY",2002-2003,111292,111329,37,0.033,167,-130,36,89,H1
"St. Lawrence County, NY",2003-2004,111329,111468,139,0.125,195,-56,36,89,H1
"St. Lawrence County, NY",2004-2005,111468,111606,138,0.124,160,-22,36,89,H1
"St. Lawrence County, NY",2005-2006,111606,111556,-50,-0.045,236,-286,36,89,H1
"St. Lawrence County, NY",2006-2007,111556,111586,30,0.027,184,-154,36,89,H1
"St. Lawrence County, NY",2007-2008,111586,111684,98,0.088,218,-120,36,89,H1
"St. Lawrence County, NY",2008-2009,111684,112169,485,0.434,257,228,36,89,H1
"St. Lawrence County, NY",2009-2010,112169,111821,-348,-0.31,63,-411,36,89,H1
"St. Lawrence County, NY",2010-2011,111821,112370,549,0.491,263,286,36,89,H1
"St. Lawrence County, NY",2011-2012,112370,112466,96,0.085,180,-84,36,89,H1
"St. Lawrence County, NY",2012-2013,112466,112019,-447,-0.397,239,-686,36,89,H1
"St. Lawrence County, NY",2013-2014,112019,111400,-619,-0.553,199,-818,36,89,H1
"St. Lawrence County, NY",2014-2015,111753,111007,-746,-0.668,175,-921,36,89,H1
"St. Lawrence County, NY",2015-2016,111007,109989,-1018,-0.917,168,-1186,36,89,H1
"St. Lawrence County, NY",2016-2017,109989,109623,-366,-0.333,61,-427,36,89,H1
"Saratoga County, NY",2000-2001,201514,203974,2460,1.221,1048,1412,36,91,H1
"Saratoga County, NY",2001-2002,203974,206446,2472,1.212,820,1652,36,91,H1
"Saratoga County, NY",2002-2003,206446,209410,2964,1.436,1085,1879,36,91,H1
"Saratoga County, NY",2003-2004,209410,211478,2068,0.988,914,1154,36,91,H1
"Saratoga County, NY",2004-2005,211478,212975,1497,0.708,752,745,36,91,H1
"Saratoga County, NY",2005-2006,212975,214627,1652,0.776,884,768,36,91,H1
"Saratoga County, NY",2006-2007,214627,215798,1171,0.546,882,289,36,91,H1
"Saratoga County, NY",2007-2008,215798,217282,1484,0.688,806,678,36,91,H1
"Saratoga County, NY",2008-2009,217282,218652,1370,0.631,860,510,36,91,H1
"Saratoga County, NY",2009-2010,218652,220018,1366,0.625,475,891,36,91,H1
"Saratoga County, NY",2010-2011,220018,221088,1070,0.486,495,575,36,91,H1
"Saratoga County, NY",2011-2012,221088,222413,1325,0.599,564,761,36,91,H1
"Saratoga County, NY",2012-2013,222413,224119,1706,0.767,466,1240,36,91,H1
"Saratoga County, NY",2013-2014,224119,224921,802,0.358,392,410,36,91,H1
"Saratoga County, NY",2014-2015,224704,226249,1545,0.688,414,1131,36,91,H1
"Saratoga County, NY",2015-2016,226249,227560,1311,0.579,258,1053,36,91,H1
"Saratoga County, NY",2016-2017,227560,229869,2309,1.015,217,2092,36,91,H1
"Schenectady County, NY",2000-2001,146581,146334,-247,-0.169,129,-376,36,93,H1
"Schenectady County, NY",2001-2002,146334,147199,865,0.591,133,732,36,93,H1
"Schenectady County, NY",2002-2003,147199,147891,692,0.47,225,467,36,93,H1
"Schenectady County, NY",2003-2004,147891,148900,1009,0.682,263,746,36,93,H1
"Schenectady County, NY",2004-2005,148900,150200,1300,0.873,319,981,36,93,H1
"Schenectady County, NY",2005-2006,150200,151768,1568,1.044,360,1208,36,93,H1
"Schenectady County, NY",2006-2007,151768,152275,507,0.334,339,168,36,93,H1
"Schenectady County, NY",2007-2008,152275,153360,1085,0.713,368,717,36,93,H1
"Schenectady County, NY",2008-2009,153360,154050,690,0.45,484,206,36,93,H1
"Schenectady County, NY",2009-2010,154050,154919,869,0.564,351,518,36,93,H1
"Schenectady County, NY",2010-2011,154919,154746,-173,-0.112,309,-482,36,93,H1
"Schenectady County, NY",2011-2012,154746,155051,305,0.197,342,-37,36,93,H1
"Schenectady County, NY",2012-2013,155051,155440,389,0.251,541,-152,36,93,H1
"Schenectady County, NY",2013-2014,155440,155735,295,0.19,526,-231,36,93,H1
"Schenectady County, NY",2014-2015,154919,154604,-315,-0.203,272,-587,36,93,H1
"Schenectady County, NY",2015-2016,154604,154972,368,0.238,372,-4,36,93,H1
"Schenectady County, NY",2016-2017,154972,155565,593,0.383,319,274,36,93,H1
"Schoharie County, NY",2000-2001,31514,31794,280,0.888,2,278,36,95,H1
"Schoharie County, NY",2001-2002,31794,31785,-9,-0.028,-20,11,36,95,H1
"Schoharie County, NY",2002-2003,31785,32032,247,0.777,7,240,36,95,H1
"Schoharie County, NY",2003-2004,32032,32310,278,0.868,-2,280,36,95,H1
"Schoharie County, NY",2004-2005,32310,32534,224,0.693,-8,232,36,95,H1
"Schoharie County, NY",2005-2006,32534,32661,127,0.39,-20,147,36,95,H1
"Schoharie County, NY",2006-2007,32661,32894,233,0.713,28,205,36,95,H1
"Schoharie County, NY",2007-2008,32894,32890,-4,-0.012,-12,8,36,95,H1
"Schoharie County, NY",2008-2009,32890,32776,-114,-0.347,23,-137,36,95,H1
"Schoharie County, NY",2009-2010,32776,32666,-110,-0.336,-31,-79,36,95,H1
"Schoharie County, NY",2010-2011,32666,32638,-28,-0.086,34,-62,36,95,H1
"Schoharie County, NY",2011-2012,32638,32048,-590,-1.808,13,-603,36,95,H1
"Schoharie County, NY",2012-2013,32048,31849,-199,-0.621,5,-204,36,95,H1
"Schoharie County, NY",2013-2014,31849,31566,-283,-0.889,-26,-257,36,95,H1
"Schoharie County, NY",2014-2015,31656,31330,-326,-1.03,-29,-297,36,95,H1
"Schoharie County, NY",2015-2016,31330,31453,123,0.393,-48,171,36,95,H1
"Schoharie County, NY",2016-2017,31453,31420,-33,-0.105,-52,19,36,95,H1
"Schuyler County, NY",2000-2001,19232,19175,-57,-0.296,24,-81,36,97,H1
"Schuyler County, NY",2001-2002,19175,19179,4,0.021,42,-38,36,97,H1
"Schuyler County, NY",2002-2003,19179,19151,-28,-0.146,-13,-15,36,97,H1
"Schuyler County, NY",2003-2004,19151,19034,-117,-0.611,-12,-105,36,97,H1
"Schuyler County, NY",2004-2005,19034,18880,-154,-0.809,11,-165,36,97,H1
"Schuyler County, NY",2005-2006,18880,18752,-128,-0.678,-63,-65,36,97,H1
"Schuyler County, NY",2006-2007,18752,18707,-45,-0.24,31,-76,36,97,H1
"Schuyler County, NY",2007-2008,18707,18644,-63,-0.337,-10,-53,36,97,H1
"Schuyler County, NY",2008-2009,18644,18398,-246,-1.319,-11,-235,36,97,H1
"Schuyler County, NY",2009-2010,18398,18302,-96,-0.522,-46,-50,36,97,H1
"Schuyler County, NY",2010-2011,18302,18478,176,0.962,-49,225,36,97,H1
"Schuyler County, NY",2011-2012,18478,18549,71,0.384,-1,72,36,97,H1
"Schuyler County, NY",2012-2013,18549,18484,-65,-0.35,-4,-61,36,97,H1
"Schuyler County, NY",2013-2014,18484,18479,-5,-0.027,15,-20,36,97,H1
"Schuyler County, NY",2014-2015,18301,18186,-115,-0.628,-22,-93,36,97,H1
"Schuyler County, NY",2015-2016,18186,17998,-188,-1.034,20,-208,36,97,H1
"Schuyler County, NY",2016-2017,17998,1.80E+04,2,0.011,-2,4,36,97,H1
"Seneca County, NY",2000-2001,33343,34764,1421,4.262,43,1378,36,99,H1
"Seneca County, NY",2001-2002,34764,35046,282,0.811,47,235,36,99,H1
"Seneca County, NY",2002-2003,35046,35212,166,0.474,37,129,36,99,H1
"Seneca County, NY",2003-2004,35212,35312,100,0.284,15,85,36,99,H1
"Seneca County, NY",2004-2005,35312,35177,-135,-0.382,30,-165,36,99,H1
"Seneca County, NY",2005-2006,35177,35223,46,0.131,40,6,36,99,H1
"Seneca County, NY",2006-2007,35223,35469,246,0.698,15,231,36,99,H1
"Seneca County, NY",2007-2008,35469,35370,-99,-0.279,87,-186,36,99,H1
"Seneca County, NY",2008-2009,35370,35286,-84,-0.237,42,-126,36,99,H1
"Seneca County, NY",2009-2010,35286,35247,-39,-0.111,-10,-29,36,99,H1
"Seneca County, NY",2010-2011,35247,35377,130,0.369,53,77,36,99,H1
"Seneca County, NY",2011-2012,35377,35381,4,0.011,50,-46,36,99,H1
"Seneca County, NY",2012-2013,35381,35273,-108,-0.305,28,-136,36,99,H1
"Seneca County, NY",2013-2014,35273,34884,-389,-1.103,31,-420,36,99,H1
"Seneca County, NY",2014-2015,34890,34833,-57,-0.163,65,-122,36,99,H1
"Seneca County, NY",2015-2016,34833,34781,-52,-0.149,19,-71,36,99,H1
"Seneca County, NY",2016-2017,34781,34498,-283,-0.814,37,-320,36,99,H1
"Steuben County, NY",2000-2001,98764,99216,452,0.458,124,328,36,101,H1
"Steuben County, NY",2001-2002,99216,99583,367,0.37,98,269,36,101,H1
"Steuben County, NY",2002-2003,99583,99191,-392,-0.394,127,-519,36,101,H1
"Steuben County, NY",2003-2004,99191,98983,-208,-0.21,97,-305,36,101,H1
"Steuben County, NY",2004-2005,98983,98868,-115,-0.116,118,-233,36,101,H1
"Steuben County, NY",2005-2006,98868,98473,-395,-0.4,146,-541,36,101,H1
"Steuben County, NY",2006-2007,98473,98541,68,0.069,128,-60,36,101,H1
"Steuben County, NY",2007-2008,98541,98726,185,0.188,204,-19,36,101,H1
"Steuben County, NY",2008-2009,98726,98949,223,0.226,202,21,36,101,H1
"Steuben County, NY",2009-2010,98949,98939,-10,-0.01,12,-22,36,101,H1
"Steuben County, NY",2010-2011,98939,99252,313,0.316,144,169,36,101,H1
"Steuben County, NY",2011-2012,99252,99048,-204,-0.206,145,-349,36,101,H1
"Steuben County, NY",2012-2013,99048,98951,-97,-0.098,123,-220,36,101,H1
"Steuben County, NY",2013-2014,98951,98394,-557,-0.563,134,-691,36,101,H1
"Steuben County, NY",2014-2015,98326,97631,-695,-0.707,100,-795,36,101,H1
"Steuben County, NY",2015-2016,97631,96830,-801,-0.82,48,-849,36,101,H1
"Steuben County, NY",2016-2017,96830,96281,-549,-0.567,30,-579,36,101,H1
"Suffolk County, NY",2000-2001,1424081,1442488,18407,1.293,9007,9400,36,103,H1
"Suffolk County, NY",2001-2002,1442488,1456745,14257,0.988,8386,5871,36,103,H1
"Suffolk County, NY",2002-2003,1456745,1470849,14104,0.968,8384,5720,36,103,H1
"Suffolk County, NY",2003-2004,1470849,1478215,7366,0.501,8314,-948,36,103,H1
"Suffolk County, NY",2004-2005,1478215,1477687,-528,-0.036,7978,-8506,36,103,H1
"Suffolk County, NY",2005-2006,1477687,1475626,-2061,-0.139,7798,-9859,36,103,H1
"Suffolk County, NY",2006-2007,1475626,1475255,-371,-0.025,7618,-7989,36,103,H1
"Suffolk County, NY",2007-2008,1475255,1480218,4963,0.336,7062,-2099,36,103,H1
"Suffolk County, NY",2008-2009,1480218,1487206,6988,0.472,6323,665,36,103,H1
"Suffolk County, NY",2009-2010,1487206,1494744,7538,0.507,5274,2264,36,103,H1
"Suffolk County, NY",2010-2011,1494744,1500780,6036,0.404,4892,1144,36,103,H1
"Suffolk County, NY",2011-2012,1500780,1500422,-358,-0.024,4604,-4962,36,103,H1
"Suffolk County, NY",2012-2013,1500422,1502953,2531,0.169,3589,-1058,36,103,H1
"Suffolk County, NY",2013-2014,1502953,1502968,15,0.001,3409,-3394,36,103,H1
"Suffolk County, NY",2014-2015,1502342,1501587,-755,-0.05,3306,-4061,36,103,H1
"Suffolk County, NY",2015-2016,1501587,1494334,-7253,-0.483,3252,-10505,36,103,H1
"Suffolk County, NY",2016-2017,1494334,1492953,-1381,-0.092,2733,-4114,36,103,H1
"Sullivan County, NY",2000-2001,74134,74143,9,0.012,77,-68,36,105,H1
"Sullivan County, NY",2001-2002,74143,74452,309,0.417,48,261,36,105,H1
"Sullivan County, NY",2002-2003,74452,75447,995,1.336,184,811,36,105,H1
"Sullivan County, NY",2003-2004,75447,76265,818,1.084,131,687,36,105,H1
"Sullivan County, NY",2004-2005,76265,76780,515,0.675,181,334,36,105,H1
"Sullivan County, NY",2005-2006,76780,77231,451,0.587,251,200,36,105,H1
"Sullivan County, NY",2006-2007,77231,77991,760,0.984,287,473,36,105,H1
"Sullivan County, NY",2007-2008,77991,77755,-236,-0.303,236,-472,36,105,H1
"Sullivan County, NY",2008-2009,77755,77647,-108,-0.139,282,-390,36,105,H1
"Sullivan County, NY",2009-2010,77647,77443,-204,-0.263,156,-360,36,105,H1
"Sullivan County, NY",2010-2011,77443,77123,-320,-0.413,118,-438,36,105,H1
"Sullivan County, NY",2011-2012,77123,76951,-172,-0.223,102,-274,36,105,H1
"Sullivan County, NY",2012-2013,76951,76999,48,0.062,271,-223,36,105,H1
"Sullivan County, NY",2013-2014,76999,75943,-1056,-1.371,229,-1285,36,105,H1
"Sullivan County, NY",2014-2015,75770,74877,-893,-1.179,85,-978,36,105,H1
"Sullivan County, NY",2015-2016,74877,75370,493,0.658,102,391,36,105,H1
"Sullivan County, NY",2016-2017,75370,75485,115,0.153,40,75,36,105,H1
"Tioga County, NY",2000-2001,51838,51712,-126,-0.243,195,-321,36,107,H1
"Tioga County, NY",2001-2002,51712,51992,280,0.541,181,99,36,107,H1
"Tioga County, NY",2002-2003,51992,51895,-97,-0.187,156,-253,36,107,H1
"Tioga County, NY",2003-2004,51895,51631,-264,-0.509,135,-399,36,107,H1
"Tioga County, NY",2004-2005,51631,51611,-20,-0.039,186,-206,36,107,H1
"Tioga County, NY",2005-2006,51611,51536,-75,-0.145,134,-209,36,107,H1
"Tioga County, NY",2006-2007,51536,51565,29,0.056,172,-143,36,107,H1
"Tioga County, NY",2007-2008,51565,51498,-67,-0.13,138,-205,36,107,H1
"Tioga County, NY",2008-2009,51498,51236,-262,-0.509,173,-435,36,107,H1
"Tioga County, NY",2009-2010,51236,51041,-195,-0.381,39,-234,36,107,H1
"Tioga County, NY",2010-2011,51041,50916,-125,-0.245,56,-181,36,107,H1
"Tioga County, NY",2011-2012,50916,50335,-581,-1.141,33,-614,36,107,H1
"Tioga County, NY",2012-2013,50335,50159,-176,-0.35,55,-231,36,107,H1
"Tioga County, NY",2013-2014,50159,49870,-289,-0.576,88,-377,36,107,H1
"Tioga County, NY",2014-2015,49930,49453,-477,-0.955,112,-589,36,107,H1
"Tioga County, NY",2015-2016,49453,48778,-675,-1.365,2,-677,36,107,H1
"Tioga County, NY",2016-2017,48778,48578,-200,-0.41,15,-215,36,107,H1
"Tompkins County, NY",2000-2001,96608,97458,850,0.88,218,632,36,109,H1
"Tompkins County, NY",2001-2002,97458,98227,769,0.789,291,478,36,109,H1
"Tompkins County, NY",2002-2003,98227,99049,822,0.837,306,516,36,109,H1
"Tompkins County, NY",2003-2004,99049,99531,482,0.487,398,84,36,109,H1
"Tompkins County, NY",2004-2005,99531,99433,-98,-0.098,281,-379,36,109,H1
"Tompkins County, NY",2005-2006,99433,99651,218,0.219,269,-51,36,109,H1
"Tompkins County, NY",2006-2007,99651,99910,259,0.26,335,-76,36,109,H1
"Tompkins County, NY",2007-2008,99910,100383,473,0.473,339,134,36,109,H1
"Tompkins County, NY",2008-2009,100383,101497,1114,1.11,414,700,36,109,H1
"Tompkins County, NY",2009-2010,101497,101726,229,0.226,240,-11,36,109,H1
"Tompkins County, NY",2010-2011,101726,102066,340,0.334,150,190,36,109,H1
"Tompkins County, NY",2011-2012,102066,103044,978,0.958,281,697,36,109,H1
"Tompkins County, NY",2012-2013,103044,104368,1324,1.285,349,975,36,109,H1
"Tompkins County, NY",2013-2014,104368,104691,323,0.309,349,-26,36,109,H1
"Tompkins County, NY",2014-2015,104727,104926,199,0.19,238,-39,36,109,H1
"Tompkins County, NY",2015-2016,104926,104561,-365,-0.348,162,-527,36,109,H1
"Tompkins County, NY",2016-2017,104561,104802,241,0.23,185,56,36,109,H1
"Ulster County, NY",2000-2001,177810,178440,630,0.354,136,494,36,111,H1
"Ulster County, NY",2001-2002,178440,180128,1688,0.946,159,1529,36,111,H1
"Ulster County, NY",2002-2003,180128,180942,814,0.452,223,591,36,111,H1
"Ulster County, NY",2003-2004,180942,181847,905,0.5,401,504,36,111,H1
"Ulster County, NY",2004-2005,181847,182438,591,0.325,159,432,36,111,H1
"Ulster County, NY",2005-2006,182438,182845,407,0.223,393,14,36,111,H1
"Ulster County, NY",2006-2007,182845,182818,-27,-0.015,408,-435,36,111,H1
"Ulster County, NY",2007-2008,182818,183174,356,0.195,297,59,36,111,H1
"Ulster County, NY",2008-2009,183174,182638,-536,-0.293,308,-844,36,111,H1
"Ulster County, NY",2009-2010,182638,182374,-264,-0.145,58,-322,36,111,H1
"Ulster County, NY",2010-2011,182374,182613,239,0.131,159,80,36,111,H1
"Ulster County, NY",2011-2012,182613,181708,-905,-0.496,27,-932,36,111,H1
"Ulster County, NY",2012-2013,181708,180848,-860,-0.473,4,-864,36,111,H1
"Ulster County, NY",2013-2014,180848,180445,-403,-0.223,-75,-328,36,111,H1
"Ulster County, NY",2014-2015,180787,180143,-644,-0.356,-39,-605,36,111,H1
"Ulster County, NY",2015-2016,180143,179546,-597,-0.331,-172,-425,36,111,H1
"Ulster County, NY",2016-2017,179546,179417,-129,-0.072,-180,51,36,111,H1
"Warren County, NY",2000-2001,63273,63406,133,0.21,-6,139,36,113,H1
"Warren County, NY",2001-2002,63406,63774,368,0.58,113,255,36,113,H1
"Warren County, NY",2002-2003,63774,64323,549,0.861,32,517,36,113,H1
"Warren County, NY",2003-2004,64323,64576,253,0.393,43,210,36,113,H1
"Warren County, NY",2004-2005,64576,65206,630,0.976,55,575,36,113,H1
"Warren County, NY",2005-2006,65206,65554,348,0.534,7,341,36,113,H1
"Warren County, NY",2006-2007,65554,65740,186,0.284,-34,220,36,113,H1
"Warren County, NY",2007-2008,65740,65848,108,0.164,-11,119,36,113,H1
"Warren County, NY",2008-2009,65848,65694,-154,-0.234,23,-177,36,113,H1
"Warren County, NY",2009-2010,65694,65675,-19,-0.029,-102,83,36,113,H1
"Warren County, NY",2010-2011,65675,65689,14,0.021,-19,33,36,113,H1
"Warren County, NY",2011-2012,65689,65430,-259,-0.394,-50,-209,36,113,H1
"Warren County, NY",2012-2013,65430,65175,-255,-0.39,-54,-201,36,113,H1
"Warren County, NY",2013-2014,65175,64973,-202,-0.31,-62,-140,36,113,H1
"Warren County, NY",2014-2015,64954,64688,-266,-0.41,-17,-249,36,113,H1
"Warren County, NY",2015-2016,64688,64519,-169,-0.261,-74,-95,36,113,H1
"Warren County, NY",2016-2017,64519,64532,13,0.02,-110,123,36,113,H1
"Washington County, NY",2000-2001,60977,61142,165,0.271,16,149,36,115,H1
"Washington County, NY",2001-2002,61142,61152,10,0.016,32,-22,36,115,H1
"Washington County, NY",2002-2003,61152,61621,469,0.767,31,438,36,115,H1
"Washington County, NY",2003-2004,61621,62278,657,1.066,-3,660,36,115,H1
"Washington County, NY",2004-2005,62278,62468,190,0.305,93,97,36,115,H1
"Washington County, NY",2005-2006,62468,62771,303,0.485,33,270,36,115,H1
"Washington County, NY",2006-2007,62771,63054,283,0.451,113,170,36,115,H1
"Washington County, NY",2007-2008,63054,63252,198,0.314,63,135,36,115,H1
"Washington County, NY",2008-2009,63252,63077,-175,-0.277,70,-245,36,115,H1
"Washington County, NY",2009-2010,63077,63316,239,0.379,-42,281,36,115,H1
"Washington County, NY",2010-2011,63316,63093,-223,-0.352,13,-236,36,115,H1
"Washington County, NY",2011-2012,63093,63046,-47,-0.074,54,-101,36,115,H1
"Washington County, NY",2012-2013,63046,62723,-323,-0.512,-49,-274,36,115,H1
"Washington County, NY",2013-2014,62723,62372,-351,-0.56,-72,-279,36,115,H1
"Washington County, NY",2014-2015,62402,62230,-172,-0.276,-37,-135,36,115,H1
"Washington County, NY",2015-2016,62230,61806,-424,-0.681,-21,-403,36,115,H1
"Washington County, NY",2016-2017,61806,61620,-186,-0.301,-80,-106,36,115,H1
"Wayne County, NY",2000-2001,93791,93794,3,0.003,348,-345,36,117,H1
"Wayne County, NY",2001-2002,93794,93735,-59,-0.063,275,-334,36,117,H1
"Wayne County, NY",2002-2003,93735,94001,266,0.284,320,-54,36,117,H1
"Wayne County, NY",2003-2004,94001,93860,-141,-0.15,327,-468,36,117,H1
"Wayne County, NY",2004-2005,93860,93727,-133,-0.142,277,-410,36,117,H1
"Wayne County, NY",2005-2006,93727,93595,-132,-0.141,341,-473,36,117,H1
"Wayne County, NY",2006-2007,93595,93539,-56,-0.06,291,-347,36,117,H1
"Wayne County, NY",2007-2008,93539,93739,200,0.214,318,-118,36,117,H1
"Wayne County, NY",2008-2009,93739,93643,-96,-0.102,364,-460,36,117,H1
"Wayne County, NY",2009-2010,93643,93734,91,0.097,206,-115,36,117,H1
"Wayne County, NY",2010-2011,93734,93255,-479,-0.511,138,-617,36,117,H1
"Wayne County, NY",2011-2012,93255,93009,-246,-0.264,200,-446,36,117,H1
"Wayne County, NY",2012-2013,93009,92388,-621,-0.668,167,-788,36,117,H1
"Wayne County, NY",2013-2014,92388,92051,-337,-0.365,181,-518,36,117,H1
"Wayne County, NY",2014-2015,91914,91446,-468,-0.509,186,-654,36,117,H1
"Wayne County, NY",2015-2016,91446,90924,-522,-0.571,146,-668,36,117,H1
"Wayne County, NY",2016-2017,90924,90670,-254,-0.279,123,-377,36,117,H1
"Westchester County, NY",2000-2001,925511,931577,6066,0.655,5469,597,36,119,H1
"Westchester County, NY",2001-2002,931577,935219,3642,0.391,5342,-1700,36,119,H1
"Westchester County, NY",2002-2003,935219,935799,580,0.062,5530,-4950,36,119,H1
"Westchester County, NY",2003-2004,935799,935457,-342,-0.037,5414,-5756,36,119,H1
"Westchester County, NY",2004-2005,935457,933401,-2056,-0.22,4968,-7024,36,119,H1
"Westchester County, NY",2005-2006,933401,931426,-1975,-0.212,5038,-7013,36,119,H1
"Westchester County, NY",2006-2007,931426,933414,1988,0.213,4822,-2834,36,119,H1
"Westchester County, NY",2007-2008,933414,937449,4035,0.432,4699,-664,36,119,H1
"Westchester County, NY",2008-2009,937449,944201,6752,0.72,4435,2317,36,119,H1
"Westchester County, NY",2009-2010,944201,950544,6343,0.672,4201,2142,36,119,H1
"Westchester County, NY",2010-2011,950544,957271,6727,0.708,3884,2843,36,119,H1
"Westchester County, NY",2011-2012,957271,961849,4578,0.478,3712,866,36,119,H1
"Westchester County, NY",2012-2013,961849,969296,7447,0.774,3391,4056,36,119,H1
"Westchester County, NY",2013-2014,969296,972634,3338,0.344,3308,30,36,119,H1
"Westchester County, NY",2014-2015,972504,976396,3892,0.4,3520,372,36,119,H1
"Westchester County, NY",2015-2016,976396,978604,2208,0.226,3353,-1145,36,119,H1
"Westchester County, NY",2016-2017,978604,980244,1640,0.168,3083,-1443,36,119,H1
"Wyoming County, NY",2000-2001,43399,43061,-338,-0.779,97,-435,36,121,H1
"Wyoming County, NY",2001-2002,43061,43007,-54,-0.125,72,-126,36,121,H1
"Wyoming County, NY",2002-2003,43007,42955,-52,-0.121,57,-109,36,121,H1
"Wyoming County, NY",2003-2004,42955,42852,-103,-0.24,54,-157,36,121,H1
"Wyoming County, NY",2004-2005,42852,42780,-72,-0.168,52,-124,36,121,H1
"Wyoming County, NY",2005-2006,42780,42673,-107,-0.25,51,-158,36,121,H1
"Wyoming County, NY",2006-2007,42673,42515,-158,-0.37,79,-237,36,121,H1
"Wyoming County, NY",2007-2008,42515,42281,-234,-0.55,72,-306,36,121,H1
"Wyoming County, NY",2008-2009,42281,42236,-45,-0.106,72,-117,36,121,H1
"Wyoming County, NY",2009-2010,42236,42097,-139,-0.329,15,-154,36,121,H1
"Wyoming County, NY",2010-2011,42097,41909,-188,-0.447,33,-221,36,121,H1
"Wyoming County, NY",2011-2012,41909,41762,-147,-0.351,23,-170,36,121,H1
"Wyoming County, NY",2012-2013,41762,41441,-321,-0.769,40,-361,36,121,H1
"Wyoming County, NY",2013-2014,41441,41188,-253,-0.611,48,-301,36,121,H1
"Wyoming County, NY",2014-2015,41179,41013,-166,-0.403,58,-224,36,121,H1
"Wyoming County, NY",2015-2016,41013,40439,-574,-1.4,-1,-573,36,121,H1
"Wyoming County, NY",2016-2017,40439,40493,54,0.134,21,33,36,121,H1
"Yates County, NY",2000-2001,24723,24725,2,0.008,25,-23,36,123,H1
"Yates County, NY",2001-2002,24725,24688,-37,-0.15,29,-66,36,123,H1
"Yates County, NY",2002-2003,24688,24898,210,0.851,63,147,36,123,H1
"Yates County, NY",2003-2004,24898,25008,110,0.442,25,85,36,123,H1
"Yates County, NY",2004-2005,25008,25129,121,0.484,38,83,36,123,H1
"Yates County, NY",2005-2006,25129,25025,-104,-0.414,62,-166,36,123,H1
"Yates County, NY",2006-2007,25025,25234,209,0.835,92,117,36,123,H1
"Yates County, NY",2007-2008,25234,25352,118,0.468,74,44,36,123,H1
"Yates County, NY",2008-2009,25352,25303,-49,-0.193,56,-105,36,123,H1
"Yates County, NY",2009-2010,25303,25360,57,0.225,25,32,36,123,H1
"Yates County, NY",2010-2011,25360,25401,41,0.162,72,-31,36,123,H1
"Yates County, NY",2011-2012,25401,25265,-136,-0.535,53,-189,36,123,H1
"Yates County, NY",2012-2013,25265,25169,-96,-0.38,72,-168,36,123,H1
"Yates County, NY",2013-2014,25169,25208,39,0.155,89,-50,36,123,H1
"Yates County, NY",2014-2015,25112,25048,-64,-0.255,53,-117,36,123,H1
"Yates County, NY",2015-2016,25048,25022,-26,-0.104,83,-109,36,123,H1
"Yates County, NY",2016-2017,25022,24955,-67,-0.268,68,-135,36,123,H1
North Carolina,2000-2001,8081614,8210122,128508,1.59,48010,80498,37,0,STATE
North Carolina,2001-2002,8210122,8326201,116079,1.414,46911,69168,37,0,STATE
North Carolina,2002-2003,8326201,8422501,96300,1.157,45199,51101,37,0,STATE
North Carolina,2003-2004,8422501,8553152,130651,1.551,45342,85309,37,0,STATE
North Carolina,2004-2005,8553152,8705407,152255,1.78,47075,105180,37,0,STATE
North Carolina,2005-2006,8705407,8917270,211863,2.434,50860,161003,37,0,STATE
North Carolina,2006-2007,8917270,9118037,200767,2.251,54768,145999,37,0,STATE
North Carolina,2007-2008,9118037,9309449,191412,2.099,54723,136689,37,0,STATE
North Carolina,2008-2009,9309449,9449566,140117,1.505,53057,87060,37,0,STATE
North Carolina,2009-2010,9449566,9558979,109413,1.158,51580,57833,37,0,STATE
North Carolina,2010-2011,9558979,9651025,92046,0.963,41105,50941,37,0,STATE
North Carolina,2011-2012,9651025,9747021,95996,0.995,40064,55932,37,0,STATE
North Carolina,2012-2013,9747021,9845432,98411,1.01,35073,63338,37,0,STATE
North Carolina,2013-2014,9845432,9940387,94955,0.964,35316,59639,37,0,STATE
North Carolina,2014-2015,9940387,10042802,102415,1.03,35319,67096,37,0,STATE
North Carolina,2015-2016,10042802,10156689,113887,1.134,31387,82500,37,0,STATE
North Carolina,2016-2017,10156689,10273419,116730,1.149,30396,86334,37,0,STATE
"Alamance County, NC",2000-2001,131423,133346,1923,1.463,515,1408,37,1,H1
"Alamance County, NC",2001-2002,133346,135239,1893,1.42,627,1266,37,1,H1
"Alamance County, NC",2002-2003,135239,136009,770,0.569,469,301,37,1,H1
"Alamance County, NC",2003-2004,136009,137619,1610,1.184,520,1090,37,1,H1
"Alamance County, NC",2004-2005,137619,139311,1692,1.229,427,1265,37,1,H1
"Alamance County, NC",2005-2006,139311,141462,2151,1.544,531,1620,37,1,H1
"Alamance County, NC",2006-2007,141462,144712,3250,2.297,572,2678,37,1,H1
"Alamance County, NC",2007-2008,144712,147704,2992,2.068,576,2416,37,1,H1
"Alamance County, NC",2008-2009,147704,149954,2250,1.523,563,1687,37,1,H1
"Alamance County, NC",2009-2010,149954,151551,1597,1.065,514,1083,37,1,H1
"Alamance County, NC",2010-2011,151551,152866,1315,0.868,305,1010,37,1,H1
"Alamance County, NC",2011-2012,152866,153672,806,0.527,212,594,37,1,H1
"Alamance County, NC",2012-2013,153672,154685,1013,0.659,196,817,37,1,H1
"Alamance County, NC",2013-2014,154685,155792,1107,0.716,235,872,37,1,H1
"Alamance County, NC",2014-2015,156357,158276,1919,1.227,249,1670,37,1,H1
"Alamance County, NC",2015-2016,158276,159325,1049,0.663,167,882,37,1,H1
"Alamance County, NC",2016-2017,159325,162391,3066,1.924,219,2847,37,1,H1
"Alexander County, NC",2000-2001,33774,34187,413,1.223,141,272,37,3,H1
"Alexander County, NC",2001-2002,34187,34665,478,1.398,175,303,37,3,H1
"Alexander County, NC",2002-2003,34665,34998,333,0.961,89,244,37,3,H1
"Alexander County, NC",2003-2004,34998,35343,345,0.986,131,214,37,3,H1
"Alexander County, NC",2004-2005,35343,35786,443,1.253,105,338,37,3,H1
"Alexander County, NC",2005-2006,35786,36243,457,1.277,90,367,37,3,H1
"Alexander County, NC",2006-2007,36243,36609,366,1.01,86,280,37,3,H1
"Alexander County, NC",2007-2008,36609,36840,231,0.631,107,124,37,3,H1
"Alexander County, NC",2008-2009,36840,37053,213,0.578,90,123,37,3,H1
"Alexander County, NC",2009-2010,37053,37272,219,0.591,113,106,37,3,H1
"Alexander County, NC",2010-2011,37272,37148,-124,-0.333,21,-145,37,3,H1
"Alexander County, NC",2011-2012,37148,37012,-136,-0.366,-2,-134,37,3,H1
"Alexander County, NC",2012-2013,37012,37050,38,0.103,20,18,37,3,H1
"Alexander County, NC",2013-2014,37050,37392,342,0.923,26,316,37,3,H1
"Alexander County, NC",2014-2015,37364,37325,-39,-0.104,-5,-34,37,3,H1
"Alexander County, NC",2015-2016,37325,37270,-55,-0.147,-40,-15,37,3,H1
"Alexander County, NC",2016-2017,37270,37286,16,0.043,-34,50,37,3,H1
"Alleghany County, NC",2000-2001,10673,10740,67,0.628,-20,87,37,5,H1
"Alleghany County, NC",2001-2002,10740,10740,0,0,-39,39,37,5,H1
"Alleghany County, NC",2002-2003,10740,10776,36,0.335,-57,93,37,5,H1
"Alleghany County, NC",2003-2004,10776,10790,14,0.13,-31,45,37,5,H1
"Alleghany County, NC",2004-2005,10790,10788,-2,-0.019,-48,46,37,5,H1
"Alleghany County, NC",2005-2006,10788,10940,152,1.409,-35,187,37,5,H1
"Alleghany County, NC",2006-2007,10940,11061,121,1.106,-14,135,37,5,H1
"Alleghany County, NC",2007-2008,11061,11131,70,0.633,-35,105,37,5,H1
"Alleghany County, NC",2008-2009,11131,11125,-6,-0.054,-51,45,37,5,H1
"Alleghany County, NC",2009-2010,11125,11145,20,0.18,-39,59,37,5,H1
"Alleghany County, NC",2010-2011,11145,11024,-121,-1.086,-42,-79,37,5,H1
"Alleghany County, NC",2011-2012,11024,10925,-99,-0.898,-38,-61,37,5,H1
"Alleghany County, NC",2012-2013,10925,10899,-26,-0.238,-1,-25,37,5,H1
"Alleghany County, NC",2013-2014,10899,10879,-20,-0.184,-33,13,37,5,H1
"Alleghany County, NC",2014-2015,10878,10837,-41,-0.377,-35,-6,37,5,H1
"Alleghany County, NC",2015-2016,10837,10945,108,0.997,-34,142,37,5,H1
"Alleghany County, NC",2016-2017,10945,11031,86,0.786,-39,125,37,5,H1
"Anson County, NC",2000-2001,25342,25553,211,0.833,73,138,37,7,H1
"Anson County, NC",2001-2002,25553,25723,170,0.665,-15,185,37,7,H1
"Anson County, NC",2002-2003,25723,25749,26,0.101,63,-37,37,7,H1
"Anson County, NC",2003-2004,25749,26386,637,2.474,34,603,37,7,H1
"Anson County, NC",2004-2005,26386,26585,199,0.754,19,180,37,7,H1
"Anson County, NC",2005-2006,26585,26599,14,0.053,42,-28,37,7,H1
"Anson County, NC",2006-2007,26599,26664,65,0.244,2,63,37,7,H1
"Anson County, NC",2007-2008,26664,26837,173,0.649,13,160,37,7,H1
"Anson County, NC",2008-2009,26837,26917,80,0.298,1,79,37,7,H1
"Anson County, NC",2009-2010,26917,26892,-25,-0.093,-6,-19,37,7,H1
"Anson County, NC",2010-2011,26892,26539,-353,-1.313,-22,-331,37,7,H1
"Anson County, NC",2011-2012,26539,26351,-188,-0.708,-19,-169,37,7,H1
"Anson County, NC",2012-2013,26351,2.60E+04,-351,-1.332,-22,-329,37,7,H1
"Anson County, NC",2013-2014,2.60E+04,25765,-235,-0.904,-23,-212,37,7,H1
"Anson County, NC",2014-2015,26122,25759,-363,-1.39,-23,-340,37,7,H1
"Anson County, NC",2015-2016,25759,25119,-640,-2.485,-119,-521,37,7,H1
"Anson County, NC",2016-2017,25119,24991,-128,-0.51,-44,-84,37,7,H1
"Ashe County, NC",2000-2001,24480,24750,270,1.103,5,265,37,9,H1
"Ashe County, NC",2001-2002,24750,25029,279,1.127,-75,354,37,9,H1
"Ashe County, NC",2002-2003,25029,25288,259,1.035,-41,300,37,9,H1
"Ashe County, NC",2003-2004,25288,25684,396,1.566,-37,433,37,9,H1
"Ashe County, NC",2004-2005,25684,25838,154,0.6,-46,200,37,9,H1
"Ashe County, NC",2005-2006,25838,26134,296,1.146,-25,321,37,9,H1
"Ashe County, NC",2006-2007,26134,26506,372,1.423,7,365,37,9,H1
"Ashe County, NC",2007-2008,26506,26858,352,1.328,-27,379,37,9,H1
"Ashe County, NC",2008-2009,26858,27144,286,1.065,-41,327,37,9,H1
"Ashe County, NC",2009-2010,27144,27267,123,0.453,-42,165,37,9,H1
"Ashe County, NC",2010-2011,27267,27176,-91,-0.334,-78,-13,37,9,H1
"Ashe County, NC",2011-2012,27176,27150,-26,-0.096,-71,45,37,9,H1
"Ashe County, NC",2012-2013,27150,27148,-2,-0.007,-74,72,37,9,H1
"Ashe County, NC",2013-2014,27148,27126,-22,-0.081,-81,59,37,9,H1
"Ashe County, NC",2014-2015,27101,27020,-81,-0.299,-115,34,37,9,H1
"Ashe County, NC",2015-2016,27020,26754,-266,-0.984,-118,-148,37,9,H1
"Ashe County, NC",2016-2017,26754,26957,203,0.759,-129,332,37,9,H1
"Avery County, NC",2000-2001,17318,17706,388,2.24,23,365,37,11,H1
"Avery County, NC",2001-2002,17706,17867,161,0.909,-34,195,37,11,H1
"Avery County, NC",2002-2003,17867,17896,29,0.162,-2,31,37,11,H1
"Avery County, NC",2003-2004,17896,17971,75,0.419,-44,119,37,11,H1
"Avery County, NC",2004-2005,17971,17945,-26,-0.145,-59,33,37,11,H1
"Avery County, NC",2005-2006,17945,18104,159,0.886,-3,162,37,11,H1
"Avery County, NC",2006-2007,18104,17949,-155,-0.856,-16,-139,37,11,H1
"Avery County, NC",2007-2008,17949,18024,75,0.418,13,62,37,11,H1
"Avery County, NC",2008-2009,18024,17925,-99,-0.549,-36,-63,37,11,H1
"Avery County, NC",2009-2010,17925,17738,-187,-1.043,-48,-139,37,11,H1
"Avery County, NC",2010-2011,17738,17782,44,0.248,-18,62,37,11,H1
"Avery County, NC",2011-2012,17782,17656,-126,-0.709,-59,-67,37,11,H1
"Avery County, NC",2012-2013,17656,17748,92,0.521,-31,123,37,11,H1
"Avery County, NC",2013-2014,17748,17773,25,0.141,-40,65,37,11,H1
"Avery County, NC",2014-2015,17726,17689,-37,-0.209,-54,17,37,11,H1
"Avery County, NC",2015-2016,17689,17500,-189,-1.068,-45,-144,37,11,H1
"Avery County, NC",2016-2017,17500,17536,36,0.206,-54,90,37,11,H1
"Beaufort County, NC",2000-2001,44950,45084,134,0.298,48,86,37,13,H1
"Beaufort County, NC",2001-2002,45084,45216,132,0.293,99,33,37,13,H1
"Beaufort County, NC",2002-2003,45216,45418,202,0.447,69,133,37,13,H1
"Beaufort County, NC",2003-2004,45418,45618,200,0.44,-1,201,37,13,H1
"Beaufort County, NC",2004-2005,45618,46059,441,0.967,73,368,37,13,H1
"Beaufort County, NC",2005-2006,46059,46622,563,1.222,34,529,37,13,H1
"Beaufort County, NC",2006-2007,46622,46702,80,0.172,44,36,37,13,H1
"Beaufort County, NC",2007-2008,46702,47297,595,1.274,50,545,37,13,H1
"Beaufort County, NC",2008-2009,47297,47485,188,0.397,34,154,37,13,H1
"Beaufort County, NC",2009-2010,47485,47767,282,0.594,45,237,37,13,H1
"Beaufort County, NC",2010-2011,47767,47664,-103,-0.216,-24,-79,37,13,H1
"Beaufort County, NC",2011-2012,47664,47491,-173,-0.363,-46,-127,37,13,H1
"Beaufort County, NC",2012-2013,47491,47429,-62,-0.131,-64,2,37,13,H1
"Beaufort County, NC",2013-2014,47429,47585,156,0.329,-61,217,37,13,H1
"Beaufort County, NC",2014-2015,47513,47651,138,0.29,-111,249,37,13,H1
"Beaufort County, NC",2015-2016,47651,47361,-290,-0.609,-150,-140,37,13,H1
"Beaufort County, NC",2016-2017,47361,47088,-273,-0.576,-140,-133,37,13,H1
"Bertie County, NC",2000-2001,19762,19829,67,0.339,-28,95,37,15,H1
"Bertie County, NC",2001-2002,19829,19841,12,0.061,11,1,37,15,H1
"Bertie County, NC",2002-2003,19841,19897,56,0.282,3,53,37,15,H1
"Bertie County, NC",2003-2004,19897,20018,121,0.608,22,99,37,15,H1
"Bertie County, NC",2004-2005,20018,20057,39,0.195,-46,85,37,15,H1
"Bertie County, NC",2005-2006,20057,19936,-121,-0.603,-5,-116,37,15,H1
"Bertie County, NC",2006-2007,19936,20927,991,4.971,3,988,37,15,H1
"Bertie County, NC",2007-2008,20927,21121,194,0.927,2,192,37,15,H1
"Bertie County, NC",2008-2009,21121,21216,95,0.45,19,76,37,15,H1
"Bertie County, NC",2009-2010,21216,21262,46,0.217,-23,69,37,15,H1
"Bertie County, NC",2010-2011,21262,20982,-280,-1.317,-71,-209,37,15,H1
"Bertie County, NC",2011-2012,20982,20601,-381,-1.816,-29,-352,37,15,H1
"Bertie County, NC",2012-2013,20601,20433,-168,-0.815,-77,-91,37,15,H1
"Bertie County, NC",2013-2014,20433,20106,-327,-1.6,-82,-245,37,15,H1
"Bertie County, NC",2014-2015,20406,20199,-207,-1.014,-88,-119,37,15,H1
"Bertie County, NC",2015-2016,20199,19449,-750,-3.713,-62,-688,37,15,H1
"Bertie County, NC",2016-2017,19449,19224,-225,-1.157,-77,-148,37,15,H1
"Bladen County, NC",2000-2001,32270,32714,444,1.376,86,358,37,17,H1
"Bladen County, NC",2001-2002,32714,32782,68,0.208,86,-18,37,17,H1
"Bladen County, NC",2002-2003,32782,33129,347,1.059,55,292,37,17,H1
"Bladen County, NC",2003-2004,33129,33684,555,1.675,47,508,37,17,H1
"Bladen County, NC",2004-2005,33684,33934,250,0.742,33,217,37,17,H1
"Bladen County, NC",2005-2006,33934,34114,180,0.53,126,54,37,17,H1
"Bladen County, NC",2006-2007,34114,34285,171,0.501,56,115,37,17,H1
"Bladen County, NC",2007-2008,34285,34665,380,1.108,22,358,37,17,H1
"Bladen County, NC",2008-2009,34665,34852,187,0.539,50,137,37,17,H1
"Bladen County, NC",2009-2010,34852,35179,327,0.938,17,310,37,17,H1
"Bladen County, NC",2010-2011,35179,34997,-182,-0.517,-29,-153,37,17,H1
"Bladen County, NC",2011-2012,34997,34906,-91,-0.26,-27,-64,37,17,H1
"Bladen County, NC",2012-2013,34906,34838,-68,-0.195,-1,-67,37,17,H1
"Bladen County, NC",2013-2014,34838,34657,-181,-0.52,-59,-122,37,17,H1
"Bladen County, NC",2014-2015,34542,34318,-224,-0.648,-81,-143,37,17,H1
"Bladen County, NC",2015-2016,34318,33796,-522,-1.521,-75,-447,37,17,H1
"Bladen County, NC",2016-2017,33796,33478,-318,-0.941,-118,-200,37,17,H1
"Brunswick County, NC",2000-2001,73717,76005,2288,3.104,125,2163,37,19,H1
"Brunswick County, NC",2001-2002,76005,78296,2291,3.014,170,2121,37,19,H1
"Brunswick County, NC",2002-2003,78296,80584,2288,2.922,102,2186,37,19,H1
"Brunswick County, NC",2003-2004,80584,83327,2743,3.404,2,2741,37,19,H1
"Brunswick County, NC",2004-2005,83327,87846,4519,5.423,97,4422,37,19,H1
"Brunswick County, NC",2005-2006,87846,93938,6092,6.935,116,5976,37,19,H1
"Brunswick County, NC",2006-2007,93938,99008,5070,5.397,214,4856,37,19,H1
"Brunswick County, NC",2007-2008,99008,103257,4249,4.292,192,4057,37,19,H1
"Brunswick County, NC",2008-2009,103257,105777,2520,2.441,138,2382,37,19,H1
"Brunswick County, NC",2009-2010,105777,108083,2306,2.18,-13,2319,37,19,H1
"Brunswick County, NC",2010-2011,108083,110215,2132,1.973,18,2114,37,19,H1
"Brunswick County, NC",2011-2012,110215,112138,1923,1.745,-188,2111,37,19,H1
"Brunswick County, NC",2012-2013,112138,115262,3124,2.786,-220,3344,37,19,H1
"Brunswick County, NC",2013-2014,115262,118836,3574,3.101,-232,3806,37,19,H1
"Brunswick County, NC",2014-2015,118919,122765,3846,3.234,-269,4115,37,19,H1
"Brunswick County, NC",2015-2016,122765,126353,3588,2.923,-409,3997,37,19,H1
"Brunswick County, NC",2016-2017,126353,130897,4544,3.596,-471,5015,37,19,H1
"Buncombe County, NC",2000-2001,207152,209104,1952,0.942,311,1641,37,21,H1
"Buncombe County, NC",2001-2002,209104,211841,2737,1.309,352,2385,37,21,H1
"Buncombe County, NC",2002-2003,211841,214982,3141,1.483,233,2908,37,21,H1
"Buncombe County, NC",2003-2004,214982,218139,3157,1.468,451,2706,37,21,H1
"Buncombe County, NC",2004-2005,218139,221642,3503,1.606,354,3149,37,21,H1
"Buncombe County, NC",2005-2006,221642,226524,4882,2.203,524,4358,37,21,H1
"Buncombe County, NC",2006-2007,226524,230766,4242,1.873,539,3703,37,21,H1
"Buncombe County, NC",2007-2008,230766,233772,3006,1.303,554,2452,37,21,H1
"Buncombe County, NC",2008-2009,233772,236349,2577,1.102,424,2153,37,21,H1
"Buncombe County, NC",2009-2010,236349,238832,2483,1.051,435,2048,37,21,H1
"Buncombe County, NC",2010-2011,238832,241416,2584,1.082,202,2382,37,21,H1
"Buncombe County, NC",2011-2012,241416,244363,2947,1.221,280,2667,37,21,H1
"Buncombe County, NC",2012-2013,244363,247846,3483,1.425,202,3281,37,21,H1
"Buncombe County, NC",2013-2014,247846,250539,2693,1.087,185,2508,37,21,H1
"Buncombe County, NC",2014-2015,250297,253178,2881,1.151,166,2715,37,21,H1
"Buncombe County, NC",2015-2016,253178,255334,2156,0.852,-41,2197,37,21,H1
"Buncombe County, NC",2016-2017,255334,257607,2273,0.89,-19,2292,37,21,H1
"Burke County, NC",2000-2001,89353,89525,172,0.192,280,-108,37,23,H1
"Burke County, NC",2001-2002,89525,89371,-154,-0.172,260,-414,37,23,H1
"Burke County, NC",2002-2003,89371,89493,122,0.137,197,-75,37,23,H1
"Burke County, NC",2003-2004,89493,89394,-99,-0.111,123,-222,37,23,H1
"Burke County, NC",2004-2005,89394,89526,132,0.148,109,23,37,23,H1
"Burke County, NC",2005-2006,89526,89903,377,0.421,119,258,37,23,H1
"Burke County, NC",2006-2007,89903,90146,243,0.27,169,74,37,23,H1
"Burke County, NC",2007-2008,90146,90788,642,0.712,166,476,37,23,H1
"Burke County, NC",2008-2009,90788,91178,390,0.43,123,267,37,23,H1
"Burke County, NC",2009-2010,91178,90699,-479,-0.525,116,-595,37,23,H1
"Burke County, NC",2010-2011,90699,90772,73,0.08,-186,259,37,23,H1
"Burke County, NC",2011-2012,90772,90235,-537,-0.592,-108,-429,37,23,H1
"Burke County, NC",2012-2013,90235,89628,-607,-0.673,-139,-468,37,23,H1
"Burke County, NC",2013-2014,89628,89486,-142,-0.158,-97,-45,37,23,H1
"Burke County, NC",2014-2015,88807,88842,35,0.039,-127,162,37,23,H1
"Burke County, NC",2015-2016,88842,88802,-40,-0.045,-114,74,37,23,H1
"Burke County, NC",2016-2017,88802,89293,491,0.553,-120,611,37,23,H1
"Cabarrus County, NC",2000-2001,132231,136463,4232,3.2,1084,3148,37,25,H1
"Cabarrus County, NC",2001-2002,136463,140054,3591,2.631,1013,2578,37,25,H1
"Cabarrus County, NC",2002-2003,140054,143336,3282,2.343,1021,2261,37,25,H1
"Cabarrus County, NC",2003-2004,143336,146429,3093,2.158,989,2104,37,25,H1
"Cabarrus County, NC",2004-2005,146429,150797,4368,2.983,1153,3215,37,25,H1
"Cabarrus County, NC",2005-2006,150797,157735,6938,4.601,1090,5848,37,25,H1
"Cabarrus County, NC",2006-2007,157735,165717,7982,5.06,1300,6682,37,25,H1
"Cabarrus County, NC",2007-2008,165717,171915,6198,3.74,1440,4758,37,25,H1
"Cabarrus County, NC",2008-2009,171915,175993,4078,2.372,1437,2641,37,25,H1
"Cabarrus County, NC",2009-2010,175993,178687,2694,1.531,1228,1466,37,25,H1
"Cabarrus County, NC",2010-2011,178687,181336,2649,1.482,940,1709,37,25,H1
"Cabarrus County, NC",2011-2012,181336,184487,3151,1.738,867,2284,37,25,H1
"Cabarrus County, NC",2012-2013,184487,187661,3174,1.72,866,2308,37,25,H1
"Cabarrus County, NC",2013-2014,187661,192103,4442,2.367,868,3574,37,25,H1
"Cabarrus County, NC",2014-2015,191929,196762,4833,2.518,929,3904,37,25,H1
"Cabarrus County, NC",2015-2016,196762,201573,4811,2.445,952,3859,37,25,H1
"Cabarrus County, NC",2016-2017,201573,206872,5299,2.629,975,4324,37,25,H1
"Caldwell County, NC",2000-2001,77721,78375,654,0.841,261,393,37,27,H1
"Caldwell County, NC",2001-2002,78375,78920,545,0.695,191,354,37,27,H1
"Caldwell County, NC",2002-2003,78920,79380,460,0.583,169,291,37,27,H1
"Caldwell County, NC",2003-2004,79380,79471,91,0.115,129,-38,37,27,H1
"Caldwell County, NC",2004-2005,79471,80218,747,0.94,190,557,37,27,H1
"Caldwell County, NC",2005-2006,80218,80897,679,0.846,51,628,37,27,H1
"Caldwell County, NC",2006-2007,80897,81588,691,0.854,153,538,37,27,H1
"Caldwell County, NC",2007-2008,81588,82527,939,1.151,85,854,37,27,H1
"Caldwell County, NC",2008-2009,82527,82798,271,0.328,80,191,37,27,H1
"Caldwell County, NC",2009-2010,82798,83002,204,0.246,39,165,37,27,H1
"Caldwell County, NC",2010-2011,83002,82297,-705,-0.849,-92,-613,37,27,H1
"Caldwell County, NC",2011-2012,82297,81946,-351,-0.427,-24,-327,37,27,H1
"Caldwell County, NC",2012-2013,81946,81969,23,0.028,-143,166,37,27,H1
"Caldwell County, NC",2013-2014,81969,81484,-485,-0.592,-80,-405,37,27,H1
"Caldwell County, NC",2014-2015,81434,81287,-147,-0.181,-120,-27,37,27,H1
"Caldwell County, NC",2015-2016,81287,81787,500,0.615,-133,633,37,27,H1
"Caldwell County, NC",2016-2017,81787,81981,194,0.237,-140,334,37,27,H1
"Camden County, NC",2000-2001,6925,7100,175,2.527,12,163,37,29,H1
"Camden County, NC",2001-2002,7100,7412,312,4.394,6,306,37,29,H1
"Camden County, NC",2002-2003,7412,7894,482,6.503,43,439,37,29,H1
"Camden County, NC",2003-2004,7894,8415,521,6.6,18,503,37,29,H1
"Camden County, NC",2004-2005,8415,8991,576,6.845,57,519,37,29,H1
"Camden County, NC",2005-2006,8991,9321,330,3.67,27,303,37,29,H1
"Camden County, NC",2006-2007,9321,9570,249,2.671,27,222,37,29,H1
"Camden County, NC",2007-2008,9570,9802,232,2.424,52,180,37,29,H1
"Camden County, NC",2008-2009,9802,9899,97,0.99,52,45,37,29,H1
"Camden County, NC",2009-2010,9899,9997,98,0.99,31,67,37,29,H1
"Camden County, NC",2010-2011,9997,10060,63,0.63,17,46,37,29,H1
"Camden County, NC",2011-2012,10060,10054,-6,-0.06,5,-11,37,29,H1
"Camden County, NC",2012-2013,10054,10193,139,1.383,35,104,37,29,H1
"Camden County, NC",2013-2014,10193,10331,138,1.354,46,92,37,29,H1
"Camden County, NC",2014-2015,10286,10309,23,0.224,35,-12,37,29,H1
"Camden County, NC",2015-2016,10309,10423,114,1.106,17,97,37,29,H1
"Camden County, NC",2016-2017,10423,10581,158,1.516,19,139,37,29,H1
"Carteret County, NC",2000-2001,59406,59790,384,0.646,-48,432,37,31,H1
"Carteret County, NC",2001-2002,59790,60311,521,0.871,-112,633,37,31,H1
"Carteret County, NC",2002-2003,60311,61067,756,1.254,-138,894,37,31,H1
"Carteret County, NC",2003-2004,61067,62127,1060,1.736,-64,1124,37,31,H1
"Carteret County, NC",2004-2005,62127,62833,706,1.136,-60,766,37,31,H1
"Carteret County, NC",2005-2006,62833,64028,1195,1.902,6,1189,37,31,H1
"Carteret County, NC",2006-2007,64028,64258,230,0.359,-32,262,37,31,H1
"Carteret County, NC",2007-2008,64258,64700,442,0.688,-60,502,37,31,H1
"Carteret County, NC",2008-2009,64700,65670,970,1.499,-81,1051,37,31,H1
"Carteret County, NC",2009-2010,65670,66749,1079,1.643,-99,1178,37,31,H1
"Carteret County, NC",2010-2011,66749,67399,650,0.974,-111,761,37,31,H1
"Carteret County, NC",2011-2012,67399,67779,380,0.564,-111,491,37,31,H1
"Carteret County, NC",2012-2013,67779,68516,737,1.087,-113,850,37,31,H1
"Carteret County, NC",2013-2014,68516,68811,295,0.431,-139,434,37,31,H1
"Carteret County, NC",2014-2015,68730,68879,149,0.217,-147,296,37,31,H1
"Carteret County, NC",2015-2016,68879,68855,-24,-0.035,-195,171,37,31,H1
"Carteret County, NC",2016-2017,68855,68881,26,0.038,-261,287,37,31,H1
"Caswell County, NC",2000-2001,23527,23610,83,0.353,33,50,37,33,H1
"Caswell County, NC",2001-2002,23610,23767,157,0.665,-27,184,37,33,H1
"Caswell County, NC",2002-2003,23767,23833,66,0.278,9,57,37,33,H1
"Caswell County, NC",2003-2004,23833,23801,-32,-0.134,-14,-18,37,33,H1
"Caswell County, NC",2004-2005,23801,23827,26,0.109,-38,64,37,33,H1
"Caswell County, NC",2005-2006,23827,23993,166,0.697,26,140,37,33,H1
"Caswell County, NC",2006-2007,23993,23914,-79,-0.329,-25,-54,37,33,H1
"Caswell County, NC",2007-2008,23914,23912,-2,-0.008,-29,27,37,33,H1
"Caswell County, NC",2008-2009,23912,23725,-187,-0.782,-29,-158,37,33,H1
"Caswell County, NC",2009-2010,23725,23697,-28,-0.118,-51,23,37,33,H1
"Caswell County, NC",2010-2011,23697,23576,-121,-0.511,-55,-66,37,33,H1
"Caswell County, NC",2011-2012,23576,23183,-393,-1.667,-72,-321,37,33,H1
"Caswell County, NC",2012-2013,23183,23248,65,0.28,-72,137,37,33,H1
"Caswell County, NC",2013-2014,23248,23082,-166,-0.714,-34,-132,37,33,H1
"Caswell County, NC",2014-2015,22956,22941,-15,-0.065,-28,13,37,33,H1
"Caswell County, NC",2015-2016,22941,22742,-199,-0.867,-102,-97,37,33,H1
"Caswell County, NC",2016-2017,22742,22646,-96,-0.422,-59,-37,37,33,H1
"Catawba County, NC",2000-2001,142399,144865,2466,1.732,762,1704,37,35,H1
"Catawba County, NC",2001-2002,144865,145343,478,0.33,819,-341,37,35,H1
"Catawba County, NC",2002-2003,145343,145601,258,0.178,743,-485,37,35,H1
"Catawba County, NC",2003-2004,145601,147016,1415,0.972,605,810,37,35,H1
"Catawba County, NC",2004-2005,147016,148629,1613,1.097,671,942,37,35,H1
"Catawba County, NC",2005-2006,148629,150449,1820,1.225,678,1142,37,35,H1
"Catawba County, NC",2006-2007,150449,152448,1999,1.329,718,1281,37,35,H1
"Catawba County, NC",2007-2008,152448,153848,1400,0.918,634,766,37,35,H1
"Catawba County, NC",2008-2009,153848,154610,762,0.495,615,147,37,35,H1
"Catawba County, NC",2009-2010,154610,154332,-278,-0.18,516,-794,37,35,H1
"Catawba County, NC",2010-2011,154332,154175,-157,-0.102,254,-411,37,35,H1
"Catawba County, NC",2011-2012,154175,154518,343,0.222,273,70,37,35,H1
"Catawba County, NC",2012-2013,154518,154726,208,0.135,148,60,37,35,H1
"Catawba County, NC",2013-2014,154726,154534,-192,-0.124,199,-391,37,35,H1
"Catawba County, NC",2014-2015,154618,155056,438,0.283,145,293,37,35,H1
"Catawba County, NC",2015-2016,155056,156647,1591,1.026,80,1511,37,35,H1
"Catawba County, NC",2016-2017,156647,157974,1327,0.847,70,1257,37,35,H1
"Chatham County, NC",2000-2001,49740,51482,1742,3.502,214,1528,37,37,H1
"Chatham County, NC",2001-2002,51482,53857,2375,4.613,172,2203,37,37,H1
"Chatham County, NC",2002-2003,53857,55061,1204,2.236,225,979,37,37,H1
"Chatham County, NC",2003-2004,55061,56236,1175,2.134,192,983,37,37,H1
"Chatham County, NC",2004-2005,56236,57045,809,1.439,240,569,37,37,H1
"Chatham County, NC",2005-2006,57045,58779,1734,3.04,249,1485,37,37,H1
"Chatham County, NC",2006-2007,58779,60054,1275,2.169,213,1062,37,37,H1
"Chatham County, NC",2007-2008,60054,61783,1729,2.879,166,1563,37,37,H1
"Chatham County, NC",2008-2009,61783,62693,910,1.473,212,698,37,37,H1
"Chatham County, NC",2009-2010,62693,63785,1092,1.742,104,988,37,37,H1
"Chatham County, NC",2010-2011,63785,65191,1406,2.204,71,1335,37,37,H1
"Chatham County, NC",2011-2012,65191,65811,620,0.951,-18,638,37,37,H1
"Chatham County, NC",2012-2013,65811,66766,955,1.451,-13,968,37,37,H1
"Chatham County, NC",2013-2014,66766,68698,1932,2.894,-69,2001,37,37,H1
"Chatham County, NC",2014-2015,68609,70928,2319,3.38,-39,2358,37,37,H1
"Chatham County, NC",2015-2016,70928,69824,-1104,-1.557,-8,-1096,37,37,H1
"Chatham County, NC",2016-2017,69824,71472,1648,2.36,-80,1728,37,37,H1
"Cherokee County, NC",2000-2001,24357,24629,272,1.117,-59,331,37,39,H1
"Cherokee County, NC",2001-2002,24629,24884,255,1.035,-23,278,37,39,H1
"Cherokee County, NC",2002-2003,24884,25229,345,1.386,-71,416,37,39,H1
"Cherokee County, NC",2003-2004,25229,25658,429,1.7,-59,488,37,39,H1
"Cherokee County, NC",2004-2005,25658,26077,419,1.633,-55,474,37,39,H1
"Cherokee County, NC",2005-2006,26077,26877,800,3.068,-35,835,37,39,H1
"Cherokee County, NC",2006-2007,26877,27350,473,1.76,-42,515,37,39,H1
"Cherokee County, NC",2007-2008,27350,27545,195,0.713,-97,292,37,39,H1
"Cherokee County, NC",2008-2009,27545,27378,-167,-0.606,-75,-92,37,39,H1
"Cherokee County, NC",2009-2010,27378,27426,48,0.175,-56,104,37,39,H1
"Cherokee County, NC",2010-2011,27426,27136,-290,-1.057,-115,-175,37,39,H1
"Cherokee County, NC",2011-2012,27136,26972,-164,-0.604,-148,-16,37,39,H1
"Cherokee County, NC",2012-2013,26972,27106,134,0.497,-133,267,37,39,H1
"Cherokee County, NC",2013-2014,27106,27141,35,0.129,-111,146,37,39,H1
"Cherokee County, NC",2014-2015,27087,27178,91,0.336,-134,225,37,39,H1
"Cherokee County, NC",2015-2016,27178,27883,705,2.594,-94,799,37,39,H1
"Cherokee County, NC",2016-2017,27883,28087,204,0.732,-89,293,37,39,H1
"Chowan County, NC",2000-2001,14478,14490,12,0.083,14,-2,37,41,H1
"Chowan County, NC",2001-2002,14490,14559,69,0.476,34,35,37,41,H1
"Chowan County, NC",2002-2003,14559,14529,-30,-0.206,-46,16,37,41,H1
"Chowan County, NC",2003-2004,14529,14573,44,0.303,-24,68,37,41,H1
"Chowan County, NC",2004-2005,14573,14625,52,0.357,-11,63,37,41,H1
"Chowan County, NC",2005-2006,14625,14835,210,1.436,3,207,37,41,H1
"Chowan County, NC",2006-2007,14835,14953,118,0.795,10,108,37,41,H1
"Chowan County, NC",2007-2008,14953,14831,-122,-0.816,21,-143,37,41,H1
"Chowan County, NC",2008-2009,14831,14915,84,0.566,-36,120,37,41,H1
"Chowan County, NC",2009-2010,14915,14753,-162,-1.086,-19,-143,37,41,H1
"Chowan County, NC",2010-2011,14753,14797,44,0.298,-59,103,37,41,H1
"Chowan County, NC",2011-2012,14797,14695,-102,-0.689,1,-103,37,41,H1
"Chowan County, NC",2012-2013,14695,14699,4,0.027,-6,10,37,41,H1
"Chowan County, NC",2013-2014,14699,14572,-127,-0.864,-39,-88,37,41,H1
"Chowan County, NC",2014-2015,14616,14394,-222,-1.519,-30,-192,37,41,H1
"Chowan County, NC",2015-2016,14394,14240,-154,-1.07,-52,-102,37,41,H1
"Chowan County, NC",2016-2017,14240,14105,-135,-0.948,-50,-85,37,41,H1
"Clay County, NC",2000-2001,8824,9086,262,2.969,-28,290,37,43,H1
"Clay County, NC",2001-2002,9086,9273,187,2.058,-52,239,37,43,H1
"Clay County, NC",2002-2003,9273,9429,156,1.682,-8,164,37,43,H1
"Clay County, NC",2003-2004,9429,9583,154,1.633,-21,175,37,43,H1
"Clay County, NC",2004-2005,9583,9833,250,2.609,-31,281,37,43,H1
"Clay County, NC",2005-2006,9833,10107,274,2.787,-52,326,37,43,H1
"Clay County, NC",2006-2007,10107,10356,249,2.464,-35,284,37,43,H1
"Clay County, NC",2007-2008,10356,10492,136,1.313,-43,179,37,43,H1
"Clay County, NC",2008-2009,10492,10540,48,0.457,-43,91,37,43,H1
"Clay County, NC",2009-2010,10540,10574,34,0.323,-40,74,37,43,H1
"Clay County, NC",2010-2011,10574,10653,79,0.747,-40,119,37,43,H1
"Clay County, NC",2011-2012,10653,10656,3,0.028,-56,59,37,43,H1
"Clay County, NC",2012-2013,10656,10618,-38,-0.357,-70,32,37,43,H1
"Clay County, NC",2013-2014,10618,10581,-37,-0.348,-65,28,37,43,H1
"Clay County, NC",2014-2015,10618,10703,85,0.801,-52,137,37,43,H1
"Clay County, NC",2015-2016,10703,10819,116,1.084,-38,154,37,43,H1
"Clay County, NC",2016-2017,10819,11074,255,2.357,-63,318,37,43,H1
"Cleveland County, NC",2000-2001,96357,96861,504,0.523,265,239,37,45,H1
"Cleveland County, NC",2001-2002,96861,97068,207,0.214,273,-66,37,45,H1
"Cleveland County, NC",2002-2003,97068,97241,173,0.178,215,-42,37,45,H1
"Cleveland County, NC",2003-2004,97241,97134,-107,-0.11,172,-279,37,45,H1
"Cleveland County, NC",2004-2005,97134,96844,-290,-0.299,184,-474,37,45,H1
"Cleveland County, NC",2005-2006,96844,96990,146,0.151,107,39,37,45,H1
"Cleveland County, NC",2006-2007,96990,97524,534,0.551,132,402,37,45,H1
"Cleveland County, NC",2007-2008,97524,98155,631,0.647,123,508,37,45,H1
"Cleveland County, NC",2008-2009,98155,98211,56,0.057,170,-114,37,45,H1
"Cleveland County, NC",2009-2010,98211,98039,-172,-0.175,161,-333,37,45,H1
"Cleveland County, NC",2010-2011,98039,97614,-425,-0.434,47,-472,37,45,H1
"Cleveland County, NC",2011-2012,97614,97515,-99,-0.101,-35,-64,37,45,H1
"Cleveland County, NC",2012-2013,97515,97077,-438,-0.449,-64,-374,37,45,H1
"Cleveland County, NC",2013-2014,97077,97076,-1,-0.001,-43,42,37,45,H1
"Cleveland County, NC",2014-2015,97007,96879,-128,-0.132,-119,-9,37,45,H1
"Cleveland County, NC",2015-2016,96879,97102,223,0.23,-166,389,37,45,H1
"Cleveland County, NC",2016-2017,97102,97334,232,0.239,-154,386,37,45,H1
"Columbus County, NC",2000-2001,54759,54806,47,0.086,149,-102,37,47,H1
"Columbus County, NC",2001-2002,54806,54975,169,0.308,137,32,37,47,H1
"Columbus County, NC",2002-2003,54975,54961,-14,-0.025,185,-199,37,47,H1
"Columbus County, NC",2003-2004,54961,55099,138,0.251,96,42,37,47,H1
"Columbus County, NC",2004-2005,55099,55155,56,0.102,108,-52,37,47,H1
"Columbus County, NC",2005-2006,55155,55654,499,0.905,90,409,37,47,H1
"Columbus County, NC",2006-2007,55654,55964,310,0.557,38,272,37,47,H1
"Columbus County, NC",2007-2008,55964,56503,539,0.963,116,423,37,47,H1
"Columbus County, NC",2008-2009,56503,58163,1660,2.938,127,1533,37,47,H1
"Columbus County, NC",2009-2010,58163,57967,-196,-0.337,111,-307,37,47,H1
"Columbus County, NC",2010-2011,57967,57844,-123,-0.212,-25,-98,37,47,H1
"Columbus County, NC",2011-2012,57844,57604,-240,-0.415,64,-304,37,47,H1
"Columbus County, NC",2012-2013,57604,57194,-410,-0.712,-110,-300,37,47,H1
"Columbus County, NC",2013-2014,57194,56953,-241,-0.421,-96,-145,37,47,H1
"Columbus County, NC",2014-2015,56938,56694,-244,-0.429,-64,-180,37,47,H1
"Columbus County, NC",2015-2016,56694,56335,-359,-0.633,-74,-285,37,47,H1
"Columbus County, NC",2016-2017,56335,55936,-399,-0.708,-133,-266,37,47,H1
"Craven County, NC",2000-2001,91954,93325,1371,1.491,814,557,37,49,H1
"Craven County, NC",2001-2002,93325,92633,-692,-0.741,679,-1371,37,49,H1
"Craven County, NC",2002-2003,92633,92906,273,0.295,671,-398,37,49,H1
"Craven County, NC",2003-2004,92906,93548,642,0.691,642,0,37,49,H1
"Craven County, NC",2004-2005,93548,94729,1181,1.262,655,526,37,49,H1
"Craven County, NC",2005-2006,94729,96926,2197,2.319,678,1519,37,49,H1
"Craven County, NC",2006-2007,96926,97825,899,0.928,696,203,37,49,H1
"Craven County, NC",2007-2008,97825,99423,1598,1.634,752,846,37,49,H1
"Craven County, NC",2008-2009,99423,101923,2500,2.515,698,1802,37,49,H1
"Craven County, NC",2009-2010,101923,103919,1996,1.958,798,1198,37,49,H1
"Craven County, NC",2010-2011,103919,104675,756,0.727,732,24,37,49,H1
"Craven County, NC",2011-2012,104675,105309,634,0.606,674,-40,37,49,H1
"Craven County, NC",2012-2013,105309,104455,-854,-0.811,556,-1410,37,49,H1
"Craven County, NC",2013-2014,104455,104510,55,0.053,542,-487,37,49,H1
"Craven County, NC",2014-2015,104350,103451,-899,-0.862,502,-1401,37,49,H1
"Craven County, NC",2015-2016,103451,102857,-594,-0.574,319,-913,37,49,H1
"Craven County, NC",2016-2017,102857,102578,-279,-0.271,363,-642,37,49,H1
"Cumberland County, NC",2000-2001,303755,304316,561,0.185,3563,-3002,37,51,H1
"Cumberland County, NC",2001-2002,304316,305697,1381,0.454,3309,-1928,37,51,H1
"Cumberland County, NC",2002-2003,305697,303318,-2379,-0.778,3359,-5738,37,51,H1
"Cumberland County, NC",2003-2004,303318,307629,4311,1.421,3095,1216,37,51,H1
"Cumberland County, NC",2004-2005,307629,303695,-3934,-1.279,3550,-7484,37,51,H1
"Cumberland County, NC",2005-2006,303695,307365,3670,1.208,3181,489,37,51,H1
"Cumberland County, NC",2006-2007,307365,308284,919,0.299,3847,-2928,37,51,H1
"Cumberland County, NC",2007-2008,308284,311800,3516,1.141,3535,-19,37,51,H1
"Cumberland County, NC",2008-2009,311800,317252,5452,1.749,3376,2076,37,51,H1
"Cumberland County, NC",2009-2010,317252,320254,3002,0.946,4178,-1176,37,51,H1
"Cumberland County, NC",2010-2011,320254,323865,3611,1.128,3699,-88,37,51,H1
"Cumberland County, NC",2011-2012,323865,323099,-766,-0.237,3359,-4125,37,51,H1
"Cumberland County, NC",2012-2013,323099,326466,3367,1.042,3340,27,37,51,H1
"Cumberland County, NC",2013-2014,326466,326328,-138,-0.042,3264,-3402,37,51,H1
"Cumberland County, NC",2014-2015,325814,323838,-1976,-0.606,3181,-5157,37,51,H1
"Cumberland County, NC",2015-2016,323838,333538,9700,2.995,2882,6818,37,51,H1
"Cumberland County, NC",2016-2017,333538,332546,-992,-0.297,2772,-3764,37,51,H1
"Currituck County, NC",2000-2001,18294,18714,420,2.296,70,350,37,53,H1
"Currituck County, NC",2001-2002,18714,19327,613,3.276,47,566,37,53,H1
"Currituck County, NC",2002-2003,19327,20299,972,5.029,65,907,37,53,H1
"Currituck County, NC",2003-2004,20299,21469,1170,5.764,71,1099,37,53,H1
"Currituck County, NC",2004-2005,21469,22418,949,4.42,68,881,37,53,H1
"Currituck County, NC",2005-2006,22418,22923,505,2.253,91,414,37,53,H1
"Currituck County, NC",2006-2007,22923,23216,293,1.278,47,246,37,53,H1
"Currituck County, NC",2007-2008,23216,23378,162,0.698,71,91,37,53,H1
"Currituck County, NC",2008-2009,23378,23335,-43,-0.184,67,-110,37,53,H1
"Currituck County, NC",2009-2010,23335,23651,316,1.354,44,272,37,53,H1
"Currituck County, NC",2010-2011,23651,23927,276,1.167,15,261,37,53,H1
"Currituck County, NC",2011-2012,23927,24092,165,0.69,4,161,37,53,H1
"Currituck County, NC",2012-2013,24092,24414,322,1.337,7,315,37,53,H1
"Currituck County, NC",2013-2014,24414,24976,562,2.302,27,535,37,53,H1
"Currituck County, NC",2014-2015,24927,25263,336,1.348,59,277,37,53,H1
"Currituck County, NC",2015-2016,25263,25664,401,1.587,44,357,37,53,H1
"Currituck County, NC",2016-2017,25664,26331,667,2.599,42,625,37,53,H1
"Dare County, NC",2000-2001,30149,30826,677,2.246,94,583,37,55,H1
"Dare County, NC",2001-2002,30826,31898,1072,3.478,102,970,37,55,H1
"Dare County, NC",2002-2003,31898,32697,799,2.505,95,704,37,55,H1
"Dare County, NC",2003-2004,32697,33196,499,1.526,195,304,37,55,H1
"Dare County, NC",2004-2005,33196,33354,158,0.476,219,-61,37,55,H1
"Dare County, NC",2005-2006,33354,33463,109,0.327,196,-87,37,55,H1
"Dare County, NC",2006-2007,33463,33541,78,0.233,215,-137,37,55,H1
"Dare County, NC",2007-2008,33541,33553,12,0.036,122,-110,37,55,H1
"Dare County, NC",2008-2009,33553,33679,126,0.376,158,-32,37,55,H1
"Dare County, NC",2009-2010,33679,33980,301,0.894,122,179,37,55,H1
"Dare County, NC",2010-2011,33980,34191,211,0.621,62,149,37,55,H1
"Dare County, NC",2011-2012,34191,34458,267,0.781,82,185,37,55,H1
"Dare County, NC",2012-2013,34458,34919,461,1.338,90,371,37,55,H1
"Dare County, NC",2013-2014,34919,35104,185,0.53,90,95,37,55,H1
"Dare County, NC",2014-2015,35083,35663,580,1.653,34,546,37,55,H1
"Dare County, NC",2015-2016,35663,35760,97,0.272,-16,113,37,55,H1
"Dare County, NC",2016-2017,35760,36099,339,0.948,-28,367,37,55,H1
"Davidson County, NC",2000-2001,147713,149663,1950,1.32,592,1358,37,57,H1
"Davidson County, NC",2001-2002,149663,151296,1633,1.091,522,1111,37,57,H1
"Davidson County, NC",2002-2003,151296,152809,1513,1,435,1078,37,57,H1
"Davidson County, NC",2003-2004,152809,154179,1370,0.897,566,804,37,57,H1
"Davidson County, NC",2004-2005,154179,155425,1246,0.808,400,846,37,57,H1
"Davidson County, NC",2005-2006,155425,157209,1784,1.148,395,1389,37,57,H1
"Davidson County, NC",2006-2007,157209,159126,1917,1.219,458,1459,37,57,H1
"Davidson County, NC",2007-2008,159126,161520,2394,1.504,485,1909,37,57,H1
"Davidson County, NC",2008-2009,161520,162406,886,0.549,503,383,37,57,H1
"Davidson County, NC",2009-2010,162406,162898,492,0.303,395,97,37,57,H1
"Davidson County, NC",2010-2011,162898,163360,462,0.284,142,320,37,57,H1
"Davidson County, NC",2011-2012,163360,163542,182,0.111,142,40,37,57,H1
"Davidson County, NC",2012-2013,163542,163854,312,0.191,-47,359,37,57,H1
"Davidson County, NC",2013-2014,163854,164072,218,0.133,33,185,37,57,H1
"Davidson County, NC",2014-2015,164067,164622,555,0.338,46,509,37,57,H1
"Davidson County, NC",2015-2016,164622,164504,-118,-0.072,-5,-113,37,57,H1
"Davidson County, NC",2016-2017,164504,165466,962,0.585,27,935,37,57,H1
"Davie County, NC",2000-2001,35046,35905,859,2.451,124,735,37,59,H1
"Davie County, NC",2001-2002,35905,36446,541,1.507,110,431,37,59,H1
"Davie County, NC",2002-2003,36446,36864,418,1.147,56,362,37,59,H1
"Davie County, NC",2003-2004,36864,37552,688,1.866,115,573,37,59,H1
"Davie County, NC",2004-2005,37552,38559,1007,2.682,69,938,37,59,H1
"Davie County, NC",2005-2006,38559,39539,980,2.542,142,838,37,59,H1
"Davie County, NC",2006-2007,39539,40260,721,1.824,51,670,37,59,H1
"Davie County, NC",2007-2008,40260,40748,488,1.212,112,376,37,59,H1
"Davie County, NC",2008-2009,40748,41035,287,0.704,105,182,37,59,H1
"Davie County, NC",2009-2010,41035,41321,286,0.697,72,214,37,59,H1
"Davie County, NC",2010-2011,41321,41383,62,0.15,-30,92,37,59,H1
"Davie County, NC",2011-2012,41383,41366,-17,-0.041,-2,-15,37,59,H1
"Davie County, NC",2012-2013,41366,41549,183,0.442,-12,195,37,59,H1
"Davie County, NC",2013-2014,41549,41434,-115,-0.277,23,-138,37,59,H1
"Davie County, NC",2014-2015,41322,41753,431,1.043,-16,447,37,59,H1
"Davie County, NC",2015-2016,41753,41973,220,0.527,-97,317,37,59,H1
"Davie County, NC",2016-2017,41973,42456,483,1.151,-27,510,37,59,H1
"Duplin County, NC",2000-2001,49236,50182,946,1.921,296,650,37,61,H1
"Duplin County, NC",2001-2002,50182,51121,939,1.871,330,609,37,61,H1
"Duplin County, NC",2002-2003,51121,51880,759,1.485,232,527,37,61,H1
"Duplin County, NC",2003-2004,51880,52732,852,1.642,250,602,37,61,H1
"Duplin County, NC",2004-2005,52732,53445,713,1.352,300,413,37,61,H1
"Duplin County, NC",2005-2006,53445,54704,1259,2.356,333,926,37,61,H1
"Duplin County, NC",2006-2007,54704,55610,906,1.656,323,583,37,61,H1
"Duplin County, NC",2007-2008,55610,56810,1200,2.158,304,896,37,61,H1
"Duplin County, NC",2008-2009,56810,57434,624,1.098,310,314,37,61,H1
"Duplin County, NC",2009-2010,57434,58710,1276,2.222,307,969,37,61,H1
"Duplin County, NC",2010-2011,58710,59425,715,1.218,300,415,37,61,H1
"Duplin County, NC",2011-2012,59425,59667,242,0.407,289,-47,37,61,H1
"Duplin County, NC",2012-2013,59667,59593,-74,-0.124,212,-286,37,61,H1
"Duplin County, NC",2013-2014,59593,59882,289,0.485,215,74,37,61,H1
"Duplin County, NC",2014-2015,59618,59159,-459,-0.77,247,-706,37,61,H1
"Duplin County, NC",2015-2016,59159,59559,400,0.676,195,205,37,61,H1
"Duplin County, NC",2016-2017,59559,59039,-520,-0.873,170,-690,37,61,H1
"Durham County, NC",2000-2001,224476,228978,4502,2.006,2212,2290,37,63,H1
"Durham County, NC",2001-2002,228978,233505,4527,1.977,2206,2321,37,63,H1
"Durham County, NC",2002-2003,233505,235570,2065,0.884,2144,-79,37,63,H1
"Durham County, NC",2003-2004,235570,238376,2806,1.191,2193,613,37,63,H1
"Durham County, NC",2004-2005,238376,241785,3409,1.43,2256,1153,37,63,H1
"Durham County, NC",2005-2006,241785,246929,5144,2.128,2439,2705,37,63,H1
"Durham County, NC",2006-2007,246929,252796,5867,2.376,2577,3290,37,63,H1
"Durham County, NC",2007-2008,252796,259356,6560,2.595,2788,3772,37,63,H1
"Durham County, NC",2008-2009,259356,265356,6.00E+03,2.313,2603,3397,37,63,H1
"Durham County, NC",2009-2010,265356,270798,5442,2.051,2679,2763,37,63,H1
"Durham County, NC",2010-2011,270798,276299,5501,2.031,2402,3099,37,63,H1
"Durham County, NC",2011-2012,276299,282308,6009,2.175,2628,3381,37,63,H1
"Durham County, NC",2012-2013,282308,288243,5935,2.102,2402,3533,37,63,H1
"Durham County, NC",2013-2014,288243,294460,6217,2.157,2459,3758,37,63,H1
"Durham County, NC",2014-2015,295323,300952,5629,1.906,2460,3169,37,63,H1
"Durham County, NC",2015-2016,300952,307090,6138,2.04,2356,3782,37,63,H1
"Durham County, NC",2016-2017,307090,311640,4550,1.482,2253,2297,37,63,H1
"Edgecombe County, NC",2000-2001,55443,55792,349,0.629,183,166,37,65,H1
"Edgecombe County, NC",2001-2002,55792,55855,63,0.113,179,-116,37,65,H1
"Edgecombe County, NC",2002-2003,55855,55994,139,0.249,108,31,37,65,H1
"Edgecombe County, NC",2003-2004,55994,56064,70,0.125,180,-110,37,65,H1
"Edgecombe County, NC",2004-2005,56064,56151,87,0.155,139,-52,37,65,H1
"Edgecombe County, NC",2005-2006,56151,56129,-22,-0.039,150,-172,37,65,H1
"Edgecombe County, NC",2006-2007,56129,55911,-218,-0.388,168,-386,37,65,H1
"Edgecombe County, NC",2007-2008,55911,56420,509,0.91,190,319,37,65,H1
"Edgecombe County, NC",2008-2009,56420,56237,-183,-0.324,187,-370,37,65,H1
"Edgecombe County, NC",2009-2010,56237,56609,372,0.661,193,179,37,65,H1
"Edgecombe County, NC",2010-2011,56609,56087,-522,-0.922,76,-598,37,65,H1
"Edgecombe County, NC",2011-2012,56087,55714,-373,-0.665,100,-473,37,65,H1
"Edgecombe County, NC",2012-2013,55714,55554,-160,-0.287,55,-215,37,65,H1
"Edgecombe County, NC",2013-2014,55554,54933,-621,-1.118,39,-660,37,65,H1
"Edgecombe County, NC",2014-2015,54898,54150,-748,-1.363,-11,-737,37,65,H1
"Edgecombe County, NC",2015-2016,54150,53293,-857,-1.583,-46,-811,37,65,H1
"Edgecombe County, NC",2016-2017,53293,52747,-546,-1.025,-57,-489,37,65,H1
"Forsyth County, NC",2000-2001,307156,310807,3651,1.189,1836,1815,37,67,H1
"Forsyth County, NC",2001-2002,310807,314215,3408,1.097,1828,1580,37,67,H1
"Forsyth County, NC",2002-2003,314215,316659,2444,0.778,1790,654,37,67,H1
"Forsyth County, NC",2003-2004,316659,319997,3338,1.054,1748,1590,37,67,H1
"Forsyth County, NC",2004-2005,319997,325065,5068,1.584,1838,3230,37,67,H1
"Forsyth County, NC",2005-2006,325065,332110,7045,2.167,1998,5047,37,67,H1
"Forsyth County, NC",2006-2007,332110,338638,6528,1.966,2302,4226,37,67,H1
"Forsyth County, NC",2007-2008,338638,344330,5692,1.681,2252,3440,37,67,H1
"Forsyth County, NC",2008-2009,344330,348532,4202,1.22,2045,2157,37,67,H1
"Forsyth County, NC",2009-2010,348532,351399,2867,0.823,1813,1054,37,67,H1
"Forsyth County, NC",2010-2011,351399,354465,3066,0.873,1647,1419,37,67,H1
"Forsyth County, NC",2011-2012,354465,357967,3502,0.988,1550,1952,37,67,H1
"Forsyth County, NC",2012-2013,357967,361521,3554,0.993,1436,2118,37,67,H1
"Forsyth County, NC",2013-2014,361521,365298,3777,1.045,1523,2254,37,67,H1
"Forsyth County, NC",2014-2015,365593,369019,3426,0.937,1506,1920,37,67,H1
"Forsyth County, NC",2015-2016,369019,371614,2595,0.703,1156,1439,37,67,H1
"Forsyth County, NC",2016-2017,371614,376320,4706,1.266,1169,3537,37,67,H1
"Franklin County, NC",2000-2001,47611,48794,1183,2.485,223,960,37,69,H1
"Franklin County, NC",2001-2002,48794,50622,1828,3.746,242,1586,37,69,H1
"Franklin County, NC",2002-2003,50622,51959,1337,2.641,224,1113,37,69,H1
"Franklin County, NC",2003-2004,51959,53119,1160,2.233,200,960,37,69,H1
"Franklin County, NC",2004-2005,53119,54260,1141,2.148,266,875,37,69,H1
"Franklin County, NC",2005-2006,54260,55460,1200,2.212,271,929,37,69,H1
"Franklin County, NC",2006-2007,55460,57174,1714,3.091,272,1442,37,69,H1
"Franklin County, NC",2007-2008,57174,58925,1751,3.063,273,1478,37,69,H1
"Franklin County, NC",2008-2009,58925,59959,1034,1.755,295,739,37,69,H1
"Franklin County, NC",2009-2010,59959,60821,862,1.438,168,694,37,69,H1
"Franklin County, NC",2010-2011,60821,61090,269,0.442,223,46,37,69,H1
"Franklin County, NC",2011-2012,61090,61571,481,0.787,128,353,37,69,H1
"Franklin County, NC",2012-2013,61571,62275,704,1.143,109,595,37,69,H1
"Franklin County, NC",2013-2014,62275,62860,585,0.939,129,456,37,69,H1
"Franklin County, NC",2014-2015,62805,63710,905,1.441,131,774,37,69,H1
"Franklin County, NC",2015-2016,63710,64659,949,1.49,149,800,37,69,H1
"Franklin County, NC",2016-2017,64659,66168,1509,2.334,121,1388,37,69,H1
"Gaston County, NC",2000-2001,190679,191424,745,0.391,669,76,37,71,H1
"Gaston County, NC",2001-2002,191424,191930,506,0.264,596,-90,37,71,H1
"Gaston County, NC",2002-2003,191930,191545,-385,-0.201,624,-1009,37,71,H1
"Gaston County, NC",2003-2004,191545,191646,101,0.053,518,-417,37,71,H1
"Gaston County, NC",2004-2005,191646,193527,1881,0.981,664,1217,37,71,H1
"Gaston County, NC",2005-2006,193527,196284,2757,1.425,698,2059,37,71,H1
"Gaston County, NC",2006-2007,196284,200377,4093,2.085,910,3183,37,71,H1
"Gaston County, NC",2007-2008,200377,204454,4077,2.035,774,3303,37,71,H1
"Gaston County, NC",2008-2009,204454,205884,1430,0.699,743,687,37,71,H1
"Gaston County, NC",2009-2010,205884,206091,207,0.101,702,-495,37,71,H1
"Gaston County, NC",2010-2011,206091,206982,891,0.432,542,349,37,71,H1
"Gaston County, NC",2011-2012,206982,208204,1222,0.59,454,768,37,71,H1
"Gaston County, NC",2012-2013,208204,209492,1288,0.619,221,1067,37,71,H1
"Gaston County, NC",2013-2014,209492,211127,1635,0.78,304,1331,37,71,H1
"Gaston County, NC",2014-2015,211040,213442,2402,1.138,287,2115,37,71,H1
"Gaston County, NC",2015-2016,213442,216903,3461,1.622,205,3256,37,71,H1
"Gaston County, NC",2016-2017,216903,220182,3279,1.512,270,3009,37,71,H1
"Gates County, NC",2000-2001,10505,10546,41,0.39,-17,58,37,73,H1
"Gates County, NC",2001-2002,10546,10616,70,0.664,-16,86,37,73,H1
"Gates County, NC",2002-2003,10616,10800,184,1.733,-20,204,37,73,H1
"Gates County, NC",2003-2004,10800,10874,74,0.685,-5,79,37,73,H1
"Gates County, NC",2004-2005,10874,11294,420,3.862,13,407,37,73,H1
"Gates County, NC",2005-2006,11294,11708,414,3.666,25,389,37,73,H1
"Gates County, NC",2006-2007,11708,12042,334,2.853,-8,342,37,73,H1
"Gates County, NC",2007-2008,12042,12098,56,0.465,28,28,37,73,H1
"Gates County, NC",2008-2009,12098,12138,40,0.331,18,22,37,73,H1
"Gates County, NC",2009-2010,12138,12163,25,0.206,-5,30,37,73,H1
"Gates County, NC",2010-2011,12163,12069,-94,-0.773,-18,-76,37,73,H1
"Gates County, NC",2011-2012,12069,11909,-160,-1.326,12,-172,37,73,H1
"Gates County, NC",2012-2013,11909,11675,-234,-1.965,20,-254,37,73,H1
"Gates County, NC",2013-2014,11675,11567,-108,-0.925,4,-112,37,73,H1
"Gates County, NC",2014-2015,11550,11431,-119,-1.03,-24,-95,37,73,H1
"Gates County, NC",2015-2016,11431,11593,162,1.417,7,155,37,73,H1
"Gates County, NC",2016-2017,11593,11544,-49,-0.423,-15,-34,37,73,H1
"Graham County, NC",2000-2001,7994,8054,60,0.751,-8,68,37,75,H1
"Graham County, NC",2001-2002,8054,8204,150,1.862,-2,152,37,75,H1
"Graham County, NC",2002-2003,8204,8222,18,0.219,-6,24,37,75,H1
"Graham County, NC",2003-2004,8222,8382,160,1.946,10,150,37,75,H1
"Graham County, NC",2004-2005,8382,8418,36,0.429,8,28,37,75,H1
"Graham County, NC",2005-2006,8418,8561,143,1.699,8,135,37,75,H1
"Graham County, NC",2006-2007,8561,8583,22,0.257,5,17,37,75,H1
"Graham County, NC",2007-2008,8583,8742,159,1.852,2,157,37,75,H1
"Graham County, NC",2008-2009,8742,8749,7,0.08,1,6,37,75,H1
"Graham County, NC",2009-2010,8749,8864,115,1.314,2,113,37,75,H1
"Graham County, NC",2010-2011,8864,8782,-82,-0.925,-6,-76,37,75,H1
"Graham County, NC",2011-2012,8782,8696,-86,-0.979,-17,-69,37,75,H1
"Graham County, NC",2012-2013,8696,8727,31,0.356,-17,48,37,75,H1
"Graham County, NC",2013-2014,8727,8644,-83,-0.951,0,-83,37,75,H1
"Graham County, NC",2014-2015,8651,8616,-35,-0.405,-14,-21,37,75,H1
"Graham County, NC",2015-2016,8616,8548,-68,-0.789,-11,-57,37,75,H1
"Graham County, NC",2016-2017,8548,8541,-7,-0.082,-17,10,37,75,H1
"Granville County, NC",2000-2001,48824,50137,1313,2.689,206,1107,37,77,H1
"Granville County, NC",2001-2002,50137,51977,1840,3.67,147,1693,37,77,H1
"Granville County, NC",2002-2003,51977,52836,859,1.653,175,684,37,77,H1
"Granville County, NC",2003-2004,52836,53296,460,0.871,131,329,37,77,H1
"Granville County, NC",2004-2005,53296,54115,819,1.537,187,632,37,77,H1
"Granville County, NC",2005-2006,54115,55167,1052,1.944,172,880,37,77,H1
"Granville County, NC",2006-2007,55167,57356,2189,3.968,137,2052,37,77,H1
"Granville County, NC",2007-2008,57356,58356,1.00E+03,1.743,74,926,37,77,H1
"Granville County, NC",2008-2009,58356,59411,1055,1.808,169,886,37,77,H1
"Granville County, NC",2009-2010,59411,57650,-1761,-2.964,167,-1928,37,77,H1
"Granville County, NC",2010-2011,57650,57681,31,0.054,123,-92,37,77,H1
"Granville County, NC",2011-2012,57681,57818,137,0.238,77,60,37,77,H1
"Granville County, NC",2012-2013,57818,58128,310,0.536,54,256,37,77,H1
"Granville County, NC",2013-2014,58128,58500,372,0.64,34,338,37,77,H1
"Granville County, NC",2014-2015,58357,58674,317,0.543,27,290,37,77,H1
"Granville County, NC",2015-2016,58674,58824,150,0.256,58,92,37,77,H1
"Granville County, NC",2016-2017,58824,59557,733,1.246,31,702,37,77,H1
"Greene County, NC",2000-2001,19020,19241,221,1.162,71,150,37,79,H1
"Greene County, NC",2001-2002,19241,19512,271,1.408,94,177,37,79,H1
"Greene County, NC",2002-2003,19512,19848,336,1.722,27,309,37,79,H1
"Greene County, NC",2003-2004,19848,20132,284,1.431,67,217,37,79,H1
"Greene County, NC",2004-2005,20132,20146,14,0.07,82,-68,37,79,H1
"Greene County, NC",2005-2006,20146,20742,596,2.958,60,536,37,79,H1
"Greene County, NC",2006-2007,20742,21178,436,2.102,97,339,37,79,H1
"Greene County, NC",2007-2008,21178,21230,52,0.246,67,-15,37,79,H1
"Greene County, NC",2008-2009,21230,21253,23,0.108,50,-27,37,79,H1
"Greene County, NC",2009-2010,21253,21383,130,0.612,45,85,37,79,H1
"Greene County, NC",2010-2011,21383,21684,301,1.408,91,210,37,79,H1
"Greene County, NC",2011-2012,21684,21391,-293,-1.351,55,-348,37,79,H1
"Greene County, NC",2012-2013,21391,21214,-177,-0.827,13,-190,37,79,H1
"Greene County, NC",2013-2014,21214,21093,-121,-0.57,8,-129,37,79,H1
"Greene County, NC",2014-2015,21247,21134,-113,-0.532,-12,-101,37,79,H1
"Greene County, NC",2015-2016,21134,21144,10,0.047,22,-12,37,79,H1
"Greene County, NC",2016-2017,21144,21015,-129,-0.61,-6,-123,37,79,H1
"Guilford County, NC",2000-2001,422324,428381,6057,1.434,2557,3500,37,81,H1
"Guilford County, NC",2001-2002,428381,432068,3687,0.861,2435,1252,37,81,H1
"Guilford County, NC",2002-2003,432068,436327,4259,0.986,2466,1793,37,81,H1
"Guilford County, NC",2003-2004,436327,440597,4270,0.979,2289,1981,37,81,H1
"Guilford County, NC",2004-2005,440597,448192,7595,1.724,2217,5378,37,81,H1
"Guilford County, NC",2005-2006,448192,458792,10600,2.365,2431,8169,37,81,H1
"Guilford County, NC",2006-2007,458792,468466,9674,2.109,2643,7031,37,81,H1
"Guilford County, NC",2007-2008,468466,477809,9343,1.994,2829,6514,37,81,H1
"Guilford County, NC",2008-2009,477809,484180,6371,1.333,2648,3723,37,81,H1
"Guilford County, NC",2009-2010,484180,489479,5299,1.094,2457,2842,37,81,H1
"Guilford County, NC",2010-2011,489479,495052,5573,1.139,2191,3382,37,81,H1
"Guilford County, NC",2011-2012,495052,500894,5842,1.18,2248,3594,37,81,H1
"Guilford County, NC",2012-2013,500894,506953,6059,1.21,2186,3873,37,81,H1
"Guilford County, NC",2013-2014,506953,512119,5166,1.019,2081,3085,37,81,H1
"Guilford County, NC",2014-2015,512959,517600,4641,0.905,1941,2700,37,81,H1
"Guilford County, NC",2015-2016,517600,521996,4396,0.849,1750,2646,37,81,H1
"Guilford County, NC",2016-2017,521996,526953,4957,0.95,1706,3251,37,81,H1
"Halifax County, NC",2000-2001,57306,56788,-518,-0.904,148,-666,37,83,H1
"Halifax County, NC",2001-2002,56788,56507,-281,-0.495,48,-329,37,83,H1
"Halifax County, NC",2002-2003,56507,56301,-206,-0.365,97,-303,37,83,H1
"Halifax County, NC",2003-2004,56301,5.60E+04,-301,-0.535,82,-383,37,83,H1
"Halifax County, NC",2004-2005,5.60E+04,55860,-140,-0.25,81,-221,37,83,H1
"Halifax County, NC",2005-2006,55860,55685,-175,-0.313,27,-202,37,83,H1
"Halifax County, NC",2006-2007,55685,55616,-69,-0.124,69,-138,37,83,H1
"Halifax County, NC",2007-2008,55616,55568,-48,-0.086,27,-75,37,83,H1
"Halifax County, NC",2008-2009,55568,55033,-535,-0.963,50,-585,37,83,H1
"Halifax County, NC",2009-2010,55033,54515,-518,-0.941,42,-560,37,83,H1
"Halifax County, NC",2010-2011,54515,54240,-275,-0.504,-45,-230,37,83,H1
"Halifax County, NC",2011-2012,54240,53923,-317,-0.584,-31,-286,37,83,H1
"Halifax County, NC",2012-2013,53923,53365,-558,-1.035,-130,-428,37,83,H1
"Halifax County, NC",2013-2014,53365,52970,-395,-0.74,-116,-279,37,83,H1
"Halifax County, NC",2014-2015,53019,52456,-563,-1.062,-124,-439,37,83,H1
"Halifax County, NC",2015-2016,52456,51871,-585,-1.115,-75,-510,37,83,H1
"Halifax County, NC",2016-2017,51871,51310,-561,-1.082,-130,-431,37,83,H1
"Harnett County, NC",2000-2001,91393,93168,1775,1.942,693,1082,37,85,H1
"Harnett County, NC",2001-2002,93168,95708,2540,2.726,745,1795,37,85,H1
"Harnett County, NC",2002-2003,95708,96787,1079,1.127,644,435,37,85,H1
"Harnett County, NC",2003-2004,96787,98545,1758,1.816,631,1127,37,85,H1
"Harnett County, NC",2004-2005,98545,100728,2183,2.215,647,1536,37,85,H1
"Harnett County, NC",2005-2006,100728,103036,2308,2.291,743,1565,37,85,H1
"Harnett County, NC",2006-2007,103036,105770,2734,2.653,870,1864,37,85,H1
"Harnett County, NC",2007-2008,105770,108752,2982,2.819,784,2198,37,85,H1
"Harnett County, NC",2008-2009,108752,111866,3114,2.863,837,2277,37,85,H1
"Harnett County, NC",2009-2010,111866,115721,3855,3.446,860,2995,37,85,H1
"Harnett County, NC",2010-2011,115721,119208,3487,3.013,955,2532,37,85,H1
"Harnett County, NC",2011-2012,119208,122213,3005,2.521,944,2061,37,85,H1
"Harnett County, NC",2012-2013,122213,125137,2924,2.393,882,2042,37,85,H1
"Harnett County, NC",2013-2014,125137,126666,1529,1.222,906,623,37,85,H1
"Harnett County, NC",2014-2015,126865,128140,1275,1.005,957,318,37,85,H1
"Harnett County, NC",2015-2016,128140,130899,2759,2.153,808,1951,37,85,H1
"Harnett County, NC",2016-2017,130899,132754,1855,1.417,826,1029,37,85,H1
"Haywood County, NC",2000-2001,54133,54802,669,1.236,-82,751,37,87,H1
"Haywood County, NC",2001-2002,54802,55387,585,1.067,-108,693,37,87,H1
"Haywood County, NC",2002-2003,55387,56077,690,1.246,-37,727,37,87,H1
"Haywood County, NC",2003-2004,56077,56785,708,1.263,-110,818,37,87,H1
"Haywood County, NC",2004-2005,56785,57085,300,0.528,-166,466,37,87,H1
"Haywood County, NC",2005-2006,57085,57701,616,1.079,-60,676,37,87,H1
"Haywood County, NC",2006-2007,57701,58386,685,1.187,-135,820,37,87,H1
"Haywood County, NC",2007-2008,58386,58811,425,0.728,-80,505,37,87,H1
"Haywood County, NC",2008-2009,58811,59152,341,0.58,-115,456,37,87,H1
"Haywood County, NC",2009-2010,59152,58950,-202,-0.341,-91,-111,37,87,H1
"Haywood County, NC",2010-2011,58950,58693,-257,-0.436,-124,-133,37,87,H1
"Haywood County, NC",2011-2012,58693,58782,89,0.152,-122,211,37,87,H1
"Haywood County, NC",2012-2013,58782,59163,381,0.648,-154,535,37,87,H1
"Haywood County, NC",2013-2014,59163,59471,308,0.521,-147,455,37,87,H1
"Haywood County, NC",2014-2015,59380,59868,488,0.822,-179,667,37,87,H1
"Haywood County, NC",2015-2016,59868,60388,520,0.869,-184,704,37,87,H1
"Haywood County, NC",2016-2017,60388,61084,696,1.153,-137,833,37,87,H1
"Henderson County, NC",2000-2001,89662,91150,1488,1.66,5,1483,37,89,H1
"Henderson County, NC",2001-2002,91150,92700,1550,1.7,-54,1604,37,89,H1
"Henderson County, NC",2002-2003,92700,94246,1546,1.668,-25,1571,37,89,H1
"Henderson County, NC",2003-2004,94246,95797,1551,1.646,-38,1589,37,89,H1
"Henderson County, NC",2004-2005,95797,97584,1787,1.865,-126,1913,37,89,H1
"Henderson County, NC",2005-2006,97584,100056,2472,2.533,-103,2575,37,89,H1
"Henderson County, NC",2006-2007,100056,102270,2214,2.213,-42,2256,37,89,H1
"Henderson County, NC",2007-2008,102270,104289,2019,1.974,-19,2038,37,89,H1
"Henderson County, NC",2008-2009,104289,105813,1524,1.461,-55,1579,37,89,H1
"Henderson County, NC",2009-2010,105813,106909,1096,1.036,-60,1156,37,89,H1
"Henderson County, NC",2010-2011,106909,107504,595,0.557,-193,788,37,89,H1
"Henderson County, NC",2011-2012,107504,108115,611,0.568,-171,782,37,89,H1
"Henderson County, NC",2012-2013,108115,109531,1416,1.31,-324,1740,37,89,H1
"Henderson County, NC",2013-2014,109531,111149,1618,1.477,-243,1861,37,89,H1
"Henderson County, NC",2014-2015,110939,112655,1716,1.547,-240,1956,37,89,H1
"Henderson County, NC",2015-2016,112655,113758,1103,0.979,-335,1438,37,89,H1
"Henderson County, NC",2016-2017,113758,115708,1950,1.714,-279,2229,37,89,H1
"Hertford County, NC",2000-2001,22598,22812,214,0.947,-42,256,37,91,H1
"Hertford County, NC",2001-2002,22812,23547,735,3.222,4,731,37,91,H1
"Hertford County, NC",2002-2003,23547,23531,-16,-0.068,-20,4,37,91,H1
"Hertford County, NC",2003-2004,23531,23729,198,0.841,-2,200,37,91,H1
"Hertford County, NC",2004-2005,23729,23895,166,0.7,20,146,37,91,H1
"Hertford County, NC",2005-2006,23895,23981,86,0.36,42,44,37,91,H1
"Hertford County, NC",2006-2007,23981,24240,259,1.08,36,223,37,91,H1
"Hertford County, NC",2007-2008,24240,24473,233,0.961,26,207,37,91,H1
"Hertford County, NC",2008-2009,24473,24580,107,0.437,38,69,37,91,H1
"Hertford County, NC",2009-2010,24580,24605,25,0.102,33,-8,37,91,H1
"Hertford County, NC",2010-2011,24605,24514,-91,-0.37,-35,-56,37,91,H1
"Hertford County, NC",2011-2012,24514,24432,-82,-0.335,-7,-75,37,91,H1
"Hertford County, NC",2012-2013,24432,24440,8,0.033,-14,22,37,91,H1
"Hertford County, NC",2013-2014,24440,24308,-132,-0.54,-33,-99,37,91,H1
"Hertford County, NC",2014-2015,24380,24184,-196,-0.804,-38,-158,37,91,H1
"Hertford County, NC",2015-2016,24184,24096,-88,-0.364,-17,-71,37,91,H1
"Hertford County, NC",2016-2017,24096,23906,-190,-0.789,-46,-144,37,91,H1
"Hoke County, NC",2000-2001,33923,34722,799,2.355,443,356,37,93,H1
"Hoke County, NC",2001-2002,34722,35785,1063,3.061,412,651,37,93,H1
"Hoke County, NC",2002-2003,35785,36505,720,2.012,414,306,37,93,H1
"Hoke County, NC",2003-2004,36505,38119,1614,4.421,470,1144,37,93,H1
"Hoke County, NC",2004-2005,38119,39798,1679,4.405,493,1186,37,93,H1
"Hoke County, NC",2005-2006,39798,41360,1562,3.925,528,1034,37,93,H1
"Hoke County, NC",2006-2007,41360,42496,1136,2.747,614,522,37,93,H1
"Hoke County, NC",2007-2008,42496,43912,1416,3.332,552,864,37,93,H1
"Hoke County, NC",2008-2009,43912,45406,1494,3.402,591,903,37,93,H1
"Hoke County, NC",2009-2010,45406,47473,2067,4.552,607,1460,37,93,H1
"Hoke County, NC",2010-2011,47473,49464,1991,4.194,677,1314,37,93,H1
"Hoke County, NC",2011-2012,49464,50467,1003,2.028,663,340,37,93,H1
"Hoke County, NC",2012-2013,50467,51153,686,1.359,621,65,37,93,H1
"Hoke County, NC",2013-2014,51153,51611,458,0.895,629,-171,37,93,H1
"Hoke County, NC",2014-2015,51644,52671,1027,1.989,603,424,37,93,H1
"Hoke County, NC",2015-2016,52671,53108,437,0.83,662,-225,37,93,H1
"Hoke County, NC",2016-2017,53108,54116,1008,1.898,593,415,37,93,H1
"Hyde County, NC",2000-2001,5833,5735,-98,-1.68,-20,-78,37,95,H1
"Hyde County, NC",2001-2002,5735,5846,111,1.935,5,106,37,95,H1
"Hyde County, NC",2002-2003,5846,5750,-96,-1.642,-6,-90,37,95,H1
"Hyde County, NC",2003-2004,5750,5712,-38,-0.661,-17,-21,37,95,H1
"Hyde County, NC",2004-2005,5712,5733,21,0.368,-20,41,37,95,H1
"Hyde County, NC",2005-2006,5733,5621,-112,-1.954,0,-112,37,95,H1
"Hyde County, NC",2006-2007,5621,5639,18,0.32,12,6,37,95,H1
"Hyde County, NC",2007-2008,5639,5764,125,2.217,1,124,37,95,H1
"Hyde County, NC",2008-2009,5764,5774,10,0.173,-4,14,37,95,H1
"Hyde County, NC",2009-2010,5774,5809,35,0.606,1,34,37,95,H1
"Hyde County, NC",2010-2011,5809,5832,23,0.396,-8,31,37,95,H1
"Hyde County, NC",2011-2012,5832,5738,-94,-1.612,-5,-89,37,95,H1
"Hyde County, NC",2012-2013,5738,5730,-8,-0.139,12,-20,37,95,H1
"Hyde County, NC",2013-2014,5730,5676,-54,-0.942,12,-66,37,95,H1
"Hyde County, NC",2014-2015,5661,5526,-135,-2.385,7,-142,37,95,H1
"Hyde County, NC",2015-2016,5526,5476,-50,-0.905,-6,-44,37,95,H1
"Hyde County, NC",2016-2017,5476,5363,-113,-2.064,-7,-106,37,95,H1
"Iredell County, NC",2000-2001,123563,127136,3573,2.892,768,2805,37,97,H1
"Iredell County, NC",2001-2002,127136,130352,3216,2.53,753,2463,37,97,H1
"Iredell County, NC",2002-2003,130352,133099,2747,2.107,688,2059,37,97,H1
"Iredell County, NC",2003-2004,133099,136514,3415,2.566,664,2751,37,97,H1
"Iredell County, NC",2004-2005,136514,140514,4.00E+03,2.93,569,3431,37,97,H1
"Iredell County, NC",2005-2006,140514,146854,6340,4.512,761,5579,37,97,H1
"Iredell County, NC",2006-2007,146854,151944,5090,3.466,731,4359,37,97,H1
"Iredell County, NC",2007-2008,151944,156204,4260,2.804,653,3607,37,97,H1
"Iredell County, NC",2008-2009,156204,158387,2183,1.398,753,1430,37,97,H1
"Iredell County, NC",2009-2010,158387,159820,1433,0.905,640,793,37,97,H1
"Iredell County, NC",2010-2011,159820,161099,1279,0.8,422,857,37,97,H1
"Iredell County, NC",2011-2012,161099,162724,1625,1.009,255,1370,37,97,H1
"Iredell County, NC",2012-2013,162724,164676,1952,1.2,309,1643,37,97,H1
"Iredell County, NC",2013-2014,164676,166675,1999,1.214,291,1708,37,97,H1
"Iredell County, NC",2014-2015,166822,169866,3044,1.825,284,2760,37,97,H1
"Iredell County, NC",2015-2016,169866,172529,2663,1.568,343,2320,37,97,H1
"Iredell County, NC",2016-2017,172529,175711,3182,1.844,354,2828,37,97,H1
"Jackson County, NC",2000-2001,33303,33885,582,1.748,96,486,37,99,H1
"Jackson County, NC",2001-2002,33885,34587,702,2.072,46,656,37,99,H1
"Jackson County, NC",2002-2003,34587,35711,1124,3.25,19,1105,37,99,H1
"Jackson County, NC",2003-2004,35711,36555,844,2.363,22,822,37,99,H1
"Jackson County, NC",2004-2005,36555,37075,520,1.423,59,461,37,99,H1
"Jackson County, NC",2005-2006,37075,38129,1054,2.843,112,942,37,99,H1
"Jackson County, NC",2006-2007,38129,38404,275,0.721,60,215,37,99,H1
"Jackson County, NC",2007-2008,38404,38994,590,1.536,105,485,37,99,H1
"Jackson County, NC",2008-2009,38994,39856,862,2.211,90,772,37,99,H1
"Jackson County, NC",2009-2010,39856,40352,496,1.244,111,385,37,99,H1
"Jackson County, NC",2010-2011,40352,40181,-171,-0.424,102,-273,37,99,H1
"Jackson County, NC",2011-2012,40181,40516,335,0.834,34,301,37,99,H1
"Jackson County, NC",2012-2013,40516,40960,444,1.096,19,425,37,99,H1
"Jackson County, NC",2013-2014,40960,40981,21,0.051,40,-19,37,99,H1
"Jackson County, NC",2014-2015,40998,41265,267,0.651,60,207,37,99,H1
"Jackson County, NC",2015-2016,41265,42268,1003,2.431,27,976,37,99,H1
"Jackson County, NC",2016-2017,42268,42973,705,1.668,31,674,37,99,H1
"Johnston County, NC",2000-2001,123279,127487,4208,3.413,1129,3079,37,101,H1
"Johnston County, NC",2001-2002,127487,132103,4616,3.621,1165,3451,37,101,H1
"Johnston County, NC",2002-2003,132103,135628,3525,2.668,1178,2347,37,101,H1
"Johnston County, NC",2003-2004,135628,140055,4427,3.264,1127,3300,37,101,H1
"Johnston County, NC",2004-2005,140055,144417,4362,3.114,1263,3099,37,101,H1
"Johnston County, NC",2005-2006,144417,149721,5304,3.673,1275,4029,37,101,H1
"Johnston County, NC",2006-2007,149721,155695,5974,3.99,1420,4554,37,101,H1
"Johnston County, NC",2007-2008,155695,161746,6051,3.886,1395,4656,37,101,H1
"Johnston County, NC",2008-2009,161746,166478,4732,2.926,1475,3257,37,101,H1
"Johnston County, NC",2009-2010,166478,169617,3139,1.886,1301,1838,37,101,H1
"Johnston County, NC",2010-2011,169617,172783,3166,1.867,1023,2143,37,101,H1
"Johnston County, NC",2011-2012,172783,174893,2110,1.221,1052,1058,37,101,H1
"Johnston County, NC",2012-2013,174893,1.78E+05,3107,1.777,943,2164,37,101,H1
"Johnston County, NC",2013-2014,1.78E+05,181423,3423,1.923,894,2529,37,101,H1
"Johnston County, NC",2014-2015,180959,185660,4701,2.598,950,3751,37,101,H1
"Johnston County, NC",2015-2016,185660,191094,5434,2.927,859,4575,37,101,H1
"Johnston County, NC",2016-2017,191094,196708,5614,2.938,863,4751,37,101,H1
"Jones County, NC",2000-2001,10289,10215,-74,-0.719,-33,-41,37,103,H1
"Jones County, NC",2001-2002,10215,10112,-103,-1.008,-32,-71,37,103,H1
"Jones County, NC",2002-2003,10112,9957,-155,-1.533,-32,-123,37,103,H1
"Jones County, NC",2003-2004,9957,10123,166,1.667,-10,176,37,103,H1
"Jones County, NC",2004-2005,10123,10053,-70,-0.691,-12,-58,37,103,H1
"Jones County, NC",2005-2006,10053,9994,-59,-0.587,10,-69,37,103,H1
"Jones County, NC",2006-2007,9994,10035,41,0.41,-24,65,37,103,H1
"Jones County, NC",2007-2008,10035,9974,-61,-0.608,-17,-44,37,103,H1
"Jones County, NC",2008-2009,9974,10143,169,1.694,-29,198,37,103,H1
"Jones County, NC",2009-2010,10143,10080,-63,-0.621,-17,-46,37,103,H1
"Jones County, NC",2010-2011,10080,10268,188,1.865,-36,224,37,103,H1
"Jones County, NC",2011-2012,10268,10276,8,0.078,-24,32,37,103,H1
"Jones County, NC",2012-2013,10276,10220,-56,-0.545,-6,-50,37,103,H1
"Jones County, NC",2013-2014,10220,10076,-144,-1.409,-31,-113,37,103,H1
"Jones County, NC",2014-2015,10074,10013,-61,-0.606,-30,-31,37,103,H1
"Jones County, NC",2015-2016,10013,9625,-388,-3.875,-22,-366,37,103,H1
"Jones County, NC",2016-2017,9625,9597,-28,-0.291,-35,7,37,103,H1
"Lee County, NC",2000-2001,49482,49853,371,0.75,298,73,37,105,H1
"Lee County, NC",2001-2002,49853,49313,-540,-1.083,371,-911,37,105,H1
"Lee County, NC",2002-2003,49313,49372,59,0.12,360,-301,37,105,H1
"Lee County, NC",2003-2004,49372,49747,375,0.76,376,-1,37,105,H1
"Lee County, NC",2004-2005,49747,51056,1309,2.631,279,1030,37,105,H1
"Lee County, NC",2005-2006,51056,52642,1586,3.106,484,1102,37,105,H1
"Lee County, NC",2006-2007,52642,54106,1464,2.781,482,982,37,105,H1
"Lee County, NC",2007-2008,54106,55822,1716,3.172,411,1305,37,105,H1
"Lee County, NC",2008-2009,55822,57359,1537,2.753,460,1077,37,105,H1
"Lee County, NC",2009-2010,57359,57896,537,0.936,397,140,37,105,H1
"Lee County, NC",2010-2011,57896,58557,661,1.142,292,369,37,105,H1
"Lee County, NC",2011-2012,58557,59368,811,1.385,299,512,37,105,H1
"Lee County, NC",2012-2013,59368,59997,629,1.059,277,352,37,105,H1
"Lee County, NC",2013-2014,59997,59662,-335,-0.558,317,-652,37,105,H1
"Lee County, NC",2014-2015,59588,59660,72,0.121,244,-172,37,105,H1
"Lee County, NC",2015-2016,59660,59746,86,0.144,185,-99,37,105,H1
"Lee County, NC",2016-2017,59746,60430,684,1.145,226,458,37,105,H1
"Lenoir County, NC",2000-2001,59556,59421,-135,-0.227,127,-262,37,107,H1
"Lenoir County, NC",2001-2002,59421,59293,-128,-0.215,97,-225,37,107,H1
"Lenoir County, NC",2002-2003,59293,59142,-151,-0.255,50,-201,37,107,H1
"Lenoir County, NC",2003-2004,59142,59088,-54,-0.091,39,-93,37,107,H1
"Lenoir County, NC",2004-2005,59088,59195,107,0.181,89,18,37,107,H1
"Lenoir County, NC",2005-2006,59195,59203,8,0.014,162,-154,37,107,H1
"Lenoir County, NC",2006-2007,59203,59072,-131,-0.221,101,-232,37,107,H1
"Lenoir County, NC",2007-2008,59072,59398,326,0.552,79,247,37,107,H1
"Lenoir County, NC",2008-2009,59398,59421,23,0.039,62,-39,37,107,H1
"Lenoir County, NC",2009-2010,59421,59452,31,0.052,74,-43,37,107,H1
"Lenoir County, NC",2010-2011,59452,59448,-4,-0.007,0,-4,37,107,H1
"Lenoir County, NC",2011-2012,59448,59181,-267,-0.449,2,-269,37,107,H1
"Lenoir County, NC",2012-2013,59181,58911,-270,-0.456,-89,-181,37,107,H1
"Lenoir County, NC",2013-2014,58911,58485,-426,-0.723,-81,-345,37,107,H1
"Lenoir County, NC",2014-2015,58399,58106,-293,-0.502,-68,-225,37,107,H1
"Lenoir County, NC",2015-2016,58106,57432,-674,-1.16,-118,-556,37,107,H1
"Lenoir County, NC",2016-2017,57432,56883,-549,-0.956,-126,-423,37,107,H1
"Lincoln County, NC",2000-2001,64152,65352,1200,1.871,336,864,37,109,H1
"Lincoln County, NC",2001-2002,65352,66400,1048,1.604,294,754,37,109,H1
"Lincoln County, NC",2002-2003,66400,67444,1044,1.572,268,776,37,109,H1
"Lincoln County, NC",2003-2004,67444,68267,823,1.22,309,514,37,109,H1
"Lincoln County, NC",2004-2005,68267,69902,1635,2.395,172,1463,37,109,H1
"Lincoln County, NC",2005-2006,69902,72179,2277,3.257,313,1964,37,109,H1
"Lincoln County, NC",2006-2007,72179,74139,1960,2.715,251,1709,37,109,H1
"Lincoln County, NC",2007-2008,74139,76143,2004,2.703,247,1757,37,109,H1
"Lincoln County, NC",2008-2009,76143,77573,1430,1.878,316,1114,37,109,H1
"Lincoln County, NC",2009-2010,77573,78409,836,1.078,259,577,37,109,H1
"Lincoln County, NC",2010-2011,78409,78541,132,0.168,78,54,37,109,H1
"Lincoln County, NC",2011-2012,78541,78973,432,0.55,101,331,37,109,H1
"Lincoln County, NC",2012-2013,78973,79451,478,0.605,34,444,37,109,H1
"Lincoln County, NC",2013-2014,79451,79829,378,0.476,6,372,37,109,H1
"Lincoln County, NC",2014-2015,79880,81035,1155,1.446,30,1125,37,109,H1
"Lincoln County, NC",2015-2016,81035,81075,40,0.049,-28,68,37,109,H1
"Lincoln County, NC",2016-2017,81075,82403,1328,1.638,-21,1349,37,109,H1
"McDowell County, NC",2000-2001,42265,42796,531,1.256,131,400,37,111,H1
"McDowell County, NC",2001-2002,42796,42911,115,0.269,16,99,37,111,H1
"McDowell County, NC",2002-2003,42911,43211,300,0.699,117,183,37,111,H1
"McDowell County, NC",2003-2004,43211,43390,179,0.414,52,127,37,111,H1
"McDowell County, NC",2004-2005,43390,43655,265,0.611,73,192,37,111,H1
"McDowell County, NC",2005-2006,43655,43969,314,0.719,99,215,37,111,H1
"McDowell County, NC",2006-2007,43969,44345,376,0.855,46,330,37,111,H1
"McDowell County, NC",2007-2008,44345,44768,423,0.954,105,318,37,111,H1
"McDowell County, NC",2008-2009,44768,44865,97,0.217,91,6,37,111,H1
"McDowell County, NC",2009-2010,44865,45069,204,0.455,69,135,37,111,H1
"McDowell County, NC",2010-2011,45069,44952,-117,-0.26,-29,-88,37,111,H1
"McDowell County, NC",2011-2012,44952,44967,15,0.033,-59,74,37,111,H1
"McDowell County, NC",2012-2013,44967,44959,-8,-0.018,-11,3,37,111,H1
"McDowell County, NC",2013-2014,44959,44965,6,0.013,-20,26,37,111,H1
"McDowell County, NC",2014-2015,44954,44989,35,0.078,-41,76,37,111,H1
"McDowell County, NC",2015-2016,44989,44989,0,0,-24,24,37,111,H1
"McDowell County, NC",2016-2017,44989,45159,170,0.378,-32,202,37,111,H1
"Macon County, NC",2000-2001,29959,30415,456,1.522,-43,499,37,113,H1
"Macon County, NC",2001-2002,30415,30870,455,1.496,-39,494,37,113,H1
"Macon County, NC",2002-2003,30870,31248,378,1.224,-109,487,37,113,H1
"Macon County, NC",2003-2004,31248,31667,419,1.341,-78,497,37,113,H1
"Macon County, NC",2004-2005,31667,32054,387,1.222,-93,480,37,113,H1
"Macon County, NC",2005-2006,32054,32736,682,2.128,-30,712,37,113,H1
"Macon County, NC",2006-2007,32736,33164,428,1.307,-56,484,37,113,H1
"Macon County, NC",2007-2008,33164,33608,444,1.339,-24,468,37,113,H1
"Macon County, NC",2008-2009,33608,33820,212,0.631,-47,259,37,113,H1
"Macon County, NC",2009-2010,33820,33930,110,0.325,-60,170,37,113,H1
"Macon County, NC",2010-2011,33930,33821,-109,-0.321,-160,51,37,113,H1
"Macon County, NC",2011-2012,33821,33796,-25,-0.074,-96,71,37,113,H1
"Macon County, NC",2012-2013,33796,33779,-17,-0.05,-55,38,37,113,H1
"Macon County, NC",2013-2014,33779,33875,96,0.284,-56,152,37,113,H1
"Macon County, NC",2014-2015,33889,34201,312,0.921,-73,385,37,113,H1
"Macon County, NC",2015-2016,34201,34309,108,0.316,-110,218,37,113,H1
"Macon County, NC",2016-2017,34309,34732,423,1.233,-88,511,37,113,H1
"Madison County, NC",2000-2001,19668,19848,180,0.915,-17,197,37,115,H1
"Madison County, NC",2001-2002,19848,19890,42,0.212,34,8,37,115,H1
"Madison County, NC",2002-2003,19890,19873,-17,-0.085,-12,-5,37,115,H1
"Madison County, NC",2003-2004,19873,19992,119,0.599,6,113,37,115,H1
"Madison County, NC",2004-2005,19992,20097,105,0.525,-39,144,37,115,H1
"Madison County, NC",2005-2006,20097,20265,168,0.836,-13,181,37,115,H1
"Madison County, NC",2006-2007,20265,20420,155,0.765,-51,206,37,115,H1
"Madison County, NC",2007-2008,20420,20585,165,0.808,-30,195,37,115,H1
"Madison County, NC",2008-2009,20585,20700,115,0.559,-25,140,37,115,H1
"Madison County, NC",2009-2010,20700,20774,74,0.357,-24,98,37,115,H1
"Madison County, NC",2010-2011,20774,20823,49,0.236,-52,101,37,115,H1
"Madison County, NC",2011-2012,20823,20882,59,0.283,-4,63,37,115,H1
"Madison County, NC",2012-2013,20882,21121,239,1.145,-23,262,37,115,H1
"Madison County, NC",2013-2014,21121,21157,36,0.17,-30,66,37,115,H1
"Madison County, NC",2014-2015,21166,21139,-27,-0.128,-40,13,37,115,H1
"Madison County, NC",2015-2016,21139,21434,295,1.396,-25,320,37,115,H1
"Madison County, NC",2016-2017,21434,21746,312,1.456,-12,324,37,115,H1
"Martin County, NC",2000-2001,25506,25211,-295,-1.157,47,-342,37,117,H1
"Martin County, NC",2001-2002,25211,25055,-156,-0.619,-27,-129,37,117,H1
"Martin County, NC",2002-2003,25055,24968,-87,-0.347,-56,-31,37,117,H1
"Martin County, NC",2003-2004,24968,24822,-146,-0.585,0,-146,37,117,H1
"Martin County, NC",2004-2005,24822,24575,-247,-0.995,-67,-180,37,117,H1
"Martin County, NC",2005-2006,24575,24651,76,0.309,-21,97,37,117,H1
"Martin County, NC",2006-2007,24651,24391,-260,-1.055,-4,-256,37,117,H1
"Martin County, NC",2007-2008,24391,24404,13,0.053,-39,52,37,117,H1
"Martin County, NC",2008-2009,24404,24408,4,0.016,-12,16,37,117,H1
"Martin County, NC",2009-2010,24408,24455,47,0.193,-36,83,37,117,H1
"Martin County, NC",2010-2011,24455,24237,-218,-0.891,-83,-135,37,117,H1
"Martin County, NC",2011-2012,24237,23886,-351,-1.448,-79,-272,37,117,H1
"Martin County, NC",2012-2013,23886,23704,-182,-0.762,-84,-98,37,117,H1
"Martin County, NC",2013-2014,23704,23454,-250,-1.055,-52,-198,37,117,H1
"Martin County, NC",2014-2015,23448,23357,-91,-0.388,-53,-38,37,117,H1
"Martin County, NC",2015-2016,23357,23081,-276,-1.182,-62,-214,37,117,H1
"Martin County, NC",2016-2017,23081,22789,-292,-1.265,-57,-235,37,117,H1
"Mecklenburg County, NC",2000-2001,700458,720171,19713,2.814,7428,12285,37,119,H1
"Mecklenburg County, NC",2001-2002,720171,736422,16251,2.257,7703,8548,37,119,H1
"Mecklenburg County, NC",2002-2003,736422,753991,17569,2.386,7769,9800,37,119,H1
"Mecklenburg County, NC",2003-2004,753991,772949,18958,2.514,8026,10932,37,119,H1
"Mecklenburg County, NC",2004-2005,772949,798701,25752,3.332,8450,17302,37,119,H1
"Mecklenburg County, NC",2005-2006,798701,831507,32806,4.107,9268,23538,37,119,H1
"Mecklenburg County, NC",2006-2007,831507,862177,30670,3.688,9649,21021,37,119,H1
"Mecklenburg County, NC",2007-2008,862177,887991,25814,2.994,9979,15835,37,119,H1
"Mecklenburg County, NC",2008-2009,887991,908704,20713,2.333,9612,11101,37,119,H1
"Mecklenburg County, NC",2009-2010,908704,923413,14709,1.619,9889,4820,37,119,H1
"Mecklenburg County, NC",2010-2011,923413,945257,21844,2.366,8496,13348,37,119,H1
"Mecklenburg County, NC",2011-2012,945257,968779,23522,2.488,8658,14864,37,119,H1
"Mecklenburg County, NC",2012-2013,968779,992514,23735,2.45,8378,15357,37,119,H1
"Mecklenburg County, NC",2013-2014,992514,1012539,20025,2.018,8324,11701,37,119,H1
"Mecklenburg County, NC",2014-2015,1011928,1034070,22142,2.188,8342,13800,37,119,H1
"Mecklenburg County, NC",2015-2016,1034070,1057237,23167,2.24,8804,14363,37,119,H1
"Mecklenburg County, NC",2016-2017,1057237,1076837,19600,1.854,8572,11028,37,119,H1
"Mitchell County, NC",2000-2001,15725,15860,135,0.859,-61,196,37,121,H1
"Mitchell County, NC",2001-2002,15860,15856,-4,-0.025,-22,18,37,121,H1
"Mitchell County, NC",2002-2003,15856,15837,-19,-0.12,-36,17,37,121,H1
"Mitchell County, NC",2003-2004,15837,15928,91,0.575,-49,140,37,121,H1
"Mitchell County, NC",2004-2005,15928,15858,-70,-0.439,-36,-34,37,121,H1
"Mitchell County, NC",2005-2006,15858,15699,-159,-1.003,-47,-112,37,121,H1
"Mitchell County, NC",2006-2007,15699,15746,47,0.299,-41,88,37,121,H1
"Mitchell County, NC",2007-2008,15746,15740,-6,-0.038,-29,23,37,121,H1
"Mitchell County, NC",2008-2009,15740,15671,-69,-0.438,-38,-31,37,121,H1
"Mitchell County, NC",2009-2010,15671,15532,-139,-0.887,-41,-98,37,121,H1
"Mitchell County, NC",2010-2011,15532,15371,-161,-1.037,-91,-70,37,121,H1
"Mitchell County, NC",2011-2012,15371,15367,-4,-0.026,-36,32,37,121,H1
"Mitchell County, NC",2012-2013,15367,15318,-49,-0.319,-65,16,37,121,H1
"Mitchell County, NC",2013-2014,15318,15311,-7,-0.046,-66,59,37,121,H1
"Mitchell County, NC",2014-2015,15330,15246,-84,-0.548,-59,-25,37,121,H1
"Mitchell County, NC",2015-2016,15246,15068,-178,-1.168,-85,-93,37,121,H1
"Mitchell County, NC",2016-2017,15068,15072,4,0.027,-76,80,37,121,H1
"Montgomery County, NC",2000-2001,26892,26952,60,0.223,175,-115,37,123,H1
"Montgomery County, NC",2001-2002,26952,26991,39,0.145,127,-88,37,123,H1
"Montgomery County, NC",2002-2003,26991,27226,235,0.871,90,145,37,123,H1
"Montgomery County, NC",2003-2004,27226,27077,-149,-0.547,85,-234,37,123,H1
"Montgomery County, NC",2004-2005,27077,27153,76,0.281,76,0,37,123,H1
"Montgomery County, NC",2005-2006,27153,27311,158,0.582,130,28,37,123,H1
"Montgomery County, NC",2006-2007,27311,27490,179,0.655,158,21,37,123,H1
"Montgomery County, NC",2007-2008,27490,27716,226,0.822,197,29,37,123,H1
"Montgomery County, NC",2008-2009,27716,27710,-6,-0.022,154,-160,37,123,H1
"Montgomery County, NC",2009-2010,27710,27734,24,0.087,78,-54,37,123,H1
"Montgomery County, NC",2010-2011,27734,27857,123,0.443,92,31,37,123,H1
"Montgomery County, NC",2011-2012,27857,27637,-220,-0.79,61,-281,37,123,H1
"Montgomery County, NC",2012-2013,27637,27509,-128,-0.463,42,-170,37,123,H1
"Montgomery County, NC",2013-2014,27509,27395,-114,-0.414,45,-159,37,123,H1
"Montgomery County, NC",2014-2015,27410,27548,138,0.503,36,102,37,123,H1
"Montgomery County, NC",2015-2016,27548,27438,-110,-0.399,22,-132,37,123,H1
"Montgomery County, NC",2016-2017,27438,27435,-3,-0.011,32,-35,37,123,H1
"Moore County, NC",2000-2001,75177,76259,1082,1.439,27,1055,37,125,H1
"Moore County, NC",2001-2002,76259,77521,1262,1.655,12,1250,37,125,H1
"Moore County, NC",2002-2003,77521,78333,812,1.047,-23,835,37,125,H1
"Moore County, NC",2003-2004,78333,79475,1142,1.458,-37,1179,37,125,H1
"Moore County, NC",2004-2005,79475,80841,1366,1.719,20,1346,37,125,H1
"Moore County, NC",2005-2006,80841,82838,1997,2.47,34,1963,37,125,H1
"Moore County, NC",2006-2007,82838,84795,1957,2.362,61,1896,37,125,H1
"Moore County, NC",2007-2008,84795,86122,1327,1.565,14,1313,37,125,H1
"Moore County, NC",2008-2009,86122,87244,1122,1.303,24,1098,37,125,H1
"Moore County, NC",2009-2010,87244,88572,1328,1.522,-51,1379,37,125,H1
"Moore County, NC",2010-2011,88572,89349,777,0.877,-58,835,37,125,H1
"Moore County, NC",2011-2012,89349,90320,971,1.087,-28,999,37,125,H1
"Moore County, NC",2012-2013,90320,91576,1256,1.391,-100,1356,37,125,H1
"Moore County, NC",2013-2014,91576,93077,1501,1.639,-117,1618,37,125,H1
"Moore County, NC",2014-2015,93066,94352,1286,1.382,-57,1343,37,125,H1
"Moore County, NC",2015-2016,94352,95392,1040,1.102,-12,1052,37,125,H1
"Moore County, NC",2016-2017,95392,97264,1872,1.962,-48,1920,37,125,H1
"Nash County, NC",2000-2001,87696,88242,546,0.623,401,145,37,127,H1
"Nash County, NC",2001-2002,88242,88843,601,0.681,334,267,37,127,H1
"Nash County, NC",2002-2003,88843,89493,650,0.732,311,339,37,127,H1
"Nash County, NC",2003-2004,89493,90262,769,0.859,263,506,37,127,H1
"Nash County, NC",2004-2005,90262,90876,614,0.68,292,322,37,127,H1
"Nash County, NC",2005-2006,90876,92127,1251,1.377,255,996,37,127,H1
"Nash County, NC",2006-2007,92127,93733,1606,1.743,380,1226,37,127,H1
"Nash County, NC",2007-2008,93733,94718,985,1.051,323,662,37,127,H1
"Nash County, NC",2008-2009,94718,95492,774,0.817,252,522,37,127,H1
"Nash County, NC",2009-2010,95492,95875,383,0.401,224,159,37,127,H1
"Nash County, NC",2010-2011,95875,95758,-117,-0.122,113,-230,37,127,H1
"Nash County, NC",2011-2012,95758,95320,-438,-0.457,132,-570,37,127,H1
"Nash County, NC",2012-2013,95320,94560,-760,-0.797,180,-940,37,127,H1
"Nash County, NC",2013-2014,94560,94357,-203,-0.215,118,-321,37,127,H1
"Nash County, NC",2014-2015,94249,93919,-330,-0.35,93,-423,37,127,H1
"Nash County, NC",2015-2016,93919,94008,89,0.095,-50,139,37,127,H1
"Nash County, NC",2016-2017,94008,93991,-17,-0.018,-6,-11,37,127,H1
"New Hanover County, NC",2000-2001,160887,164386,3499,2.175,714,2785,37,129,H1
"New Hanover County, NC",2001-2002,164386,168147,3761,2.288,530,3231,37,129,H1
"New Hanover County, NC",2002-2003,168147,171928,3781,2.249,592,3189,37,129,H1
"New Hanover County, NC",2003-2004,171928,178362,6434,3.742,714,5720,37,129,H1
"New Hanover County, NC",2004-2005,178362,185412,7050,3.953,728,6322,37,129,H1
"New Hanover County, NC",2005-2006,185412,190791,5379,2.901,974,4405,37,129,H1
"New Hanover County, NC",2006-2007,190791,194339,3548,1.86,927,2621,37,129,H1
"New Hanover County, NC",2007-2008,194339,197709,3370,1.734,903,2467,37,129,H1
"New Hanover County, NC",2008-2009,197709,200178,2469,1.249,862,1607,37,129,H1
"New Hanover County, NC",2009-2010,200178,203335,3157,1.577,862,2295,37,129,H1
"New Hanover County, NC",2010-2011,203335,205972,2637,1.297,540,2097,37,129,H1
"New Hanover County, NC",2011-2012,205972,209134,3162,1.535,592,2570,37,129,H1
"New Hanover County, NC",2012-2013,209134,213190,4056,1.939,503,3553,37,129,H1
"New Hanover County, NC",2013-2014,213190,216298,3108,1.458,526,2582,37,129,H1
"New Hanover County, NC",2014-2015,216585,220358,3773,1.742,460,3313,37,129,H1
"New Hanover County, NC",2015-2016,220358,223234,2876,1.305,312,2564,37,129,H1
"New Hanover County, NC",2016-2017,223234,227198,3964,1.776,331,3633,37,129,H1
"Northampton County, NC",2000-2001,22041,22063,22,0.1,-19,41,37,131,H1
"Northampton County, NC",2001-2002,22063,22073,10,0.045,-39,49,37,131,H1
"Northampton County, NC",2002-2003,22073,22101,28,0.127,-61,89,37,131,H1
"Northampton County, NC",2003-2004,22101,21981,-120,-0.543,-42,-78,37,131,H1
"Northampton County, NC",2004-2005,21981,22180,199,0.905,-77,276,37,131,H1
"Northampton County, NC",2005-2006,22180,22112,-68,-0.307,-54,-14,37,131,H1
"Northampton County, NC",2006-2007,22112,22293,181,0.819,4,177,37,131,H1
"Northampton County, NC",2007-2008,22293,22259,-34,-0.153,-56,22,37,131,H1
"Northampton County, NC",2008-2009,22259,22102,-157,-0.705,-51,-106,37,131,H1
"Northampton County, NC",2009-2010,22102,22007,-95,-0.43,-54,-41,37,131,H1
"Northampton County, NC",2010-2011,22007,21967,-40,-0.182,-85,45,37,131,H1
"Northampton County, NC",2011-2012,21967,21311,-656,-2.986,-53,-603,37,131,H1
"Northampton County, NC",2012-2013,21311,20803,-508,-2.384,-80,-428,37,131,H1
"Northampton County, NC",2013-2014,20803,20463,-340,-1.634,-81,-259,37,131,H1
"Northampton County, NC",2014-2015,20567,20426,-141,-0.686,-112,-29,37,131,H1
"Northampton County, NC",2015-2016,20426,20166,-260,-1.273,-101,-159,37,131,H1
"Northampton County, NC",2016-2017,20166,19862,-304,-1.507,-113,-191,37,131,H1
"Onslow County, NC",2000-2001,150678,151068,390,0.259,2423,-2033,37,133,H1
"Onslow County, NC",2001-2002,151068,153397,2329,1.542,2321,8,37,133,H1
"Onslow County, NC",2002-2003,153397,150481,-2916,-1.901,2418,-5334,37,133,H1
"Onslow County, NC",2003-2004,150481,158837,8356,5.553,2521,5835,37,133,H1
"Onslow County, NC",2004-2005,158837,157205,-1632,-1.027,2437,-4069,37,133,H1
"Onslow County, NC",2005-2006,157205,161185,3980,2.532,2417,1563,37,133,H1
"Onslow County, NC",2006-2007,161185,163256,2071,1.285,2938,-867,37,133,H1
"Onslow County, NC",2007-2008,163256,169059,5803,3.555,2814,2989,37,133,H1
"Onslow County, NC",2008-2009,169059,173064,4005,2.369,2593,1412,37,133,H1
"Onslow County, NC",2009-2010,173064,179563,6499,3.755,3394,3105,37,133,H1
"Onslow County, NC",2010-2011,179563,177895,-1668,-0.929,3568,-5236,37,133,H1
"Onslow County, NC",2011-2012,177895,183888,5993,3.369,3265,2728,37,133,H1
"Onslow County, NC",2012-2013,183888,185669,1781,0.969,3570,-1789,37,133,H1
"Onslow County, NC",2013-2014,185669,187589,1920,1.034,3390,-1470,37,133,H1
"Onslow County, NC",2014-2015,185267,186311,1044,0.564,3353,-2309,37,133,H1
"Onslow County, NC",2015-2016,186311,192199,5888,3.16,2905,2983,37,133,H1
"Onslow County, NC",2016-2017,192199,193893,1694,0.881,2821,-1127,37,133,H1
"Orange County, NC",2000-2001,116141,118684,2543,2.19,594,1949,37,135,H1
"Orange County, NC",2001-2002,118684,117667,-1017,-0.857,651,-1668,37,135,H1
"Orange County, NC",2002-2003,117667,118667,1.00E+03,0.85,643,357,37,135,H1
"Orange County, NC",2003-2004,118667,119320,653,0.55,600,53,37,135,H1
"Orange County, NC",2004-2005,119320,121526,2206,1.849,636,1570,37,135,H1
"Orange County, NC",2005-2006,121526,124286,2760,2.271,608,2152,37,135,H1
"Orange County, NC",2006-2007,124286,127193,2907,2.339,703,2204,37,135,H1
"Orange County, NC",2007-2008,127193,129764,2571,2.021,623,1948,37,135,H1
"Orange County, NC",2008-2009,129764,132369,2605,2.007,654,1951,37,135,H1
"Orange County, NC",2009-2010,132369,134051,1682,1.271,547,1135,37,135,H1
"Orange County, NC",2010-2011,134051,134813,762,0.568,481,281,37,135,H1
"Orange County, NC",2011-2012,134813,137728,2915,2.162,562,2353,37,135,H1
"Orange County, NC",2012-2013,137728,139365,1637,1.189,538,1099,37,135,H1
"Orange County, NC",2013-2014,139365,140420,1055,0.757,531,524,37,135,H1
"Orange County, NC",2014-2015,140160,141354,1194,0.852,446,748,37,135,H1
"Orange County, NC",2015-2016,141354,142723,1369,0.968,392,977,37,135,H1
"Orange County, NC",2016-2017,142723,144946,2223,1.558,390,1833,37,135,H1
"Pamlico County, NC",2000-2001,12913,12848,-65,-0.503,-42,-23,37,137,H1
"Pamlico County, NC",2001-2002,12848,12919,71,0.553,-52,123,37,137,H1
"Pamlico County, NC",2002-2003,12919,12913,-6,-0.046,-42,36,37,137,H1
"Pamlico County, NC",2003-2004,12913,12849,-64,-0.496,-22,-42,37,137,H1
"Pamlico County, NC",2004-2005,12849,13005,156,1.214,-50,206,37,137,H1
"Pamlico County, NC",2005-2006,13005,12995,-10,-0.077,-19,9,37,137,H1
"Pamlico County, NC",2006-2007,12995,13013,18,0.139,-42,60,37,137,H1
"Pamlico County, NC",2007-2008,13013,13094,81,0.622,-34,115,37,137,H1
"Pamlico County, NC",2008-2009,13094,13136,42,0.321,-37,79,37,137,H1
"Pamlico County, NC",2009-2010,13136,13106,-30,-0.228,-30,0,37,137,H1
"Pamlico County, NC",2010-2011,13106,13298,192,1.465,-53,245,37,137,H1
"Pamlico County, NC",2011-2012,13298,13045,-253,-1.903,-44,-209,37,137,H1
"Pamlico County, NC",2012-2013,13045,12914,-131,-1.004,-33,-98,37,137,H1
"Pamlico County, NC",2013-2014,12914,12948,34,0.263,-48,82,37,137,H1
"Pamlico County, NC",2014-2015,12909,12781,-128,-0.992,-62,-66,37,137,H1
"Pamlico County, NC",2015-2016,12781,12799,18,0.141,-64,82,37,137,H1
"Pamlico County, NC",2016-2017,12799,12689,-110,-0.859,-64,-46,37,137,H1
"Pasquotank County, NC",2000-2001,34874,34787,-87,-0.249,111,-198,37,139,H1
"Pasquotank County, NC",2001-2002,34787,35281,494,1.42,117,377,37,139,H1
"Pasquotank County, NC",2002-2003,35281,35673,392,1.111,118,274,37,139,H1
"Pasquotank County, NC",2003-2004,35673,36533,860,2.411,136,724,37,139,H1
"Pasquotank County, NC",2004-2005,36533,37741,1208,3.307,135,1073,37,139,H1
"Pasquotank County, NC",2005-2006,37741,38956,1215,3.219,231,984,37,139,H1
"Pasquotank County, NC",2006-2007,38956,40049,1093,2.806,234,859,37,139,H1
"Pasquotank County, NC",2007-2008,40049,40554,505,1.261,204,301,37,139,H1
"Pasquotank County, NC",2008-2009,40554,40541,-13,-0.032,219,-232,37,139,H1
"Pasquotank County, NC",2009-2010,40541,40713,172,0.424,187,-15,37,139,H1
"Pasquotank County, NC",2010-2011,40713,40378,-335,-0.823,94,-429,37,139,H1
"Pasquotank County, NC",2011-2012,40378,40528,150,0.371,66,84,37,139,H1
"Pasquotank County, NC",2012-2013,40528,39761,-767,-1.893,74,-841,37,139,H1
"Pasquotank County, NC",2013-2014,39761,39787,26,0.065,91,-65,37,139,H1
"Pasquotank County, NC",2014-2015,39628,39829,201,0.507,136,65,37,139,H1
"Pasquotank County, NC",2015-2016,39829,39615,-214,-0.537,60,-274,37,139,H1
"Pasquotank County, NC",2016-2017,39615,39743,128,0.323,96,32,37,139,H1
"Pender County, NC",2000-2001,41212,41610,398,0.966,123,275,37,141,H1
"Pender County, NC",2001-2002,41610,42416,806,1.937,127,679,37,141,H1
"Pender County, NC",2002-2003,42416,42949,533,1.257,104,429,37,141,H1
"Pender County, NC",2003-2004,42949,44136,1187,2.764,19,1168,37,141,H1
"Pender County, NC",2004-2005,44136,45485,1349,3.056,137,1212,37,141,H1
"Pender County, NC",2005-2006,45485,47481,1996,4.388,108,1888,37,141,H1
"Pender County, NC",2006-2007,47481,49181,1700,3.58,124,1576,37,141,H1
"Pender County, NC",2007-2008,49181,50551,1370,2.786,160,1210,37,141,H1
"Pender County, NC",2008-2009,50551,51636,1085,2.146,133,952,37,141,H1
"Pender County, NC",2009-2010,51636,52399,763,1.478,113,650,37,141,H1
"Pender County, NC",2010-2011,52399,53362,963,1.838,144,819,37,141,H1
"Pender County, NC",2011-2012,53362,53967,605,1.134,135,470,37,141,H1
"Pender County, NC",2012-2013,53967,55111,1144,2.12,87,1057,37,141,H1
"Pender County, NC",2013-2014,55111,56250,1139,2.067,108,1031,37,141,H1
"Pender County, NC",2014-2015,56086,57611,1525,2.719,113,1412,37,141,H1
"Pender County, NC",2015-2016,57611,58897,1286,2.232,62,1224,37,141,H1
"Pender County, NC",2016-2017,58897,60958,2061,3.499,69,1992,37,141,H1
"Perquimans County, NC",2000-2001,11413,11533,120,1.051,-27,147,37,143,H1
"Perquimans County, NC",2001-2002,11533,11598,65,0.564,-41,106,37,143,H1
"Perquimans County, NC",2002-2003,11598,11696,98,0.845,-34,132,37,143,H1
"Perquimans County, NC",2003-2004,11696,11817,121,1.035,-25,146,37,143,H1
"Perquimans County, NC",2004-2005,11817,12102,285,2.412,-11,296,37,143,H1
"Perquimans County, NC",2005-2006,12102,12494,392,3.239,-30,422,37,143,H1
"Perquimans County, NC",2006-2007,12494,12901,407,3.258,9,398,37,143,H1
"Perquimans County, NC",2007-2008,12901,13292,391,3.031,-23,414,37,143,H1
"Perquimans County, NC",2008-2009,13292,13273,-19,-0.143,-6,-13,37,143,H1
"Perquimans County, NC",2009-2010,13273,13477,204,1.537,-13,217,37,143,H1
"Perquimans County, NC",2010-2011,13477,13456,-21,-0.156,-4,-17,37,143,H1
"Perquimans County, NC",2011-2012,13456,13532,76,0.565,-17,93,37,143,H1
"Perquimans County, NC",2012-2013,13532,13603,71,0.525,-6,77,37,143,H1
"Perquimans County, NC",2013-2014,13603,13466,-137,-1.007,-7,-130,37,143,H1
"Perquimans County, NC",2014-2015,13462,13440,-22,-0.163,-3,-19,37,143,H1
"Perquimans County, NC",2015-2016,13440,13427,-13,-0.097,-40,27,37,143,H1
"Perquimans County, NC",2016-2017,13427,13474,47,0.35,-30,77,37,143,H1
"Person County, NC",2000-2001,35759,36085,326,0.912,81,245,37,145,H1
"Person County, NC",2001-2002,36085,36751,666,1.846,92,574,37,145,H1
"Person County, NC",2002-2003,36751,37104,353,0.961,36,317,37,145,H1
"Person County, NC",2003-2004,37104,37391,287,0.774,84,203,37,145,H1
"Person County, NC",2004-2005,37391,37931,540,1.444,67,473,37,145,H1
"Person County, NC",2005-2006,37931,38244,313,0.825,88,225,37,145,H1
"Person County, NC",2006-2007,38244,38656,412,1.077,37,375,37,145,H1
"Person County, NC",2007-2008,38656,39016,360,0.931,83,277,37,145,H1
"Person County, NC",2008-2009,39016,39335,319,0.818,70,249,37,145,H1
"Person County, NC",2009-2010,39335,39429,94,0.239,62,32,37,145,H1
"Person County, NC",2010-2011,39429,39525,96,0.243,-14,110,37,145,H1
"Person County, NC",2011-2012,39525,39179,-346,-0.875,-10,-336,37,145,H1
"Person County, NC",2012-2013,39179,39248,69,0.176,16,53,37,145,H1
"Person County, NC",2013-2014,39248,39132,-116,-0.296,-10,-106,37,145,H1
"Person County, NC",2014-2015,39125,39259,134,0.342,2,132,37,145,H1
"Person County, NC",2015-2016,39259,39283,24,0.061,-24,48,37,145,H1
"Person County, NC",2016-2017,39283,39370,87,0.221,-33,120,37,145,H1
"Pitt County, NC",2000-2001,134298,136605,2307,1.718,919,1388,37,147,H1
"Pitt County, NC",2001-2002,136605,139128,2523,1.847,966,1557,37,147,H1
"Pitt County, NC",2002-2003,139128,141610,2482,1.784,944,1538,37,147,H1
"Pitt County, NC",2003-2004,141610,144486,2876,2.031,953,1923,37,147,H1
"Pitt County, NC",2004-2005,144486,147929,3443,2.383,967,2476,37,147,H1
"Pitt County, NC",2005-2006,147929,152934,5005,3.383,1016,3989,37,147,H1
"Pitt County, NC",2006-2007,152934,157479,4545,2.972,1182,3363,37,147,H1
"Pitt County, NC",2007-2008,157479,162116,4637,2.945,1218,3419,37,147,H1
"Pitt County, NC",2008-2009,162116,165581,3465,2.137,1132,2333,37,147,H1
"Pitt County, NC",2009-2010,165581,168826,3245,1.96,1137,2108,37,147,H1
"Pitt County, NC",2010-2011,168826,170763,1937,1.147,951,986,37,147,H1
"Pitt County, NC",2011-2012,170763,172895,2132,1.249,968,1164,37,147,H1
"Pitt County, NC",2012-2013,172895,174351,1456,0.842,997,459,37,147,H1
"Pitt County, NC",2013-2014,174351,175354,1003,0.575,909,94,37,147,H1
"Pitt County, NC",2014-2015,175103,175842,739,0.422,872,-133,37,147,H1
"Pitt County, NC",2015-2016,175842,177627,1785,1.015,812,973,37,147,H1
"Pitt County, NC",2016-2017,177627,179042,1415,0.797,796,619,37,147,H1
"Polk County, NC",2000-2001,18403,18683,280,1.521,-99,379,37,149,H1
"Polk County, NC",2001-2002,18683,18928,245,1.311,-76,321,37,149,H1
"Polk County, NC",2002-2003,18928,19064,136,0.719,-131,267,37,149,H1
"Polk County, NC",2003-2004,19064,19325,261,1.369,-134,395,37,149,H1
"Polk County, NC",2004-2005,19325,19557,232,1.201,-91,323,37,149,H1
"Polk County, NC",2005-2006,19557,19912,355,1.815,-98,453,37,149,H1
"Polk County, NC",2006-2007,19912,20145,233,1.17,-168,401,37,149,H1
"Polk County, NC",2007-2008,20145,20393,248,1.231,-164,412,37,149,H1
"Polk County, NC",2008-2009,20393,20531,138,0.677,-128,266,37,149,H1
"Polk County, NC",2009-2010,20531,20446,-85,-0.414,-115,30,37,149,H1
"Polk County, NC",2010-2011,20446,20290,-156,-0.763,-172,16,37,149,H1
"Polk County, NC",2011-2012,20290,20248,-42,-0.207,-123,81,37,149,H1
"Polk County, NC",2012-2013,20248,20419,171,0.845,-126,297,37,149,H1
"Polk County, NC",2013-2014,20419,20357,-62,-0.304,-143,81,37,149,H1
"Polk County, NC",2014-2015,20337,20366,29,0.143,-112,141,37,149,H1
"Polk County, NC",2015-2016,20366,20421,55,0.27,-126,181,37,149,H1
"Polk County, NC",2016-2017,20421,20558,137,0.671,-152,289,37,149,H1
"Randolph County, NC",2000-2001,130995,132092,1097,0.837,781,316,37,151,H1
"Randolph County, NC",2001-2002,132092,132989,897,0.679,663,234,37,151,H1
"Randolph County, NC",2002-2003,132989,134034,1045,0.786,685,360,37,151,H1
"Randolph County, NC",2003-2004,134034,134732,698,0.521,622,76,37,151,H1
"Randolph County, NC",2004-2005,134732,136301,1569,1.165,645,924,37,151,H1
"Randolph County, NC",2005-2006,136301,137885,1584,1.162,518,1066,37,151,H1
"Randolph County, NC",2006-2007,137885,138855,970,0.703,522,448,37,151,H1
"Randolph County, NC",2007-2008,138855,140297,1442,1.038,633,809,37,151,H1
"Randolph County, NC",2008-2009,140297,141175,878,0.626,568,310,37,151,H1
"Randolph County, NC",2009-2010,141175,141957,782,0.554,512,270,37,151,H1
"Randolph County, NC",2010-2011,141957,141865,-92,-0.065,316,-408,37,151,H1
"Randolph County, NC",2011-2012,141865,142326,461,0.325,296,165,37,151,H1
"Randolph County, NC",2012-2013,142326,142456,130,0.091,175,-45,37,151,H1
"Randolph County, NC",2013-2014,142456,142778,322,0.226,214,108,37,151,H1
"Randolph County, NC",2014-2015,142617,142799,182,0.128,170,12,37,151,H1
"Randolph County, NC",2015-2016,142799,143209,410,0.287,73,337,37,151,H1
"Randolph County, NC",2016-2017,143209,143282,73,0.051,63,10,37,151,H1
"Richmond County, NC",2000-2001,46611,46480,-131,-0.281,174,-305,37,153,H1
"Richmond County, NC",2001-2002,46480,46659,179,0.385,108,71,37,153,H1
"Richmond County, NC",2002-2003,46659,46292,-367,-0.787,68,-435,37,153,H1
"Richmond County, NC",2003-2004,46292,46227,-65,-0.14,100,-165,37,153,H1
"Richmond County, NC",2004-2005,46227,46310,83,0.18,92,-9,37,153,H1
"Richmond County, NC",2005-2006,46310,46263,-47,-0.101,105,-152,37,153,H1
"Richmond County, NC",2006-2007,46263,46390,127,0.275,185,-58,37,153,H1
"Richmond County, NC",2007-2008,46390,46538,148,0.319,124,24,37,153,H1
"Richmond County, NC",2008-2009,46538,46537,-1,-0.002,114,-115,37,153,H1
"Richmond County, NC",2009-2010,46537,46624,87,0.187,93,-6,37,153,H1
"Richmond County, NC",2010-2011,46624,46621,-3,-0.006,56,-59,37,153,H1
"Richmond County, NC",2011-2012,46621,46381,-240,-0.515,31,-271,37,153,H1
"Richmond County, NC",2012-2013,46381,46224,-157,-0.339,-3,-154,37,153,H1
"Richmond County, NC",2013-2014,46224,45733,-491,-1.062,-10,-481,37,153,H1
"Richmond County, NC",2014-2015,45700,45437,-263,-0.575,-4,-259,37,153,H1
"Richmond County, NC",2015-2016,45437,45054,-383,-0.843,-15,-368,37,153,H1
"Richmond County, NC",2016-2017,45054,44798,-256,-0.568,-37,-219,37,153,H1
"Robeson County, NC",2000-2001,123334,123913,579,0.469,918,-339,37,155,H1
"Robeson County, NC",2001-2002,123913,124676,763,0.616,866,-103,37,155,H1
"Robeson County, NC",2002-2003,124676,125665,989,0.793,808,181,37,155,H1
"Robeson County, NC",2003-2004,125665,126117,452,0.36,795,-343,37,155,H1
"Robeson County, NC",2004-2005,126117,127885,1768,1.402,999,769,37,155,H1
"Robeson County, NC",2005-2006,127885,128894,1009,0.789,866,143,37,155,H1
"Robeson County, NC",2006-2007,128894,130453,1559,1.21,1056,503,37,155,H1
"Robeson County, NC",2007-2008,130453,131734,1281,0.982,1039,242,37,155,H1
"Robeson County, NC",2008-2009,131734,132984,1250,0.949,935,315,37,155,H1
"Robeson County, NC",2009-2010,132984,134425,1441,1.084,889,552,37,155,H1
"Robeson County, NC",2010-2011,134425,135056,631,0.469,799,-168,37,155,H1
"Robeson County, NC",2011-2012,135056,135368,312,0.231,571,-259,37,155,H1
"Robeson County, NC",2012-2013,135368,134956,-412,-0.304,609,-1021,37,155,H1
"Robeson County, NC",2013-2014,134956,134760,-196,-0.145,544,-740,37,155,H1
"Robeson County, NC",2014-2015,134732,134197,-535,-0.397,534,-1069,37,155,H1
"Robeson County, NC",2015-2016,134197,133514,-683,-0.509,319,-1002,37,155,H1
"Robeson County, NC",2016-2017,133514,132606,-908,-0.68,311,-1219,37,155,H1
"Rockingham County, NC",2000-2001,92090,92268,178,0.193,167,11,37,157,H1
"Rockingham County, NC",2001-2002,92268,92798,530,0.574,119,411,37,157,H1
"Rockingham County, NC",2002-2003,92798,92779,-19,-0.02,58,-77,37,157,H1
"Rockingham County, NC",2003-2004,92779,92382,-397,-0.428,17,-414,37,157,H1
"Rockingham County, NC",2004-2005,92382,92587,205,0.222,24,181,37,157,H1
"Rockingham County, NC",2005-2006,92587,92960,373,0.403,-22,395,37,157,H1
"Rockingham County, NC",2006-2007,92960,93164,204,0.219,-58,262,37,157,H1
"Rockingham County, NC",2007-2008,93164,93299,135,0.145,55,80,37,157,H1
"Rockingham County, NC",2008-2009,93299,93547,248,0.266,7,241,37,157,H1
"Rockingham County, NC",2009-2010,93547,93604,57,0.061,-9,66,37,157,H1
"Rockingham County, NC",2010-2011,93604,93160,-444,-0.474,-50,-394,37,157,H1
"Rockingham County, NC",2011-2012,93160,92646,-514,-0.552,-157,-357,37,157,H1
"Rockingham County, NC",2012-2013,92646,91905,-741,-0.8,-208,-533,37,157,H1
"Rockingham County, NC",2013-2014,91905,91696,-209,-0.227,-176,-33,37,157,H1
"Rockingham County, NC",2014-2015,91821,91758,-63,-0.069,-163,100,37,157,H1
"Rockingham County, NC",2015-2016,91758,91359,-399,-0.435,-262,-137,37,157,H1
"Rockingham County, NC",2016-2017,91359,90949,-410,-0.449,-248,-162,37,157,H1
"Rowan County, NC",2000-2001,130610,131852,1242,0.951,365,877,37,159,H1
"Rowan County, NC",2001-2002,131852,132765,913,0.692,333,580,37,159,H1
"Rowan County, NC",2002-2003,132765,132562,-203,-0.153,344,-547,37,159,H1
"Rowan County, NC",2003-2004,132562,132202,-360,-0.272,378,-738,37,159,H1
"Rowan County, NC",2004-2005,132202,132527,325,0.246,245,80,37,159,H1
"Rowan County, NC",2005-2006,132527,134045,1518,1.145,412,1106,37,159,H1
"Rowan County, NC",2006-2007,134045,135626,1581,1.179,415,1166,37,159,H1
"Rowan County, NC",2007-2008,135626,137721,2095,1.545,431,1664,37,159,H1
"Rowan County, NC",2008-2009,137721,138562,841,0.611,387,454,37,159,H1
"Rowan County, NC",2009-2010,138562,138329,-233,-0.168,295,-528,37,159,H1
"Rowan County, NC",2010-2011,138329,138043,-286,-0.207,92,-378,37,159,H1
"Rowan County, NC",2011-2012,138043,137915,-128,-0.093,89,-217,37,159,H1
"Rowan County, NC",2012-2013,137915,138313,398,0.289,-62,460,37,159,H1
"Rowan County, NC",2013-2014,138313,138630,317,0.229,43,274,37,159,H1
"Rowan County, NC",2014-2015,138648,139142,494,0.356,10,484,37,159,H1
"Rowan County, NC",2015-2016,139142,139529,387,0.278,23,364,37,159,H1
"Rowan County, NC",2016-2017,139529,140644,1115,0.799,47,1068,37,159,H1
"Rutherford County, NC",2000-2001,63064,63671,607,0.963,149,458,37,161,H1
"Rutherford County, NC",2001-2002,63671,63924,253,0.397,37,216,37,161,H1
"Rutherford County, NC",2002-2003,63924,64475,551,0.862,-4,555,37,161,H1
"Rutherford County, NC",2003-2004,64475,64692,217,0.337,34,183,37,161,H1
"Rutherford County, NC",2004-2005,64692,65126,434,0.671,-39,473,37,161,H1
"Rutherford County, NC",2005-2006,65126,65855,729,1.119,-108,837,37,161,H1
"Rutherford County, NC",2006-2007,65855,66305,450,0.683,32,418,37,161,H1
"Rutherford County, NC",2007-2008,66305,67145,840,1.267,-124,964,37,161,H1
"Rutherford County, NC",2008-2009,67145,67561,416,0.62,-63,479,37,161,H1
"Rutherford County, NC",2009-2010,67561,67781,220,0.326,-18,238,37,161,H1
"Rutherford County, NC",2010-2011,67781,67403,-378,-0.558,-107,-271,37,161,H1
"Rutherford County, NC",2011-2012,67403,67243,-160,-0.237,-107,-53,37,161,H1
"Rutherford County, NC",2012-2013,67243,66879,-364,-0.541,-161,-203,37,161,H1
"Rutherford County, NC",2013-2014,66879,66600,-279,-0.417,-178,-101,37,161,H1
"Rutherford County, NC",2014-2015,66537,66390,-147,-0.221,-179,32,37,161,H1
"Rutherford County, NC",2015-2016,66390,66305,-85,-0.128,-180,95,37,161,H1
"Rutherford County, NC",2016-2017,66305,66551,246,0.371,-173,419,37,161,H1
"Sampson County, NC",2000-2001,60242,60526,284,0.471,241,43,37,163,H1
"Sampson County, NC",2001-2002,60526,60732,206,0.34,328,-122,37,163,H1
"Sampson County, NC",2002-2003,60732,61144,412,0.678,220,192,37,163,H1
"Sampson County, NC",2003-2004,61144,61376,232,0.379,289,-57,37,163,H1
"Sampson County, NC",2004-2005,61376,61720,344,0.56,283,61,37,163,H1
"Sampson County, NC",2005-2006,61720,62118,398,0.645,331,67,37,163,H1
"Sampson County, NC",2006-2007,62118,62539,421,0.678,359,62,37,163,H1
"Sampson County, NC",2007-2008,62539,62837,298,0.477,316,-18,37,163,H1
"Sampson County, NC",2008-2009,62837,63127,290,0.462,304,-14,37,163,H1
"Sampson County, NC",2009-2010,63127,63517,390,0.618,282,108,37,163,H1
"Sampson County, NC",2010-2011,63517,63650,133,0.209,210,-77,37,163,H1
"Sampson County, NC",2011-2012,63650,63895,245,0.385,265,-20,37,163,H1
"Sampson County, NC",2012-2013,63895,64098,203,0.318,252,-49,37,163,H1
"Sampson County, NC",2013-2014,64098,64050,-48,-0.075,240,-288,37,163,H1
"Sampson County, NC",2014-2015,64010,63724,-286,-0.447,180,-466,37,163,H1
"Sampson County, NC",2015-2016,63724,63363,-361,-0.567,152,-513,37,163,H1
"Sampson County, NC",2016-2017,63363,63430,67,0.106,112,-45,37,163,H1
"Scotland County, NC",2000-2001,35944,35851,-93,-0.259,92,-185,37,165,H1
"Scotland County, NC",2001-2002,35851,35450,-401,-1.119,159,-560,37,165,H1
"Scotland County, NC",2002-2003,35450,35442,-8,-0.023,100,-108,37,165,H1
"Scotland County, NC",2003-2004,35442,36446,1004,2.833,147,857,37,165,H1
"Scotland County, NC",2004-2005,36446,36405,-41,-0.112,123,-164,37,165,H1
"Scotland County, NC",2005-2006,36405,36348,-57,-0.157,132,-189,37,165,H1
"Scotland County, NC",2006-2007,36348,36399,51,0.14,156,-105,37,165,H1
"Scotland County, NC",2007-2008,36399,36463,64,0.176,147,-83,37,165,H1
"Scotland County, NC",2008-2009,36463,36313,-150,-0.411,109,-259,37,165,H1
"Scotland County, NC",2009-2010,36313,36099,-214,-0.589,115,-329,37,165,H1
"Scotland County, NC",2010-2011,36099,36332,233,0.645,118,115,37,165,H1
"Scotland County, NC",2011-2012,36332,36157,-175,-0.482,58,-233,37,165,H1
"Scotland County, NC",2012-2013,36157,36006,-151,-0.418,47,-198,37,165,H1
"Scotland County, NC",2013-2014,36006,35576,-430,-1.194,57,-487,37,165,H1
"Scotland County, NC",2014-2015,35715,35509,-206,-0.577,39,-245,37,165,H1
"Scotland County, NC",2015-2016,35509,35250,-259,-0.729,44,-303,37,165,H1
"Scotland County, NC",2016-2017,35250,35093,-157,-0.445,19,-176,37,165,H1
"Stanly County, NC",2000-2001,58246,58674,428,0.735,149,279,37,167,H1
"Stanly County, NC",2001-2002,58674,58689,15,0.026,159,-144,37,167,H1
"Stanly County, NC",2002-2003,58689,58748,59,0.101,135,-76,37,167,H1
"Stanly County, NC",2003-2004,58748,58638,-110,-0.187,129,-239,37,167,H1
"Stanly County, NC",2004-2005,58638,58931,293,0.5,147,146,37,167,H1
"Stanly County, NC",2005-2006,58931,59185,254,0.431,56,198,37,167,H1
"Stanly County, NC",2006-2007,59185,59849,664,1.122,112,552,37,167,H1
"Stanly County, NC",2007-2008,59849,60418,569,0.951,137,432,37,167,H1
"Stanly County, NC",2008-2009,60418,60496,78,0.129,91,-13,37,167,H1
"Stanly County, NC",2009-2010,60496,60562,66,0.109,118,-52,37,167,H1
"Stanly County, NC",2010-2011,60562,60480,-82,-0.135,55,-137,37,167,H1
"Stanly County, NC",2011-2012,60480,60493,13,0.021,-55,68,37,167,H1
"Stanly County, NC",2012-2013,60493,60630,137,0.226,-9,146,37,167,H1
"Stanly County, NC",2013-2014,60630,60600,-30,-0.049,-23,-7,37,167,H1
"Stanly County, NC",2014-2015,60629,60714,85,0.14,2,83,37,167,H1
"Stanly County, NC",2015-2016,60714,60880,166,0.273,-29,195,37,167,H1
"Stanly County, NC",2016-2017,60880,61482,602,0.989,-13,615,37,167,H1
"Stokes County, NC",2000-2001,44779,44974,195,0.435,99,96,37,169,H1
"Stokes County, NC",2001-2002,44974,45079,105,0.233,80,25,37,169,H1
"Stokes County, NC",2002-2003,45079,45331,252,0.559,76,176,37,169,H1
"Stokes County, NC",2003-2004,45331,45772,441,0.973,85,356,37,169,H1
"Stokes County, NC",2004-2005,45772,46165,393,0.859,5,388,37,169,H1
"Stokes County, NC",2005-2006,46165,46755,590,1.278,7,583,37,169,H1
"Stokes County, NC",2006-2007,46755,47079,324,0.693,58,266,37,169,H1
"Stokes County, NC",2007-2008,47079,47363,284,0.603,-18,302,37,169,H1
"Stokes County, NC",2008-2009,47363,47422,59,0.125,-7,66,37,169,H1
"Stokes County, NC",2009-2010,47422,47339,-83,-0.175,-36,-47,37,169,H1
"Stokes County, NC",2010-2011,47339,47191,-148,-0.313,-70,-78,37,169,H1
"Stokes County, NC",2011-2012,47191,46756,-435,-0.922,-89,-346,37,169,H1
"Stokes County, NC",2012-2013,46756,46587,-169,-0.361,-80,-89,37,169,H1
"Stokes County, NC",2013-2014,46587,46419,-168,-0.361,-98,-70,37,169,H1
"Stokes County, NC",2014-2015,46415,46351,-64,-0.138,-124,60,37,169,H1
"Stokes County, NC",2015-2016,46351,45891,-460,-0.992,-133,-327,37,169,H1
"Stokes County, NC",2016-2017,45891,45717,-174,-0.379,-159,-15,37,169,H1
"Surry County, NC",2000-2001,71308,71782,474,0.665,213,261,37,171,H1
"Surry County, NC",2001-2002,71782,72152,370,0.515,151,219,37,171,H1
"Surry County, NC",2002-2003,72152,72404,252,0.349,162,90,37,171,H1
"Surry County, NC",2003-2004,72404,72219,-185,-0.256,89,-274,37,171,H1
"Surry County, NC",2004-2005,72219,72562,343,0.475,64,279,37,171,H1
"Surry County, NC",2005-2006,72562,72807,245,0.338,43,202,37,171,H1
"Surry County, NC",2006-2007,72807,73027,220,0.302,112,108,37,171,H1
"Surry County, NC",2007-2008,73027,73404,377,0.516,82,295,37,171,H1
"Surry County, NC",2008-2009,73404,73505,101,0.138,82,19,37,171,H1
"Surry County, NC",2009-2010,73505,73714,209,0.284,87,122,37,171,H1
"Surry County, NC",2010-2011,73714,73644,-70,-0.095,-77,7,37,171,H1
"Surry County, NC",2011-2012,73644,73568,-76,-0.103,-3,-73,37,171,H1
"Surry County, NC",2012-2013,73568,73062,-506,-0.688,-90,-416,37,171,H1
"Surry County, NC",2013-2014,73062,72968,-94,-0.129,-83,-11,37,171,H1
"Surry County, NC",2014-2015,72980,72743,-237,-0.325,-112,-125,37,171,H1
"Surry County, NC",2015-2016,72743,72049,-694,-0.954,-138,-556,37,171,H1
"Surry County, NC",2016-2017,72049,72224,175,0.243,-144,319,37,171,H1
"Swain County, NC",2000-2001,13041,13030,-11,-0.084,-1,-10,37,173,H1
"Swain County, NC",2001-2002,13030,13120,90,0.691,22,68,37,173,H1
"Swain County, NC",2002-2003,13120,13199,79,0.602,-9,88,37,173,H1
"Swain County, NC",2003-2004,13199,13240,41,0.311,-18,59,37,173,H1
"Swain County, NC",2004-2005,13240,13463,223,1.684,40,183,37,173,H1
"Swain County, NC",2005-2006,13463,13693,230,1.708,13,217,37,173,H1
"Swain County, NC",2006-2007,13693,13819,126,0.92,-3,129,37,173,H1
"Swain County, NC",2007-2008,13819,13872,53,0.384,15,38,37,173,H1
"Swain County, NC",2008-2009,13872,13933,61,0.44,15,46,37,173,H1
"Swain County, NC",2009-2010,13933,13991,58,0.416,22,36,37,173,H1
"Swain County, NC",2010-2011,13991,13992,1,0.007,-29,30,37,173,H1
"Swain County, NC",2011-2012,13992,14080,88,0.629,50,38,37,173,H1
"Swain County, NC",2012-2013,14080,14014,-66,-0.469,1,-67,37,173,H1
"Swain County, NC",2013-2014,14014,14274,260,1.855,-4,264,37,173,H1
"Swain County, NC",2014-2015,14286,14434,148,1.036,14,134,37,173,H1
"Swain County, NC",2015-2016,14434,14187,-247,-1.711,-1,-246,37,173,H1
"Swain County, NC",2016-2017,14187,14294,107,0.754,-16,123,37,173,H1
"Transylvania County, NC",2000-2001,29416,29619,203,0.69,-60,263,37,175,H1
"Transylvania County, NC",2001-2002,29619,30009,390,1.317,-91,481,37,175,H1
"Transylvania County, NC",2002-2003,30009,30073,64,0.213,-148,212,37,175,H1
"Transylvania County, NC",2003-2004,30073,30417,344,1.144,-98,442,37,175,H1
"Transylvania County, NC",2004-2005,30417,30910,493,1.621,-94,587,37,175,H1
"Transylvania County, NC",2005-2006,30910,31469,559,1.808,4,555,37,175,H1
"Transylvania County, NC",2006-2007,31469,32061,592,1.881,-56,648,37,175,H1
"Transylvania County, NC",2007-2008,32061,32543,482,1.503,-90,572,37,175,H1
"Transylvania County, NC",2008-2009,32543,32852,309,0.95,-108,417,37,175,H1
"Transylvania County, NC",2009-2010,32852,33073,221,0.673,-90,311,37,175,H1
"Transylvania County, NC",2010-2011,33073,32819,-254,-0.768,-136,-118,37,175,H1
"Transylvania County, NC",2011-2012,32819,32854,35,0.107,-112,147,37,175,H1
"Transylvania County, NC",2012-2013,32854,32925,71,0.216,-146,217,37,175,H1
"Transylvania County, NC",2013-2014,32925,33045,120,0.364,-124,244,37,175,H1
"Transylvania County, NC",2014-2015,32991,33211,220,0.667,-80,300,37,175,H1
"Transylvania County, NC",2015-2016,33211,33471,260,0.783,-138,398,37,175,H1
"Transylvania County, NC",2016-2017,33471,33956,485,1.449,-144,629,37,175,H1
"Tyrrell County, NC",2000-2001,4126,4166,40,0.969,8,32,37,177,H1
"Tyrrell County, NC",2001-2002,4166,4235,69,1.656,-11,80,37,177,H1
"Tyrrell County, NC",2002-2003,4235,4344,109,2.574,-3,112,37,177,H1
"Tyrrell County, NC",2003-2004,4344,4289,-55,-1.266,4,-59,37,177,H1
"Tyrrell County, NC",2004-2005,4289,4280,-9,-0.21,8,-17,37,177,H1
"Tyrrell County, NC",2005-2006,4280,4339,59,1.379,17,42,37,177,H1
"Tyrrell County, NC",2006-2007,4339,4402,63,1.452,21,42,37,177,H1
"Tyrrell County, NC",2007-2008,4402,4353,-49,-1.113,29,-78,37,177,H1
"Tyrrell County, NC",2008-2009,4353,4358,5,0.115,1,4,37,177,H1
"Tyrrell County, NC",2009-2010,4358,4409,51,1.17,24,27,37,177,H1
"Tyrrell County, NC",2010-2011,4409,4333,-76,-1.724,-22,-54,37,177,H1
"Tyrrell County, NC",2011-2012,4333,4131,-202,-4.662,-8,-194,37,177,H1
"Tyrrell County, NC",2012-2013,4131,4105,-26,-0.629,22,-48,37,177,H1
"Tyrrell County, NC",2013-2014,4105,4115,10,0.244,4,6,37,177,H1
"Tyrrell County, NC",2014-2015,4118,4070,-48,-1.166,6,-54,37,177,H1
"Tyrrell County, NC",2015-2016,4070,4039,-31,-0.762,10,-41,37,177,H1
"Tyrrell County, NC",2016-2017,4039,4052,13,0.322,4,9,37,177,H1
"Union County, NC",2000-2001,125573,131661,6088,4.848,1387,4701,37,179,H1
"Union County, NC",2001-2002,131661,138329,6668,5.065,1448,5220,37,179,H1
"Union County, NC",2002-2003,138329,144244,5915,4.276,1475,4440,37,179,H1
"Union County, NC",2003-2004,144244,151452,7208,4.997,1448,5760,37,179,H1
"Union County, NC",2004-2005,151452,160835,9383,6.195,1629,7754,37,179,H1
"Union County, NC",2005-2006,160835,172529,11694,7.271,1608,10086,37,179,H1
"Union County, NC",2006-2007,172529,184782,12253,7.102,1714,10539,37,179,H1
"Union County, NC",2007-2008,184782,193678,8896,4.814,1670,7226,37,179,H1
"Union County, NC",2008-2009,193678,198533,4855,2.507,1922,2933,37,179,H1
"Union County, NC",2009-2010,198533,202171,3638,1.832,1477,2161,37,179,H1
"Union County, NC",2010-2011,202171,205109,2938,1.453,1153,1785,37,179,H1
"Union County, NC",2011-2012,205109,208393,3284,1.601,1225,2059,37,179,H1
"Union County, NC",2012-2013,208393,212696,4303,2.065,1098,3205,37,179,H1
"Union County, NC",2013-2014,212696,218568,5872,2.761,1145,4727,37,179,H1
"Union County, NC",2014-2015,218337,222742,4405,2.018,1118,3287,37,179,H1
"Union County, NC",2015-2016,222742,226540,3798,1.705,980,2818,37,179,H1
"Union County, NC",2016-2017,226540,231366,4826,2.13,998,3828,37,179,H1
"Vance County, NC",2000-2001,43159,43932,773,1.791,258,515,37,181,H1
"Vance County, NC",2001-2002,43932,44056,124,0.282,224,-100,37,181,H1
"Vance County, NC",2002-2003,44056,44030,-26,-0.059,178,-204,37,181,H1
"Vance County, NC",2003-2004,44030,44081,51,0.116,161,-110,37,181,H1
"Vance County, NC",2004-2005,44081,44136,55,0.125,205,-150,37,181,H1
"Vance County, NC",2005-2006,44136,44574,438,0.992,240,198,37,181,H1
"Vance County, NC",2006-2007,44574,44676,102,0.229,291,-189,37,181,H1
"Vance County, NC",2007-2008,44676,44977,301,0.674,216,85,37,181,H1
"Vance County, NC",2008-2009,44977,45223,246,0.547,158,88,37,181,H1
"Vance County, NC",2009-2010,45223,45314,91,0.201,139,-48,37,181,H1
"Vance County, NC",2010-2011,45314,45258,-56,-0.124,109,-165,37,181,H1
"Vance County, NC",2011-2012,45258,45074,-184,-0.407,166,-350,37,181,H1
"Vance County, NC",2012-2013,45074,44730,-344,-0.763,46,-390,37,181,H1
"Vance County, NC",2013-2014,44730,44614,-116,-0.259,60,-176,37,181,H1
"Vance County, NC",2014-2015,44587,44568,-19,-0.043,78,-97,37,181,H1
"Vance County, NC",2015-2016,44568,44426,-142,-0.319,7,-149,37,181,H1
"Vance County, NC",2016-2017,44426,44211,-215,-0.484,-1,-214,37,181,H1
"Wake County, NC",2000-2001,633267,656819,23552,3.719,7165,16387,37,183,H1
"Wake County, NC",2001-2002,656819,676392,19573,2.98,7576,11997,37,183,H1
"Wake County, NC",2002-2003,676392,695746,19354,2.861,7623,11731,37,183,H1
"Wake County, NC",2003-2004,695746,716336,20590,2.959,8002,12588,37,183,H1
"Wake County, NC",2004-2005,716336,746048,29712,4.148,8194,21518,37,183,H1
"Wake County, NC",2005-2006,746048,784038,37990,5.092,9050,28940,37,183,H1
"Wake County, NC",2006-2007,784038,821607,37569,4.792,9232,28337,37,183,H1
"Wake County, NC",2007-2008,821607,856492,34885,4.246,9479,25406,37,183,H1
"Wake County, NC",2008-2009,856492,883624,27132,3.168,9608,17524,37,183,H1
"Wake County, NC",2009-2010,883624,906908,23284,2.635,9102,14182,37,183,H1
"Wake County, NC",2010-2011,906908,929330,22422,2.472,8147,14275,37,183,H1
"Wake County, NC",2011-2012,929330,952611,23281,2.505,7709,15572,37,183,H1
"Wake County, NC",2012-2013,952611,975024,22413,2.353,7673,14740,37,183,H1
"Wake County, NC",2013-2014,975024,998691,23667,2.427,7582,16085,37,183,H1
"Wake County, NC",2014-2015,999271,1024198,24927,2.495,7578,17349,37,183,H1
"Wake County, NC",2015-2016,1024198,1049143,24945,2.436,7536,17409,37,183,H1
"Wake County, NC",2016-2017,1049143,1072203,23060,2.198,7386,15674,37,183,H1
"Warren County, NC",2000-2001,19913,20067,154,0.773,-23,177,37,185,H1
"Warren County, NC",2001-2002,20067,20131,64,0.319,-42,106,37,185,H1
"Warren County, NC",2002-2003,20131,20293,162,0.805,-49,211,37,185,H1
"Warren County, NC",2003-2004,20293,20464,171,0.843,-34,205,37,185,H1
"Warren County, NC",2004-2005,20464,20642,178,0.87,-1,179,37,185,H1
"Warren County, NC",2005-2006,20642,20513,-129,-0.625,-27,-102,37,185,H1
"Warren County, NC",2006-2007,20513,20724,211,1.029,26,185,37,185,H1
"Warren County, NC",2007-2008,20724,20923,199,0.96,-35,234,37,185,H1
"Warren County, NC",2008-2009,20923,20959,36,0.172,-31,67,37,185,H1
"Warren County, NC",2009-2010,20959,20920,-39,-0.186,-24,-15,37,185,H1
"Warren County, NC",2010-2011,20920,20928,8,0.038,4,4,37,185,H1
"Warren County, NC",2011-2012,20928,20594,-334,-1.596,-46,-288,37,185,H1
"Warren County, NC",2012-2013,20594,20467,-127,-0.617,-66,-61,37,185,H1
"Warren County, NC",2013-2014,20467,20231,-236,-1.153,-68,-168,37,185,H1
"Warren County, NC",2014-2015,20224,20155,-69,-0.341,-50,-19,37,185,H1
"Warren County, NC",2015-2016,20155,19889,-266,-1.32,-67,-199,37,185,H1
"Warren County, NC",2016-2017,19889,19883,-6,-0.03,-80,74,37,185,H1
"Washington County, NC",2000-2001,13695,13589,-106,-0.774,-12,-94,37,187,H1
"Washington County, NC",2001-2002,13589,13472,-117,-0.861,-8,-109,37,187,H1
"Washington County, NC",2002-2003,13472,13510,38,0.282,-1,39,37,187,H1
"Washington County, NC",2003-2004,13510,13393,-117,-0.866,26,-143,37,187,H1
"Washington County, NC",2004-2005,13393,13401,8,0.06,0,8,37,187,H1
"Washington County, NC",2005-2006,13401,13305,-96,-0.716,57,-153,37,187,H1
"Washington County, NC",2006-2007,13305,13176,-129,-0.97,37,-166,37,187,H1
"Washington County, NC",2007-2008,13176,13300,124,0.941,33,91,37,187,H1
"Washington County, NC",2008-2009,13300,13252,-48,-0.361,20,-68,37,187,H1
"Washington County, NC",2009-2010,13252,13169,-83,-0.626,25,-108,37,187,H1
"Washington County, NC",2010-2011,13169,12957,-212,-1.61,-10,-202,37,187,H1
"Washington County, NC",2011-2012,12957,12726,-231,-1.783,-10,-221,37,187,H1
"Washington County, NC",2012-2013,12726,12765,39,0.306,-23,62,37,187,H1
"Washington County, NC",2013-2014,12765,12570,-195,-1.528,-21,-174,37,187,H1
"Washington County, NC",2014-2015,12558,12385,-173,-1.378,-11,-162,37,187,H1
"Washington County, NC",2015-2016,12385,12132,-253,-2.043,-35,-218,37,187,H1
"Washington County, NC",2016-2017,12132,12012,-120,-0.989,-39,-81,37,187,H1
"Watauga County, NC",2000-2001,42905,43853,948,2.21,71,877,37,189,H1
"Watauga County, NC",2001-2002,43853,44570,717,1.635,43,674,37,189,H1
"Watauga County, NC",2002-2003,44570,45095,525,1.178,78,447,37,189,H1
"Watauga County, NC",2003-2004,45095,45478,383,0.849,8,375,37,189,H1
"Watauga County, NC",2004-2005,45478,46390,912,2.005,77,835,37,189,H1
"Watauga County, NC",2005-2006,46390,47748,1358,2.927,103,1255,37,189,H1
"Watauga County, NC",2006-2007,47748,48765,1017,2.13,67,950,37,189,H1
"Watauga County, NC",2007-2008,48765,50266,1501,3.078,108,1393,37,189,H1
"Watauga County, NC",2008-2009,50266,50706,440,0.875,103,337,37,189,H1
"Watauga County, NC",2009-2010,50706,50993,287,0.566,50,237,37,189,H1
"Watauga County, NC",2010-2011,50993,51583,590,1.157,-1,591,37,189,H1
"Watauga County, NC",2011-2012,51583,52064,481,0.932,48,433,37,189,H1
"Watauga County, NC",2012-2013,52064,52317,253,0.486,42,211,37,189,H1
"Watauga County, NC",2013-2014,52317,52560,243,0.464,3,240,37,189,H1
"Watauga County, NC",2014-2015,52388,52906,518,0.989,13,505,37,189,H1
"Watauga County, NC",2015-2016,52906,54099,1193,2.255,-2,1195,37,189,H1
"Watauga County, NC",2016-2017,54099,55121,1022,1.889,17,1005,37,189,H1
"Wayne County, NC",2000-2001,113648,113934,286,0.252,685,-399,37,191,H1
"Wayne County, NC",2001-2002,113934,114305,371,0.326,722,-351,37,191,H1
"Wayne County, NC",2002-2003,114305,114595,290,0.254,621,-331,37,191,H1
"Wayne County, NC",2003-2004,114595,116484,1889,1.648,646,1243,37,191,H1
"Wayne County, NC",2004-2005,116484,117009,525,0.451,706,-181,37,191,H1
"Wayne County, NC",2005-2006,117009,117534,525,0.449,751,-226,37,191,H1
"Wayne County, NC",2006-2007,117534,118942,1408,1.198,677,731,37,191,H1
"Wayne County, NC",2007-2008,118942,119910,968,0.814,748,220,37,191,H1
"Wayne County, NC",2008-2009,119910,121217,1307,1.09,701,606,37,191,H1
"Wayne County, NC",2009-2010,121217,122888,1671,1.379,701,970,37,191,H1
"Wayne County, NC",2010-2011,122888,124022,1134,0.923,517,617,37,191,H1
"Wayne County, NC",2011-2012,124022,124504,482,0.389,653,-171,37,191,H1
"Wayne County, NC",2012-2013,124504,124596,92,0.074,636,-544,37,191,H1
"Wayne County, NC",2013-2014,124596,124456,-140,-0.112,532,-672,37,191,H1
"Wayne County, NC",2014-2015,124502,124132,-370,-0.297,463,-833,37,191,H1
"Wayne County, NC",2015-2016,124132,124476,344,0.277,415,-71,37,191,H1
"Wayne County, NC",2016-2017,124476,124172,-304,-0.244,289,-593,37,191,H1
"Wilkes County, NC",2000-2001,65839,66694,855,1.299,268,587,37,193,H1
"Wilkes County, NC",2001-2002,66694,67202,508,0.762,212,296,37,193,H1
"Wilkes County, NC",2002-2003,67202,67617,415,0.618,203,212,37,193,H1
"Wilkes County, NC",2003-2004,67617,67668,51,0.075,76,-25,37,193,H1
"Wilkes County, NC",2004-2005,67668,68104,436,0.644,107,329,37,193,H1
"Wilkes County, NC",2005-2006,68104,68489,385,0.565,111,274,37,193,H1
"Wilkes County, NC",2006-2007,68489,68966,477,0.696,120,357,37,193,H1
"Wilkes County, NC",2007-2008,68966,69317,351,0.509,144,207,37,193,H1
"Wilkes County, NC",2008-2009,69317,69258,-59,-0.085,72,-131,37,193,H1
"Wilkes County, NC",2009-2010,69258,69223,-35,-0.051,40,-75,37,193,H1
"Wilkes County, NC",2010-2011,69223,69181,-42,-0.061,-15,-27,37,193,H1
"Wilkes County, NC",2011-2012,69181,69210,29,0.042,-38,67,37,193,H1
"Wilkes County, NC",2012-2013,69210,69012,-198,-0.286,-128,-70,37,193,H1
"Wilkes County, NC",2013-2014,69012,68838,-174,-0.252,-107,-67,37,193,H1
"Wilkes County, NC",2014-2015,68802,68502,-300,-0.436,-110,-190,37,193,H1
"Wilkes County, NC",2015-2016,68502,68634,132,0.193,-75,207,37,193,H1
"Wilkes County, NC",2016-2017,68634,68576,-58,-0.085,-120,62,37,193,H1
"Wilson County, NC",2000-2001,73971,74232,261,0.353,346,-85,37,195,H1
"Wilson County, NC",2001-2002,74232,75213,981,1.322,357,624,37,195,H1
"Wilson County, NC",2002-2003,75213,75685,472,0.628,344,128,37,195,H1
"Wilson County, NC",2003-2004,75685,76140,455,0.601,270,185,37,195,H1
"Wilson County, NC",2004-2005,76140,76775,635,0.834,244,391,37,195,H1
"Wilson County, NC",2005-2006,76775,77379,604,0.787,291,313,37,195,H1
"Wilson County, NC",2006-2007,77379,78474,1095,1.415,289,806,37,195,H1
"Wilson County, NC",2007-2008,78474,79790,1316,1.677,383,933,37,195,H1
"Wilson County, NC",2008-2009,79790,80664,874,1.095,358,516,37,195,H1
"Wilson County, NC",2009-2010,80664,81277,613,0.76,321,292,37,195,H1
"Wilson County, NC",2010-2011,81277,81449,172,0.212,217,-45,37,195,H1
"Wilson County, NC",2011-2012,81449,81768,319,0.392,242,77,37,195,H1
"Wilson County, NC",2012-2013,81768,81598,-170,-0.208,31,-201,37,195,H1
"Wilson County, NC",2013-2014,81598,81401,-197,-0.241,50,-247,37,195,H1
"Wilson County, NC",2014-2015,81394,81714,320,0.393,82,238,37,195,H1
"Wilson County, NC",2015-2016,81714,81433,-281,-0.344,160,-441,37,195,H1
"Wilson County, NC",2016-2017,81433,81671,238,0.292,77,161,37,195,H1
"Yadkin County, NC",2000-2001,36516,36837,321,0.879,127,194,37,197,H1
"Yadkin County, NC",2001-2002,36837,37285,448,1.216,103,345,37,197,H1
"Yadkin County, NC",2002-2003,37285,37301,16,0.043,53,-37,37,197,H1
"Yadkin County, NC",2003-2004,37301,37265,-36,-0.097,95,-131,37,197,H1
"Yadkin County, NC",2004-2005,37265,37591,326,0.875,124,202,37,197,H1
"Yadkin County, NC",2005-2006,37591,37881,290,0.771,89,201,37,197,H1
"Yadkin County, NC",2006-2007,37881,37965,84,0.222,58,26,37,197,H1
"Yadkin County, NC",2007-2008,37965,38225,260,0.685,126,134,37,197,H1
"Yadkin County, NC",2008-2009,38225,38293,68,0.178,88,-20,37,197,H1
"Yadkin County, NC",2009-2010,38293,38394,101,0.264,45,56,37,197,H1
"Yadkin County, NC",2010-2011,38394,38252,-142,-0.37,1,-143,37,197,H1
"Yadkin County, NC",2011-2012,38252,38056,-196,-0.512,20,-216,37,197,H1
"Yadkin County, NC",2012-2013,38056,38009,-47,-0.124,-1,-46,37,197,H1
"Yadkin County, NC",2013-2014,38009,37792,-217,-0.571,-6,-211,37,197,H1
"Yadkin County, NC",2014-2015,37798,37585,-213,-0.564,-23,-190,37,197,H1
"Yadkin County, NC",2015-2016,37585,37726,141,0.375,-61,202,37,197,H1
"Yadkin County, NC",2016-2017,37726,37774,48,0.127,-15,63,37,197,H1
"Yancey County, NC",2000-2001,17768,17789,21,0.118,8,13,37,199,H1
"Yancey County, NC",2001-2002,17789,17710,-79,-0.444,17,-96,37,199,H1
"Yancey County, NC",2002-2003,17710,17664,-46,-0.26,-26,-20,37,199,H1
"Yancey County, NC",2003-2004,17664,17704,40,0.226,-45,85,37,199,H1
"Yancey County, NC",2004-2005,17704,17757,53,0.299,-11,64,37,199,H1
"Yancey County, NC",2005-2006,17757,17814,57,0.321,-19,76,37,199,H1
"Yancey County, NC",2006-2007,17814,1.80E+04,186,1.044,-48,234,37,199,H1
"Yancey County, NC",2007-2008,1.80E+04,18016,16,0.089,-12,28,37,199,H1
"Yancey County, NC",2008-2009,18016,17931,-85,-0.472,-17,-68,37,199,H1
"Yancey County, NC",2009-2010,17931,17808,-123,-0.686,-6,-117,37,199,H1
"Yancey County, NC",2010-2011,17808,17692,-116,-0.651,-68,-48,37,199,H1
"Yancey County, NC",2011-2012,17692,17633,-59,-0.333,-53,-6,37,199,H1
"Yancey County, NC",2012-2013,17633,17564,-69,-0.391,-58,-11,37,199,H1
"Yancey County, NC",2013-2014,17564,17614,50,0.285,-33,83,37,199,H1
"Yancey County, NC",2014-2015,17586,17587,1,0.006,-36,37,37,199,H1
"Yancey County, NC",2015-2016,17587,17622,35,0.199,-56,91,37,199,H1
"Yancey County, NC",2016-2017,17622,17744,122,0.692,-29,151,37,199,H1
North Dakota,2000-2001,642023,639062,-2961,-0.461,1719,-4680,38,0,STATE
North Dakota,2001-2002,639062,638168,-894,-0.14,1669,-2563,38,0,STATE
North Dakota,2002-2003,638168,638817,649,0.102,1861,-1212,38,0,STATE
North Dakota,2003-2004,638817,644705,5888,0.922,2214,3674,38,0,STATE
North Dakota,2004-2005,644705,646089,1384,0.215,2506,-1122,38,0,STATE
North Dakota,2005-2006,646089,649422,3333,0.516,2889,444,38,0,STATE
North Dakota,2006-2007,649422,652822,3400,0.524,2915,485,38,0,STATE
North Dakota,2007-2008,652822,657569,4747,0.727,3373,1374,38,0,STATE
North Dakota,2008-2009,657569,664968,7399,1.125,3420,3979,38,0,STATE
North Dakota,2009-2010,664968,674530,9562,1.438,3446,6116,38,0,STATE
North Dakota,2010-2011,674530,685326,10796,1.601,3143,7653,38,0,STATE
North Dakota,2011-2012,685326,702265,16939,2.472,3940,12999,38,0,STATE
North Dakota,2012-2013,702265,723626,21361,3.042,4022,17339,38,0,STATE
North Dakota,2013-2014,723626,740040,16414,2.268,5041,11373,38,0,STATE
North Dakota,2014-2015,740040,756927,16887,2.282,5291,11596,38,0,STATE
North Dakota,2015-2016,756927,755548,-1379,-0.182,5364,-6743,38,0,STATE
North Dakota,2016-2017,755548,755393,-155,-0.021,4978,-5133,38,0,STATE
"Adams County, ND",2000-2001,2578,2542,-36,-1.396,-24,-12,38,1,H1
"Adams County, ND",2001-2002,2542,2509,-33,-1.298,-20,-13,38,1,H1
"Adams County, ND",2002-2003,2509,2469,-40,-1.594,-28,-12,38,1,H1
"Adams County, ND",2003-2004,2469,2436,-33,-1.337,-20,-13,38,1,H1
"Adams County, ND",2004-2005,2436,2405,-31,-1.273,-17,-14,38,1,H1
"Adams County, ND",2005-2006,2405,2366,-39,-1.622,-9,-30,38,1,H1
"Adams County, ND",2006-2007,2366,2362,-4,-0.169,-16,12,38,1,H1
"Adams County, ND",2007-2008,2362,2343,-19,-0.804,-4,-15,38,1,H1
"Adams County, ND",2008-2009,2343,2325,-18,-0.768,-14,-4,38,1,H1
"Adams County, ND",2009-2010,2325,2344,19,0.817,-7,26,38,1,H1
"Adams County, ND",2010-2011,2344,2299,-45,-1.92,-4,-41,38,1,H1
"Adams County, ND",2011-2012,2299,2302,3,0.13,-11,14,38,1,H1
"Adams County, ND",2012-2013,2302,2366,64,2.78,5,59,38,1,H1
"Adams County, ND",2013-2014,2366,2384,18,0.761,10,8,38,1,H1
"Adams County, ND",2014-2015,2359,2359,0,0,-3,3,38,1,H1
"Adams County, ND",2015-2016,2359,2348,-11,-0.466,-1,-10,38,1,H1
"Adams County, ND",2016-2017,2348,2318,-30,-1.278,-9,-21,38,1,H1
"Barnes County, ND",2000-2001,11692,11446,-246,-2.104,-58,-188,38,3,H1
"Barnes County, ND",2001-2002,11446,11281,-165,-1.442,-24,-141,38,3,H1
"Barnes County, ND",2002-2003,11281,11199,-82,-0.727,-28,-54,38,3,H1
"Barnes County, ND",2003-2004,11199,11202,3,0.027,-44,47,38,3,H1
"Barnes County, ND",2004-2005,11202,11171,-31,-0.277,-48,17,38,3,H1
"Barnes County, ND",2005-2006,11171,11106,-65,-0.582,-29,-36,38,3,H1
"Barnes County, ND",2006-2007,11106,11057,-49,-0.441,-42,-7,38,3,H1
"Barnes County, ND",2007-2008,11057,11027,-30,-0.271,-12,-18,38,3,H1
"Barnes County, ND",2008-2009,11027,11028,1,0.009,-11,12,38,3,H1
"Barnes County, ND",2009-2010,11028,11059,31,0.281,-9,40,38,3,H1
"Barnes County, ND",2010-2011,11059,11101,42,0.38,-8,50,38,3,H1
"Barnes County, ND",2011-2012,11101,11013,-88,-0.793,-17,-71,38,3,H1
"Barnes County, ND",2012-2013,11013,11162,149,1.353,-12,161,38,3,H1
"Barnes County, ND",2013-2014,11162,11144,-18,-0.161,2,-20,38,3,H1
"Barnes County, ND",2014-2015,11118,11099,-19,-0.171,4,-23,38,3,H1
"Barnes County, ND",2015-2016,11099,10929,-170,-1.532,-12,-158,38,3,H1
"Barnes County, ND",2016-2017,10929,10734,-195,-1.784,-5,-190,38,3,H1
"Benson County, ND",2000-2001,6943,6898,-45,-0.648,74,-119,38,5,H1
"Benson County, ND",2001-2002,6898,6727,-171,-2.479,55,-226,38,5,H1
"Benson County, ND",2002-2003,6727,6744,17,0.253,79,-62,38,5,H1
"Benson County, ND",2003-2004,6744,6788,44,0.652,80,-36,38,5,H1
"Benson County, ND",2004-2005,6788,6745,-43,-0.633,70,-113,38,5,H1
"Benson County, ND",2005-2006,6745,6709,-36,-0.534,108,-144,38,5,H1
"Benson County, ND",2006-2007,6709,6683,-26,-0.388,79,-105,38,5,H1
"Benson County, ND",2007-2008,6683,6622,-61,-0.913,110,-171,38,5,H1
"Benson County, ND",2008-2009,6622,6609,-13,-0.196,121,-134,38,5,H1
"Benson County, ND",2009-2010,6609,6666,57,0.862,87,-30,38,5,H1
"Benson County, ND",2010-2011,6666,6687,21,0.315,50,-29,38,5,H1
"Benson County, ND",2011-2012,6687,6762,75,1.122,88,-13,38,5,H1
"Benson County, ND",2012-2013,6762,6874,112,1.656,84,28,38,5,H1
"Benson County, ND",2013-2014,6874,6833,-41,-0.596,91,-132,38,5,H1
"Benson County, ND",2014-2015,6854,6753,-101,-1.474,66,-167,38,5,H1
"Benson County, ND",2015-2016,6753,6851,98,1.451,107,-9,38,5,H1
"Benson County, ND",2016-2017,6851,6936,85,1.241,96,-11,38,5,H1
"Billings County, ND",2000-2001,876,877,1,0.114,3,-2,38,7,H1
"Billings County, ND",2001-2002,877,854,-23,-2.623,8,-31,38,7,H1
"Billings County, ND",2002-2003,854,820,-34,-3.981,0,-34,38,7,H1
"Billings County, ND",2003-2004,820,792,-28,-3.415,-2,-26,38,7,H1
"Billings County, ND",2004-2005,792,773,-19,-2.399,6,-25,38,7,H1
"Billings County, ND",2005-2006,773,741,-32,-4.14,3,-35,38,7,H1
"Billings County, ND",2006-2007,741,762,21,2.834,9,12,38,7,H1
"Billings County, ND",2007-2008,762,768,6,0.787,4,2,38,7,H1
"Billings County, ND",2008-2009,768,796,28,3.646,6,22,38,7,H1
"Billings County, ND",2009-2010,796,771,-25,-3.141,3,-28,38,7,H1
"Billings County, ND",2010-2011,771,836,65,8.431,1,64,38,7,H1
"Billings County, ND",2011-2012,836,913,77,9.211,8,69,38,7,H1
"Billings County, ND",2012-2013,913,891,-22,-2.41,12,-34,38,7,H1
"Billings County, ND",2013-2014,891,901,10,1.122,9,1,38,7,H1
"Billings County, ND",2014-2015,910,936,26,2.857,11,15,38,7,H1
"Billings County, ND",2015-2016,936,953,17,1.816,11,6,38,7,H1
"Billings County, ND",2016-2017,953,940,-13,-1.364,15,-28,38,7,H1
"Bottineau County, ND",2000-2001,7126,6995,-131,-1.838,-51,-80,38,9,H1
"Bottineau County, ND",2001-2002,6995,6835,-160,-2.287,-42,-118,38,9,H1
"Bottineau County, ND",2002-2003,6835,6789,-46,-0.673,-26,-20,38,9,H1
"Bottineau County, ND",2003-2004,6789,6690,-99,-1.458,-45,-54,38,9,H1
"Bottineau County, ND",2004-2005,6690,6650,-40,-0.598,-12,-28,38,9,H1
"Bottineau County, ND",2005-2006,6650,6526,-124,-1.865,-18,-106,38,9,H1
"Bottineau County, ND",2006-2007,6526,6428,-98,-1.502,-26,-72,38,9,H1
"Bottineau County, ND",2007-2008,6428,6370,-58,-0.902,-25,-33,38,9,H1
"Bottineau County, ND",2008-2009,6370,6390,20,0.314,-18,38,38,9,H1
"Bottineau County, ND",2009-2010,6390,6426,36,0.563,-6,42,38,9,H1
"Bottineau County, ND",2010-2011,6426,6505,79,1.229,-19,98,38,9,H1
"Bottineau County, ND",2011-2012,6505,6583,78,1.199,-22,100,38,9,H1
"Bottineau County, ND",2012-2013,6583,6733,150,2.279,15,135,38,9,H1
"Bottineau County, ND",2013-2014,6733,6650,-83,-1.233,-10,-73,38,9,H1
"Bottineau County, ND",2014-2015,6649,6716,67,1.008,2,65,38,9,H1
"Bottineau County, ND",2015-2016,6716,6579,-137,-2.04,-13,-124,38,9,H1
"Bottineau County, ND",2016-2017,6579,6530,-49,-0.745,-23,-26,38,9,H1
"Bowman County, ND",2000-2001,3233,3118,-115,-3.557,-15,-100,38,11,H1
"Bowman County, ND",2001-2002,3118,3087,-31,-0.994,-26,-5,38,11,H1
"Bowman County, ND",2002-2003,3087,3089,2,0.065,-17,19,38,11,H1
"Bowman County, ND",2003-2004,3089,3132,43,1.392,-12,55,38,11,H1
"Bowman County, ND",2004-2005,3132,3046,-86,-2.746,-15,-71,38,11,H1
"Bowman County, ND",2005-2006,3046,3020,-26,-0.854,-9,-17,38,11,H1
"Bowman County, ND",2006-2007,3020,3050,30,0.993,-15,45,38,11,H1
"Bowman County, ND",2007-2008,3050,3158,108,3.541,7,101,38,11,H1
"Bowman County, ND",2008-2009,3158,3137,-21,-0.665,5,-26,38,11,H1
"Bowman County, ND",2009-2010,3137,3140,3,0.096,-4,7,38,11,H1
"Bowman County, ND",2010-2011,3140,3140,0,0,-8,8,38,11,H1
"Bowman County, ND",2011-2012,3140,3220,80,2.548,-1,81,38,11,H1
"Bowman County, ND",2012-2013,3220,3212,-8,-0.248,-4,-4,38,11,H1
"Bowman County, ND",2013-2014,3212,3247,35,1.09,10,25,38,11,H1
"Bowman County, ND",2014-2015,3244,3294,50,1.541,18,32,38,11,H1
"Bowman County, ND",2015-2016,3294,3230,-64,-1.943,16,-80,38,11,H1
"Bowman County, ND",2016-2017,3230,3166,-64,-1.981,15,-79,38,11,H1
"Burke County, ND",2000-2001,2236,2183,-53,-2.37,-8,-45,38,13,H1
"Burke County, ND",2001-2002,2183,2137,-46,-2.107,-6,-40,38,13,H1
"Burke County, ND",2002-2003,2137,2108,-29,-1.357,-3,-26,38,13,H1
"Burke County, ND",2003-2004,2108,2081,-27,-1.281,-5,-22,38,13,H1
"Burke County, ND",2004-2005,2081,2042,-39,-1.874,-6,-33,38,13,H1
"Burke County, ND",2005-2006,2042,1975,-67,-3.281,-5,-62,38,13,H1
"Burke County, ND",2006-2007,1975,1933,-42,-2.127,1,-43,38,13,H1
"Burke County, ND",2007-2008,1933,1902,-31,-1.604,-3,-28,38,13,H1
"Burke County, ND",2008-2009,1902,1962,60,3.155,-6,66,38,13,H1
"Burke County, ND",2009-2010,1962,1965,3,0.153,7,-4,38,13,H1
"Burke County, ND",2010-2011,1965,2056,91,4.631,0,91,38,13,H1
"Burke County, ND",2011-2012,2056,2170,114,5.545,6,108,38,13,H1
"Burke County, ND",2012-2013,2170,2291,121,5.576,17,104,38,13,H1
"Burke County, ND",2013-2014,2291,2245,-46,-2.008,17,-63,38,13,H1
"Burke County, ND",2014-2015,2235,2308,73,3.266,13,60,38,13,H1
"Burke County, ND",2015-2016,2308,2227,-81,-3.51,20,-101,38,13,H1
"Burke County, ND",2016-2017,2227,2131,-96,-4.311,14,-110,38,13,H1
"Burleigh County, ND",2000-2001,69534,70121,587,0.844,351,236,38,15,H1
"Burleigh County, ND",2001-2002,70121,71090,969,1.382,300,669,38,15,H1
"Burleigh County, ND",2002-2003,71090,71987,897,1.262,373,524,38,15,H1
"Burleigh County, ND",2003-2004,71987,72837,850,1.181,384,466,38,15,H1
"Burleigh County, ND",2004-2005,72837,74375,1538,2.112,490,1048,38,15,H1
"Burleigh County, ND",2005-2006,74375,75940,1565,2.104,492,1073,38,15,H1
"Burleigh County, ND",2006-2007,75940,77473,1533,2.019,461,1072,38,15,H1
"Burleigh County, ND",2007-2008,77473,78678,1205,1.555,465,740,38,15,H1
"Burleigh County, ND",2008-2009,78678,80122,1444,1.835,456,988,38,15,H1
"Burleigh County, ND",2009-2010,80122,81689,1567,1.956,431,1136,38,15,H1
"Burleigh County, ND",2010-2011,81689,83582,1893,2.317,441,1452,38,15,H1
"Burleigh County, ND",2011-2012,83582,86073,2491,2.98,552,1939,38,15,H1
"Burleigh County, ND",2012-2013,86073,88709,2636,3.063,567,2069,38,15,H1
"Burleigh County, ND",2013-2014,88709,90503,1794,2.022,587,1207,38,15,H1
"Burleigh County, ND",2014-2015,90521,92991,2470,2.729,597,1873,38,15,H1
"Burleigh County, ND",2015-2016,92991,94429,1438,1.546,585,853,38,15,H1
"Burleigh County, ND",2016-2017,94429,95030,601,0.636,605,-4,38,15,H1
"Cass County, ND",2000-2001,123662,125520,1858,1.502,961,897,38,17,H1
"Cass County, ND",2001-2002,125520,127119,1599,1.274,972,627,38,17,H1
"Cass County, ND",2002-2003,127119,129356,2237,1.76,863,1374,38,17,H1
"Cass County, ND",2003-2004,129356,133197,3841,2.969,1067,2774,38,17,H1
"Cass County, ND",2004-2005,133197,135181,1984,1.49,1083,901,38,17,H1
"Cass County, ND",2005-2006,135181,138340,3159,2.337,1256,1903,38,17,H1
"Cass County, ND",2006-2007,138340,141316,2976,2.151,1287,1689,38,17,H1
"Cass County, ND",2007-2008,141316,144290,2974,2.105,1218,1756,38,17,H1
"Cass County, ND",2008-2009,144290,147872,3582,2.483,1271,2311,38,17,H1
"Cass County, ND",2009-2010,147872,150278,2406,1.627,1256,1150,38,17,H1
"Cass County, ND",2010-2011,150278,152878,2600,1.73,1308,1292,38,17,H1
"Cass County, ND",2011-2012,152878,156839,3961,2.591,1525,2436,38,17,H1
"Cass County, ND",2012-2013,156839,163207,6368,4.06,1496,4872,38,17,H1
"Cass County, ND",2013-2014,163207,167005,3798,2.327,1524,2274,38,17,H1
"Cass County, ND",2014-2015,167276,171512,4236,2.532,1510,2726,38,17,H1
"Cass County, ND",2015-2016,171512,174625,3113,1.815,1567,1546,38,17,H1
"Cass County, ND",2016-2017,174625,177787,3162,1.811,1524,1638,38,17,H1
"Cavalier County, ND",2000-2001,4811,4696,-115,-2.39,-28,-87,38,19,H1
"Cavalier County, ND",2001-2002,4696,4620,-76,-1.618,-17,-59,38,19,H1
"Cavalier County, ND",2002-2003,4620,4543,-77,-1.667,-11,-66,38,19,H1
"Cavalier County, ND",2003-2004,4543,4456,-87,-1.915,-20,-67,38,19,H1
"Cavalier County, ND",2004-2005,4456,4384,-72,-1.616,-25,-47,38,19,H1
"Cavalier County, ND",2005-2006,4384,4202,-182,-4.151,-28,-154,38,19,H1
"Cavalier County, ND",2006-2007,4202,4056,-146,-3.475,-36,-110,38,19,H1
"Cavalier County, ND",2007-2008,4056,4008,-48,-1.183,-19,-29,38,19,H1
"Cavalier County, ND",2008-2009,4008,3975,-33,-0.823,-8,-25,38,19,H1
"Cavalier County, ND",2009-2010,3975,3982,7,0.176,2,5,38,19,H1
"Cavalier County, ND",2010-2011,3982,3953,-29,-0.728,-7,-22,38,19,H1
"Cavalier County, ND",2011-2012,3953,3943,-10,-0.253,-24,14,38,19,H1
"Cavalier County, ND",2012-2013,3943,3875,-68,-1.725,-5,-63,38,19,H1
"Cavalier County, ND",2013-2014,3875,3855,-20,-0.516,-6,-14,38,19,H1
"Cavalier County, ND",2014-2015,3858,3828,-30,-0.778,0,-30,38,19,H1
"Cavalier County, ND",2015-2016,3828,3810,-18,-0.47,18,-36,38,19,H1
"Cavalier County, ND",2016-2017,3810,3762,-48,-1.26,7,-55,38,19,H1
"Dickey County, ND",2000-2001,5761,5683,-78,-1.354,-4,-74,38,21,H1
"Dickey County, ND",2001-2002,5683,5611,-72,-1.267,12,-84,38,21,H1
"Dickey County, ND",2002-2003,5611,5510,-101,-1.8,-16,-85,38,21,H1
"Dickey County, ND",2003-2004,5510,5561,51,0.926,-16,67,38,21,H1
"Dickey County, ND",2004-2005,5561,5496,-65,-1.169,-3,-62,38,21,H1
"Dickey County, ND",2005-2006,5496,5419,-77,-1.401,-13,-64,38,21,H1
"Dickey County, ND",2006-2007,5419,5412,-7,-0.129,8,-15,38,21,H1
"Dickey County, ND",2007-2008,5412,5305,-107,-1.977,5,-112,38,21,H1
"Dickey County, ND",2008-2009,5305,5269,-36,-0.679,4,-40,38,21,H1
"Dickey County, ND",2009-2010,5269,5280,11,0.209,4,7,38,21,H1
"Dickey County, ND",2010-2011,5280,5264,-16,-0.303,-34,18,38,21,H1
"Dickey County, ND",2011-2012,5264,5245,-19,-0.361,-40,21,38,21,H1
"Dickey County, ND",2012-2013,5245,5231,-14,-0.267,13,-27,38,21,H1
"Dickey County, ND",2013-2014,5231,5150,-81,-1.548,-4,-77,38,21,H1
"Dickey County, ND",2014-2015,5123,5104,-19,-0.371,-5,-14,38,21,H1
"Dickey County, ND",2015-2016,5104,4995,-109,-2.136,10,-119,38,21,H1
"Dickey County, ND",2016-2017,4995,4861,-134,-2.683,8,-142,38,21,H1
"Divide County, ND",2000-2001,2263,2176,-87,-3.844,-42,-45,38,23,H1
"Divide County, ND",2001-2002,2176,2192,16,0.735,-19,35,38,23,H1
"Divide County, ND",2002-2003,2192,2191,-1,-0.046,-26,25,38,23,H1
"Divide County, ND",2003-2004,2191,2178,-13,-0.593,-16,3,38,23,H1
"Divide County, ND",2004-2005,2178,2116,-62,-2.847,-20,-42,38,23,H1
"Divide County, ND",2005-2006,2116,2083,-33,-1.56,-16,-17,38,23,H1
"Divide County, ND",2006-2007,2083,2041,-42,-2.016,-17,-25,38,23,H1
"Divide County, ND",2007-2008,2041,2022,-19,-0.931,-15,-4,38,23,H1
"Divide County, ND",2008-2009,2022,2020,-2,-0.099,-11,9,38,23,H1
"Divide County, ND",2009-2010,2020,2074,54,2.673,-2,56,38,23,H1
"Divide County, ND",2010-2011,2074,2139,65,3.134,5,60,38,23,H1
"Divide County, ND",2011-2012,2139,2233,94,4.395,-15,109,38,23,H1
"Divide County, ND",2012-2013,2233,2315,82,3.672,8,74,38,23,H1
"Divide County, ND",2013-2014,2315,2432,117,5.054,12,105,38,23,H1
"Divide County, ND",2014-2015,2429,2450,21,0.865,16,5,38,23,H1
"Divide County, ND",2015-2016,2450,2389,-61,-2.49,-2,-59,38,23,H1
"Divide County, ND",2016-2017,2389,2288,-101,-4.228,1,-102,38,23,H1
"Dunn County, ND",2000-2001,3605,3582,-23,-0.638,-7,-16,38,25,H1
"Dunn County, ND",2001-2002,3582,3548,-34,-0.949,-4,-30,38,25,H1
"Dunn County, ND",2002-2003,3548,3526,-22,-0.62,-11,-11,38,25,H1
"Dunn County, ND",2003-2004,3526,3443,-83,-2.354,-3,-80,38,25,H1
"Dunn County, ND",2004-2005,3443,3422,-21,-0.61,-8,-13,38,25,H1
"Dunn County, ND",2005-2006,3422,3432,10,0.292,-1,11,38,25,H1
"Dunn County, ND",2006-2007,3432,3429,-3,-0.087,3,-6,38,25,H1
"Dunn County, ND",2007-2008,3429,3470,41,1.196,4,37,38,25,H1
"Dunn County, ND",2008-2009,3470,3513,43,1.239,16,27,38,25,H1
"Dunn County, ND",2009-2010,3513,3541,28,0.797,16,12,38,25,H1
"Dunn County, ND",2010-2011,3541,3751,210,5.931,1,209,38,25,H1
"Dunn County, ND",2011-2012,3751,3974,223,5.945,9,214,38,25,H1
"Dunn County, ND",2012-2013,3974,4162,188,4.731,20,168,38,25,H1
"Dunn County, ND",2013-2014,4162,4399,237,5.694,47,190,38,25,H1
"Dunn County, ND",2014-2015,4428,4646,218,4.923,55,163,38,25,H1
"Dunn County, ND",2015-2016,4646,4373,-273,-5.876,32,-305,38,25,H1
"Dunn County, ND",2016-2017,4373,4289,-84,-1.921,44,-128,38,25,H1
"Eddy County, ND",2000-2001,2742,2683,-59,-2.152,-25,-34,38,27,H1
"Eddy County, ND",2001-2002,2683,2654,-29,-1.081,-27,-2,38,27,H1
"Eddy County, ND",2002-2003,2654,2656,2,0.075,-19,21,38,27,H1
"Eddy County, ND",2003-2004,2656,2641,-15,-0.565,-16,1,38,27,H1
"Eddy County, ND",2004-2005,2641,2610,-31,-1.174,-23,-8,38,27,H1
"Eddy County, ND",2005-2006,2610,2529,-81,-3.103,-30,-51,38,27,H1
"Eddy County, ND",2006-2007,2529,2503,-26,-1.028,-9,-17,38,27,H1
"Eddy County, ND",2007-2008,2503,2470,-33,-1.318,-24,-9,38,27,H1
"Eddy County, ND",2008-2009,2470,2393,-77,-3.117,-14,-63,38,27,H1
"Eddy County, ND",2009-2010,2393,2383,-10,-0.418,-10,0,38,27,H1
"Eddy County, ND",2010-2011,2383,2354,-29,-1.217,-36,7,38,27,H1
"Eddy County, ND",2011-2012,2354,2377,23,0.977,-25,48,38,27,H1
"Eddy County, ND",2012-2013,2377,2406,29,1.22,-7,36,38,27,H1
"Eddy County, ND",2013-2014,2406,2377,-29,-1.205,-13,-16,38,27,H1
"Eddy County, ND",2014-2015,2368,2365,-3,-0.127,-16,13,38,27,H1
"Eddy County, ND",2015-2016,2365,2288,-77,-3.256,-2,-75,38,27,H1
"Eddy County, ND",2016-2017,2288,2316,28,1.224,-10,38,38,27,H1
"Emmons County, ND",2000-2001,4302,4208,-94,-2.185,-36,-58,38,29,H1
"Emmons County, ND",2001-2002,4208,4107,-101,-2.4,-25,-76,38,29,H1
"Emmons County, ND",2002-2003,4107,4025,-82,-1.997,-7,-75,38,29,H1
"Emmons County, ND",2003-2004,4025,3955,-70,-1.739,-9,-61,38,29,H1
"Emmons County, ND",2004-2005,3955,3825,-130,-3.287,-30,-100,38,29,H1
"Emmons County, ND",2005-2006,3825,3748,-77,-2.013,-30,-47,38,29,H1
"Emmons County, ND",2006-2007,3748,3640,-108,-2.882,-43,-65,38,29,H1
"Emmons County, ND",2007-2008,3640,3588,-52,-1.429,-12,-40,38,29,H1
"Emmons County, ND",2008-2009,3588,3568,-20,-0.557,-22,2,38,29,H1
"Emmons County, ND",2009-2010,3568,3543,-25,-0.701,-20,-5,38,29,H1
"Emmons County, ND",2010-2011,3543,3525,-18,-0.508,-31,13,38,29,H1
"Emmons County, ND",2011-2012,3525,3483,-42,-1.191,-21,-21,38,29,H1
"Emmons County, ND",2012-2013,3483,3481,-2,-0.057,-9,7,38,29,H1
"Emmons County, ND",2013-2014,3481,3422,-59,-1.695,-18,-41,38,29,H1
"Emmons County, ND",2014-2015,3424,3402,-22,-0.643,-21,-1,38,29,H1
"Emmons County, ND",2015-2016,3402,3335,-67,-1.969,-29,-38,38,29,H1
"Emmons County, ND",2016-2017,3335,3301,-34,-1.019,-18,-16,38,29,H1
"Foster County, ND",2000-2001,3739,3639,-100,-2.675,-26,-74,38,31,H1
"Foster County, ND",2001-2002,3639,3577,-62,-1.704,-34,-28,38,31,H1
"Foster County, ND",2002-2003,3577,3515,-62,-1.733,-32,-30,38,31,H1
"Foster County, ND",2003-2004,3515,3514,-1,-0.028,-16,15,38,31,H1
"Foster County, ND",2004-2005,3514,3564,50,1.423,17,33,38,31,H1
"Foster County, ND",2005-2006,3564,3565,1,0.028,12,-11,38,31,H1
"Foster County, ND",2006-2007,3565,3500,-65,-1.823,-10,-55,38,31,H1
"Foster County, ND",2007-2008,3500,3436,-64,-1.829,-5,-59,38,31,H1
"Foster County, ND",2008-2009,3436,3319,-117,-3.405,-13,-104,38,31,H1
"Foster County, ND",2009-2010,3319,3343,24,0.723,-22,46,38,31,H1
"Foster County, ND",2010-2011,3343,3352,9,0.269,-11,20,38,31,H1
"Foster County, ND",2011-2012,3352,3392,40,1.193,-10,50,38,31,H1
"Foster County, ND",2012-2013,3392,3372,-20,-0.59,-4,-16,38,31,H1
"Foster County, ND",2013-2014,3372,3362,-10,-0.297,-4,-6,38,31,H1
"Foster County, ND",2014-2015,3362,3356,-6,-0.178,2,-8,38,31,H1
"Foster County, ND",2015-2016,3356,3310,-46,-1.371,-13,-33,38,31,H1
"Foster County, ND",2016-2017,3310,3257,-53,-1.601,-5,-48,38,31,H1
"Golden Valley County, ND",2000-2001,1915,1862,-53,-2.768,-7,-46,38,33,H1
"Golden Valley County, ND",2001-2002,1862,1825,-37,-1.987,-1,-36,38,33,H1
"Golden Valley County, ND",2002-2003,1825,1804,-21,-1.151,0,-21,38,33,H1
"Golden Valley County, ND",2003-2004,1804,1741,-63,-3.492,-1,-62,38,33,H1
"Golden Valley County, ND",2004-2005,1741,1709,-32,-1.838,-5,-27,38,33,H1
"Golden Valley County, ND",2005-2006,1709,1670,-39,-2.282,0,-39,38,33,H1
"Golden Valley County, ND",2006-2007,1670,1670,0,0,-8,8,38,33,H1
"Golden Valley County, ND",2007-2008,1670,1650,-20,-1.198,6,-26,38,33,H1
"Golden Valley County, ND",2008-2009,1650,1657,7,0.424,10,-3,38,33,H1
"Golden Valley County, ND",2009-2010,1657,1679,22,1.328,4,18,38,33,H1
"Golden Valley County, ND",2010-2011,1679,1746,67,3.99,8,59,38,33,H1
"Golden Valley County, ND",2011-2012,1746,1799,53,3.036,-2,55,38,33,H1
"Golden Valley County, ND",2012-2013,1799,1815,16,0.889,2,14,38,33,H1
"Golden Valley County, ND",2013-2014,1815,1825,10,0.551,14,-4,38,33,H1
"Golden Valley County, ND",2014-2015,1828,1845,17,0.93,10,7,38,33,H1
"Golden Valley County, ND",2015-2016,1845,1861,16,0.867,14,2,38,33,H1
"Golden Valley County, ND",2016-2017,1861,1789,-72,-3.869,17,-89,38,33,H1
"Grand Forks County, ND",2000-2001,66021,65567,-454,-0.688,408,-862,38,35,H1
"Grand Forks County, ND",2001-2002,65567,65409,-158,-0.241,355,-513,38,35,H1
"Grand Forks County, ND",2002-2003,65409,65287,-122,-0.187,478,-600,38,35,H1
"Grand Forks County, ND",2003-2004,65287,67071,1784,2.733,454,1330,38,35,H1
"Grand Forks County, ND",2004-2005,67071,66629,-442,-0.659,460,-902,38,35,H1
"Grand Forks County, ND",2005-2006,66629,67096,467,0.701,492,-25,38,35,H1
"Grand Forks County, ND",2006-2007,67096,66333,-763,-1.137,478,-1241,38,35,H1
"Grand Forks County, ND",2007-2008,66333,66917,584,0.88,562,22,38,35,H1
"Grand Forks County, ND",2008-2009,66917,66518,-399,-0.596,556,-955,38,35,H1
"Grand Forks County, ND",2009-2010,66518,66943,425,0.639,536,-111,38,35,H1
"Grand Forks County, ND",2010-2011,66943,66626,-317,-0.474,467,-784,38,35,H1
"Grand Forks County, ND",2011-2012,66626,67701,1075,1.613,536,539,38,35,H1
"Grand Forks County, ND",2012-2013,67701,69311,1610,2.378,472,1138,38,35,H1
"Grand Forks County, ND",2013-2014,69311,70138,827,1.193,529,298,38,35,H1
"Grand Forks County, ND",2014-2015,70262,70916,654,0.931,552,102,38,35,H1
"Grand Forks County, ND",2015-2016,70916,70596,-320,-0.451,554,-874,38,35,H1
"Grand Forks County, ND",2016-2017,70596,70795,199,0.282,548,-349,38,35,H1
"Grant County, ND",2000-2001,2835,2783,-52,-1.834,-20,-32,38,37,H1
"Grant County, ND",2001-2002,2783,2699,-84,-3.018,-33,-51,38,37,H1
"Grant County, ND",2002-2003,2699,2674,-25,-0.926,-27,2,38,37,H1
"Grant County, ND",2003-2004,2674,2626,-48,-1.795,-22,-26,38,37,H1
"Grant County, ND",2004-2005,2626,2599,-27,-1.028,-17,-10,38,37,H1
"Grant County, ND",2005-2006,2599,2519,-80,-3.078,-17,-63,38,37,H1
"Grant County, ND",2006-2007,2519,2478,-41,-1.628,-16,-25,38,37,H1
"Grant County, ND",2007-2008,2478,2440,-38,-1.533,-15,-23,38,37,H1
"Grant County, ND",2008-2009,2440,2399,-41,-1.68,-14,-27,38,37,H1
"Grant County, ND",2009-2010,2399,2389,-10,-0.417,-13,3,38,37,H1
"Grant County, ND",2010-2011,2389,2356,-33,-1.381,13,-46,38,37,H1
"Grant County, ND",2011-2012,2356,2337,-19,-0.806,-16,-3,38,37,H1
"Grant County, ND",2012-2013,2337,2371,34,1.455,3,31,38,37,H1
"Grant County, ND",2013-2014,2371,2361,-10,-0.422,-9,-1,38,37,H1
"Grant County, ND",2014-2015,2358,2388,30,1.272,2,28,38,37,H1
"Grant County, ND",2015-2016,2388,2396,8,0.335,13,-5,38,37,H1
"Grant County, ND",2016-2017,2396,2376,-20,-0.835,2,-22,38,37,H1
"Griggs County, ND",2000-2001,2732,2645,-87,-3.184,-26,-61,38,39,H1
"Griggs County, ND",2001-2002,2645,2598,-47,-1.777,-25,-22,38,39,H1
"Griggs County, ND",2002-2003,2598,2578,-20,-0.77,-39,19,38,39,H1
"Griggs County, ND",2003-2004,2578,2531,-47,-1.823,-25,-22,38,39,H1
"Griggs County, ND",2004-2005,2531,2519,-12,-0.474,-15,3,38,39,H1
"Griggs County, ND",2005-2006,2519,2457,-62,-2.461,-28,-34,38,39,H1
"Griggs County, ND",2006-2007,2457,2430,-27,-1.099,-17,-10,38,39,H1
"Griggs County, ND",2007-2008,2430,2406,-24,-0.988,-4,-20,38,39,H1
"Griggs County, ND",2008-2009,2406,2420,14,0.582,-13,27,38,39,H1
"Griggs County, ND",2009-2010,2420,2407,-13,-0.537,-19,6,38,39,H1
"Griggs County, ND",2010-2011,2407,2369,-38,-1.579,-19,-19,38,39,H1
"Griggs County, ND",2011-2012,2369,2351,-18,-0.76,-20,2,38,39,H1
"Griggs County, ND",2012-2013,2351,2292,-59,-2.51,-13,-46,38,39,H1
"Griggs County, ND",2013-2014,2292,2319,27,1.178,-16,43,38,39,H1
"Griggs County, ND",2014-2015,2312,2314,2,0.087,-16,18,38,39,H1
"Griggs County, ND",2015-2016,2314,2262,-52,-2.247,-15,-37,38,39,H1
"Griggs County, ND",2016-2017,2262,2258,-4,-0.177,-14,10,38,39,H1
"Hettinger County, ND",2000-2001,2697,2658,-39,-1.446,-22,-17,38,41,H1
"Hettinger County, ND",2001-2002,2658,2641,-17,-0.64,-21,4,38,41,H1
"Hettinger County, ND",2002-2003,2641,2591,-50,-1.893,-25,-25,38,41,H1
"Hettinger County, ND",2003-2004,2591,2612,21,0.81,-21,42,38,41,H1
"Hettinger County, ND",2004-2005,2612,2587,-25,-0.957,-5,-20,38,41,H1
"Hettinger County, ND",2005-2006,2587,2577,-10,-0.387,-15,5,38,41,H1
"Hettinger County, ND",2006-2007,2577,2524,-53,-2.057,-17,-36,38,41,H1
"Hettinger County, ND",2007-2008,2524,2479,-45,-1.783,-8,-37,38,41,H1
"Hettinger County, ND",2008-2009,2479,2481,2,0.081,-16,18,38,41,H1
"Hettinger County, ND",2009-2010,2481,2472,-9,-0.363,-12,3,38,41,H1
"Hettinger County, ND",2010-2011,2472,2522,50,2.023,-18,68,38,41,H1
"Hettinger County, ND",2011-2012,2522,2553,31,1.229,-11,42,38,41,H1
"Hettinger County, ND",2012-2013,2553,2668,115,4.505,9,106,38,41,H1
"Hettinger County, ND",2013-2014,2668,2660,-8,-0.3,7,-15,38,41,H1
"Hettinger County, ND",2014-2015,2656,2704,48,1.807,15,33,38,41,H1
"Hettinger County, ND",2015-2016,2704,2599,-105,-3.883,8,-113,38,41,H1
"Hettinger County, ND",2016-2017,2599,2483,-116,-4.463,14,-130,38,41,H1
"Kidder County, ND",2000-2001,2724,2652,-72,-2.643,-5,-67,38,43,H1
"Kidder County, ND",2001-2002,2652,2591,-61,-2.3,-12,-49,38,43,H1
"Kidder County, ND",2002-2003,2591,2606,15,0.579,-4,19,38,43,H1
"Kidder County, ND",2003-2004,2606,2592,-14,-0.537,-12,-2,38,43,H1
"Kidder County, ND",2004-2005,2592,2496,-96,-3.704,-18,-78,38,43,H1
"Kidder County, ND",2005-2006,2496,2509,13,0.521,-12,25,38,43,H1
"Kidder County, ND",2006-2007,2509,2450,-59,-2.352,-17,-42,38,43,H1
"Kidder County, ND",2007-2008,2450,2419,-31,-1.265,7,-38,38,43,H1
"Kidder County, ND",2008-2009,2419,2396,-23,-0.951,-2,-21,38,43,H1
"Kidder County, ND",2009-2010,2396,2439,43,1.795,10,33,38,43,H1
"Kidder County, ND",2010-2011,2439,2446,7,0.287,15,-8,38,43,H1
"Kidder County, ND",2011-2012,2446,2434,-12,-0.491,3,-15,38,43,H1
"Kidder County, ND",2012-2013,2434,2429,-5,-0.205,14,-19,38,43,H1
"Kidder County, ND",2013-2014,2429,2424,-5,-0.206,20,-25,38,43,H1
"Kidder County, ND",2014-2015,2424,2417,-7,-0.289,20,-27,38,43,H1
"Kidder County, ND",2015-2016,2417,2463,46,1.903,9,37,38,43,H1
"Kidder County, ND",2016-2017,2463,2482,19,0.771,19,0,38,43,H1
"LaMoure County, ND",2000-2001,4671,4642,-29,-0.621,-2,-27,38,45,H1
"LaMoure County, ND",2001-2002,4642,4598,-44,-0.948,-12,-32,38,45,H1
"LaMoure County, ND",2002-2003,4598,4575,-23,-0.5,-5,-18,38,45,H1
"LaMoure County, ND",2003-2004,4575,4552,-23,-0.503,-18,-5,38,45,H1
"LaMoure County, ND",2004-2005,4552,4447,-105,-2.307,-22,-83,38,45,H1
"LaMoure County, ND",2005-2006,4447,4357,-90,-2.024,-14,-76,38,45,H1
"LaMoure County, ND",2006-2007,4357,4320,-37,-0.849,-10,-27,38,45,H1
"LaMoure County, ND",2007-2008,4320,4218,-102,-2.361,-3,-99,38,45,H1
"LaMoure County, ND",2008-2009,4218,4142,-76,-1.802,-10,-66,38,45,H1
"LaMoure County, ND",2009-2010,4142,4129,-13,-0.314,-10,-3,38,45,H1
"LaMoure County, ND",2010-2011,4129,4121,-8,-0.194,-19,11,38,45,H1
"LaMoure County, ND",2011-2012,4121,4103,-18,-0.437,-11,-7,38,45,H1
"LaMoure County, ND",2012-2013,4103,4133,30,0.731,19,11,38,45,H1
"LaMoure County, ND",2013-2014,4133,4149,16,0.387,4,12,38,45,H1
"LaMoure County, ND",2014-2015,4111,4125,14,0.341,9,5,38,45,H1
"LaMoure County, ND",2015-2016,4125,4114,-11,-0.267,2,-13,38,45,H1
"LaMoure County, ND",2016-2017,4114,4087,-27,-0.656,1,-28,38,45,H1
"Logan County, ND",2000-2001,2300,2229,-71,-3.087,-18,-53,38,47,H1
"Logan County, ND",2001-2002,2229,2209,-20,-0.897,-10,-10,38,47,H1
"Logan County, ND",2002-2003,2209,2155,-54,-2.445,-14,-40,38,47,H1
"Logan County, ND",2003-2004,2155,2126,-29,-1.346,-15,-14,38,47,H1
"Logan County, ND",2004-2005,2126,2074,-52,-2.446,-17,-35,38,47,H1
"Logan County, ND",2005-2006,2074,2018,-56,-2.7,-12,-44,38,47,H1
"Logan County, ND",2006-2007,2018,2023,5,0.248,-20,25,38,47,H1
"Logan County, ND",2007-2008,2023,2.00E+03,-23,-1.137,-13,-10,38,47,H1
"Logan County, ND",2008-2009,2.00E+03,1970,-30,-1.5,6,-36,38,47,H1
"Logan County, ND",2009-2010,1970,1999,29,1.472,-2,31,38,47,H1
"Logan County, ND",2010-2011,1999,1967,-32,-1.601,-8,-24,38,47,H1
"Logan County, ND",2011-2012,1967,1932,-35,-1.779,-7,-28,38,47,H1
"Logan County, ND",2012-2013,1932,1932,0,0,-4,4,38,47,H1
"Logan County, ND",2013-2014,1932,1944,12,0.621,4,8,38,47,H1
"Logan County, ND",2014-2015,1950,1935,-15,-0.769,0,-15,38,47,H1
"Logan County, ND",2015-2016,1935,1932,-3,-0.155,-4,1,38,47,H1
"Logan County, ND",2016-2017,1932,1918,-14,-0.725,-7,-7,38,47,H1
"McHenry County, ND",2000-2001,5963,5854,-109,-1.828,7,-116,38,49,H1
"McHenry County, ND",2001-2002,5854,5778,-76,-1.298,-20,-56,38,49,H1
"McHenry County, ND",2002-2003,5778,5749,-29,-0.502,-9,-20,38,49,H1
"McHenry County, ND",2003-2004,5749,5669,-80,-1.392,-16,-64,38,49,H1
"McHenry County, ND",2004-2005,5669,5568,-101,-1.782,-16,-85,38,49,H1
"McHenry County, ND",2005-2006,5568,5507,-61,-1.096,-33,-28,38,49,H1
"McHenry County, ND",2006-2007,5507,5370,-137,-2.488,-10,-127,38,49,H1
"McHenry County, ND",2007-2008,5370,5355,-15,-0.279,9,-24,38,49,H1
"McHenry County, ND",2008-2009,5355,5373,18,0.336,4,14,38,49,H1
"McHenry County, ND",2009-2010,5373,5395,22,0.409,6,16,38,49,H1
"McHenry County, ND",2010-2011,5395,5483,88,1.631,-6,94,38,49,H1
"McHenry County, ND",2011-2012,5483,5784,301,5.49,12,289,38,49,H1
"McHenry County, ND",2012-2013,5784,5904,120,2.075,14,106,38,49,H1
"McHenry County, ND",2013-2014,5904,5988,84,1.423,18,66,38,49,H1
"McHenry County, ND",2014-2015,5955,5968,13,0.218,16,-3,38,49,H1
"McHenry County, ND",2015-2016,5968,5988,20,0.335,30,-10,38,49,H1
"McHenry County, ND",2016-2017,5988,5900,-88,-1.47,10,-98,38,49,H1
"McIntosh County, ND",2000-2001,3383,3349,-34,-1.005,-34,0,38,51,H1
"McIntosh County, ND",2001-2002,3349,3292,-57,-1.702,-34,-23,38,51,H1
"McIntosh County, ND",2002-2003,3292,3285,-7,-0.213,-32,25,38,51,H1
"McIntosh County, ND",2003-2004,3285,3192,-93,-2.831,-58,-35,38,51,H1
"McIntosh County, ND",2004-2005,3192,3137,-55,-1.723,-30,-25,38,51,H1
"McIntosh County, ND",2005-2006,3137,3080,-57,-1.817,-43,-14,38,51,H1
"McIntosh County, ND",2006-2007,3080,2966,-114,-3.701,-51,-63,38,51,H1
"McIntosh County, ND",2007-2008,2966,2911,-55,-1.854,-27,-28,38,51,H1
"McIntosh County, ND",2008-2009,2911,2840,-71,-2.439,-36,-35,38,51,H1
"McIntosh County, ND",2009-2010,2840,2816,-24,-0.845,-30,6,38,51,H1
"McIntosh County, ND",2010-2011,2816,2784,-32,-1.136,-30,-2,38,51,H1
"McIntosh County, ND",2011-2012,2784,2774,-10,-0.359,-34,24,38,51,H1
"McIntosh County, ND",2012-2013,2774,2764,-10,-0.36,-32,22,38,51,H1
"McIntosh County, ND",2013-2014,2764,2801,37,1.339,-22,59,38,51,H1
"McIntosh County, ND",2014-2015,2763,2759,-4,-0.145,-19,15,38,51,H1
"McIntosh County, ND",2015-2016,2759,2604,-155,-5.618,-18,-137,38,51,H1
"McIntosh County, ND",2016-2017,2604,2606,2,0.077,-24,26,38,51,H1
"McKenzie County, ND",2000-2001,5722,5647,-75,-1.311,9,-84,38,53,H1
"McKenzie County, ND",2001-2002,5647,5692,45,0.797,12,33,38,53,H1
"McKenzie County, ND",2002-2003,5692,5613,-79,-1.388,-14,-65,38,53,H1
"McKenzie County, ND",2003-2004,5613,5611,-2,-0.036,-10,8,38,53,H1
"McKenzie County, ND",2004-2005,5611,5721,110,1.96,13,97,38,53,H1
"McKenzie County, ND",2005-2006,5721,5727,6,0.105,29,-23,38,53,H1
"McKenzie County, ND",2006-2007,5727,5812,85,1.484,-1,86,38,53,H1
"McKenzie County, ND",2007-2008,5812,5908,96,1.652,26,70,38,53,H1
"McKenzie County, ND",2008-2009,5908,6159,251,4.248,38,213,38,53,H1
"McKenzie County, ND",2009-2010,6159,6395,236,3.832,41,195,38,53,H1
"McKenzie County, ND",2010-2011,6395,7012,617,9.648,32,585,38,53,H1
"McKenzie County, ND",2011-2012,7012,7965,953,13.591,34,919,38,53,H1
"McKenzie County, ND",2012-2013,7965,9297,1332,16.723,117,1215,38,53,H1
"McKenzie County, ND",2013-2014,9297,10996,1699,18.275,129,1570,38,53,H1
"McKenzie County, ND",2014-2015,10995,12826,1831,16.653,199,1632,38,53,H1
"McKenzie County, ND",2015-2016,12826,12616,-210,-1.637,189,-399,38,53,H1
"McKenzie County, ND",2016-2017,12616,12724,108,0.856,157,-49,38,53,H1
"McLean County, ND",2000-2001,9396,9261,-135,-1.437,-30,-105,38,55,H1
"McLean County, ND",2001-2002,9261,9150,-111,-1.199,-66,-45,38,55,H1
"McLean County, ND",2002-2003,9150,9098,-52,-0.568,-49,-3,38,55,H1
"McLean County, ND",2003-2004,9098,8948,-150,-1.649,-53,-97,38,55,H1
"McLean County, ND",2004-2005,8948,8815,-133,-1.486,-55,-78,38,55,H1
"McLean County, ND",2005-2006,8815,8767,-48,-0.545,-39,-9,38,55,H1
"McLean County, ND",2006-2007,8767,8811,44,0.502,-47,91,38,55,H1
"McLean County, ND",2007-2008,8811,8883,72,0.817,-36,108,38,55,H1
"McLean County, ND",2008-2009,8883,8860,-23,-0.259,-14,-9,38,55,H1
"McLean County, ND",2009-2010,8860,8991,131,1.479,-13,144,38,55,H1
"McLean County, ND",2010-2011,8991,9081,90,1.001,-6,96,38,55,H1
"McLean County, ND",2011-2012,9081,9371,290,3.193,11,279,38,55,H1
"McLean County, ND",2012-2013,9371,9476,105,1.12,-4,109,38,55,H1
"McLean County, ND",2013-2014,9476,9578,102,1.076,21,81,38,55,H1
"McLean County, ND",2014-2015,9587,9744,157,1.638,18,139,38,55,H1
"McLean County, ND",2015-2016,9744,9665,-79,-0.811,32,-111,38,55,H1
"McLean County, ND",2016-2017,9665,9685,20,0.207,24,-4,38,55,H1
"Mercer County, ND",2000-2001,8597,8542,-55,-0.64,12,-67,38,57,H1
"Mercer County, ND",2001-2002,8542,8536,-6,-0.07,-31,25,38,57,H1
"Mercer County, ND",2002-2003,8536,8501,-35,-0.41,6,-41,38,57,H1
"Mercer County, ND",2003-2004,8501,8437,-64,-0.753,-14,-50,38,57,H1
"Mercer County, ND",2004-2005,8437,8366,-71,-0.842,-6,-65,38,57,H1
"Mercer County, ND",2005-2006,8366,8309,-57,-0.681,14,-71,38,57,H1
"Mercer County, ND",2006-2007,8309,8351,42,0.505,1,41,38,57,H1
"Mercer County, ND",2007-2008,8351,8295,-56,-0.671,9,-65,38,57,H1
"Mercer County, ND",2008-2009,8295,8390,95,1.145,14,81,38,57,H1
"Mercer County, ND",2009-2010,8390,8411,21,0.25,20,1,38,57,H1
"Mercer County, ND",2010-2011,8411,8419,8,0.095,26,-18,38,57,H1
"Mercer County, ND",2011-2012,8419,8486,67,0.796,26,41,38,57,H1
"Mercer County, ND",2012-2013,8486,8596,110,1.296,19,91,38,57,H1
"Mercer County, ND",2013-2014,8596,8746,150,1.745,29,121,38,57,H1
"Mercer County, ND",2014-2015,8763,8853,90,1.027,18,72,38,57,H1
"Mercer County, ND",2015-2016,8853,8637,-216,-2.44,30,-246,38,57,H1
"Mercer County, ND",2016-2017,8637,8465,-172,-1.991,16,-188,38,57,H1
"Morton County, ND",2000-2001,25332,25143,-189,-0.746,19,-208,38,59,H1
"Morton County, ND",2001-2002,25143,25195,52,0.207,86,-34,38,59,H1
"Morton County, ND",2002-2003,25195,25197,2,0.008,65,-63,38,59,H1
"Morton County, ND",2003-2004,25197,25372,175,0.695,108,67,38,59,H1
"Morton County, ND",2004-2005,25372,25576,204,0.804,90,114,38,59,H1
"Morton County, ND",2005-2006,25576,25910,334,1.306,104,230,38,59,H1
"Morton County, ND",2006-2007,25910,26310,400,1.544,145,255,38,59,H1
"Morton County, ND",2007-2008,26310,26696,386,1.467,116,270,38,59,H1
"Morton County, ND",2008-2009,26696,27043,347,1.3,145,202,38,59,H1
"Morton County, ND",2009-2010,27043,27565,522,1.93,159,363,38,59,H1
"Morton County, ND",2010-2011,27565,27720,155,0.562,126,29,38,59,H1
"Morton County, ND",2011-2012,27720,28045,325,1.172,128,197,38,59,H1
"Morton County, ND",2012-2013,28045,28989,944,3.366,197,747,38,59,H1
"Morton County, ND",2013-2014,28989,29822,833,2.874,216,617,38,59,H1
"Morton County, ND",2014-2015,29833,30310,477,1.599,223,254,38,59,H1
"Morton County, ND",2015-2016,30310,30615,305,1.006,253,52,38,59,H1
"Morton County, ND",2016-2017,30615,30796,181,0.591,238,-57,38,59,H1
"Mountrail County, ND",2000-2001,6625,6625,0,0,-3,3,38,61,H1
"Mountrail County, ND",2001-2002,6625,6628,3,0.045,-15,18,38,61,H1
"Mountrail County, ND",2002-2003,6628,6681,53,0.8,-3,56,38,61,H1
"Mountrail County, ND",2003-2004,6681,6798,117,1.751,8,109,38,61,H1
"Mountrail County, ND",2004-2005,6798,6840,42,0.618,1,41,38,61,H1
"Mountrail County, ND",2005-2006,6840,6826,-14,-0.205,18,-32,38,61,H1
"Mountrail County, ND",2006-2007,6826,6991,165,2.417,41,124,38,61,H1
"Mountrail County, ND",2007-2008,6991,7153,162,2.317,56,106,38,61,H1
"Mountrail County, ND",2008-2009,7153,7439,286,3.998,50,236,38,61,H1
"Mountrail County, ND",2009-2010,7439,7725,286,3.845,29,257,38,61,H1
"Mountrail County, ND",2010-2011,7725,8110,385,4.984,59,326,38,61,H1
"Mountrail County, ND",2011-2012,8110,8750,640,7.891,72,568,38,61,H1
"Mountrail County, ND",2012-2013,8750,9346,596,6.811,91,505,38,61,H1
"Mountrail County, ND",2013-2014,9346,9782,436,4.665,100,336,38,61,H1
"Mountrail County, ND",2014-2015,9749,10331,582,5.97,95,487,38,61,H1
"Mountrail County, ND",2015-2016,10331,10245,-86,-0.832,111,-197,38,61,H1
"Mountrail County, ND",2016-2017,10245,10265,20,0.195,97,-77,38,61,H1
"Nelson County, ND",2000-2001,3685,3578,-107,-2.904,-45,-62,38,63,H1
"Nelson County, ND",2001-2002,3578,3442,-136,-3.801,-35,-101,38,63,H1
"Nelson County, ND",2002-2003,3442,3399,-43,-1.249,-46,3,38,63,H1
"Nelson County, ND",2003-2004,3399,3406,7,0.206,-36,43,38,63,H1
"Nelson County, ND",2004-2005,3406,3384,-22,-0.646,-46,24,38,63,H1
"Nelson County, ND",2005-2006,3384,3271,-113,-3.339,-28,-85,38,63,H1
"Nelson County, ND",2006-2007,3271,3222,-49,-1.498,-36,-13,38,63,H1
"Nelson County, ND",2007-2008,3222,3176,-46,-1.428,-33,-13,38,63,H1
"Nelson County, ND",2008-2009,3176,3130,-46,-1.448,-40,-6,38,63,H1
"Nelson County, ND",2009-2010,3130,3118,-12,-0.383,-45,33,38,63,H1
"Nelson County, ND",2010-2011,3118,3065,-53,-1.7,-38,-15,38,63,H1
"Nelson County, ND",2011-2012,3065,3081,16,0.522,-34,50,38,63,H1
"Nelson County, ND",2012-2013,3081,3079,-2,-0.065,-10,8,38,63,H1
"Nelson County, ND",2013-2014,3079,3045,-34,-1.104,-21,-13,38,63,H1
"Nelson County, ND",2014-2015,3042,2968,-74,-2.433,-26,-48,38,63,H1
"Nelson County, ND",2015-2016,2968,2901,-67,-2.257,-16,-51,38,63,H1
"Nelson County, ND",2016-2017,2901,2937,36,1.241,-25,61,38,63,H1
"Oliver County, ND",2000-2001,2051,1989,-62,-3.023,0,-62,38,65,H1
"Oliver County, ND",2001-2002,1989,1969,-20,-1.006,6,-26,38,65,H1
"Oliver County, ND",2002-2003,1969,1944,-25,-1.27,1,-26,38,65,H1
"Oliver County, ND",2003-2004,1944,1925,-19,-0.977,3,-22,38,65,H1
"Oliver County, ND",2004-2005,1925,1907,-18,-0.935,14,-32,38,65,H1
"Oliver County, ND",2005-2006,1907,1863,-44,-2.307,-8,-36,38,65,H1
"Oliver County, ND",2006-2007,1863,1865,2,0.107,6,-4,38,65,H1
"Oliver County, ND",2007-2008,1865,1836,-29,-1.555,14,-43,38,65,H1
"Oliver County, ND",2008-2009,1836,1844,8,0.436,10,-2,38,65,H1
"Oliver County, ND",2009-2010,1844,1833,-11,-0.597,12,-23,38,65,H1
"Oliver County, ND",2010-2011,1833,1845,12,0.655,8,4,38,65,H1
"Oliver County, ND",2011-2012,1845,1832,-13,-0.705,7,-20,38,65,H1
"Oliver County, ND",2012-2013,1832,1869,37,2.02,11,26,38,65,H1
"Oliver County, ND",2013-2014,1869,1850,-19,-1.017,20,-39,38,65,H1
"Oliver County, ND",2014-2015,1848,1846,-2,-0.108,15,-17,38,65,H1
"Oliver County, ND",2015-2016,1846,1898,52,2.817,14,38,38,65,H1
"Oliver County, ND",2016-2017,1898,1940,42,2.213,19,23,38,65,H1
"Pembina County, ND",2000-2001,8590,8376,-214,-2.491,-10,-204,38,67,H1
"Pembina County, ND",2001-2002,8376,8217,-159,-1.898,-22,-137,38,67,H1
"Pembina County, ND",2002-2003,8217,8188,-29,-0.353,2,-31,38,67,H1
"Pembina County, ND",2003-2004,8188,8088,-100,-1.221,-18,-82,38,67,H1
"Pembina County, ND",2004-2005,8088,7911,-177,-2.188,-13,-164,38,67,H1
"Pembina County, ND",2005-2006,7911,7786,-125,-1.58,-11,-114,38,67,H1
"Pembina County, ND",2006-2007,7786,7585,-201,-2.582,-19,-182,38,67,H1
"Pembina County, ND",2007-2008,7585,7452,-133,-1.753,1,-134,38,67,H1
"Pembina County, ND",2008-2009,7452,7407,-45,-0.604,-9,-36,38,67,H1
"Pembina County, ND",2009-2010,7407,7396,-11,-0.149,19,-30,38,67,H1
"Pembina County, ND",2010-2011,7396,7383,-13,-0.176,7,-20,38,67,H1
"Pembina County, ND",2011-2012,7383,7261,-122,-1.652,-9,-113,38,67,H1
"Pembina County, ND",2012-2013,7261,7164,-97,-1.336,-12,-85,38,67,H1
"Pembina County, ND",2013-2014,7164,7128,-36,-0.503,-19,-17,38,67,H1
"Pembina County, ND",2014-2015,7129,7091,-38,-0.533,-5,-33,38,67,H1
"Pembina County, ND",2015-2016,7091,7063,-28,-0.395,23,-51,38,67,H1
"Pembina County, ND",2016-2017,7063,6972,-91,-1.288,8,-99,38,67,H1
"Pierce County, ND",2000-2001,4657,4610,-47,-1.009,-38,-9,38,69,H1
"Pierce County, ND",2001-2002,4610,4577,-33,-0.716,-18,-15,38,69,H1
"Pierce County, ND",2002-2003,4577,4511,-66,-1.442,-44,-22,38,69,H1
"Pierce County, ND",2003-2004,4511,4450,-61,-1.352,-9,-52,38,69,H1
"Pierce County, ND",2004-2005,4450,4398,-52,-1.169,-25,-27,38,69,H1
"Pierce County, ND",2005-2006,4398,4394,-4,-0.091,-35,31,38,69,H1
"Pierce County, ND",2006-2007,4394,4368,-26,-0.592,-13,-13,38,69,H1
"Pierce County, ND",2007-2008,4368,4372,4,0.092,-11,15,38,69,H1
"Pierce County, ND",2008-2009,4372,4329,-43,-0.984,-15,-28,38,69,H1
"Pierce County, ND",2009-2010,4329,4361,32,0.739,-21,53,38,69,H1
"Pierce County, ND",2010-2011,4361,4387,26,0.596,-25,51,38,69,H1
"Pierce County, ND",2011-2012,4387,4466,79,1.801,-23,102,38,69,H1
"Pierce County, ND",2012-2013,4466,4392,-74,-1.657,-11,-63,38,69,H1
"Pierce County, ND",2013-2014,4392,4404,12,0.273,-4,16,38,69,H1
"Pierce County, ND",2014-2015,4386,4312,-74,-1.687,-6,-68,38,69,H1
"Pierce County, ND",2015-2016,4312,4213,-99,-2.296,-16,-83,38,69,H1
"Pierce County, ND",2016-2017,4213,4099,-114,-2.706,-9,-105,38,69,H1
"Ramsey County, ND",2000-2001,12001,11822,-179,-1.492,0,-179,38,71,H1
"Ramsey County, ND",2001-2002,11822,11789,-33,-0.279,-14,-19,38,71,H1
"Ramsey County, ND",2002-2003,11789,11555,-234,-1.985,-57,-177,38,71,H1
"Ramsey County, ND",2003-2004,11555,11451,-104,-0.9,-20,-84,38,71,H1
"Ramsey County, ND",2004-2005,11451,11344,-107,-0.934,-10,-97,38,71,H1
"Ramsey County, ND",2005-2006,11344,11298,-46,-0.406,39,-85,38,71,H1
"Ramsey County, ND",2006-2007,11298,11320,22,0.195,8,14,38,71,H1
"Ramsey County, ND",2007-2008,11320,11434,114,1.007,-8,122,38,71,H1
"Ramsey County, ND",2008-2009,11434,11328,-106,-0.927,19,-125,38,71,H1
"Ramsey County, ND",2009-2010,11328,11445,117,1.033,16,101,38,71,H1
"Ramsey County, ND",2010-2011,11445,11504,59,0.516,52,7,38,71,H1
"Ramsey County, ND",2011-2012,11504,11555,51,0.443,4,47,38,71,H1
"Ramsey County, ND",2012-2013,11555,11543,-12,-0.104,42,-54,38,71,H1
"Ramsey County, ND",2013-2014,11543,11564,21,0.182,23,-2,38,71,H1
"Ramsey County, ND",2014-2015,11583,11630,47,0.406,36,11,38,71,H1
"Ramsey County, ND",2015-2016,11630,11514,-116,-0.997,34,-150,38,71,H1
"Ramsey County, ND",2016-2017,11514,11519,5,0.043,26,-21,38,71,H1
"Ransom County, ND",2000-2001,5891,5855,-36,-0.611,-46,10,38,73,H1
"Ransom County, ND",2001-2002,5855,5822,-33,-0.564,-37,4,38,73,H1
"Ransom County, ND",2002-2003,5822,5841,19,0.326,-6,25,38,73,H1
"Ransom County, ND",2003-2004,5841,5792,-49,-0.839,-23,-26,38,73,H1
"Ransom County, ND",2004-2005,5792,5770,-22,-0.38,-28,6,38,73,H1
"Ransom County, ND",2005-2006,5770,5720,-50,-0.867,3,-53,38,73,H1
"Ransom County, ND",2006-2007,5720,5766,46,0.804,-14,60,38,73,H1
"Ransom County, ND",2007-2008,5766,5677,-89,-1.544,-22,-67,38,73,H1
"Ransom County, ND",2008-2009,5677,5521,-156,-2.748,-13,-143,38,73,H1
"Ransom County, ND",2009-2010,5521,5431,-90,-1.63,-23,-67,38,73,H1
"Ransom County, ND",2010-2011,5431,5420,-11,-0.203,-20,9,38,73,H1
"Ransom County, ND",2011-2012,5420,5474,54,0.996,-9,63,38,73,H1
"Ransom County, ND",2012-2013,5474,5490,16,0.292,-2,18,38,73,H1
"Ransom County, ND",2013-2014,5490,5446,-44,-0.801,-17,-27,38,73,H1
"Ransom County, ND",2014-2015,5437,5448,11,0.202,-24,35,38,73,H1
"Ransom County, ND",2015-2016,5448,5373,-75,-1.377,-27,-48,38,73,H1
"Ransom County, ND",2016-2017,5373,5297,-76,-1.414,-23,-53,38,73,H1
"Renville County, ND",2000-2001,2599,2551,-48,-1.847,-18,-30,38,75,H1
"Renville County, ND",2001-2002,2551,2566,15,0.588,-7,22,38,75,H1
"Renville County, ND",2002-2003,2566,2530,-36,-1.403,-8,-28,38,75,H1
"Renville County, ND",2003-2004,2530,2517,-13,-0.514,-12,-1,38,75,H1
"Renville County, ND",2004-2005,2517,2519,2,0.079,1,1,38,75,H1
"Renville County, ND",2005-2006,2519,2499,-20,-0.794,0,-20,38,75,H1
"Renville County, ND",2006-2007,2499,2415,-84,-3.361,-17,-67,38,75,H1
"Renville County, ND",2007-2008,2415,2387,-28,-1.159,-3,-25,38,75,H1
"Renville County, ND",2008-2009,2387,2432,45,1.885,1,44,38,75,H1
"Renville County, ND",2009-2010,2432,2476,44,1.809,7,37,38,75,H1
"Renville County, ND",2010-2011,2476,2495,19,0.767,3,16,38,75,H1
"Renville County, ND",2011-2012,2495,2554,59,2.365,0,59,38,75,H1
"Renville County, ND",2012-2013,2554,2616,62,2.428,6,56,38,75,H1
"Renville County, ND",2013-2014,2616,2587,-29,-1.109,7,-36,38,75,H1
"Renville County, ND",2014-2015,2578,2571,-7,-0.272,11,-18,38,75,H1
"Renville County, ND",2015-2016,2571,2523,-48,-1.867,10,-58,38,75,H1
"Renville County, ND",2016-2017,2523,2463,-60,-2.378,6,-66,38,75,H1
"Richland County, ND",2000-2001,17946,17624,-322,-1.794,47,-369,38,77,H1
"Richland County, ND",2001-2002,17624,17422,-202,-1.146,52,-254,38,77,H1
"Richland County, ND",2002-2003,17422,17615,193,1.108,51,142,38,77,H1
"Richland County, ND",2003-2004,17615,17451,-164,-0.931,55,-219,38,77,H1
"Richland County, ND",2004-2005,17451,17306,-145,-0.831,68,-213,38,77,H1
"Richland County, ND",2005-2006,17306,16869,-437,-2.525,73,-510,38,77,H1
"Richland County, ND",2006-2007,16869,16659,-210,-1.245,64,-274,38,77,H1
"Richland County, ND",2007-2008,16659,16488,-171,-1.026,63,-234,38,77,H1
"Richland County, ND",2008-2009,16488,16178,-310,-1.88,64,-374,38,77,H1
"Richland County, ND",2009-2010,16178,16317,139,0.859,60,79,38,77,H1
"Richland County, ND",2010-2011,16317,16255,-62,-0.38,-1,-61,38,77,H1
"Richland County, ND",2011-2012,16255,16210,-45,-0.277,40,-85,38,77,H1
"Richland County, ND",2012-2013,16210,16321,111,0.685,77,34,38,77,H1
"Richland County, ND",2013-2014,16321,16432,111,0.68,64,47,38,77,H1
"Richland County, ND",2014-2015,16396,16402,6,0.037,51,-45,38,77,H1
"Richland County, ND",2015-2016,16402,16338,-64,-0.39,63,-127,38,77,H1
"Richland County, ND",2016-2017,16338,16351,13,0.08,77,-64,38,77,H1
"Rolette County, ND",2000-2001,13658,13718,60,0.439,178,-118,38,79,H1
"Rolette County, ND",2001-2002,13718,13680,-38,-0.277,158,-196,38,79,H1
"Rolette County, ND",2002-2003,13680,13595,-85,-0.621,153,-238,38,79,H1
"Rolette County, ND",2003-2004,13595,13646,51,0.375,192,-141,38,79,H1
"Rolette County, ND",2004-2005,13646,13663,17,0.125,166,-149,38,79,H1
"Rolette County, ND",2005-2006,13663,13625,-38,-0.278,169,-207,38,79,H1
"Rolette County, ND",2006-2007,13625,13679,54,0.396,193,-139,38,79,H1
"Rolette County, ND",2007-2008,13679,13744,65,0.475,216,-151,38,79,H1
"Rolette County, ND",2008-2009,13744,13798,54,0.393,211,-157,38,79,H1
"Rolette County, ND",2009-2010,13798,13993,195,1.413,182,13,38,79,H1
"Rolette County, ND",2010-2011,13993,14138,145,1.036,160,-15,38,79,H1
"Rolette County, ND",2011-2012,14138,14350,212,1.5,172,40,38,79,H1
"Rolette County, ND",2012-2013,14350,14607,257,1.791,137,120,38,79,H1
"Rolette County, ND",2013-2014,14607,14616,9,0.062,115,-106,38,79,H1
"Rolette County, ND",2014-2015,14673,14649,-24,-0.164,115,-139,38,79,H1
"Rolette County, ND",2015-2016,14649,14667,18,0.123,114,-96,38,79,H1
"Rolette County, ND",2016-2017,14667,14531,-136,-0.927,72,-208,38,79,H1
"Sargent County, ND",2000-2001,4349,4320,-29,-0.667,19,-48,38,81,H1
"Sargent County, ND",2001-2002,4320,4231,-89,-2.06,10,-99,38,81,H1
"Sargent County, ND",2002-2003,4231,4122,-109,-2.576,-1,-108,38,81,H1
"Sargent County, ND",2003-2004,4122,4060,-62,-1.504,10,-72,38,81,H1
"Sargent County, ND",2004-2005,4060,4101,41,1.01,18,23,38,81,H1
"Sargent County, ND",2005-2006,4101,4115,14,0.341,-12,26,38,81,H1
"Sargent County, ND",2006-2007,4115,4057,-58,-1.409,-7,-51,38,81,H1
"Sargent County, ND",2007-2008,4057,3978,-79,-1.947,21,-100,38,81,H1
"Sargent County, ND",2008-2009,3978,3901,-77,-1.936,12,-89,38,81,H1
"Sargent County, ND",2009-2010,3901,3805,-96,-2.461,1,-97,38,81,H1
"Sargent County, ND",2010-2011,3805,3804,-1,-0.026,0,-1,38,81,H1
"Sargent County, ND",2011-2012,3804,3895,91,2.392,-5,96,38,81,H1
"Sargent County, ND",2012-2013,3895,3880,-15,-0.385,11,-26,38,81,H1
"Sargent County, ND",2013-2014,3880,3931,51,1.314,8,43,38,81,H1
"Sargent County, ND",2014-2015,3922,3876,-46,-1.173,23,-69,38,81,H1
"Sargent County, ND",2015-2016,3876,3890,14,0.361,19,-5,38,81,H1
"Sargent County, ND",2016-2017,3890,3858,-32,-0.823,11,-43,38,81,H1
"Sheridan County, ND",2000-2001,1702,1641,-61,-3.584,-7,-54,38,83,H1
"Sheridan County, ND",2001-2002,1641,1601,-40,-2.438,-9,-31,38,83,H1
"Sheridan County, ND",2002-2003,1601,1564,-37,-2.311,-11,-26,38,83,H1
"Sheridan County, ND",2003-2004,1564,1503,-61,-3.9,-9,-52,38,83,H1
"Sheridan County, ND",2004-2005,1503,1483,-20,-1.331,-5,-15,38,83,H1
"Sheridan County, ND",2005-2006,1483,1435,-48,-3.237,-13,-35,38,83,H1
"Sheridan County, ND",2006-2007,1435,1406,-29,-2.021,-3,-26,38,83,H1
"Sheridan County, ND",2007-2008,1406,1351,-55,-3.912,-4,-51,38,83,H1
"Sheridan County, ND",2008-2009,1351,1349,-2,-0.148,-5,3,38,83,H1
"Sheridan County, ND",2009-2010,1349,1311,-38,-2.817,2,-40,38,83,H1
"Sheridan County, ND",2010-2011,1311,1310,-1,-0.076,-1,0,38,83,H1
"Sheridan County, ND",2011-2012,1310,1270,-40,-3.053,-2,-38,38,83,H1
"Sheridan County, ND",2012-2013,1270,1313,43,3.386,4,39,38,83,H1
"Sheridan County, ND",2013-2014,1313,1326,13,0.99,12,1,38,83,H1
"Sheridan County, ND",2014-2015,1323,1310,-13,-0.983,16,-29,38,83,H1
"Sheridan County, ND",2015-2016,1310,1347,37,2.824,12,25,38,83,H1
"Sheridan County, ND",2016-2017,1347,1353,6,0.445,1,5,38,83,H1
"Sioux County, ND",2000-2001,4103,4036,-67,-1.633,66,-133,38,85,H1
"Sioux County, ND",2001-2002,4036,4086,50,1.239,52,-2,38,85,H1
"Sioux County, ND",2002-2003,4086,4073,-13,-0.318,61,-74,38,85,H1
"Sioux County, ND",2003-2004,4073,4077,4,0.098,69,-65,38,85,H1
"Sioux County, ND",2004-2005,4077,4084,7,0.172,70,-63,38,85,H1
"Sioux County, ND",2005-2006,4084,4148,64,1.567,96,-32,38,85,H1
"Sioux County, ND",2006-2007,4148,4094,-54,-1.302,70,-124,38,85,H1
"Sioux County, ND",2007-2008,4094,4072,-22,-0.537,77,-99,38,85,H1
"Sioux County, ND",2008-2009,4072,4134,62,1.523,80,-18,38,85,H1
"Sioux County, ND",2009-2010,4134,4146,12,0.29,91,-79,38,85,H1
"Sioux County, ND",2010-2011,4146,4246,100,2.412,55,45,38,85,H1
"Sioux County, ND",2011-2012,4246,4343,97,2.285,68,29,38,85,H1
"Sioux County, ND",2012-2013,4343,4426,83,1.911,22,61,38,85,H1
"Sioux County, ND",2013-2014,4426,4422,-4,-0.09,25,-29,38,85,H1
"Sioux County, ND",2014-2015,4466,4370,-96,-2.15,27,-123,38,85,H1
"Sioux County, ND",2015-2016,4370,4455,85,1.945,37,48,38,85,H1
"Sioux County, ND",2016-2017,4455,4376,-79,-1.773,11,-90,38,85,H1
"Slope County, ND",2000-2001,760,749,-11,-1.447,6,-17,38,87,H1
"Slope County, ND",2001-2002,749,747,-2,-0.267,3,-5,38,87,H1
"Slope County, ND",2002-2003,747,744,-3,-0.402,8,-11,38,87,H1
"Slope County, ND",2003-2004,744,732,-12,-1.613,-5,-7,38,87,H1
"Slope County, ND",2004-2005,732,732,0,0,2,-2,38,87,H1
"Slope County, ND",2005-2006,732,744,12,1.639,-3,15,38,87,H1
"Slope County, ND",2006-2007,744,711,-33,-4.435,4,-37,38,87,H1
"Slope County, ND",2007-2008,711,730,19,2.672,6,13,38,87,H1
"Slope County, ND",2008-2009,730,718,-12,-1.644,8,-20,38,87,H1
"Slope County, ND",2009-2010,718,727,9,1.253,7,2,38,87,H1
"Slope County, ND",2010-2011,727,721,-6,-0.825,5,-11,38,87,H1
"Slope County, ND",2011-2012,721,759,38,5.27,2,36,38,87,H1
"Slope County, ND",2012-2013,759,761,2,0.264,9,-7,38,87,H1
"Slope County, ND",2013-2014,761,765,4,0.526,8,-4,38,87,H1
"Slope County, ND",2014-2015,767,767,0,0,10,-10,38,87,H1
"Slope County, ND",2015-2016,767,784,17,2.216,5,12,38,87,H1
"Slope County, ND",2016-2017,784,771,-13,-1.658,6,-19,38,87,H1
"Stark County, ND",2000-2001,22585,22494,-91,-0.403,27,-118,38,89,H1
"Stark County, ND",2001-2002,22494,22384,-110,-0.489,27,-137,38,89,H1
"Stark County, ND",2002-2003,22384,22431,47,0.21,71,-24,38,89,H1
"Stark County, ND",2003-2004,22431,22539,108,0.481,67,41,38,89,H1
"Stark County, ND",2004-2005,22539,22671,132,0.586,61,71,38,89,H1
"Stark County, ND",2005-2006,22671,22770,99,0.437,40,59,38,89,H1
"Stark County, ND",2006-2007,22770,23176,406,1.783,72,334,38,89,H1
"Stark County, ND",2007-2008,23176,23375,199,0.859,88,111,38,89,H1
"Stark County, ND",2008-2009,23375,23786,411,1.758,95,316,38,89,H1
"Stark County, ND",2009-2010,23786,24353,567,2.384,92,475,38,89,H1
"Stark County, ND",2010-2011,24353,25168,815,3.347,58,757,38,89,H1
"Stark County, ND",2011-2012,25168,26921,1753,6.965,200,1553,38,89,H1
"Stark County, ND",2012-2013,26921,28377,1456,5.408,220,1236,38,89,H1
"Stark County, ND",2013-2014,28377,30372,1995,7.03,216,1779,38,89,H1
"Stark County, ND",2014-2015,30490,32154,1664,5.458,326,1338,38,89,H1
"Stark County, ND",2015-2016,32154,30856,-1298,-4.037,317,-1615,38,89,H1
"Stark County, ND",2016-2017,30856,30209,-647,-2.097,282,-929,38,89,H1
"Steele County, ND",2000-2001,2238,2186,-52,-2.324,-23,-29,38,91,H1
"Steele County, ND",2001-2002,2186,2138,-48,-2.196,-1,-47,38,91,H1
"Steele County, ND",2002-2003,2138,2113,-25,-1.169,1,-26,38,91,H1
"Steele County, ND",2003-2004,2113,2108,-5,-0.237,-1,-4,38,91,H1
"Steele County, ND",2004-2005,2108,2077,-31,-1.471,-3,-28,38,91,H1
"Steele County, ND",2005-2006,2077,2026,-51,-2.455,4,-55,38,91,H1
"Steele County, ND",2006-2007,2026,1985,-41,-2.024,0,-41,38,91,H1
"Steele County, ND",2007-2008,1985,1960,-25,-1.259,11,-36,38,91,H1
"Steele County, ND",2008-2009,1960,1930,-30,-1.531,11,-41,38,91,H1
"Steele County, ND",2009-2010,1930,1974,44,2.28,6,38,38,91,H1
"Steele County, ND",2010-2011,1974,2030,56,2.837,-1,57,38,91,H1
"Steele County, ND",2011-2012,2030,1993,-37,-1.823,1,-38,38,91,H1
"Steele County, ND",2012-2013,1993,1960,-33,-1.656,7,-40,38,91,H1
"Steele County, ND",2013-2014,1960,1955,-5,-0.255,10,-15,38,91,H1
"Steele County, ND",2014-2015,1953,1956,3,0.154,9,-6,38,91,H1
"Steele County, ND",2015-2016,1956,1913,-43,-2.198,11,-54,38,91,H1
"Steele County, ND",2016-2017,1913,1917,4,0.209,13,-9,38,91,H1
"Stutsman County, ND",2000-2001,21887,21664,-223,-1.019,-43,-180,38,93,H1
"Stutsman County, ND",2001-2002,21664,21525,-139,-0.642,-21,-118,38,93,H1
"Stutsman County, ND",2002-2003,21525,21345,-180,-0.836,-24,-156,38,93,H1
"Stutsman County, ND",2003-2004,21345,21175,-170,-0.796,-34,-136,38,93,H1
"Stutsman County, ND",2004-2005,21175,21132,-43,-0.203,-4,-39,38,93,H1
"Stutsman County, ND",2005-2006,21132,21115,-17,-0.08,5,-22,38,93,H1
"Stutsman County, ND",2006-2007,21115,20876,-239,-1.132,-17,-222,38,93,H1
"Stutsman County, ND",2007-2008,20876,20812,-64,-0.307,-1,-63,38,93,H1
"Stutsman County, ND",2008-2009,20812,21009,197,0.947,6,191,38,93,H1
"Stutsman County, ND",2009-2010,21009,21114,105,0.5,13,92,38,93,H1
"Stutsman County, ND",2010-2011,21114,20989,-125,-0.592,-29,-96,38,93,H1
"Stutsman County, ND",2011-2012,20989,20958,-31,-0.148,-20,-11,38,93,H1
"Stutsman County, ND",2012-2013,20958,21090,132,0.63,-2,134,38,93,H1
"Stutsman County, ND",2013-2014,21090,21129,39,0.185,15,24,38,93,H1
"Stutsman County, ND",2014-2015,21174,21103,-71,-0.335,18,-89,38,93,H1
"Stutsman County, ND",2015-2016,21103,21009,-94,-0.445,-12,-82,38,93,H1
"Stutsman County, ND",2016-2017,21009,21087,78,0.371,-1,79,38,93,H1
"Towner County, ND",2000-2001,2858,2774,-84,-2.939,-26,-58,38,95,H1
"Towner County, ND",2001-2002,2774,2710,-64,-2.307,-15,-49,38,95,H1
"Towner County, ND",2002-2003,2710,2628,-82,-3.026,-30,-52,38,95,H1
"Towner County, ND",2003-2004,2628,2553,-75,-2.854,-20,-55,38,95,H1
"Towner County, ND",2004-2005,2553,2478,-75,-2.938,-16,-59,38,95,H1
"Towner County, ND",2005-2006,2478,2408,-70,-2.825,-22,-48,38,95,H1
"Towner County, ND",2006-2007,2408,2320,-88,-3.654,-21,-67,38,95,H1
"Towner County, ND",2007-2008,2320,2234,-86,-3.707,-10,-76,38,95,H1
"Towner County, ND",2008-2009,2234,2236,2,0.09,-19,21,38,95,H1
"Towner County, ND",2009-2010,2236,2238,2,0.089,-14,16,38,95,H1
"Towner County, ND",2010-2011,2238,2294,56,2.502,-11,67,38,95,H1
"Towner County, ND",2011-2012,2294,2323,29,1.264,2,27,38,95,H1
"Towner County, ND",2012-2013,2323,2297,-26,-1.119,-7,-19,38,95,H1
"Towner County, ND",2013-2014,2297,2310,13,0.566,10,3,38,95,H1
"Towner County, ND",2014-2015,2298,2272,-26,-1.131,15,-41,38,95,H1
"Towner County, ND",2015-2016,2272,2247,-25,-1.1,3,-28,38,95,H1
"Towner County, ND",2016-2017,2247,2253,6,0.267,5,1,38,95,H1
"Traill County, ND",2000-2001,8475,8357,-118,-1.392,-34,-84,38,97,H1
"Traill County, ND",2001-2002,8357,8326,-31,-0.371,-13,-18,38,97,H1
"Traill County, ND",2002-2003,8326,8292,-34,-0.408,-21,-13,38,97,H1
"Traill County, ND",2003-2004,8292,8353,61,0.736,-39,100,38,97,H1
"Traill County, ND",2004-2005,8353,8317,-36,-0.431,-27,-9,38,97,H1
"Traill County, ND",2005-2006,8317,8249,-68,-0.818,4,-72,38,97,H1
"Traill County, ND",2006-2007,8249,8318,69,0.836,13,56,38,97,H1
"Traill County, ND",2007-2008,8318,8157,-161,-1.936,-9,-152,38,97,H1
"Traill County, ND",2008-2009,8157,8123,-34,-0.417,-17,-17,38,97,H1
"Traill County, ND",2009-2010,8123,8113,-10,-0.123,-21,11,38,97,H1
"Traill County, ND",2010-2011,8113,8053,-60,-0.74,8,-68,38,97,H1
"Traill County, ND",2011-2012,8053,8073,20,0.248,2,18,38,97,H1
"Traill County, ND",2012-2013,8073,8210,137,1.697,14,123,38,97,H1
"Traill County, ND",2013-2014,8210,8082,-128,-1.559,6,-134,38,97,H1
"Traill County, ND",2014-2015,8063,8014,-49,-0.608,5,-54,38,97,H1
"Traill County, ND",2015-2016,8014,8025,11,0.137,14,-3,38,97,H1
"Traill County, ND",2016-2017,8025,8013,-12,-0.15,9,-21,38,97,H1
"Walsh County, ND",2000-2001,12354,12150,-204,-1.651,-5,-199,38,99,H1
"Walsh County, ND",2001-2002,12150,11883,-267,-2.198,-70,-197,38,99,H1
"Walsh County, ND",2002-2003,11883,11814,-69,-0.581,-9,-60,38,99,H1
"Walsh County, ND",2003-2004,11814,11695,-119,-1.007,-17,-102,38,99,H1
"Walsh County, ND",2004-2005,11695,11639,-56,-0.479,-60,4,38,99,H1
"Walsh County, ND",2005-2006,11639,11501,-138,-1.186,-4,-134,38,99,H1
"Walsh County, ND",2006-2007,11501,11355,-146,-1.269,-1,-145,38,99,H1
"Walsh County, ND",2007-2008,11355,11296,-59,-0.52,4,-63,38,99,H1
"Walsh County, ND",2008-2009,11296,11195,-101,-0.894,-7,-94,38,99,H1
"Walsh County, ND",2009-2010,11195,11095,-100,-0.893,-15,-85,38,99,H1
"Walsh County, ND",2010-2011,11095,11037,-58,-0.523,-7,-51,38,99,H1
"Walsh County, ND",2011-2012,11037,11054,17,0.154,-1,18,38,99,H1
"Walsh County, ND",2012-2013,11054,11106,52,0.47,5,47,38,99,H1
"Walsh County, ND",2013-2014,11106,10970,-136,-1.225,14,-150,38,99,H1
"Walsh County, ND",2014-2015,10959,10897,-62,-0.566,16,-78,38,99,H1
"Walsh County, ND",2015-2016,10897,10862,-35,-0.321,12,-47,38,99,H1
"Walsh County, ND",2016-2017,10862,10855,-7,-0.064,17,-24,38,99,H1
"Ward County, ND",2000-2001,58839,58246,-593,-1.008,333,-926,38,101,H1
"Ward County, ND",2001-2002,58246,57741,-505,-0.867,395,-900,38,101,H1
"Ward County, ND",2002-2003,57741,57193,-548,-0.949,397,-945,38,101,H1
"Ward County, ND",2003-2004,57193,58054,861,1.505,467,394,38,101,H1
"Ward County, ND",2004-2005,58054,57878,-176,-0.303,515,-691,38,101,H1
"Ward County, ND",2005-2006,57878,58030,152,0.263,432,-280,38,101,H1
"Ward County, ND",2006-2007,58030,58297,267,0.46,518,-251,38,101,H1
"Ward County, ND",2007-2008,58297,58670,373,0.64,538,-165,38,101,H1
"Ward County, ND",2008-2009,58670,60213,1543,2.63,492,1051,38,101,H1
"Ward County, ND",2009-2010,60213,62090,1877,3.117,570,1307,38,101,H1
"Ward County, ND",2010-2011,62090,64318,2228,3.588,570,1658,38,101,H1
"Ward County, ND",2011-2012,64318,65480,1162,1.807,645,517,38,101,H1
"Ward County, ND",2012-2013,65480,67998,2518,3.845,654,1864,38,101,H1
"Ward County, ND",2013-2014,67998,69384,1386,2.038,713,673,38,101,H1
"Ward County, ND",2014-2015,69536,71275,1739,2.501,790,949,38,101,H1
"Ward County, ND",2015-2016,71275,70153,-1122,-1.574,778,-1900,38,101,H1
"Ward County, ND",2016-2017,70153,68946,-1207,-1.721,684,-1891,38,101,H1
"Wells County, ND",2000-2001,5074,4886,-188,-3.705,-39,-149,38,103,H1
"Wells County, ND",2001-2002,4886,4794,-92,-1.883,-32,-60,38,103,H1
"Wells County, ND",2002-2003,4794,4694,-100,-2.086,-56,-44,38,103,H1
"Wells County, ND",2003-2004,4694,4625,-69,-1.47,-20,-49,38,103,H1
"Wells County, ND",2004-2005,4625,4552,-73,-1.578,-29,-44,38,103,H1
"Wells County, ND",2005-2006,4552,4404,-148,-3.251,-28,-120,38,103,H1
"Wells County, ND",2006-2007,4404,4317,-87,-1.975,-50,-37,38,103,H1
"Wells County, ND",2007-2008,4317,4253,-64,-1.483,-31,-33,38,103,H1
"Wells County, ND",2008-2009,4253,4202,-51,-1.199,-27,-24,38,103,H1
"Wells County, ND",2009-2010,4202,4197,-5,-0.119,-13,8,38,103,H1
"Wells County, ND",2010-2011,4197,4217,20,0.477,-56,76,38,103,H1
"Wells County, ND",2011-2012,4217,4260,43,1.02,-24,67,38,103,H1
"Wells County, ND",2012-2013,4260,4185,-75,-1.761,-30,-45,38,103,H1
"Wells County, ND",2013-2014,4185,4192,7,0.167,-5,12,38,103,H1
"Wells County, ND",2014-2015,4184,4168,-16,-0.382,-7,-9,38,103,H1
"Wells County, ND",2015-2016,4168,4058,-110,-2.639,-9,-101,38,103,H1
"Wells County, ND",2016-2017,4058,4022,-36,-0.887,-6,-30,38,103,H1
"Williams County, ND",2000-2001,19705,19610,-95,-0.482,24,-119,38,105,H1
"Williams County, ND",2001-2002,19610,19729,119,0.607,-16,135,38,105,H1
"Williams County, ND",2002-2003,19729,19705,-24,-0.122,10,-34,38,105,H1
"Williams County, ND",2003-2004,19705,19724,19,0.096,2,17,38,105,H1
"Williams County, ND",2004-2005,19724,19855,131,0.664,40,91,38,105,H1
"Williams County, ND",2005-2006,19855,20122,267,1.345,61,206,38,105,H1
"Williams County, ND",2006-2007,20122,20547,425,2.112,80,345,38,105,H1
"Williams County, ND",2007-2008,20547,20928,381,1.854,87,294,38,105,H1
"Williams County, ND",2008-2009,20928,21820,892,4.262,83,809,38,105,H1
"Williams County, ND",2009-2010,21820,22573,753,3.451,88,665,38,105,H1
"Williams County, ND",2010-2011,22573,24379,1806,8.001,122,1684,38,105,H1
"Williams County, ND",2011-2012,24379,26686,2307,9.463,213,2094,38,105,H1
"Williams County, ND",2012-2013,26686,29563,2877,10.781,312,2565,38,105,H1
"Williams County, ND",2013-2014,29563,32130,2567,8.683,403,2164,38,105,H1
"Williams County, ND",2014-2015,32129,35294,3165,9.851,485,2680,38,105,H1
"Williams County, ND",2015-2016,35294,34195,-1099,-3.114,476,-1575,38,105,H1
"Williams County, ND",2016-2017,34195,33349,-846,-2.474,438,-1284,38,105,H1
Ohio,2000-2001,11363543,11387404,23861,0.21,45249,-21388,39,0,STATE
Ohio,2001-2002,11387404,11407889,20485,0.18,40159,-19674,39,0,STATE
Ohio,2002-2003,11407889,11434788,26899,0.236,40655,-13756,39,0,STATE
Ohio,2003-2004,11434788,11452251,17463,0.153,40620,-23157,39,0,STATE
Ohio,2004-2005,11452251,11463320,11069,0.097,38676,-27607,39,0,STATE
Ohio,2005-2006,11463320,11481213,17893,0.156,43589,-25696,39,0,STATE
Ohio,2006-2007,11481213,11500468,19255,0.168,44130,-24875,39,0,STATE
Ohio,2007-2008,11500468,11515391,14923,0.13,41944,-27021,39,0,STATE
Ohio,2008-2009,11515391,11528896,13505,0.117,40241,-26736,39,0,STATE
Ohio,2009-2010,11528896,11540766,11870,0.103,32868,-20998,39,0,STATE
Ohio,2010-2011,11540766,11545442,4676,0.041,27227,-22551,39,0,STATE
Ohio,2011-2012,11545442,11551783,6341,0.055,26309,-19968,39,0,STATE
Ohio,2012-2013,11551783,11572232,20449,0.177,24643,-4194,39,0,STATE
Ohio,2013-2014,11572232,11596998,24766,0.214,27360,-2594,39,0,STATE
Ohio,2014-2015,11596998,11613423,16425,0.142,28162,-11737,39,0,STATE
Ohio,2015-2016,11613423,11622554,9131,0.079,22185,-13054,39,0,STATE
Ohio,2016-2017,11622554,11658609,36055,0.31,22458,13597,39,0,STATE
"Adams County, OH",2000-2001,27317,27522,205,0.75,87,118,39,1,H1
"Adams County, OH",2001-2002,27522,27817,295,1.072,56,239,39,1,H1
"Adams County, OH",2002-2003,27817,28111,294,1.057,88,206,39,1,H1
"Adams County, OH",2003-2004,28111,28328,217,0.772,80,137,39,1,H1
"Adams County, OH",2004-2005,28328,28522,194,0.685,95,99,39,1,H1
"Adams County, OH",2005-2006,28522,28615,93,0.326,102,-9,39,1,H1
"Adams County, OH",2006-2007,28615,28538,-77,-0.269,91,-168,39,1,H1
"Adams County, OH",2007-2008,28538,28686,148,0.519,79,69,39,1,H1
"Adams County, OH",2008-2009,28686,28500,-186,-0.648,73,-259,39,1,H1
"Adams County, OH",2009-2010,28500,28568,68,0.239,10,58,39,1,H1
"Adams County, OH",2010-2011,28568,28523,-45,-0.158,46,-91,39,1,H1
"Adams County, OH",2011-2012,28523,28366,-157,-0.55,3,-160,39,1,H1
"Adams County, OH",2012-2013,28366,28126,-240,-0.846,32,-272,39,1,H1
"Adams County, OH",2013-2014,28126,28129,3,0.011,16,-13,39,1,H1
"Adams County, OH",2014-2015,28124,28024,-100,-0.356,14,-114,39,1,H1
"Adams County, OH",2015-2016,28024,27832,-192,-0.685,11,-203,39,1,H1
"Adams County, OH",2016-2017,27832,27726,-106,-0.381,-19,-87,39,1,H1
"Allen County, OH",2000-2001,108589,108523,-66,-0.061,442,-508,39,3,H1
"Allen County, OH",2001-2002,108523,108518,-5,-0.005,359,-364,39,3,H1
"Allen County, OH",2002-2003,108518,107418,-1100,-1.014,391,-1491,39,3,H1
"Allen County, OH",2003-2004,107418,106826,-592,-0.551,438,-1030,39,3,H1
"Allen County, OH",2004-2005,106826,106861,35,0.033,459,-424,39,3,H1
"Allen County, OH",2005-2006,106861,106716,-145,-0.136,427,-572,39,3,H1
"Allen County, OH",2006-2007,106716,106717,1,0.001,355,-354,39,3,H1
"Allen County, OH",2007-2008,106717,106773,56,0.052,405,-349,39,3,H1
"Allen County, OH",2008-2009,106773,106518,-255,-0.239,385,-640,39,3,H1
"Allen County, OH",2009-2010,106518,106364,-154,-0.145,311,-465,39,3,H1
"Allen County, OH",2010-2011,106364,105907,-457,-0.43,243,-700,39,3,H1
"Allen County, OH",2011-2012,105907,105283,-624,-0.589,154,-778,39,3,H1
"Allen County, OH",2012-2013,105283,105214,-69,-0.066,210,-279,39,3,H1
"Allen County, OH",2013-2014,105214,105040,-174,-0.165,225,-399,39,3,H1
"Allen County, OH",2014-2015,105048,104425,-623,-0.593,225,-848,39,3,H1
"Allen County, OH",2015-2016,104425,103626,-799,-0.765,141,-940,39,3,H1
"Allen County, OH",2016-2017,103626,103198,-428,-0.413,168,-596,39,3,H1
"Ashland County, OH",2000-2001,52502,52560,58,0.11,238,-180,39,5,H1
"Ashland County, OH",2001-2002,52560,52595,35,0.067,242,-207,39,5,H1
"Ashland County, OH",2002-2003,52595,52867,272,0.517,177,95,39,5,H1
"Ashland County, OH",2003-2004,52867,52852,-15,-0.028,83,-98,39,5,H1
"Ashland County, OH",2004-2005,52852,53048,196,0.371,230,-34,39,5,H1
"Ashland County, OH",2005-2006,53048,53231,183,0.345,169,14,39,5,H1
"Ashland County, OH",2006-2007,53231,53544,313,0.588,188,125,39,5,H1
"Ashland County, OH",2007-2008,53544,53499,-45,-0.084,193,-238,39,5,H1
"Ashland County, OH",2008-2009,53499,53305,-194,-0.363,202,-396,39,5,H1
"Ashland County, OH",2009-2010,53305,53329,24,0.045,97,-73,39,5,H1
"Ashland County, OH",2010-2011,53329,53288,-41,-0.077,22,-63,39,5,H1
"Ashland County, OH",2011-2012,53288,53240,-48,-0.09,69,-117,39,5,H1
"Ashland County, OH",2012-2013,53240,53117,-123,-0.231,81,-204,39,5,H1
"Ashland County, OH",2013-2014,53117,53035,-82,-0.154,63,-145,39,5,H1
"Ashland County, OH",2014-2015,53085,53213,128,0.241,83,45,39,5,H1
"Ashland County, OH",2015-2016,53213,53417,204,0.383,18,186,39,5,H1
"Ashland County, OH",2016-2017,53417,53628,211,0.395,40,171,39,5,H1
"Ashtabula County, OH",2000-2001,102705,102450,-255,-0.248,146,-401,39,7,H1
"Ashtabula County, OH",2001-2002,102450,102577,127,0.124,142,-15,39,7,H1
"Ashtabula County, OH",2002-2003,102577,102667,90,0.088,94,-4,39,7,H1
"Ashtabula County, OH",2003-2004,102667,102648,-19,-0.019,181,-200,39,7,H1
"Ashtabula County, OH",2004-2005,102648,102638,-10,-0.01,106,-116,39,7,H1
"Ashtabula County, OH",2005-2006,102638,102340,-298,-0.29,223,-521,39,7,H1
"Ashtabula County, OH",2006-2007,102340,102156,-184,-0.18,195,-379,39,7,H1
"Ashtabula County, OH",2007-2008,102156,101826,-330,-0.323,222,-552,39,7,H1
"Ashtabula County, OH",2008-2009,101826,101584,-242,-0.238,169,-411,39,7,H1
"Ashtabula County, OH",2009-2010,101584,101409,-175,-0.172,28,-203,39,7,H1
"Ashtabula County, OH",2010-2011,101409,101101,-308,-0.304,-11,-297,39,7,H1
"Ashtabula County, OH",2011-2012,101101,100264,-837,-0.828,-102,-735,39,7,H1
"Ashtabula County, OH",2012-2013,100264,99779,-485,-0.484,19,-504,39,7,H1
"Ashtabula County, OH",2013-2014,99779,99175,-604,-0.605,-1,-603,39,7,H1
"Ashtabula County, OH",2014-2015,99138,98632,-506,-0.51,-14,-492,39,7,H1
"Ashtabula County, OH",2015-2016,98632,98169,-463,-0.469,-31,-432,39,7,H1
"Ashtabula County, OH",2016-2017,98169,97807,-362,-0.369,-24,-338,39,7,H1
"Athens County, OH",2000-2001,62324,62997,673,1.08,179,494,39,9,H1
"Athens County, OH",2001-2002,62997,63401,404,0.641,142,262,39,9,H1
"Athens County, OH",2002-2003,63401,63827,426,0.672,150,276,39,9,H1
"Athens County, OH",2003-2004,63827,63230,-597,-0.935,171,-768,39,9,H1
"Athens County, OH",2004-2005,63230,64075,845,1.336,180,665,39,9,H1
"Athens County, OH",2005-2006,64075,64237,162,0.253,125,37,39,9,H1
"Athens County, OH",2006-2007,64237,64102,-135,-0.21,114,-249,39,9,H1
"Athens County, OH",2007-2008,64102,64546,444,0.693,134,310,39,9,H1
"Athens County, OH",2008-2009,64546,64618,72,0.112,147,-75,39,9,H1
"Athens County, OH",2009-2010,64618,65218,600,0.929,106,494,39,9,H1
"Athens County, OH",2010-2011,65218,65117,-101,-0.155,32,-133,39,9,H1
"Athens County, OH",2011-2012,65117,64638,-479,-0.736,107,-586,39,9,H1
"Athens County, OH",2012-2013,64638,64515,-123,-0.19,86,-209,39,9,H1
"Athens County, OH",2013-2014,64515,64713,198,0.307,116,82,39,9,H1
"Athens County, OH",2014-2015,64722,65886,1164,1.798,78,1086,39,9,H1
"Athens County, OH",2015-2016,65886,66320,434,0.659,30,404,39,9,H1
"Athens County, OH",2016-2017,66320,66597,277,0.418,58,219,39,9,H1
"Auglaize County, OH",2000-2001,46186,46137,-49,-0.106,160,-209,39,11,H1
"Auglaize County, OH",2001-2002,46137,45943,-194,-0.42,93,-287,39,11,H1
"Auglaize County, OH",2002-2003,45943,45872,-71,-0.155,142,-213,39,11,H1
"Auglaize County, OH",2003-2004,45872,45932,60,0.131,157,-97,39,11,H1
"Auglaize County, OH",2004-2005,45932,46166,234,0.509,179,55,39,11,H1
"Auglaize County, OH",2005-2006,46166,46034,-132,-0.286,122,-254,39,11,H1
"Auglaize County, OH",2006-2007,46034,45977,-57,-0.124,115,-172,39,11,H1
"Auglaize County, OH",2007-2008,45977,46167,190,0.413,125,65,39,11,H1
"Auglaize County, OH",2008-2009,46167,45996,-171,-0.37,168,-339,39,11,H1
"Auglaize County, OH",2009-2010,45996,45936,-60,-0.13,108,-168,39,11,H1
"Auglaize County, OH",2010-2011,45936,45815,-121,-0.263,110,-231,39,11,H1
"Auglaize County, OH",2011-2012,45815,45866,51,0.111,60,-9,39,11,H1
"Auglaize County, OH",2012-2013,45866,45876,10,0.022,-1,11,39,11,H1
"Auglaize County, OH",2013-2014,45876,45841,-35,-0.076,34,-69,39,11,H1
"Auglaize County, OH",2014-2015,45890,45876,-14,-0.031,65,-79,39,11,H1
"Auglaize County, OH",2015-2016,45876,45797,-79,-0.172,53,-132,39,11,H1
"Auglaize County, OH",2016-2017,45797,45778,-19,-0.041,72,-91,39,11,H1
"Belmont County, OH",2000-2001,70172,69901,-271,-0.386,-256,-15,39,13,H1
"Belmont County, OH",2001-2002,69901,70293,392,0.561,-186,578,39,13,H1
"Belmont County, OH",2002-2003,70293,70219,-74,-0.105,-242,168,39,13,H1
"Belmont County, OH",2003-2004,70219,70241,22,0.031,-209,231,39,13,H1
"Belmont County, OH",2004-2005,70241,70203,-38,-0.054,-232,194,39,13,H1
"Belmont County, OH",2005-2006,70203,70469,266,0.379,-151,417,39,13,H1
"Belmont County, OH",2006-2007,70469,70430,-39,-0.055,-190,151,39,13,H1
"Belmont County, OH",2007-2008,70430,70356,-74,-0.105,-192,118,39,13,H1
"Belmont County, OH",2008-2009,70356,70439,83,0.118,-154,237,39,13,H1
"Belmont County, OH",2009-2010,70439,70290,-149,-0.212,-195,46,39,13,H1
"Belmont County, OH",2010-2011,70290,70045,-245,-0.349,-260,15,39,13,H1
"Belmont County, OH",2011-2012,70045,69624,-421,-0.601,-287,-134,39,13,H1
"Belmont County, OH",2012-2013,69624,69545,-79,-0.113,-146,67,39,13,H1
"Belmont County, OH",2013-2014,69545,69461,-84,-0.121,-142,58,39,13,H1
"Belmont County, OH",2014-2015,69414,69154,-260,-0.375,-92,-168,39,13,H1
"Belmont County, OH",2015-2016,69154,68568,-586,-0.847,-203,-383,39,13,H1
"Belmont County, OH",2016-2017,68568,68029,-539,-0.786,-197,-342,39,13,H1
"Brown County, OH",2000-2001,42566,42839,273,0.641,198,75,39,15,H1
"Brown County, OH",2001-2002,42839,43368,529,1.235,150,379,39,15,H1
"Brown County, OH",2002-2003,43368,43794,426,0.982,173,253,39,15,H1
"Brown County, OH",2003-2004,43794,43995,201,0.459,157,44,39,15,H1
"Brown County, OH",2004-2005,43995,44161,166,0.377,111,55,39,15,H1
"Brown County, OH",2005-2006,44161,44334,173,0.392,126,47,39,15,H1
"Brown County, OH",2006-2007,44334,44490,156,0.352,140,16,39,15,H1
"Brown County, OH",2007-2008,44490,44668,178,0.4,114,64,39,15,H1
"Brown County, OH",2008-2009,44668,44740,72,0.161,127,-55,39,15,H1
"Brown County, OH",2009-2010,44740,44886,146,0.326,68,78,39,15,H1
"Brown County, OH",2010-2011,44886,44678,-208,-0.463,26,-234,39,15,H1
"Brown County, OH",2011-2012,44678,44404,-274,-0.613,75,-349,39,15,H1
"Brown County, OH",2012-2013,44404,44235,-169,-0.381,51,-220,39,15,H1
"Brown County, OH",2013-2014,44235,44116,-119,-0.269,45,-164,39,15,H1
"Brown County, OH",2014-2015,44078,43839,-239,-0.542,5,-244,39,15,H1
"Brown County, OH",2015-2016,43839,43644,-195,-0.445,-30,-165,39,15,H1
"Brown County, OH",2016-2017,43644,43576,-68,-0.156,-2,-66,39,15,H1
"Butler County, OH",2000-2001,333368,336679,3311,0.993,2161,1150,39,17,H1
"Butler County, OH",2001-2002,336679,339514,2835,0.842,1940,895,39,17,H1
"Butler County, OH",2002-2003,339514,343022,3508,1.033,1925,1583,39,17,H1
"Butler County, OH",2003-2004,343022,346655,3633,1.059,2046,1587,39,17,H1
"Butler County, OH",2004-2005,346655,350732,4077,1.176,2117,1960,39,17,H1
"Butler County, OH",2005-2006,350732,356691,5959,1.699,2266,3693,39,17,H1
"Butler County, OH",2006-2007,356691,361192,4501,1.262,2372,2129,39,17,H1
"Butler County, OH",2007-2008,361192,364179,2987,0.827,2217,770,39,17,H1
"Butler County, OH",2008-2009,364179,366633,2454,0.674,2211,243,39,17,H1
"Butler County, OH",2009-2010,366633,369056,2423,0.661,1605,818,39,17,H1
"Butler County, OH",2010-2011,369056,370210,1154,0.313,1530,-376,39,17,H1
"Butler County, OH",2011-2012,370210,370833,623,0.168,1484,-861,39,17,H1
"Butler County, OH",2012-2013,370833,371511,678,0.183,1739,-1061,39,17,H1
"Butler County, OH",2013-2014,371511,374158,2647,0.712,1386,1261,39,17,H1
"Butler County, OH",2014-2015,373948,376353,2405,0.643,1303,1102,39,17,H1
"Butler County, OH",2015-2016,376353,377933,1580,0.42,1243,337,39,17,H1
"Butler County, OH",2016-2017,377933,380604,2671,0.707,1184,1487,39,17,H1
"Carroll County, OH",2000-2001,28851,28961,110,0.381,60,50,39,19,H1
"Carroll County, OH",2001-2002,28961,29172,211,0.729,115,96,39,19,H1
"Carroll County, OH",2002-2003,29172,29325,153,0.524,63,90,39,19,H1
"Carroll County, OH",2003-2004,29325,29297,-28,-0.095,50,-78,39,19,H1
"Carroll County, OH",2004-2005,29297,29118,-179,-0.611,-15,-164,39,19,H1
"Carroll County, OH",2005-2006,29118,29163,45,0.155,54,-9,39,19,H1
"Carroll County, OH",2006-2007,29163,29062,-101,-0.346,63,-164,39,19,H1
"Carroll County, OH",2007-2008,29062,28999,-63,-0.217,61,-124,39,19,H1
"Carroll County, OH",2008-2009,28999,28917,-82,-0.283,32,-114,39,19,H1
"Carroll County, OH",2009-2010,28917,28804,-113,-0.391,-21,-92,39,19,H1
"Carroll County, OH",2010-2011,28804,28871,67,0.233,22,45,39,19,H1
"Carroll County, OH",2011-2012,28871,28560,-311,-1.077,-59,-252,39,19,H1
"Carroll County, OH",2012-2013,28560,28271,-289,-1.012,-19,-270,39,19,H1
"Carroll County, OH",2013-2014,28271,28187,-84,-0.297,-17,-67,39,19,H1
"Carroll County, OH",2014-2015,28209,27811,-398,-1.411,-54,-344,39,19,H1
"Carroll County, OH",2015-2016,27811,27637,-174,-0.626,4,-178,39,19,H1
"Carroll County, OH",2016-2017,27637,27385,-252,-0.912,-18,-234,39,19,H1
"Champaign County, OH",2000-2001,38941,39047,106,0.272,103,3,39,21,H1
"Champaign County, OH",2001-2002,39047,39280,233,0.597,129,104,39,21,H1
"Champaign County, OH",2002-2003,39280,39395,115,0.293,163,-48,39,21,H1
"Champaign County, OH",2003-2004,39395,39565,170,0.432,87,83,39,21,H1
"Champaign County, OH",2004-2005,39565,39592,27,0.068,129,-102,39,21,H1
"Champaign County, OH",2005-2006,39592,40018,426,1.076,164,262,39,21,H1
"Champaign County, OH",2006-2007,40018,40127,109,0.272,76,33,39,21,H1
"Champaign County, OH",2007-2008,40127,40263,136,0.339,123,13,39,21,H1
"Champaign County, OH",2008-2009,40263,40265,2,0.005,142,-140,39,21,H1
"Champaign County, OH",2009-2010,40265,40074,-191,-0.474,86,-277,39,21,H1
"Champaign County, OH",2010-2011,40074,39878,-196,-0.489,22,-218,39,21,H1
"Champaign County, OH",2011-2012,39878,39586,-292,-0.732,23,-315,39,21,H1
"Champaign County, OH",2012-2013,39586,39475,-111,-0.28,60,-171,39,21,H1
"Champaign County, OH",2013-2014,39475,39128,-347,-0.879,47,-394,39,21,H1
"Champaign County, OH",2014-2015,39078,38987,-91,-0.233,-11,-80,39,21,H1
"Champaign County, OH",2015-2016,38987,38737,-250,-0.641,2,-252,39,21,H1
"Champaign County, OH",2016-2017,38737,38840,103,0.266,0,103,39,21,H1
"Clark County, OH",2000-2001,144605,143803,-802,-0.555,335,-1137,39,23,H1
"Clark County, OH",2001-2002,143803,143229,-574,-0.399,218,-792,39,23,H1
"Clark County, OH",2002-2003,143229,141758,-1471,-1.027,55,-1526,39,23,H1
"Clark County, OH",2003-2004,141758,141380,-378,-0.267,174,-552,39,23,H1
"Clark County, OH",2004-2005,141380,141367,-13,-0.009,72,-85,39,23,H1
"Clark County, OH",2005-2006,141367,140668,-699,-0.494,192,-891,39,23,H1
"Clark County, OH",2006-2007,140668,139829,-839,-0.596,332,-1171,39,23,H1
"Clark County, OH",2007-2008,139829,139404,-425,-0.304,199,-624,39,23,H1
"Clark County, OH",2008-2009,139404,138778,-626,-0.449,126,-752,39,23,H1
"Clark County, OH",2009-2010,138778,138227,-551,-0.397,-36,-515,39,23,H1
"Clark County, OH",2010-2011,138227,137738,-489,-0.354,29,-518,39,23,H1
"Clark County, OH",2011-2012,137738,137194,-544,-0.395,-100,-444,39,23,H1
"Clark County, OH",2012-2013,137194,136803,-391,-0.285,-86,-305,39,23,H1
"Clark County, OH",2013-2014,136803,136554,-249,-0.182,-64,-185,39,23,H1
"Clark County, OH",2014-2015,136482,135959,-523,-0.383,-62,-461,39,23,H1
"Clark County, OH",2015-2016,135959,134621,-1338,-0.984,-167,-1171,39,23,H1
"Clark County, OH",2016-2017,134621,134557,-64,-0.048,-119,55,39,23,H1
"Clermont County, OH",2000-2001,177960,179845,1885,1.059,1434,451,39,25,H1
"Clermont County, OH",2001-2002,179845,182143,2298,1.278,1349,949,39,25,H1
"Clermont County, OH",2002-2003,182143,184446,2303,1.264,1398,905,39,25,H1
"Clermont County, OH",2003-2004,184446,187281,2835,1.537,1492,1343,39,25,H1
"Clermont County, OH",2004-2005,187281,189486,2205,1.177,1204,1001,39,25,H1
"Clermont County, OH",2005-2006,189486,192209,2723,1.437,1415,1308,39,25,H1
"Clermont County, OH",2006-2007,192209,194346,2137,1.112,1535,602,39,25,H1
"Clermont County, OH",2007-2008,194346,195891,1545,0.795,1319,226,39,25,H1
"Clermont County, OH",2008-2009,195891,196512,621,0.317,1310,-689,39,25,H1
"Clermont County, OH",2009-2010,196512,197638,1126,0.573,962,164,39,25,H1
"Clermont County, OH",2010-2011,197638,198581,943,0.477,908,35,39,25,H1
"Clermont County, OH",2011-2012,198581,199219,638,0.321,855,-217,39,25,H1
"Clermont County, OH",2012-2013,199219,200254,1035,0.52,728,307,39,25,H1
"Clermont County, OH",2013-2014,200254,201560,1306,0.652,783,523,39,25,H1
"Clermont County, OH",2014-2015,201375,201973,598,0.297,683,-85,39,25,H1
"Clermont County, OH",2015-2016,201973,203016,1043,0.516,552,491,39,25,H1
"Clermont County, OH",2016-2017,203016,204214,1198,0.59,601,597,39,25,H1
"Clinton County, OH",2000-2001,40566,40777,211,0.52,182,29,39,27,H1
"Clinton County, OH",2001-2002,40777,41042,265,0.65,250,15,39,27,H1
"Clinton County, OH",2002-2003,41042,41250,208,0.507,216,-8,39,27,H1
"Clinton County, OH",2003-2004,41250,41557,307,0.744,195,112,39,27,H1
"Clinton County, OH",2004-2005,41557,41775,218,0.525,201,17,39,27,H1
"Clinton County, OH",2005-2006,41775,42499,724,1.733,236,488,39,27,H1
"Clinton County, OH",2006-2007,42499,42576,77,0.181,201,-124,39,27,H1
"Clinton County, OH",2007-2008,42576,42656,80,0.188,194,-114,39,27,H1
"Clinton County, OH",2008-2009,42656,42418,-238,-0.558,205,-443,39,27,H1
"Clinton County, OH",2009-2010,42418,41892,-526,-1.24,130,-656,39,27,H1
"Clinton County, OH",2010-2011,41892,41906,14,0.033,67,-53,39,27,H1
"Clinton County, OH",2011-2012,41906,41831,-75,-0.179,57,-132,39,27,H1
"Clinton County, OH",2012-2013,41831,41889,58,0.139,78,-20,39,27,H1
"Clinton County, OH",2013-2014,41889,41835,-54,-0.129,68,-122,39,27,H1
"Clinton County, OH",2014-2015,41880,41917,37,0.088,92,-55,39,27,H1
"Clinton County, OH",2015-2016,41917,41881,-36,-0.086,92,-128,39,27,H1
"Clinton County, OH",2016-2017,41881,42009,128,0.306,67,61,39,27,H1
"Columbiana County, OH",2000-2001,112048,111370,-678,-0.605,50,-728,39,29,H1
"Columbiana County, OH",2001-2002,111370,111097,-273,-0.245,0,-273,39,29,H1
"Columbiana County, OH",2002-2003,111097,1.11E+05,-97,-0.087,58,-155,39,29,H1
"Columbiana County, OH",2003-2004,1.11E+05,110627,-373,-0.336,72,-445,39,29,H1
"Columbiana County, OH",2004-2005,110627,109784,-843,-0.762,-96,-747,39,29,H1
"Columbiana County, OH",2005-2006,109784,109673,-111,-0.101,71,-182,39,29,H1
"Columbiana County, OH",2006-2007,109673,109153,-520,-0.474,25,-545,39,29,H1
"Columbiana County, OH",2007-2008,109153,108469,-684,-0.627,15,-699,39,29,H1
"Columbiana County, OH",2008-2009,108469,107948,-521,-0.48,-28,-493,39,29,H1
"Columbiana County, OH",2009-2010,107948,107843,-105,-0.097,-128,23,39,29,H1
"Columbiana County, OH",2010-2011,107843,107260,-583,-0.541,-114,-469,39,29,H1
"Columbiana County, OH",2011-2012,107260,106438,-822,-0.766,-104,-718,39,29,H1
"Columbiana County, OH",2012-2013,106438,105885,-553,-0.52,-33,-520,39,29,H1
"Columbiana County, OH",2013-2014,105885,105686,-199,-0.188,-45,-154,39,29,H1
"Columbiana County, OH",2014-2015,105597,104806,-791,-0.749,-69,-722,39,29,H1
"Columbiana County, OH",2015-2016,104806,103744,-1062,-1.013,-149,-913,39,29,H1
"Columbiana County, OH",2016-2017,103744,103077,-667,-0.643,-130,-537,39,29,H1
"Coshocton County, OH",2000-2001,36724,36975,251,0.683,118,133,39,31,H1
"Coshocton County, OH",2001-2002,36975,37149,174,0.471,119,55,39,31,H1
"Coshocton County, OH",2002-2003,37149,37288,139,0.374,28,111,39,31,H1
"Coshocton County, OH",2003-2004,37288,37421,133,0.357,86,47,39,31,H1
"Coshocton County, OH",2004-2005,37421,37363,-58,-0.155,85,-143,39,31,H1
"Coshocton County, OH",2005-2006,37363,37339,-24,-0.064,64,-88,39,31,H1
"Coshocton County, OH",2006-2007,37339,37184,-155,-0.415,97,-252,39,31,H1
"Coshocton County, OH",2007-2008,37184,36953,-231,-0.621,63,-294,39,31,H1
"Coshocton County, OH",2008-2009,36953,36878,-75,-0.203,54,-129,39,31,H1
"Coshocton County, OH",2009-2010,36878,36914,36,0.098,19,17,39,31,H1
"Coshocton County, OH",2010-2011,36914,36903,-11,-0.03,42,-53,39,31,H1
"Coshocton County, OH",2011-2012,36903,36806,-97,-0.263,41,-138,39,31,H1
"Coshocton County, OH",2012-2013,36806,36700,-106,-0.288,50,-156,39,31,H1
"Coshocton County, OH",2013-2014,36700,36516,-184,-0.501,57,-241,39,31,H1
"Coshocton County, OH",2014-2015,36568,36569,1,0.003,82,-81,39,31,H1
"Coshocton County, OH",2015-2016,36569,36644,75,0.205,104,-29,39,31,H1
"Coshocton County, OH",2016-2017,36644,36544,-100,-0.273,93,-193,39,31,H1
"Crawford County, OH",2000-2001,46827,46533,-294,-0.628,51,-345,39,33,H1
"Crawford County, OH",2001-2002,46533,46271,-262,-0.563,53,-315,39,33,H1
"Crawford County, OH",2002-2003,46271,45928,-343,-0.741,53,-396,39,33,H1
"Crawford County, OH",2003-2004,45928,45776,-152,-0.331,113,-265,39,33,H1
"Crawford County, OH",2004-2005,45776,45536,-240,-0.524,43,-283,39,33,H1
"Crawford County, OH",2005-2006,45536,44907,-629,-1.381,52,-681,39,33,H1
"Crawford County, OH",2006-2007,44907,44634,-273,-0.608,7,-280,39,33,H1
"Crawford County, OH",2007-2008,44634,44291,-343,-0.768,-17,-326,39,33,H1
"Crawford County, OH",2008-2009,44291,43921,-370,-0.835,23,-393,39,33,H1
"Crawford County, OH",2009-2010,43921,43778,-143,-0.326,-11,-132,39,33,H1
"Crawford County, OH",2010-2011,43778,43307,-471,-1.076,18,-489,39,33,H1
"Crawford County, OH",2011-2012,43307,42847,-460,-1.062,-89,-371,39,33,H1
"Crawford County, OH",2012-2013,42847,42770,-77,-0.18,-13,-64,39,33,H1
"Crawford County, OH",2013-2014,42770,42480,-290,-0.678,9,-299,39,33,H1
"Crawford County, OH",2014-2015,42439,42306,-133,-0.313,-36,-97,39,33,H1
"Crawford County, OH",2015-2016,42306,42037,-269,-0.636,-72,-197,39,33,H1
"Crawford County, OH",2016-2017,42037,41746,-291,-0.692,-24,-267,39,33,H1
"Cuyahoga County, OH",2000-2001,1391959,1382520,-9439,-0.678,3041,-12480,39,35,H1
"Cuyahoga County, OH",2001-2002,1382520,1371493,-11027,-0.798,2316,-13343,39,35,H1
"Cuyahoga County, OH",2002-2003,1371493,1359929,-11564,-0.843,2573,-14137,39,35,H1
"Cuyahoga County, OH",2003-2004,1359929,1346714,-13215,-0.972,2331,-15546,39,35,H1
"Cuyahoga County, OH",2004-2005,1346714,1330612,-16102,-1.196,1750,-17852,39,35,H1
"Cuyahoga County, OH",2005-2006,1330612,1312816,-17796,-1.337,2523,-20319,39,35,H1
"Cuyahoga County, OH",2006-2007,1312816,1301540,-11276,-0.859,2538,-13814,39,35,H1
"Cuyahoga County, OH",2007-2008,1301540,1291479,-10061,-0.773,2277,-12338,39,35,H1
"Cuyahoga County, OH",2008-2009,1291479,1285082,-6397,-0.495,1828,-8225,39,35,H1
"Cuyahoga County, OH",2009-2010,1285082,1278172,-6910,-0.538,2567,-9477,39,35,H1
"Cuyahoga County, OH",2010-2011,1278172,1269839,-8333,-0.652,1253,-9586,39,35,H1
"Cuyahoga County, OH",2011-2012,1269839,1265889,-3950,-0.311,1003,-4953,39,35,H1
"Cuyahoga County, OH",2012-2013,1265889,1263837,-2052,-0.162,1496,-3548,39,35,H1
"Cuyahoga County, OH",2013-2014,1263837,1259828,-4009,-0.317,1485,-5494,39,35,H1
"Cuyahoga County, OH",2014-2015,1260610,1255921,-4689,-0.372,1932,-6621,39,35,H1
"Cuyahoga County, OH",2015-2016,1255921,1253454,-2467,-0.196,1066,-3533,39,35,H1
"Cuyahoga County, OH",2016-2017,1253454,1248514,-4940,-0.394,1198,-6138,39,35,H1
"Darke County, OH",2000-2001,53291,53110,-181,-0.34,104,-285,39,37,H1
"Darke County, OH",2001-2002,53110,53011,-99,-0.186,66,-165,39,37,H1
"Darke County, OH",2002-2003,53011,53190,179,0.338,115,64,39,37,H1
"Darke County, OH",2003-2004,53190,53236,46,0.086,87,-41,39,37,H1
"Darke County, OH",2004-2005,53236,53200,-36,-0.068,144,-180,39,37,H1
"Darke County, OH",2005-2006,53200,53023,-177,-0.333,178,-355,39,37,H1
"Darke County, OH",2006-2007,53023,52996,-27,-0.051,71,-98,39,37,H1
"Darke County, OH",2007-2008,52996,52909,-87,-0.164,133,-220,39,37,H1
"Darke County, OH",2008-2009,52909,52829,-80,-0.151,118,-198,39,37,H1
"Darke County, OH",2009-2010,52829,52958,129,0.244,54,75,39,37,H1
"Darke County, OH",2010-2011,52958,52672,-286,-0.54,37,-323,39,37,H1
"Darke County, OH",2011-2012,52672,52506,-166,-0.315,98,-264,39,37,H1
"Darke County, OH",2012-2013,52506,52351,-155,-0.295,26,-181,39,37,H1
"Darke County, OH",2013-2014,52351,52196,-155,-0.296,15,-170,39,37,H1
"Darke County, OH",2014-2015,52215,52076,-139,-0.266,62,-201,39,37,H1
"Darke County, OH",2015-2016,52076,51636,-440,-0.845,38,-478,39,37,H1
"Darke County, OH",2016-2017,51636,51536,-100,-0.194,2,-102,39,37,H1
"Defiance County, OH",2000-2001,39461,39456,-5,-0.013,160,-165,39,39,H1
"Defiance County, OH",2001-2002,39456,39303,-153,-0.388,151,-304,39,39,H1
"Defiance County, OH",2002-2003,39303,39209,-94,-0.239,188,-282,39,39,H1
"Defiance County, OH",2003-2004,39209,39115,-94,-0.24,180,-274,39,39,H1
"Defiance County, OH",2004-2005,39115,39049,-66,-0.169,150,-216,39,39,H1
"Defiance County, OH",2005-2006,39049,39154,105,0.269,168,-63,39,39,H1
"Defiance County, OH",2006-2007,39154,39123,-31,-0.079,192,-223,39,39,H1
"Defiance County, OH",2007-2008,39123,39250,127,0.325,155,-28,39,39,H1
"Defiance County, OH",2008-2009,39250,39060,-190,-0.484,172,-362,39,39,H1
"Defiance County, OH",2009-2010,39060,39106,46,0.118,116,-70,39,39,H1
"Defiance County, OH",2010-2011,39106,39024,-82,-0.21,118,-200,39,39,H1
"Defiance County, OH",2011-2012,39024,38818,-206,-0.528,65,-271,39,39,H1
"Defiance County, OH",2012-2013,38818,38515,-303,-0.781,34,-337,39,39,H1
"Defiance County, OH",2013-2014,38515,38510,-5,-0.013,34,-39,39,39,H1
"Defiance County, OH",2014-2015,38551,38352,-199,-0.516,38,-237,39,39,H1
"Defiance County, OH",2015-2016,38352,38121,-231,-0.602,57,-288,39,39,H1
"Defiance County, OH",2016-2017,38121,38156,35,0.092,27,8,39,39,H1
"Delaware County, OH",2000-2001,111759,118646,6887,6.162,1205,5682,39,41,H1
"Delaware County, OH",2001-2002,118646,126172,7526,6.343,1351,6175,39,41,H1
"Delaware County, OH",2002-2003,126172,133842,7670,6.079,1504,6166,39,41,H1
"Delaware County, OH",2003-2004,133842,141348,7506,5.608,1583,5923,39,41,H1
"Delaware County, OH",2004-2005,141348,149153,7805,5.522,1644,6161,39,41,H1
"Delaware County, OH",2005-2006,149153,156164,7011,4.701,1758,5253,39,41,H1
"Delaware County, OH",2006-2007,156164,161796,5632,3.606,1581,4051,39,41,H1
"Delaware County, OH",2007-2008,161796,166652,4856,3.001,1748,3108,39,41,H1
"Delaware County, OH",2008-2009,166652,170676,4024,2.415,1931,2093,39,41,H1
"Delaware County, OH",2009-2010,170676,175108,4432,2.597,1419,3013,39,41,H1
"Delaware County, OH",2010-2011,175108,178537,3429,1.958,1204,2225,39,41,H1
"Delaware County, OH",2011-2012,178537,181147,2610,1.462,1232,1378,39,41,H1
"Delaware County, OH",2012-2013,181147,185202,4055,2.239,1094,2961,39,41,H1
"Delaware County, OH",2013-2014,185202,189113,3911,2.112,1100,2811,39,41,H1
"Delaware County, OH",2014-2015,189237,193013,3776,1.995,1200,2576,39,41,H1
"Delaware County, OH",2015-2016,193013,196777,3764,1.95,1072,2692,39,41,H1
"Delaware County, OH",2016-2017,196777,200464,3687,1.874,1013,2674,39,41,H1
"Erie County, OH",2000-2001,79662,79308,-354,-0.444,134,-488,39,43,H1
"Erie County, OH",2001-2002,79308,78762,-546,-0.688,60,-606,39,43,H1
"Erie County, OH",2002-2003,78762,78673,-89,-0.113,133,-222,39,43,H1
"Erie County, OH",2003-2004,78673,78596,-77,-0.098,121,-198,39,43,H1
"Erie County, OH",2004-2005,78596,78070,-526,-0.669,-4,-522,39,43,H1
"Erie County, OH",2005-2006,78070,77876,-194,-0.248,41,-235,39,43,H1
"Erie County, OH",2006-2007,77876,77668,-208,-0.267,-12,-196,39,43,H1
"Erie County, OH",2007-2008,77668,77573,-95,-0.122,52,-147,39,43,H1
"Erie County, OH",2008-2009,77573,77085,-488,-0.629,52,-540,39,43,H1
"Erie County, OH",2009-2010,77085,77013,-72,-0.093,-53,-19,39,43,H1
"Erie County, OH",2010-2011,77013,76662,-351,-0.456,-105,-246,39,43,H1
"Erie County, OH",2011-2012,76662,76442,-220,-0.287,-152,-68,39,43,H1
"Erie County, OH",2012-2013,76442,76134,-308,-0.403,-58,-250,39,43,H1
"Erie County, OH",2013-2014,76134,75828,-306,-0.402,-87,-219,39,43,H1
"Erie County, OH",2014-2015,75860,75550,-310,-0.409,-75,-235,39,43,H1
"Erie County, OH",2015-2016,75550,74944,-606,-0.802,-177,-429,39,43,H1
"Erie County, OH",2016-2017,74944,74817,-127,-0.169,-132,5,39,43,H1
"Fairfield County, OH",2000-2001,123485,126245,2760,2.235,630,2130,39,45,H1
"Fairfield County, OH",2001-2002,126245,129355,3110,2.463,708,2402,39,45,H1
"Fairfield County, OH",2002-2003,129355,132770,3415,2.64,572,2843,39,45,H1
"Fairfield County, OH",2003-2004,132770,136074,3304,2.489,555,2749,39,45,H1
"Fairfield County, OH",2004-2005,136074,138745,2671,1.963,618,2053,39,45,H1
"Fairfield County, OH",2005-2006,138745,141005,2260,1.629,836,1424,39,45,H1
"Fairfield County, OH",2006-2007,141005,142915,1910,1.355,674,1236,39,45,H1
"Fairfield County, OH",2007-2008,142915,144029,1114,0.779,656,458,39,45,H1
"Fairfield County, OH",2008-2009,144029,145446,1417,0.984,724,693,39,45,H1
"Fairfield County, OH",2009-2010,145446,146391,945,0.65,478,467,39,45,H1
"Fairfield County, OH",2010-2011,146391,147319,928,0.634,517,411,39,45,H1
"Fairfield County, OH",2011-2012,147319,147446,127,0.086,537,-410,39,45,H1
"Fairfield County, OH",2012-2013,147446,148797,1351,0.916,444,907,39,45,H1
"Fairfield County, OH",2013-2014,148797,150381,1584,1.065,414,1170,39,45,H1
"Fairfield County, OH",2014-2015,150432,151408,976,0.649,489,487,39,45,H1
"Fairfield County, OH",2015-2016,151408,152681,1273,0.841,423,850,39,45,H1
"Fairfield County, OH",2016-2017,152681,154733,2052,1.344,378,1674,39,45,H1
"Fayette County, OH",2000-2001,28495,28310,-185,-0.649,5,-190,39,47,H1
"Fayette County, OH",2001-2002,28310,28370,60,0.212,79,-19,39,47,H1
"Fayette County, OH",2002-2003,28370,28450,80,0.282,7,73,39,47,H1
"Fayette County, OH",2003-2004,28450,28470,20,0.07,23,-3,39,47,H1
"Fayette County, OH",2004-2005,28470,28695,225,0.79,84,141,39,47,H1
"Fayette County, OH",2005-2006,28695,28791,96,0.335,66,30,39,47,H1
"Fayette County, OH",2006-2007,28791,28908,117,0.406,62,55,39,47,H1
"Fayette County, OH",2007-2008,28908,28896,-12,-0.042,71,-83,39,47,H1
"Fayette County, OH",2008-2009,28896,28929,33,0.114,38,-5,39,47,H1
"Fayette County, OH",2009-2010,28929,29017,88,0.304,22,66,39,47,H1
"Fayette County, OH",2010-2011,29017,28907,-110,-0.379,8,-118,39,47,H1
"Fayette County, OH",2011-2012,28907,28850,-57,-0.197,35,-92,39,47,H1
"Fayette County, OH",2012-2013,28850,28799,-51,-0.177,55,-106,39,47,H1
"Fayette County, OH",2013-2014,28799,28800,1,0.003,77,-76,39,47,H1
"Fayette County, OH",2014-2015,28690,28679,-11,-0.038,25,-36,39,47,H1
"Fayette County, OH",2015-2016,28679,28662,-17,-0.059,12,-29,39,47,H1
"Fayette County, OH",2016-2017,28662,28752,90,0.314,28,62,39,47,H1
"Franklin County, OH",2000-2001,1072018,1082938,10920,1.019,9082,1838,39,49,H1
"Franklin County, OH",2001-2002,1082938,1088693,5755,0.531,8821,-3066,39,49,H1
"Franklin County, OH",2002-2003,1088693,1095250,6557,0.602,8819,-2262,39,49,H1
"Franklin County, OH",2003-2004,1095250,1099603,4353,0.397,8936,-4583,39,49,H1
"Franklin County, OH",2004-2005,1099603,1105497,5894,0.536,8909,-3015,39,49,H1
"Franklin County, OH",2005-2006,1105497,1115924,10427,0.943,9583,844,39,49,H1
"Franklin County, OH",2006-2007,1115924,1127174,11250,1.008,10250,1.00E+03,39,49,H1
"Franklin County, OH",2007-2008,1127174,1141183,14009,1.243,9309,4700,39,49,H1
"Franklin County, OH",2008-2009,1141183,1155408,14225,1.247,8819,5406,39,49,H1
"Franklin County, OH",2009-2010,1155408,1166107,10699,0.926,9791,908,39,49,H1
"Franklin County, OH",2010-2011,1166107,1179691,13584,1.165,9222,4362,39,49,H1
"Franklin County, OH",2011-2012,1179691,1196936,17245,1.462,9511,7734,39,49,H1
"Franklin County, OH",2012-2013,1196936,1213834,16898,1.412,9353,7545,39,49,H1
"Franklin County, OH",2013-2014,1213834,1231393,17559,1.447,9398,8161,39,49,H1
"Franklin County, OH",2014-2015,1234126,1251722,17596,1.426,9941,7655,39,49,H1
"Franklin County, OH",2015-2016,1251722,1269998,18276,1.46,9636,8640,39,49,H1
"Franklin County, OH",2016-2017,1269998,1291981,21983,1.731,9497,12486,39,49,H1
"Fulton County, OH",2000-2001,42104,42169,65,0.154,232,-167,39,51,H1
"Fulton County, OH",2001-2002,42169,42275,106,0.251,176,-70,39,51,H1
"Fulton County, OH",2002-2003,42275,42402,127,0.3,127,0,39,51,H1
"Fulton County, OH",2003-2004,42402,42777,375,0.884,177,198,39,51,H1
"Fulton County, OH",2004-2005,42777,42897,120,0.281,158,-38,39,51,H1
"Fulton County, OH",2005-2006,42897,42785,-112,-0.261,197,-309,39,51,H1
"Fulton County, OH",2006-2007,42785,42800,15,0.035,154,-139,39,51,H1
"Fulton County, OH",2007-2008,42800,42780,-20,-0.047,174,-194,39,51,H1
"Fulton County, OH",2008-2009,42780,42747,-33,-0.077,192,-225,39,51,H1
"Fulton County, OH",2009-2010,42747,42660,-87,-0.204,148,-235,39,51,H1
"Fulton County, OH",2010-2011,42660,42529,-131,-0.307,90,-221,39,51,H1
"Fulton County, OH",2011-2012,42529,42516,-13,-0.031,81,-94,39,51,H1
"Fulton County, OH",2012-2013,42516,42418,-98,-0.231,89,-187,39,51,H1
"Fulton County, OH",2013-2014,42418,42580,162,0.382,46,116,39,51,H1
"Fulton County, OH",2014-2015,42591,42537,-54,-0.127,126,-180,39,51,H1
"Fulton County, OH",2015-2016,42537,42325,-212,-0.498,97,-309,39,51,H1
"Fulton County, OH",2016-2017,42325,42289,-36,-0.085,71,-107,39,51,H1
"Gallia County, OH",2000-2001,31072,31017,-55,-0.177,90,-145,39,53,H1
"Gallia County, OH",2001-2002,31017,31083,66,0.213,31,35,39,53,H1
"Gallia County, OH",2002-2003,31083,31095,12,0.039,62,-50,39,53,H1
"Gallia County, OH",2003-2004,31095,31029,-66,-0.212,63,-129,39,53,H1
"Gallia County, OH",2004-2005,31029,30993,-36,-0.116,32,-68,39,53,H1
"Gallia County, OH",2005-2006,30993,30927,-66,-0.213,105,-171,39,53,H1
"Gallia County, OH",2006-2007,30927,30977,50,0.162,40,10,39,53,H1
"Gallia County, OH",2007-2008,30977,30997,20,0.065,89,-69,39,53,H1
"Gallia County, OH",2008-2009,30997,30857,-140,-0.452,49,-189,39,53,H1
"Gallia County, OH",2009-2010,30857,31057,200,0.648,17,183,39,53,H1
"Gallia County, OH",2010-2011,31057,30960,-97,-0.312,4,-101,39,53,H1
"Gallia County, OH",2011-2012,30960,30805,-155,-0.501,41,-196,39,53,H1
"Gallia County, OH",2012-2013,30805,30597,-208,-0.675,23,-231,39,53,H1
"Gallia County, OH",2013-2014,30597,30397,-200,-0.654,19,-219,39,53,H1
"Gallia County, OH",2014-2015,30326,30142,-184,-0.607,30,-214,39,53,H1
"Gallia County, OH",2015-2016,30142,29996,-146,-0.484,5,-151,39,53,H1
"Gallia County, OH",2016-2017,29996,29973,-23,-0.077,6,-29,39,53,H1
"Geauga County, OH",2000-2001,91179,91429,250,0.274,499,-249,39,55,H1
"Geauga County, OH",2001-2002,91429,91970,541,0.592,404,137,39,55,H1
"Geauga County, OH",2002-2003,91970,93042,1072,1.166,408,664,39,55,H1
"Geauga County, OH",2003-2004,93042,93218,176,0.189,369,-193,39,55,H1
"Geauga County, OH",2004-2005,93218,93614,396,0.425,376,20,39,55,H1
"Geauga County, OH",2005-2006,93614,93839,225,0.24,358,-133,39,55,H1
"Geauga County, OH",2006-2007,93839,93742,-97,-0.103,260,-357,39,55,H1
"Geauga County, OH",2007-2008,93742,93583,-159,-0.17,368,-527,39,55,H1
"Geauga County, OH",2008-2009,93583,93446,-137,-0.146,413,-550,39,55,H1
"Geauga County, OH",2009-2010,93446,93422,-24,-0.026,144,-168,39,55,H1
"Geauga County, OH",2010-2011,93422,93403,-19,-0.02,183,-202,39,55,H1
"Geauga County, OH",2011-2012,93403,93917,514,0.55,195,319,39,55,H1
"Geauga County, OH",2012-2013,93917,94059,142,0.151,165,-23,39,55,H1
"Geauga County, OH",2013-2014,94059,94295,236,0.251,199,37,39,55,H1
"Geauga County, OH",2014-2015,94099,94102,3,0.003,161,-158,39,55,H1
"Geauga County, OH",2015-2016,94102,93848,-254,-0.27,60,-314,39,55,H1
"Geauga County, OH",2016-2017,93848,93918,70,0.075,85,-15,39,55,H1
"Greene County, OH",2000-2001,148401,149643,1242,0.837,504,738,39,57,H1
"Greene County, OH",2001-2002,149643,151537,1894,1.266,500,1394,39,57,H1
"Greene County, OH",2002-2003,151537,153064,1527,1.008,579,948,39,57,H1
"Greene County, OH",2003-2004,153064,155442,2378,1.554,631,1747,39,57,H1
"Greene County, OH",2004-2005,155442,156223,781,0.502,507,274,39,57,H1
"Greene County, OH",2005-2006,156223,157850,1627,1.041,690,937,39,57,H1
"Greene County, OH",2006-2007,157850,159055,1205,0.763,608,597,39,57,H1
"Greene County, OH",2007-2008,159055,160115,1060,0.666,652,408,39,57,H1
"Greene County, OH",2008-2009,160115,161075,960,0.6,631,329,39,57,H1
"Greene County, OH",2009-2010,161075,161614,539,0.335,533,6,39,57,H1
"Greene County, OH",2010-2011,161614,163522,1908,1.181,482,1426,39,57,H1
"Greene County, OH",2011-2012,163522,164145,623,0.381,411,212,39,57,H1
"Greene County, OH",2012-2013,164145,163465,-680,-0.414,444,-1124,39,57,H1
"Greene County, OH",2013-2014,163465,163820,355,0.217,407,-52,39,57,H1
"Greene County, OH",2014-2015,164660,164427,-233,-0.142,405,-638,39,57,H1
"Greene County, OH",2015-2016,164427,165109,682,0.415,452,230,39,57,H1
"Greene County, OH",2016-2017,165109,166752,1643,0.995,414,1229,39,57,H1
"Guernsey County, OH",2000-2001,40803,40860,57,0.14,127,-70,39,59,H1
"Guernsey County, OH",2001-2002,40860,40991,131,0.321,71,60,39,59,H1
"Guernsey County, OH",2002-2003,40991,41138,147,0.359,90,57,39,59,H1
"Guernsey County, OH",2003-2004,41138,40965,-173,-0.421,77,-250,39,59,H1
"Guernsey County, OH",2004-2005,40965,40752,-213,-0.52,55,-268,39,59,H1
"Guernsey County, OH",2005-2006,40752,40600,-152,-0.373,40,-192,39,59,H1
"Guernsey County, OH",2006-2007,40600,40531,-69,-0.17,78,-147,39,59,H1
"Guernsey County, OH",2007-2008,40531,40347,-184,-0.454,69,-253,39,59,H1
"Guernsey County, OH",2008-2009,40347,40242,-105,-0.26,50,-155,39,59,H1
"Guernsey County, OH",2009-2010,40242,40102,-140,-0.348,5,-145,39,59,H1
"Guernsey County, OH",2010-2011,40102,39847,-255,-0.636,8,-263,39,59,H1
"Guernsey County, OH",2011-2012,39847,39813,-34,-0.085,20,-54,39,59,H1
"Guernsey County, OH",2012-2013,39813,39614,-199,-0.5,47,-246,39,59,H1
"Guernsey County, OH",2013-2014,39614,39590,-24,-0.061,12,-36,39,59,H1
"Guernsey County, OH",2014-2015,39582,39258,-324,-0.819,20,-344,39,59,H1
"Guernsey County, OH",2015-2016,39258,39200,-58,-0.148,18,-76,39,59,H1
"Guernsey County, OH",2016-2017,39200,39093,-107,-0.273,11,-118,39,59,H1
"Hamilton County, OH",2000-2001,844124,840335,-3789,-0.449,3649,-7438,39,61,H1
"Hamilton County, OH",2001-2002,840335,832390,-7945,-0.945,3019,-10964,39,61,H1
"Hamilton County, OH",2002-2003,832390,825139,-7251,-0.871,3553,-10804,39,61,H1
"Hamilton County, OH",2003-2004,825139,817306,-7833,-0.949,3603,-11436,39,61,H1
"Hamilton County, OH",2004-2005,817306,810352,-6954,-0.851,3439,-10393,39,61,H1
"Hamilton County, OH",2005-2006,810352,804913,-5439,-0.671,3489,-8928,39,61,H1
"Hamilton County, OH",2006-2007,804913,801815,-3098,-0.385,3861,-6959,39,61,H1
"Hamilton County, OH",2007-2008,801815,799840,-1975,-0.246,3693,-5668,39,61,H1
"Hamilton County, OH",2008-2009,799840,802149,2309,0.289,3380,-1071,39,61,H1
"Hamilton County, OH",2009-2010,802149,802298,149,0.019,4057,-3908,39,61,H1
"Hamilton County, OH",2010-2011,802298,800648,-1650,-0.206,3208,-4858,39,61,H1
"Hamilton County, OH",2011-2012,800648,802355,1707,0.213,3470,-1763,39,61,H1
"Hamilton County, OH",2012-2013,802355,804429,2074,0.258,3452,-1378,39,61,H1
"Hamilton County, OH",2013-2014,804429,806631,2202,0.274,3291,-1089,39,61,H1
"Hamilton County, OH",2014-2015,806332,807598,1266,0.157,3174,-1908,39,61,H1
"Hamilton County, OH",2015-2016,807598,810087,2489,0.308,2819,-330,39,61,H1
"Hamilton County, OH",2016-2017,810087,813822,3735,0.461,3019,716,39,61,H1
"Hancock County, OH",2000-2001,71321,71972,651,0.913,353,298,39,63,H1
"Hancock County, OH",2001-2002,71972,72617,645,0.896,321,324,39,63,H1
"Hancock County, OH",2002-2003,72617,73118,501,0.69,305,196,39,63,H1
"Hancock County, OH",2003-2004,73118,73532,414,0.566,288,126,39,63,H1
"Hancock County, OH",2004-2005,73532,73585,53,0.072,270,-217,39,63,H1
"Hancock County, OH",2005-2006,73585,74167,582,0.791,319,263,39,63,H1
"Hancock County, OH",2006-2007,74167,74712,545,0.735,296,249,39,63,H1
"Hancock County, OH",2007-2008,74712,74781,69,0.092,378,-309,39,63,H1
"Hancock County, OH",2008-2009,74781,74964,183,0.245,317,-134,39,63,H1
"Hancock County, OH",2009-2010,74964,74674,-290,-0.387,240,-530,39,63,H1
"Hancock County, OH",2010-2011,74674,75080,406,0.544,166,240,39,63,H1
"Hancock County, OH",2011-2012,75080,75647,567,0.755,228,339,39,63,H1
"Hancock County, OH",2012-2013,75647,75712,65,0.086,206,-141,39,63,H1
"Hancock County, OH",2013-2014,75712,75337,-375,-0.495,249,-624,39,63,H1
"Hancock County, OH",2014-2015,75263,75573,310,0.412,266,44,39,63,H1
"Hancock County, OH",2015-2016,75573,75590,17,0.022,160,-143,39,63,H1
"Hancock County, OH",2016-2017,75590,75754,164,0.217,196,-32,39,63,H1
"Hardin County, OH",2000-2001,31952,31753,-199,-0.623,97,-296,39,65,H1
"Hardin County, OH",2001-2002,31753,31804,51,0.161,56,-5,39,65,H1
"Hardin County, OH",2002-2003,31804,31729,-75,-0.236,94,-169,39,65,H1
"Hardin County, OH",2003-2004,31729,32119,390,1.229,56,334,39,65,H1
"Hardin County, OH",2004-2005,32119,31983,-136,-0.423,70,-206,39,65,H1
"Hardin County, OH",2005-2006,31983,31939,-44,-0.138,30,-74,39,65,H1
"Hardin County, OH",2006-2007,31939,32132,193,0.604,74,119,39,65,H1
"Hardin County, OH",2007-2008,32132,32200,68,0.212,109,-41,39,65,H1
"Hardin County, OH",2008-2009,32200,32185,-15,-0.047,79,-94,39,65,H1
"Hardin County, OH",2009-2010,32185,32102,-83,-0.258,30,-113,39,65,H1
"Hardin County, OH",2010-2011,32102,31821,-281,-0.875,53,-334,39,65,H1
"Hardin County, OH",2011-2012,31821,31643,-178,-0.559,59,-237,39,65,H1
"Hardin County, OH",2012-2013,31643,31767,124,0.392,72,52,39,65,H1
"Hardin County, OH",2013-2014,31767,31796,29,0.091,54,-25,39,65,H1
"Hardin County, OH",2014-2015,31791,31682,-109,-0.343,71,-180,39,65,H1
"Hardin County, OH",2015-2016,31682,31407,-275,-0.868,49,-324,39,65,H1
"Hardin County, OH",2016-2017,31407,31364,-43,-0.137,32,-75,39,65,H1
"Harrison County, OH",2000-2001,15854,15796,-58,-0.366,-42,-16,39,67,H1
"Harrison County, OH",2001-2002,15796,15902,106,0.671,-25,131,39,67,H1
"Harrison County, OH",2002-2003,15902,16002,100,0.629,-40,140,39,67,H1
"Harrison County, OH",2003-2004,16002,15856,-146,-0.912,-69,-77,39,67,H1
"Harrison County, OH",2004-2005,15856,15907,51,0.322,-38,89,39,67,H1
"Harrison County, OH",2005-2006,15907,15868,-39,-0.245,-33,-6,39,67,H1
"Harrison County, OH",2006-2007,15868,15901,33,0.208,-13,46,39,67,H1
"Harrison County, OH",2007-2008,15901,15856,-45,-0.283,-13,-32,39,67,H1
"Harrison County, OH",2008-2009,15856,15860,4,0.025,-48,52,39,67,H1
"Harrison County, OH",2009-2010,15860,15840,-20,-0.126,-58,38,39,67,H1
"Harrison County, OH",2010-2011,15840,15788,-52,-0.328,-50,-2,39,67,H1
"Harrison County, OH",2011-2012,15788,15694,-94,-0.595,-49,-45,39,67,H1
"Harrison County, OH",2012-2013,15694,15624,-70,-0.446,-35,-35,39,67,H1
"Harrison County, OH",2013-2014,15624,15543,-81,-0.518,-44,-37,39,67,H1
"Harrison County, OH",2014-2015,15567,15450,-117,-0.752,-46,-71,39,67,H1
"Harrison County, OH",2015-2016,15450,15257,-193,-1.249,-30,-163,39,67,H1
"Harrison County, OH",2016-2017,15257,15216,-41,-0.269,-37,-4,39,67,H1
"Henry County, OH",2000-2001,29177,29055,-122,-0.418,127,-249,39,69,H1
"Henry County, OH",2001-2002,29055,29119,64,0.22,122,-58,39,69,H1
"Henry County, OH",2002-2003,29119,29021,-98,-0.337,65,-163,39,69,H1
"Henry County, OH",2003-2004,29021,29014,-7,-0.024,105,-112,39,69,H1
"Henry County, OH",2004-2005,29014,29031,17,0.059,138,-121,39,69,H1
"Henry County, OH",2005-2006,29031,29026,-5,-0.017,142,-147,39,69,H1
"Henry County, OH",2006-2007,29026,28671,-355,-1.223,151,-506,39,69,H1
"Henry County, OH",2007-2008,28671,28523,-148,-0.516,86,-234,39,69,H1
"Henry County, OH",2008-2009,28523,28322,-201,-0.705,94,-295,39,69,H1
"Henry County, OH",2009-2010,28322,28102,-220,-0.777,64,-284,39,69,H1
"Henry County, OH",2010-2011,28102,28210,108,0.384,45,63,39,69,H1
"Henry County, OH",2011-2012,28210,28060,-150,-0.532,55,-205,39,69,H1
"Henry County, OH",2012-2013,28060,28061,1,0.004,113,-112,39,69,H1
"Henry County, OH",2013-2014,28061,27937,-124,-0.442,107,-231,39,69,H1
"Henry County, OH",2014-2015,27887,27816,-71,-0.255,61,-132,39,69,H1
"Henry County, OH",2015-2016,27816,27269,-547,-1.966,-12,-535,39,69,H1
"Henry County, OH",2016-2017,27269,27185,-84,-0.308,42,-126,39,69,H1
"Highland County, OH",2000-2001,41019,41295,276,0.673,130,146,39,71,H1
"Highland County, OH",2001-2002,41295,41857,562,1.361,149,413,39,71,H1
"Highland County, OH",2002-2003,41857,42269,412,0.984,201,211,39,71,H1
"Highland County, OH",2003-2004,42269,42938,669,1.583,180,489,39,71,H1
"Highland County, OH",2004-2005,42938,42967,29,0.068,123,-94,39,71,H1
"Highland County, OH",2005-2006,42967,43562,595,1.385,178,417,39,71,H1
"Highland County, OH",2006-2007,43562,43845,283,0.65,165,118,39,71,H1
"Highland County, OH",2007-2008,43845,43700,-145,-0.331,152,-297,39,71,H1
"Highland County, OH",2008-2009,43700,43578,-122,-0.279,145,-267,39,71,H1
"Highland County, OH",2009-2010,43578,43598,20,0.046,79,-59,39,71,H1
"Highland County, OH",2010-2011,43598,43428,-170,-0.39,67,-237,39,71,H1
"Highland County, OH",2011-2012,43428,43024,-404,-0.93,57,-461,39,71,H1
"Highland County, OH",2012-2013,43024,43233,209,0.486,12,197,39,71,H1
"Highland County, OH",2013-2014,43233,43045,-188,-0.435,40,-228,39,71,H1
"Highland County, OH",2014-2015,43115,43026,-89,-0.206,93,-182,39,71,H1
"Highland County, OH",2015-2016,43026,42993,-33,-0.077,77,-110,39,71,H1
"Highland County, OH",2016-2017,42993,42971,-22,-0.051,93,-115,39,71,H1
"Hocking County, OH",2000-2001,28262,28452,190,0.672,57,133,39,73,H1
"Hocking County, OH",2001-2002,28452,28653,201,0.706,76,125,39,73,H1
"Hocking County, OH",2002-2003,28653,28823,170,0.593,71,99,39,73,H1
"Hocking County, OH",2003-2004,28823,28962,139,0.482,95,44,39,73,H1
"Hocking County, OH",2004-2005,28962,29058,96,0.331,84,12,39,73,H1
"Hocking County, OH",2005-2006,29058,29097,39,0.134,69,-30,39,73,H1
"Hocking County, OH",2006-2007,29097,29418,321,1.103,95,226,39,73,H1
"Hocking County, OH",2007-2008,29418,29445,27,0.092,42,-15,39,73,H1
"Hocking County, OH",2008-2009,29445,29358,-87,-0.295,64,-151,39,73,H1
"Hocking County, OH",2009-2010,29358,29466,108,0.368,16,92,39,73,H1
"Hocking County, OH",2010-2011,29466,29466,0,0,6,-6,39,73,H1
"Hocking County, OH",2011-2012,29466,29291,-175,-0.594,12,-187,39,73,H1
"Hocking County, OH",2012-2013,29291,28608,-683,-2.332,25,-708,39,73,H1
"Hocking County, OH",2013-2014,28608,28725,117,0.409,18,99,39,73,H1
"Hocking County, OH",2014-2015,28700,28491,-209,-0.728,19,-228,39,73,H1
"Hocking County, OH",2015-2016,28491,28386,-105,-0.369,36,-141,39,73,H1
"Hocking County, OH",2016-2017,28386,28474,88,0.31,15,73,39,73,H1
"Holmes County, OH",2000-2001,39049,39805,756,1.936,640,116,39,75,H1
"Holmes County, OH",2001-2002,39805,40475,670,1.683,583,87,39,75,H1
"Holmes County, OH",2002-2003,40475,40844,369,0.912,597,-228,39,75,H1
"Holmes County, OH",2003-2004,40844,41370,526,1.288,573,-47,39,75,H1
"Holmes County, OH",2004-2005,41370,41630,260,0.628,484,-224,39,75,H1
"Holmes County, OH",2005-2006,41630,41828,198,0.476,495,-297,39,75,H1
"Holmes County, OH",2006-2007,41828,41826,-2,-0.005,551,-553,39,75,H1
"Holmes County, OH",2007-2008,41826,42029,203,0.485,489,-286,39,75,H1
"Holmes County, OH",2008-2009,42029,42275,246,0.585,541,-295,39,75,H1
"Holmes County, OH",2009-2010,42275,42467,192,0.454,424,-232,39,75,H1
"Holmes County, OH",2010-2011,42467,42777,310,0.73,503,-193,39,75,H1
"Holmes County, OH",2011-2012,42777,43105,328,0.767,506,-178,39,75,H1
"Holmes County, OH",2012-2013,43105,43635,530,1.23,522,8,39,75,H1
"Holmes County, OH",2013-2014,43635,43898,263,0.603,506,-243,39,75,H1
"Holmes County, OH",2014-2015,43801,43909,108,0.247,462,-354,39,75,H1
"Holmes County, OH",2015-2016,43909,43832,-77,-0.175,397,-474,39,75,H1
"Holmes County, OH",2016-2017,43832,43957,125,0.285,445,-320,39,75,H1
"Huron County, OH",2000-2001,59611,59620,9,0.015,370,-361,39,77,H1
"Huron County, OH",2001-2002,59620,59917,297,0.498,348,-51,39,77,H1
"Huron County, OH",2002-2003,59917,59947,30,0.05,342,-312,39,77,H1
"Huron County, OH",2003-2004,59947,60011,64,0.107,267,-203,39,77,H1
"Huron County, OH",2004-2005,60011,60116,105,0.175,324,-219,39,77,H1
"Huron County, OH",2005-2006,60116,60113,-3,-0.005,247,-250,39,77,H1
"Huron County, OH",2006-2007,60113,60086,-27,-0.045,313,-340,39,77,H1
"Huron County, OH",2007-2008,60086,60121,35,0.058,337,-302,39,77,H1
"Huron County, OH",2008-2009,60121,59754,-367,-0.61,308,-675,39,77,H1
"Huron County, OH",2009-2010,59754,59599,-155,-0.259,185,-340,39,77,H1
"Huron County, OH",2010-2011,59599,59431,-168,-0.282,212,-380,39,77,H1
"Huron County, OH",2011-2012,59431,59295,-136,-0.229,108,-244,39,77,H1
"Huron County, OH",2012-2013,59295,58889,-406,-0.685,152,-558,39,77,H1
"Huron County, OH",2013-2014,58889,58714,-175,-0.297,165,-340,39,77,H1
"Huron County, OH",2014-2015,58685,58469,-216,-0.368,199,-415,39,77,H1
"Huron County, OH",2015-2016,58469,58391,-78,-0.133,227,-305,39,77,H1
"Huron County, OH",2016-2017,58391,58494,103,0.176,201,-98,39,77,H1
"Jackson County, OH",2000-2001,32633,32670,37,0.113,75,-38,39,79,H1
"Jackson County, OH",2001-2002,32670,32846,176,0.539,46,130,39,79,H1
"Jackson County, OH",2002-2003,32846,32880,34,0.104,75,-41,39,79,H1
"Jackson County, OH",2003-2004,32880,33025,145,0.441,81,64,39,79,H1
"Jackson County, OH",2004-2005,33025,33242,217,0.657,87,130,39,79,H1
"Jackson County, OH",2005-2006,33242,33135,-107,-0.322,76,-183,39,79,H1
"Jackson County, OH",2006-2007,33135,33144,9,0.027,60,-51,39,79,H1
"Jackson County, OH",2007-2008,33144,33164,20,0.06,80,-60,39,79,H1
"Jackson County, OH",2008-2009,33164,33115,-49,-0.148,68,-117,39,79,H1
"Jackson County, OH",2009-2010,33115,33238,123,0.371,25,98,39,79,H1
"Jackson County, OH",2010-2011,33238,33116,-122,-0.367,14,-136,39,79,H1
"Jackson County, OH",2011-2012,33116,32873,-243,-0.734,9,-252,39,79,H1
"Jackson County, OH",2012-2013,32873,32784,-89,-0.271,52,-141,39,79,H1
"Jackson County, OH",2013-2014,32784,32748,-36,-0.11,57,-93,39,79,H1
"Jackson County, OH",2014-2015,32784,32596,-188,-0.573,54,-242,39,79,H1
"Jackson County, OH",2015-2016,32596,32534,-62,-0.19,16,-78,39,79,H1
"Jackson County, OH",2016-2017,32534,32449,-85,-0.261,30,-115,39,79,H1
"Jefferson County, OH",2000-2001,73663,73043,-620,-0.842,-237,-383,39,81,H1
"Jefferson County, OH",2001-2002,73043,72416,-627,-0.858,-363,-264,39,81,H1
"Jefferson County, OH",2002-2003,72416,72122,-294,-0.406,-262,-32,39,81,H1
"Jefferson County, OH",2003-2004,72122,71774,-348,-0.483,-318,-30,39,81,H1
"Jefferson County, OH",2004-2005,71774,71251,-523,-0.729,-229,-294,39,81,H1
"Jefferson County, OH",2005-2006,71251,70656,-595,-0.835,-232,-363,39,81,H1
"Jefferson County, OH",2006-2007,70656,70114,-542,-0.767,-263,-279,39,81,H1
"Jefferson County, OH",2007-2008,70114,69989,-125,-0.178,-251,126,39,81,H1
"Jefferson County, OH",2008-2009,69989,69833,-156,-0.223,-251,95,39,81,H1
"Jefferson County, OH",2009-2010,69833,69613,-220,-0.315,-290,70,39,81,H1
"Jefferson County, OH",2010-2011,69613,68889,-724,-1.04,-403,-321,39,81,H1
"Jefferson County, OH",2011-2012,68889,68347,-542,-0.787,-374,-168,39,81,H1
"Jefferson County, OH",2012-2013,68347,68007,-340,-0.497,-257,-83,39,81,H1
"Jefferson County, OH",2013-2014,68007,67694,-313,-0.46,-289,-24,39,81,H1
"Jefferson County, OH",2014-2015,67703,67347,-356,-0.526,-250,-106,39,81,H1
"Jefferson County, OH",2015-2016,67347,66914,-433,-0.643,-245,-188,39,81,H1
"Jefferson County, OH",2016-2017,66914,66359,-555,-0.829,-276,-279,39,81,H1
"Knox County, OH",2000-2001,54616,55460,844,1.545,182,662,39,83,H1
"Knox County, OH",2001-2002,55460,56377,917,1.653,221,696,39,83,H1
"Knox County, OH",2002-2003,56377,57232,855,1.517,165,690,39,83,H1
"Knox County, OH",2003-2004,57232,57995,763,1.333,100,663,39,83,H1
"Knox County, OH",2004-2005,57995,58641,646,1.114,139,507,39,83,H1
"Knox County, OH",2005-2006,58641,59194,553,0.943,185,368,39,83,H1
"Knox County, OH",2006-2007,59194,59843,649,1.096,222,427,39,83,H1
"Knox County, OH",2007-2008,59843,60348,505,0.844,170,335,39,83,H1
"Knox County, OH",2008-2009,60348,60633,285,0.472,150,135,39,83,H1
"Knox County, OH",2009-2010,60633,61095,462,0.762,49,413,39,83,H1
"Knox County, OH",2010-2011,61095,61311,216,0.354,58,158,39,83,H1
"Knox County, OH",2011-2012,61311,60817,-494,-0.806,100,-594,39,83,H1
"Knox County, OH",2012-2013,60817,60923,106,0.174,144,-38,39,83,H1
"Knox County, OH",2013-2014,60923,61167,244,0.401,163,81,39,83,H1
"Knox County, OH",2014-2015,61013,61061,48,0.079,137,-89,39,83,H1
"Knox County, OH",2015-2016,61061,60832,-229,-0.375,140,-369,39,83,H1
"Knox County, OH",2016-2017,60832,61261,429,0.705,116,313,39,83,H1
"Lake County, OH",2000-2001,227548,227648,100,0.044,713,-613,39,85,H1
"Lake County, OH",2001-2002,227648,227747,99,0.043,498,-399,39,85,H1
"Lake County, OH",2002-2003,227747,227232,-515,-0.226,435,-950,39,85,H1
"Lake County, OH",2003-2004,227232,227829,597,0.263,395,202,39,85,H1
"Lake County, OH",2004-2005,227829,227647,-182,-0.08,278,-460,39,85,H1
"Lake County, OH",2005-2006,227647,228203,556,0.244,432,124,39,85,H1
"Lake County, OH",2006-2007,228203,228930,727,0.319,324,403,39,85,H1
"Lake County, OH",2007-2008,228930,229904,974,0.425,434,540,39,85,H1
"Lake County, OH",2008-2009,229904,229954,50,0.022,418,-368,39,85,H1
"Lake County, OH",2009-2010,229954,229993,39,0.017,171,-132,39,85,H1
"Lake County, OH",2010-2011,229993,229787,-206,-0.09,-9,-197,39,85,H1
"Lake County, OH",2011-2012,229787,229365,-422,-0.184,-127,-295,39,85,H1
"Lake County, OH",2012-2013,229365,229634,269,0.117,-78,347,39,85,H1
"Lake County, OH",2013-2014,229634,229230,-404,-0.176,-162,-242,39,85,H1
"Lake County, OH",2014-2015,229220,229245,25,0.011,-70,95,39,85,H1
"Lake County, OH",2015-2016,229245,229270,25,0.011,-188,213,39,85,H1
"Lake County, OH",2016-2017,229270,230117,847,0.369,-200,1047,39,85,H1
"Lawrence County, OH",2000-2001,62237,61965,-272,-0.437,48,-320,39,87,H1
"Lawrence County, OH",2001-2002,61965,61847,-118,-0.19,-59,-59,39,87,H1
"Lawrence County, OH",2002-2003,61847,62197,350,0.566,26,324,39,87,H1
"Lawrence County, OH",2003-2004,62197,62169,-28,-0.045,-6,-22,39,87,H1
"Lawrence County, OH",2004-2005,62169,62476,307,0.494,30,277,39,87,H1
"Lawrence County, OH",2005-2006,62476,62798,322,0.515,98,224,39,87,H1
"Lawrence County, OH",2006-2007,62798,62748,-50,-0.08,49,-99,39,87,H1
"Lawrence County, OH",2007-2008,62748,62640,-108,-0.172,51,-159,39,87,H1
"Lawrence County, OH",2008-2009,62640,62667,27,0.043,-8,35,39,87,H1
"Lawrence County, OH",2009-2010,62667,62445,-222,-0.354,-65,-157,39,87,H1
"Lawrence County, OH",2010-2011,62445,62406,-39,-0.062,4,-43,39,87,H1
"Lawrence County, OH",2011-2012,62406,62108,-298,-0.478,4,-302,39,87,H1
"Lawrence County, OH",2012-2013,62108,61918,-190,-0.306,-33,-157,39,87,H1
"Lawrence County, OH",2013-2014,61918,61623,-295,-0.476,9,-304,39,87,H1
"Lawrence County, OH",2014-2015,61601,61109,-492,-0.799,-7,-485,39,87,H1
"Lawrence County, OH",2015-2016,61109,60729,-380,-0.622,-95,-285,39,87,H1
"Lawrence County, OH",2016-2017,60729,60249,-480,-0.79,-67,-413,39,87,H1
"Licking County, OH",2000-2001,146268,148226,1958,1.339,724,1234,39,89,H1
"Licking County, OH",2001-2002,148226,150061,1835,1.238,664,1171,39,89,H1
"Licking County, OH",2002-2003,150061,152582,2521,1.68,777,1744,39,89,H1
"Licking County, OH",2003-2004,152582,155264,2682,1.758,736,1946,39,89,H1
"Licking County, OH",2004-2005,155264,157950,2686,1.73,625,2061,39,89,H1
"Licking County, OH",2005-2006,157950,160263,2313,1.464,819,1494,39,89,H1
"Licking County, OH",2006-2007,160263,162375,2112,1.318,766,1346,39,89,H1
"Licking County, OH",2007-2008,162375,163916,1541,0.949,745,796,39,89,H1
"Licking County, OH",2008-2009,163916,165283,1367,0.834,756,611,39,89,H1
"Licking County, OH",2009-2010,165283,166707,1424,0.862,474,950,39,89,H1
"Licking County, OH",2010-2011,166707,167234,527,0.316,523,4,39,89,H1
"Licking County, OH",2011-2012,167234,167719,485,0.29,462,23,39,89,H1
"Licking County, OH",2012-2013,167719,168503,784,0.467,449,335,39,89,H1
"Licking County, OH",2013-2014,168503,169390,887,0.526,443,444,39,89,H1
"Licking County, OH",2014-2015,169407,170570,1163,0.687,457,706,39,89,H1
"Licking County, OH",2015-2016,170570,171822,1252,0.734,449,803,39,89,H1
"Licking County, OH",2016-2017,171822,173448,1626,0.946,408,1218,39,89,H1
"Logan County, OH",2000-2001,45984,45865,-119,-0.259,148,-267,39,91,H1
"Logan County, OH",2001-2002,45865,46089,224,0.488,217,7,39,91,H1
"Logan County, OH",2002-2003,46089,46257,168,0.365,154,14,39,91,H1
"Logan County, OH",2003-2004,46257,46247,-10,-0.022,153,-163,39,91,H1
"Logan County, OH",2004-2005,46247,46066,-181,-0.391,122,-303,39,91,H1
"Logan County, OH",2005-2006,46066,45902,-164,-0.356,164,-328,39,91,H1
"Logan County, OH",2006-2007,45902,46154,252,0.549,201,51,39,91,H1
"Logan County, OH",2007-2008,46154,46115,-39,-0.084,193,-232,39,91,H1
"Logan County, OH",2008-2009,46115,46055,-60,-0.13,158,-218,39,91,H1
"Logan County, OH",2009-2010,46055,45774,-281,-0.61,84,-365,39,91,H1
"Logan County, OH",2010-2011,45774,45621,-153,-0.334,131,-284,39,91,H1
"Logan County, OH",2011-2012,45621,45454,-167,-0.366,79,-246,39,91,H1
"Logan County, OH",2012-2013,45454,45466,12,0.026,45,-33,39,91,H1
"Logan County, OH",2013-2014,45466,45507,41,0.09,40,1,39,91,H1
"Logan County, OH",2014-2015,45509,45386,-123,-0.27,72,-195,39,91,H1
"Logan County, OH",2015-2016,45386,45171,-215,-0.474,59,-274,39,91,H1
"Logan County, OH",2016-2017,45171,45325,154,0.341,48,106,39,91,H1
"Lorain County, OH",2000-2001,285095,285827,732,0.257,1373,-641,39,93,H1
"Lorain County, OH",2001-2002,285827,287489,1662,0.581,1075,587,39,93,H1
"Lorain County, OH",2002-2003,287489,290622,3133,1.09,1063,2070,39,93,H1
"Lorain County, OH",2003-2004,290622,292125,1503,0.517,1040,463,39,93,H1
"Lorain County, OH",2004-2005,292125,294873,2748,0.941,974,1774,39,93,H1
"Lorain County, OH",2005-2006,294873,297259,2386,0.809,1123,1263,39,93,H1
"Lorain County, OH",2006-2007,297259,298609,1350,0.454,936,414,39,93,H1
"Lorain County, OH",2007-2008,298609,299814,1205,0.404,1104,101,39,93,H1
"Lorain County, OH",2008-2009,299814,300893,1079,0.36,1067,12,39,93,H1
"Lorain County, OH",2009-2010,300893,301478,585,0.194,540,45,39,93,H1
"Lorain County, OH",2010-2011,301478,301932,454,0.151,574,-120,39,93,H1
"Lorain County, OH",2011-2012,301932,301695,-237,-0.078,543,-780,39,93,H1
"Lorain County, OH",2012-2013,301695,303006,1311,0.435,558,753,39,93,H1
"Lorain County, OH",2013-2014,303006,304216,1210,0.399,546,664,39,93,H1
"Lorain County, OH",2014-2015,304187,305147,960,0.316,542,418,39,93,H1
"Lorain County, OH",2015-2016,305147,306590,1443,0.473,327,1116,39,93,H1
"Lorain County, OH",2016-2017,306590,307924,1334,0.435,382,952,39,93,H1
"Lucas County, OH",2000-2001,454904,454855,-49,-0.011,1749,-1798,39,95,H1
"Lucas County, OH",2001-2002,454855,454240,-615,-0.135,1907,-2522,39,95,H1
"Lucas County, OH",2002-2003,454240,453778,-462,-0.102,1845,-2307,39,95,H1
"Lucas County, OH",2003-2004,453778,451255,-2523,-0.556,1973,-4496,39,95,H1
"Lucas County, OH",2004-2005,451255,449224,-2031,-0.45,1972,-4003,39,95,H1
"Lucas County, OH",2005-2006,449224,446769,-2455,-0.546,2174,-4629,39,95,H1
"Lucas County, OH",2006-2007,446769,445482,-1287,-0.288,2151,-3438,39,95,H1
"Lucas County, OH",2007-2008,445482,443909,-1573,-0.353,2098,-3671,39,95,H1
"Lucas County, OH",2008-2009,443909,442603,-1306,-0.294,1973,-3279,39,95,H1
"Lucas County, OH",2009-2010,442603,441599,-1004,-0.227,1841,-2845,39,95,H1
"Lucas County, OH",2010-2011,441599,439771,-1828,-0.414,1400,-3228,39,95,H1
"Lucas County, OH",2011-2012,439771,437376,-2395,-0.545,1364,-3759,39,95,H1
"Lucas County, OH",2012-2013,437376,436803,-573,-0.131,1330,-1903,39,95,H1
"Lucas County, OH",2013-2014,436803,435286,-1517,-0.347,1377,-2894,39,95,H1
"Lucas County, OH",2014-2015,434615,433689,-926,-0.213,1301,-2227,39,95,H1
"Lucas County, OH",2015-2016,433689,432562,-1127,-0.26,1141,-2268,39,95,H1
"Lucas County, OH",2016-2017,432562,430887,-1675,-0.387,1029,-2704,39,95,H1
"Madison County, OH",2000-2001,40218,40256,38,0.094,135,-97,39,97,H1
"Madison County, OH",2001-2002,40256,40539,283,0.703,161,122,39,97,H1
"Madison County, OH",2002-2003,40539,40879,340,0.839,164,176,39,97,H1
"Madison County, OH",2003-2004,40879,41122,243,0.594,87,156,39,97,H1
"Madison County, OH",2004-2005,41122,41292,170,0.413,93,77,39,97,H1
"Madison County, OH",2005-2006,41292,41865,573,1.388,156,417,39,97,H1
"Madison County, OH",2006-2007,41865,42392,527,1.259,153,374,39,97,H1
"Madison County, OH",2007-2008,42392,43163,771,1.819,131,640,39,97,H1
"Madison County, OH",2008-2009,43163,43353,190,0.44,130,60,39,97,H1
"Madison County, OH",2009-2010,43353,43412,59,0.136,73,-14,39,97,H1
"Madison County, OH",2010-2011,43412,43071,-341,-0.785,56,-397,39,97,H1
"Madison County, OH",2011-2012,43071,42959,-112,-0.26,55,-167,39,97,H1
"Madison County, OH",2012-2013,42959,43272,313,0.729,26,287,39,97,H1
"Madison County, OH",2013-2014,43272,43918,646,1.493,71,575,39,97,H1
"Madison County, OH",2014-2015,43937,44094,157,0.357,69,88,39,97,H1
"Madison County, OH",2015-2016,44094,43354,-740,-1.678,-8,-732,39,97,H1
"Madison County, OH",2016-2017,43354,44036,682,1.573,1,681,39,97,H1
"Mahoning County, OH",2000-2001,257104,255264,-1840,-0.716,-209,-1631,39,99,H1
"Mahoning County, OH",2001-2002,255264,252998,-2266,-0.888,-269,-1997,39,99,H1
"Mahoning County, OH",2002-2003,252998,251696,-1302,-0.515,-419,-883,39,99,H1
"Mahoning County, OH",2003-2004,251696,249825,-1871,-0.743,-306,-1565,39,99,H1
"Mahoning County, OH",2004-2005,249825,247702,-2123,-0.85,-480,-1643,39,99,H1
"Mahoning County, OH",2005-2006,247702,246112,-1590,-0.642,-168,-1422,39,99,H1
"Mahoning County, OH",2006-2007,246112,243453,-2659,-1.08,-352,-2307,39,99,H1
"Mahoning County, OH",2007-2008,243453,241572,-1881,-0.773,-366,-1515,39,99,H1
"Mahoning County, OH",2008-2009,241572,240050,-1522,-0.63,-365,-1157,39,99,H1
"Mahoning County, OH",2009-2010,240050,238406,-1644,-0.685,-470,-1174,39,99,H1
"Mahoning County, OH",2010-2011,238406,237314,-1092,-0.458,-679,-413,39,99,H1
"Mahoning County, OH",2011-2012,237314,235787,-1527,-0.643,-713,-814,39,99,H1
"Mahoning County, OH",2012-2013,235787,234336,-1451,-0.615,-606,-845,39,99,H1
"Mahoning County, OH",2013-2014,234336,233204,-1132,-0.483,-588,-544,39,99,H1
"Mahoning County, OH",2014-2015,233298,231900,-1398,-0.599,-531,-867,39,99,H1
"Mahoning County, OH",2015-2016,231900,230169,-1731,-0.746,-594,-1137,39,99,H1
"Mahoning County, OH",2016-2017,230169,229796,-373,-0.162,-538,165,39,99,H1
"Marion County, OH",2000-2001,66135,66156,21,0.032,212,-191,39,101,H1
"Marion County, OH",2001-2002,66156,66188,32,0.048,151,-119,39,101,H1
"Marion County, OH",2002-2003,66188,66372,184,0.278,88,96,39,101,H1
"Marion County, OH",2003-2004,66372,66361,-11,-0.017,144,-155,39,101,H1
"Marion County, OH",2004-2005,66361,66468,107,0.161,94,13,39,101,H1
"Marion County, OH",2005-2006,66468,66345,-123,-0.185,105,-228,39,101,H1
"Marion County, OH",2006-2007,66345,66487,142,0.214,138,4,39,101,H1
"Marion County, OH",2007-2008,66487,66840,353,0.531,132,221,39,101,H1
"Marion County, OH",2008-2009,66840,66497,-343,-0.513,124,-467,39,101,H1
"Marion County, OH",2009-2010,66497,66450,-47,-0.071,82,-129,39,101,H1
"Marion County, OH",2010-2011,66450,66542,92,0.138,185,-93,39,101,H1
"Marion County, OH",2011-2012,66542,66235,-307,-0.461,85,-392,39,101,H1
"Marion County, OH",2012-2013,66235,65910,-325,-0.491,68,-393,39,101,H1
"Marion County, OH",2013-2014,65910,65720,-190,-0.288,81,-271,39,101,H1
"Marion County, OH",2014-2015,65674,65355,-319,-0.486,56,-375,39,101,H1
"Marion County, OH",2015-2016,65355,65334,-21,-0.032,-24,3,39,101,H1
"Marion County, OH",2016-2017,65334,64967,-367,-0.562,13,-380,39,101,H1
"Medina County, OH",2000-2001,151751,154363,2612,1.721,993,1619,39,103,H1
"Medina County, OH",2001-2002,154363,157502,3139,2.034,983,2156,39,103,H1
"Medina County, OH",2002-2003,157502,160325,2823,1.792,949,1874,39,103,H1
"Medina County, OH",2003-2004,160325,163048,2723,1.698,892,1831,39,103,H1
"Medina County, OH",2004-2005,163048,164953,1905,1.168,847,1058,39,103,H1
"Medina County, OH",2005-2006,164953,167298,2345,1.422,1027,1318,39,103,H1
"Medina County, OH",2006-2007,167298,168775,1477,0.883,771,706,39,103,H1
"Medina County, OH",2007-2008,168775,170330,1555,0.921,843,712,39,103,H1
"Medina County, OH",2008-2009,170330,171688,1358,0.797,962,396,39,103,H1
"Medina County, OH",2009-2010,171688,172493,805,0.469,563,242,39,103,H1
"Medina County, OH",2010-2011,172493,173438,945,0.548,528,417,39,103,H1
"Medina County, OH",2011-2012,173438,173704,266,0.153,345,-79,39,103,H1
"Medina County, OH",2012-2013,173704,174792,1088,0.626,314,774,39,103,H1
"Medina County, OH",2013-2014,174792,176029,1237,0.708,380,857,39,103,H1
"Medina County, OH",2014-2015,175963,176395,432,0.246,409,23,39,103,H1
"Medina County, OH",2015-2016,176395,176903,508,0.288,353,155,39,103,H1
"Medina County, OH",2016-2017,176903,178371,1468,0.83,340,1128,39,103,H1
"Meigs County, OH",2000-2001,23028,23119,91,0.395,62,29,39,105,H1
"Meigs County, OH",2001-2002,23119,23305,186,0.805,12,174,39,105,H1
"Meigs County, OH",2002-2003,23305,23441,136,0.584,28,108,39,105,H1
"Meigs County, OH",2003-2004,23441,23506,65,0.277,22,43,39,105,H1
"Meigs County, OH",2004-2005,23506,23588,82,0.349,12,70,39,105,H1
"Meigs County, OH",2005-2006,23588,23586,-2,-0.008,2,-4,39,105,H1
"Meigs County, OH",2006-2007,23586,23612,26,0.11,1,25,39,105,H1
"Meigs County, OH",2007-2008,23612,23534,-78,-0.33,-9,-69,39,105,H1
"Meigs County, OH",2008-2009,23534,23770,236,1.003,22,214,39,105,H1
"Meigs County, OH",2009-2010,23770,23724,-46,-0.194,-1,-45,39,105,H1
"Meigs County, OH",2010-2011,23724,23695,-29,-0.122,-4,-25,39,105,H1
"Meigs County, OH",2011-2012,23695,23600,-95,-0.401,-14,-81,39,105,H1
"Meigs County, OH",2012-2013,23600,23470,-130,-0.551,-3,-127,39,105,H1
"Meigs County, OH",2013-2014,23470,23331,-139,-0.592,-19,-120,39,105,H1
"Meigs County, OH",2014-2015,23326,23257,-69,-0.296,-25,-44,39,105,H1
"Meigs County, OH",2015-2016,23257,23177,-80,-0.344,-50,-30,39,105,H1
"Meigs County, OH",2016-2017,23177,23080,-97,-0.419,-62,-35,39,105,H1
"Mercer County, OH",2000-2001,40913,40819,-94,-0.23,216,-310,39,107,H1
"Mercer County, OH",2001-2002,40819,40843,24,0.059,205,-181,39,107,H1
"Mercer County, OH",2002-2003,40843,40841,-2,-0.005,152,-154,39,107,H1
"Mercer County, OH",2003-2004,40841,40889,48,0.118,184,-136,39,107,H1
"Mercer County, OH",2004-2005,40889,40967,78,0.191,188,-110,39,107,H1
"Mercer County, OH",2005-2006,40967,41063,96,0.234,154,-58,39,107,H1
"Mercer County, OH",2006-2007,41063,41055,-8,-0.019,162,-170,39,107,H1
"Mercer County, OH",2007-2008,41055,41022,-33,-0.08,194,-227,39,107,H1
"Mercer County, OH",2008-2009,41022,40855,-167,-0.407,222,-389,39,107,H1
"Mercer County, OH",2009-2010,40855,40767,-88,-0.215,168,-256,39,107,H1
"Mercer County, OH",2010-2011,40767,40795,28,0.069,131,-103,39,107,H1
"Mercer County, OH",2011-2012,40795,40827,32,0.078,95,-63,39,107,H1
"Mercer County, OH",2012-2013,40827,40724,-103,-0.252,152,-255,39,107,H1
"Mercer County, OH",2013-2014,40724,40831,107,0.263,139,-32,39,107,H1
"Mercer County, OH",2014-2015,40926,40968,42,0.103,187,-145,39,107,H1
"Mercer County, OH",2015-2016,40968,40710,-258,-0.63,170,-428,39,107,H1
"Mercer County, OH",2016-2017,40710,40873,163,0.4,202,-39,39,107,H1
"Miami County, OH",2000-2001,99015,99300,285,0.288,305,-20,39,109,H1
"Miami County, OH",2001-2002,99300,99579,279,0.281,345,-66,39,109,H1
"Miami County, OH",2002-2003,99579,100120,541,0.543,318,223,39,109,H1
"Miami County, OH",2003-2004,100120,100775,655,0.654,271,384,39,109,H1
"Miami County, OH",2004-2005,100775,101564,789,0.783,330,459,39,109,H1
"Miami County, OH",2005-2006,101564,102028,464,0.457,296,168,39,109,H1
"Miami County, OH",2006-2007,102028,102130,102,0.1,291,-189,39,109,H1
"Miami County, OH",2007-2008,102130,102430,300,0.294,303,-3,39,109,H1
"Miami County, OH",2008-2009,102430,102526,96,0.094,319,-223,39,109,H1
"Miami County, OH",2009-2010,102526,102456,-70,-0.068,175,-245,39,109,H1
"Miami County, OH",2010-2011,102456,102833,377,0.368,146,231,39,109,H1
"Miami County, OH",2011-2012,102833,103118,285,0.277,160,125,39,109,H1
"Miami County, OH",2012-2013,103118,103416,298,0.289,110,188,39,109,H1
"Miami County, OH",2013-2014,103416,103900,484,0.468,140,344,39,109,H1
"Miami County, OH",2014-2015,103970,104224,254,0.244,243,11,39,109,H1
"Miami County, OH",2015-2016,104224,104382,158,0.152,99,59,39,109,H1
"Miami County, OH",2016-2017,104382,105122,740,0.709,149,591,39,109,H1
"Monroe County, OH",2000-2001,15172,15107,-65,-0.428,-1,-64,39,111,H1
"Monroe County, OH",2001-2002,15107,15006,-101,-0.669,-30,-71,39,111,H1
"Monroe County, OH",2002-2003,15006,15048,42,0.28,-10,52,39,111,H1
"Monroe County, OH",2003-2004,15048,15113,65,0.432,-30,95,39,111,H1
"Monroe County, OH",2004-2005,15113,14943,-170,-1.125,-29,-141,39,111,H1
"Monroe County, OH",2005-2006,14943,14818,-125,-0.837,-44,-81,39,111,H1
"Monroe County, OH",2006-2007,14818,14774,-44,-0.297,-13,-31,39,111,H1
"Monroe County, OH",2007-2008,14774,14833,59,0.399,-21,80,39,111,H1
"Monroe County, OH",2008-2009,14833,14742,-91,-0.613,-33,-58,39,111,H1
"Monroe County, OH",2009-2010,14742,14583,-159,-1.079,-56,-103,39,111,H1
"Monroe County, OH",2010-2011,14583,14722,139,0.953,-14,153,39,111,H1
"Monroe County, OH",2011-2012,14722,14579,-143,-0.971,-25,-118,39,111,H1
"Monroe County, OH",2012-2013,14579,14601,22,0.151,-27,49,39,111,H1
"Monroe County, OH",2013-2014,14601,14465,-136,-0.931,-38,-98,39,111,H1
"Monroe County, OH",2014-2015,14453,14409,-44,-0.304,-43,-1,39,111,H1
"Monroe County, OH",2015-2016,14409,14097,-312,-2.165,-42,-270,39,111,H1
"Monroe County, OH",2016-2017,14097,13946,-151,-1.071,-54,-97,39,111,H1
"Montgomery County, OH",2000-2001,558522,555536,-2986,-0.535,2133,-5119,39,113,H1
"Montgomery County, OH",2001-2002,555536,553170,-2366,-0.426,1837,-4203,39,113,H1
"Montgomery County, OH",2002-2003,553170,551742,-1428,-0.258,1782,-3210,39,113,H1
"Montgomery County, OH",2003-2004,551742,549713,-2029,-0.368,1778,-3807,39,113,H1
"Montgomery County, OH",2004-2005,549713,546979,-2734,-0.497,1657,-4391,39,113,H1
"Montgomery County, OH",2005-2006,546979,543620,-3359,-0.614,1847,-5206,39,113,H1
"Montgomery County, OH",2006-2007,543620,540667,-2953,-0.543,1971,-4924,39,113,H1
"Montgomery County, OH",2007-2008,540667,537664,-3003,-0.555,1620,-4623,39,113,H1
"Montgomery County, OH",2008-2009,537664,535294,-2370,-0.441,1346,-3716,39,113,H1
"Montgomery County, OH",2009-2010,535294,536175,881,0.165,1363,-482,39,113,H1
"Montgomery County, OH",2010-2011,536175,534979,-1196,-0.223,849,-2045,39,113,H1
"Montgomery County, OH",2011-2012,534979,534971,-8,-0.001,1148,-1156,39,113,H1
"Montgomery County, OH",2012-2013,534971,534764,-207,-0.039,1056,-1263,39,113,H1
"Montgomery County, OH",2013-2014,534764,533116,-1648,-0.308,1076,-2724,39,113,H1
"Montgomery County, OH",2014-2015,532515,532258,-257,-0.048,947,-1204,39,113,H1
"Montgomery County, OH",2015-2016,532258,531395,-863,-0.162,593,-1456,39,113,H1
"Montgomery County, OH",2016-2017,531395,531542,147,0.028,693,-546,39,113,H1
"Morgan County, OH",2000-2001,14944,14942,-2,-0.013,21,-23,39,115,H1
"Morgan County, OH",2001-2002,14942,14917,-25,-0.167,-2,-23,39,115,H1
"Morgan County, OH",2002-2003,14917,14999,82,0.55,10,72,39,115,H1
"Morgan County, OH",2003-2004,14999,15130,131,0.873,19,112,39,115,H1
"Morgan County, OH",2004-2005,15130,15216,86,0.568,41,45,39,115,H1
"Morgan County, OH",2005-2006,15216,15189,-27,-0.177,29,-56,39,115,H1
"Morgan County, OH",2006-2007,15189,15175,-14,-0.092,9,-23,39,115,H1
"Morgan County, OH",2007-2008,15175,15104,-71,-0.468,-8,-63,39,115,H1
"Morgan County, OH",2008-2009,15104,15073,-31,-0.205,1,-32,39,115,H1
"Morgan County, OH",2009-2010,15073,15053,-20,-0.133,-13,-7,39,115,H1
"Morgan County, OH",2010-2011,15053,15077,24,0.159,-12,36,39,115,H1
"Morgan County, OH",2011-2012,15077,14945,-132,-0.876,-38,-94,39,115,H1
"Morgan County, OH",2012-2013,14945,14967,22,0.147,-2,24,39,115,H1
"Morgan County, OH",2013-2014,14967,14843,-124,-0.828,12,-136,39,115,H1
"Morgan County, OH",2014-2015,14792,14777,-15,-0.101,-12,-3,39,115,H1
"Morgan County, OH",2015-2016,14777,14762,-15,-0.102,-12,-3,39,115,H1
"Morgan County, OH",2016-2017,14762,14709,-53,-0.359,-13,-40,39,115,H1
"Morrow County, OH",2000-2001,31813,32438,625,1.965,171,454,39,117,H1
"Morrow County, OH",2001-2002,32438,32955,517,1.594,170,347,39,117,H1
"Morrow County, OH",2002-2003,32955,33524,569,1.727,156,413,39,117,H1
"Morrow County, OH",2003-2004,33524,34025,501,1.494,158,343,39,117,H1
"Morrow County, OH",2004-2005,34025,34271,246,0.723,107,139,39,117,H1
"Morrow County, OH",2005-2006,34271,34561,290,0.846,165,125,39,117,H1
"Morrow County, OH",2006-2007,34561,34937,376,1.088,158,218,39,117,H1
"Morrow County, OH",2007-2008,34937,34877,-60,-0.172,156,-216,39,117,H1
"Morrow County, OH",2008-2009,34877,34907,30,0.086,156,-126,39,117,H1
"Morrow County, OH",2009-2010,34907,34833,-74,-0.212,75,-149,39,117,H1
"Morrow County, OH",2010-2011,34833,34929,96,0.276,65,31,39,117,H1
"Morrow County, OH",2011-2012,34929,35003,74,0.212,116,-42,39,117,H1
"Morrow County, OH",2012-2013,35003,35038,35,0.1,107,-72,39,117,H1
"Morrow County, OH",2013-2014,35038,35152,114,0.325,83,31,39,117,H1
"Morrow County, OH",2014-2015,35064,35074,10,0.029,60,-50,39,117,H1
"Morrow County, OH",2015-2016,35074,34954,-120,-0.342,55,-175,39,117,H1
"Morrow County, OH",2016-2017,34954,34994,40,0.114,71,-31,39,117,H1
"Muskingum County, OH",2000-2001,84732,84789,57,0.067,189,-132,39,119,H1
"Muskingum County, OH",2001-2002,84789,85247,458,0.54,229,229,39,119,H1
"Muskingum County, OH",2002-2003,85247,85418,171,0.201,225,-54,39,119,H1
"Muskingum County, OH",2003-2004,85418,85589,171,0.2,178,-7,39,119,H1
"Muskingum County, OH",2004-2005,85589,85696,107,0.125,203,-96,39,119,H1
"Muskingum County, OH",2005-2006,85696,86023,327,0.382,174,153,39,119,H1
"Muskingum County, OH",2006-2007,86023,85939,-84,-0.098,284,-368,39,119,H1
"Muskingum County, OH",2007-2008,85939,85874,-65,-0.076,202,-267,39,119,H1
"Muskingum County, OH",2008-2009,85874,85779,-95,-0.111,177,-272,39,119,H1
"Muskingum County, OH",2009-2010,85779,86185,406,0.473,69,337,39,119,H1
"Muskingum County, OH",2010-2011,86185,86199,14,0.016,154,-140,39,119,H1
"Muskingum County, OH",2011-2012,86199,85838,-361,-0.419,68,-429,39,119,H1
"Muskingum County, OH",2012-2013,85838,85696,-142,-0.165,53,-195,39,119,H1
"Muskingum County, OH",2013-2014,85696,85818,122,0.142,48,74,39,119,H1
"Muskingum County, OH",2014-2015,85946,86290,344,0.4,85,259,39,119,H1
"Muskingum County, OH",2015-2016,86290,85929,-361,-0.418,51,-412,39,119,H1
"Muskingum County, OH",2016-2017,85929,86149,220,0.256,54,166,39,119,H1
"Noble County, OH",2000-2001,14108,13857,-251,-1.779,8,-259,39,121,H1
"Noble County, OH",2001-2002,13857,13931,74,0.534,18,56,39,121,H1
"Noble County, OH",2002-2003,13931,14221,290,2.082,17,273,39,121,H1
"Noble County, OH",2003-2004,14221,14352,131,0.921,27,104,39,121,H1
"Noble County, OH",2004-2005,14352,14210,-142,-0.989,-16,-126,39,121,H1
"Noble County, OH",2005-2006,14210,14616,406,2.857,37,369,39,121,H1
"Noble County, OH",2006-2007,14616,14614,-2,-0.014,23,-25,39,121,H1
"Noble County, OH",2007-2008,14614,14653,39,0.267,58,-19,39,121,H1
"Noble County, OH",2008-2009,14653,14649,-4,-0.027,25,-29,39,121,H1
"Noble County, OH",2009-2010,14649,14629,-20,-0.137,8,-28,39,121,H1
"Noble County, OH",2010-2011,14629,14696,67,0.458,41,26,39,121,H1
"Noble County, OH",2011-2012,14696,14577,-119,-0.81,26,-145,39,121,H1
"Noble County, OH",2012-2013,14577,14541,-36,-0.247,-11,-25,39,121,H1
"Noble County, OH",2013-2014,14541,14363,-178,-1.224,-14,-164,39,121,H1
"Noble County, OH",2014-2015,14377,14326,-51,-0.355,20,-71,39,121,H1
"Noble County, OH",2015-2016,14326,14443,117,0.817,2,115,39,121,H1
"Noble County, OH",2016-2017,14443,14406,-37,-0.256,0,-37,39,121,H1
"Ottawa County, OH",2000-2001,40983,41015,32,0.078,16,16,39,123,H1
"Ottawa County, OH",2001-2002,41015,41029,14,0.034,-25,39,39,123,H1
"Ottawa County, OH",2002-2003,41029,41329,300,0.731,-23,323,39,123,H1
"Ottawa County, OH",2003-2004,41329,41564,235,0.569,-10,245,39,123,H1
"Ottawa County, OH",2004-2005,41564,41629,65,0.156,-60,125,39,123,H1
"Ottawa County, OH",2005-2006,41629,41641,12,0.029,-73,85,39,123,H1
"Ottawa County, OH",2006-2007,41641,41690,49,0.118,-67,116,39,123,H1
"Ottawa County, OH",2007-2008,41690,41554,-136,-0.326,-19,-117,39,123,H1
"Ottawa County, OH",2008-2009,41554,41498,-56,-0.135,-10,-46,39,123,H1
"Ottawa County, OH",2009-2010,41498,41408,-90,-0.217,-85,-5,39,123,H1
"Ottawa County, OH",2010-2011,41408,41436,28,0.068,-79,107,39,123,H1
"Ottawa County, OH",2011-2012,41436,41361,-75,-0.181,-78,3,39,123,H1
"Ottawa County, OH",2012-2013,41361,41160,-201,-0.486,-170,-31,39,123,H1
"Ottawa County, OH",2013-2014,41160,41154,-6,-0.015,-135,129,39,123,H1
"Ottawa County, OH",2014-2015,41072,40877,-195,-0.475,-128,-67,39,123,H1
"Ottawa County, OH",2015-2016,40877,40495,-382,-0.935,-136,-246,39,123,H1
"Ottawa County, OH",2016-2017,40495,40657,162,0.4,-171,333,39,123,H1
"Paulding County, OH",2000-2001,20251,20183,-68,-0.336,74,-142,39,125,H1
"Paulding County, OH",2001-2002,20183,19972,-211,-1.045,41,-252,39,125,H1
"Paulding County, OH",2002-2003,19972,19887,-85,-0.426,31,-116,39,125,H1
"Paulding County, OH",2003-2004,19887,19803,-84,-0.422,70,-154,39,125,H1
"Paulding County, OH",2004-2005,19803,19810,7,0.035,88,-81,39,125,H1
"Paulding County, OH",2005-2006,19810,19748,-62,-0.313,86,-148,39,125,H1
"Paulding County, OH",2006-2007,19748,19735,-13,-0.066,68,-81,39,125,H1
"Paulding County, OH",2007-2008,19735,19670,-65,-0.329,82,-147,39,125,H1
"Paulding County, OH",2008-2009,19670,19659,-11,-0.056,91,-102,39,125,H1
"Paulding County, OH",2009-2010,19659,19583,-76,-0.387,73,-149,39,125,H1
"Paulding County, OH",2010-2011,19583,19411,-172,-0.878,41,-213,39,125,H1
"Paulding County, OH",2011-2012,19411,19287,-124,-0.639,14,-138,39,125,H1
"Paulding County, OH",2012-2013,19287,19194,-93,-0.482,14,-107,39,125,H1
"Paulding County, OH",2013-2014,19194,18989,-205,-1.068,28,-233,39,125,H1
"Paulding County, OH",2014-2015,18996,18976,-20,-0.105,38,-58,39,125,H1
"Paulding County, OH",2015-2016,18976,18839,-137,-0.722,3,-140,39,125,H1
"Paulding County, OH",2016-2017,18839,18845,6,0.032,27,-21,39,125,H1
"Perry County, OH",2000-2001,34099,34375,276,0.809,159,117,39,127,H1
"Perry County, OH",2001-2002,34375,34629,254,0.739,177,77,39,127,H1
"Perry County, OH",2002-2003,34629,34944,315,0.91,110,205,39,127,H1
"Perry County, OH",2003-2004,34944,35117,173,0.495,120,53,39,127,H1
"Perry County, OH",2004-2005,35117,35254,137,0.39,97,40,39,127,H1
"Perry County, OH",2005-2006,35254,35430,176,0.499,144,32,39,127,H1
"Perry County, OH",2006-2007,35430,35582,152,0.429,173,-21,39,127,H1
"Perry County, OH",2007-2008,35582,36150,568,1.596,141,427,39,127,H1
"Perry County, OH",2008-2009,36150,35996,-154,-0.426,110,-264,39,127,H1
"Perry County, OH",2009-2010,35996,36037,41,0.114,24,17,39,127,H1
"Perry County, OH",2010-2011,36037,36223,186,0.516,128,58,39,127,H1
"Perry County, OH",2011-2012,36223,35997,-226,-0.624,46,-272,39,127,H1
"Perry County, OH",2012-2013,35997,35932,-65,-0.181,28,-93,39,127,H1
"Perry County, OH",2013-2014,35932,35812,-120,-0.334,25,-145,39,127,H1
"Perry County, OH",2014-2015,35910,35985,75,0.209,81,-6,39,127,H1
"Perry County, OH",2015-2016,35985,36019,34,0.094,130,-96,39,127,H1
"Perry County, OH",2016-2017,36019,36024,5,0.014,67,-62,39,127,H1
"Pickaway County, OH",2000-2001,52808,52344,-464,-0.879,180,-644,39,129,H1
"Pickaway County, OH",2001-2002,52344,51778,-566,-1.081,146,-712,39,129,H1
"Pickaway County, OH",2002-2003,51778,51983,205,0.396,81,124,39,129,H1
"Pickaway County, OH",2003-2004,51983,52238,255,0.491,227,28,39,129,H1
"Pickaway County, OH",2004-2005,52238,52954,716,1.371,139,577,39,129,H1
"Pickaway County, OH",2005-2006,52954,54094,1140,2.153,152,988,39,129,H1
"Pickaway County, OH",2006-2007,54094,55044,950,1.756,141,809,39,129,H1
"Pickaway County, OH",2007-2008,55044,55376,332,0.603,146,186,39,129,H1
"Pickaway County, OH",2008-2009,55376,55323,-53,-0.096,177,-230,39,129,H1
"Pickaway County, OH",2009-2010,55323,55725,402,0.727,86,316,39,129,H1
"Pickaway County, OH",2010-2011,55725,55983,258,0.463,98,160,39,129,H1
"Pickaway County, OH",2011-2012,55983,56346,363,0.648,89,274,39,129,H1
"Pickaway County, OH",2012-2013,56346,56466,120,0.213,96,24,39,129,H1
"Pickaway County, OH",2013-2014,56466,56876,410,0.726,88,322,39,129,H1
"Pickaway County, OH",2014-2015,56782,56998,216,0.38,92,124,39,129,H1
"Pickaway County, OH",2015-2016,56998,57530,532,0.933,6,526,39,129,H1
"Pickaway County, OH",2016-2017,57530,57830,300,0.521,46,254,39,129,H1
"Pike County, OH",2000-2001,27688,27807,119,0.43,113,6,39,131,H1
"Pike County, OH",2001-2002,27807,28072,265,0.953,45,220,39,131,H1
"Pike County, OH",2002-2003,28072,28258,186,0.663,50,136,39,131,H1
"Pike County, OH",2003-2004,28258,28427,169,0.598,94,75,39,131,H1
"Pike County, OH",2004-2005,28427,28299,-128,-0.45,69,-197,39,131,H1
"Pike County, OH",2005-2006,28299,28590,291,1.028,62,229,39,131,H1
"Pike County, OH",2006-2007,28590,28645,55,0.192,94,-39,39,131,H1
"Pike County, OH",2007-2008,28645,28763,118,0.412,52,66,39,131,H1
"Pike County, OH",2008-2009,28763,28679,-84,-0.292,41,-125,39,131,H1
"Pike County, OH",2009-2010,28679,28736,57,0.199,1,56,39,131,H1
"Pike County, OH",2010-2011,28736,28633,-103,-0.358,15,-118,39,131,H1
"Pike County, OH",2011-2012,28633,28501,-132,-0.461,-8,-124,39,131,H1
"Pike County, OH",2012-2013,28501,28392,-109,-0.382,19,-128,39,131,H1
"Pike County, OH",2013-2014,28392,28256,-136,-0.479,-20,-116,39,131,H1
"Pike County, OH",2014-2015,28276,28217,-59,-0.209,22,-81,39,131,H1
"Pike County, OH",2015-2016,28217,28237,20,0.071,-2,22,39,131,H1
"Pike County, OH",2016-2017,28237,28270,33,0.117,-20,53,39,131,H1
"Portage County, OH",2000-2001,152504,153554,1050,0.689,659,391,39,133,H1
"Portage County, OH",2001-2002,153554,154667,1113,0.725,473,640,39,133,H1
"Portage County, OH",2002-2003,154667,155976,1309,0.846,457,852,39,133,H1
"Portage County, OH",2003-2004,155976,156774,798,0.512,479,319,39,133,H1
"Portage County, OH",2004-2005,156774,157469,695,0.443,343,352,39,133,H1
"Portage County, OH",2005-2006,157469,157773,304,0.193,388,-84,39,133,H1
"Portage County, OH",2006-2007,157773,159148,1375,0.872,501,874,39,133,H1
"Portage County, OH",2007-2008,159148,160184,1036,0.651,476,560,39,133,H1
"Portage County, OH",2008-2009,160184,161226,1042,0.651,480,562,39,133,H1
"Portage County, OH",2009-2010,161226,161355,129,0.08,267,-138,39,133,H1
"Portage County, OH",2010-2011,161355,161770,415,0.257,221,194,39,133,H1
"Portage County, OH",2011-2012,161770,161336,-434,-0.268,27,-461,39,133,H1
"Portage County, OH",2012-2013,161336,161423,87,0.054,45,42,39,133,H1
"Portage County, OH",2013-2014,161423,161882,459,0.284,40,419,39,133,H1
"Portage County, OH",2014-2015,162235,162275,40,0.025,149,-109,39,133,H1
"Portage County, OH",2015-2016,162275,162162,-113,-0.07,-40,-73,39,133,H1
"Portage County, OH",2016-2017,162162,162277,115,0.071,-6,121,39,133,H1
"Preble County, OH",2000-2001,42381,42427,46,0.109,152,-106,39,135,H1
"Preble County, OH",2001-2002,42427,42587,160,0.377,63,97,39,135,H1
"Preble County, OH",2002-2003,42587,42640,53,0.124,130,-77,39,135,H1
"Preble County, OH",2003-2004,42640,42613,-27,-0.063,67,-94,39,135,H1
"Preble County, OH",2004-2005,42613,42584,-29,-0.068,103,-132,39,135,H1
"Preble County, OH",2005-2006,42584,42651,67,0.157,137,-70,39,135,H1
"Preble County, OH",2006-2007,42651,42561,-90,-0.211,110,-200,39,135,H1
"Preble County, OH",2007-2008,42561,42688,127,0.298,96,31,39,135,H1
"Preble County, OH",2008-2009,42688,42424,-264,-0.618,97,-361,39,135,H1
"Preble County, OH",2009-2010,42424,42188,-236,-0.556,25,-261,39,135,H1
"Preble County, OH",2010-2011,42188,42036,-152,-0.36,-4,-148,39,135,H1
"Preble County, OH",2011-2012,42036,41895,-141,-0.335,-29,-112,39,135,H1
"Preble County, OH",2012-2013,41895,41728,-167,-0.399,19,-186,39,135,H1
"Preble County, OH",2013-2014,41728,41586,-142,-0.34,21,-163,39,135,H1
"Preble County, OH",2014-2015,41521,41329,-192,-0.462,11,-203,39,135,H1
"Preble County, OH",2015-2016,41329,41105,-224,-0.542,-56,-168,39,135,H1
"Preble County, OH",2016-2017,41105,41120,15,0.036,-25,40,39,135,H1
"Putnam County, OH",2000-2001,34750,34746,-4,-0.012,221,-225,39,137,H1
"Putnam County, OH",2001-2002,34746,34643,-103,-0.296,131,-234,39,137,H1
"Putnam County, OH",2002-2003,34643,34758,115,0.332,155,-40,39,137,H1
"Putnam County, OH",2003-2004,34758,34680,-78,-0.224,188,-266,39,137,H1
"Putnam County, OH",2004-2005,34680,34798,118,0.34,183,-65,39,137,H1
"Putnam County, OH",2005-2006,34798,34781,-17,-0.049,243,-260,39,137,H1
"Putnam County, OH",2006-2007,34781,34752,-29,-0.083,235,-264,39,137,H1
"Putnam County, OH",2007-2008,34752,34655,-97,-0.279,199,-296,39,137,H1
"Putnam County, OH",2008-2009,34655,34583,-72,-0.208,225,-297,39,137,H1
"Putnam County, OH",2009-2010,34583,34448,-135,-0.39,200,-335,39,137,H1
"Putnam County, OH",2010-2011,34448,34382,-66,-0.192,168,-234,39,137,H1
"Putnam County, OH",2011-2012,34382,34181,-201,-0.585,152,-353,39,137,H1
"Putnam County, OH",2012-2013,34181,34098,-83,-0.243,114,-197,39,137,H1
"Putnam County, OH",2013-2014,34098,34171,73,0.214,130,-57,39,137,H1
"Putnam County, OH",2014-2015,34206,34042,-164,-0.479,169,-333,39,137,H1
"Putnam County, OH",2015-2016,34042,34016,-26,-0.076,148,-174,39,137,H1
"Putnam County, OH",2016-2017,34016,33878,-138,-0.406,120,-258,39,137,H1
"Richland County, OH",2000-2001,128853,128187,-666,-0.517,481,-1147,39,139,H1
"Richland County, OH",2001-2002,128187,128363,176,0.137,317,-141,39,139,H1
"Richland County, OH",2002-2003,128363,128312,-51,-0.04,369,-420,39,139,H1
"Richland County, OH",2003-2004,128312,128094,-218,-0.17,337,-555,39,139,H1
"Richland County, OH",2004-2005,128094,127724,-370,-0.289,227,-597,39,139,H1
"Richland County, OH",2005-2006,127724,127292,-432,-0.338,450,-882,39,139,H1
"Richland County, OH",2006-2007,127292,126995,-297,-0.233,347,-644,39,139,H1
"Richland County, OH",2007-2008,126995,126128,-867,-0.683,316,-1183,39,139,H1
"Richland County, OH",2008-2009,126128,125308,-820,-0.65,268,-1088,39,139,H1
"Richland County, OH",2009-2010,125308,124175,-1133,-0.904,176,-1309,39,139,H1
"Richland County, OH",2010-2011,124175,123070,-1105,-0.89,65,-1170,39,139,H1
"Richland County, OH",2011-2012,123070,122588,-482,-0.392,97,-579,39,139,H1
"Richland County, OH",2012-2013,122588,122292,-296,-0.241,115,-411,39,139,H1
"Richland County, OH",2013-2014,122292,121942,-350,-0.286,100,-450,39,139,H1
"Richland County, OH",2014-2015,121914,121707,-207,-0.17,39,-246,39,139,H1
"Richland County, OH",2015-2016,121707,121167,-540,-0.444,1,-541,39,139,H1
"Richland County, OH",2016-2017,121167,120589,-578,-0.477,10,-588,39,139,H1
"Ross County, OH",2000-2001,73507,73840,333,0.453,160,173,39,141,H1
"Ross County, OH",2001-2002,73840,74363,523,0.708,208,315,39,141,H1
"Ross County, OH",2002-2003,74363,75008,645,0.867,116,529,39,141,H1
"Ross County, OH",2003-2004,75008,75251,243,0.324,111,132,39,141,H1
"Ross County, OH",2004-2005,75251,75935,684,0.909,215,469,39,141,H1
"Ross County, OH",2005-2006,75935,76639,704,0.927,211,493,39,141,H1
"Ross County, OH",2006-2007,76639,77419,780,1.018,229,551,39,141,H1
"Ross County, OH",2007-2008,77419,77675,256,0.331,165,91,39,141,H1
"Ross County, OH",2008-2009,77675,77862,187,0.241,103,84,39,141,H1
"Ross County, OH",2009-2010,77862,78126,264,0.339,6,258,39,141,H1
"Ross County, OH",2010-2011,78126,77627,-499,-0.639,-66,-433,39,141,H1
"Ross County, OH",2011-2012,77627,77485,-142,-0.183,91,-233,39,141,H1
"Ross County, OH",2012-2013,77485,77364,-121,-0.156,19,-140,39,141,H1
"Ross County, OH",2013-2014,77364,77159,-205,-0.265,43,-248,39,141,H1
"Ross County, OH",2014-2015,77115,77170,55,0.071,58,-3,39,141,H1
"Ross County, OH",2015-2016,77170,76910,-260,-0.337,9,-269,39,141,H1
"Ross County, OH",2016-2017,76910,77313,403,0.524,-3,406,39,141,H1
"Sandusky County, OH",2000-2001,61812,61788,-24,-0.039,302,-326,39,143,H1
"Sandusky County, OH",2001-2002,61788,61918,130,0.21,227,-97,39,143,H1
"Sandusky County, OH",2002-2003,61918,61784,-134,-0.216,200,-334,39,143,H1
"Sandusky County, OH",2003-2004,61784,61930,146,0.236,138,8,39,143,H1
"Sandusky County, OH",2004-2005,61930,61865,-65,-0.105,180,-245,39,143,H1
"Sandusky County, OH",2005-2006,61865,61745,-120,-0.194,144,-264,39,143,H1
"Sandusky County, OH",2006-2007,61745,61571,-174,-0.282,153,-327,39,143,H1
"Sandusky County, OH",2007-2008,61571,61184,-387,-0.629,196,-583,39,143,H1
"Sandusky County, OH",2008-2009,61184,61039,-145,-0.237,172,-317,39,143,H1
"Sandusky County, OH",2009-2010,61039,60907,-132,-0.216,127,-259,39,143,H1
"Sandusky County, OH",2010-2011,60907,60644,-263,-0.432,76,-339,39,143,H1
"Sandusky County, OH",2011-2012,60644,60560,-84,-0.139,105,-189,39,143,H1
"Sandusky County, OH",2012-2013,60560,60200,-360,-0.594,95,-455,39,143,H1
"Sandusky County, OH",2013-2014,60200,60179,-21,-0.035,98,-119,39,143,H1
"Sandusky County, OH",2014-2015,60004,59679,-325,-0.542,47,-372,39,143,H1
"Sandusky County, OH",2015-2016,59679,59281,-398,-0.667,39,-437,39,143,H1
"Sandusky County, OH",2016-2017,59281,59195,-86,-0.145,70,-156,39,143,H1
"Scioto County, OH",2000-2001,79168,78784,-384,-0.485,103,-487,39,145,H1
"Scioto County, OH",2001-2002,78784,78652,-132,-0.168,-50,-82,39,145,H1
"Scioto County, OH",2002-2003,78652,78278,-374,-0.476,47,-421,39,145,H1
"Scioto County, OH",2003-2004,78278,77788,-490,-0.626,-17,-473,39,145,H1
"Scioto County, OH",2004-2005,77788,77926,138,0.177,111,27,39,145,H1
"Scioto County, OH",2005-2006,77926,78285,359,0.461,119,240,39,145,H1
"Scioto County, OH",2006-2007,78285,78775,490,0.626,142,348,39,145,H1
"Scioto County, OH",2007-2008,78775,79133,358,0.454,67,291,39,145,H1
"Scioto County, OH",2008-2009,79133,79241,108,0.136,80,28,39,145,H1
"Scioto County, OH",2009-2010,79241,79531,290,0.366,2,288,39,145,H1
"Scioto County, OH",2010-2011,79531,79218,-313,-0.394,-37,-276,39,145,H1
"Scioto County, OH",2011-2012,79218,78572,-646,-0.815,-42,-604,39,145,H1
"Scioto County, OH",2012-2013,78572,78023,-549,-0.699,-27,-522,39,145,H1
"Scioto County, OH",2013-2014,78023,77258,-765,-0.98,-18,-747,39,145,H1
"Scioto County, OH",2014-2015,77326,76825,-501,-0.648,-40,-461,39,145,H1
"Scioto County, OH",2015-2016,76825,76240,-585,-0.761,-106,-479,39,145,H1
"Scioto County, OH",2016-2017,76240,75929,-311,-0.408,-68,-243,39,145,H1
"Seneca County, OH",2000-2001,58588,58376,-212,-0.362,120,-332,39,147,H1
"Seneca County, OH",2001-2002,58376,58090,-286,-0.49,187,-473,39,147,H1
"Seneca County, OH",2002-2003,58090,58006,-84,-0.145,193,-277,39,147,H1
"Seneca County, OH",2003-2004,58006,57857,-149,-0.257,173,-322,39,147,H1
"Seneca County, OH",2004-2005,57857,57664,-193,-0.334,201,-394,39,147,H1
"Seneca County, OH",2005-2006,57664,57406,-258,-0.447,119,-377,39,147,H1
"Seneca County, OH",2006-2007,57406,57289,-117,-0.204,140,-257,39,147,H1
"Seneca County, OH",2007-2008,57289,57199,-90,-0.157,145,-235,39,147,H1
"Seneca County, OH",2008-2009,57199,56897,-302,-0.528,212,-514,39,147,H1
"Seneca County, OH",2009-2010,56897,56631,-266,-0.468,141,-407,39,147,H1
"Seneca County, OH",2010-2011,56631,56420,-211,-0.373,37,-248,39,147,H1
"Seneca County, OH",2011-2012,56420,56025,-395,-0.7,-41,-354,39,147,H1
"Seneca County, OH",2012-2013,56025,55756,-269,-0.48,-52,-217,39,147,H1
"Seneca County, OH",2013-2014,55756,55669,-87,-0.156,-17,-70,39,147,H1
"Seneca County, OH",2014-2015,55751,55610,-141,-0.253,51,-192,39,147,H1
"Seneca County, OH",2015-2016,55610,55357,-253,-0.455,25,-278,39,147,H1
"Seneca County, OH",2016-2017,55357,55243,-114,-0.206,26,-140,39,147,H1
"Shelby County, OH",2000-2001,48360,48662,302,0.624,341,-39,39,149,H1
"Shelby County, OH",2001-2002,48662,48671,9,0.018,275,-266,39,149,H1
"Shelby County, OH",2002-2003,48671,48766,95,0.195,331,-236,39,149,H1
"Shelby County, OH",2003-2004,48766,48791,25,0.051,349,-324,39,149,H1
"Shelby County, OH",2004-2005,48791,49044,253,0.519,337,-84,39,149,H1
"Shelby County, OH",2005-2006,49044,49099,55,0.112,320,-265,39,149,H1
"Shelby County, OH",2006-2007,49099,49284,185,0.377,296,-111,39,149,H1
"Shelby County, OH",2007-2008,49284,49454,170,0.345,326,-156,39,149,H1
"Shelby County, OH",2008-2009,49454,49540,86,0.174,330,-244,39,149,H1
"Shelby County, OH",2009-2010,49540,49348,-192,-0.388,271,-463,39,149,H1
"Shelby County, OH",2010-2011,49348,49270,-78,-0.158,194,-272,39,149,H1
"Shelby County, OH",2011-2012,49270,49142,-128,-0.26,234,-362,39,149,H1
"Shelby County, OH",2012-2013,49142,49112,-30,-0.061,199,-229,39,149,H1
"Shelby County, OH",2013-2014,49112,48951,-161,-0.328,212,-373,39,149,H1
"Shelby County, OH",2014-2015,48942,48901,-41,-0.084,212,-253,39,149,H1
"Shelby County, OH",2015-2016,48901,48726,-175,-0.358,145,-320,39,149,H1
"Shelby County, OH",2016-2017,48726,48759,33,0.068,151,-118,39,149,H1
"Stark County, OH",2000-2001,378036,377295,-741,-0.196,860,-1601,39,151,H1
"Stark County, OH",2001-2002,377295,376867,-428,-0.113,613,-1041,39,151,H1
"Stark County, OH",2002-2003,376867,376721,-146,-0.039,568,-714,39,151,H1
"Stark County, OH",2003-2004,376721,376663,-58,-0.015,562,-620,39,151,H1
"Stark County, OH",2004-2005,376663,376050,-613,-0.163,510,-1123,39,151,H1
"Stark County, OH",2005-2006,376050,376180,130,0.035,656,-526,39,151,H1
"Stark County, OH",2006-2007,376180,376877,697,0.185,785,-88,39,151,H1
"Stark County, OH",2007-2008,376877,377141,264,0.07,633,-369,39,151,H1
"Stark County, OH",2008-2009,377141,376210,-931,-0.247,619,-1550,39,151,H1
"Stark County, OH",2009-2010,376210,375398,-812,-0.216,267,-1079,39,151,H1
"Stark County, OH",2010-2011,375398,374248,-1150,-0.306,-26,-1124,39,151,H1
"Stark County, OH",2011-2012,374248,374844,596,0.159,142,454,39,151,H1
"Stark County, OH",2012-2013,374844,375222,378,0.101,144,234,39,151,H1
"Stark County, OH",2013-2014,375222,375736,514,0.137,196,318,39,151,H1
"Stark County, OH",2014-2015,375638,375165,-473,-0.126,342,-815,39,151,H1
"Stark County, OH",2015-2016,375165,373528,-1637,-0.436,88,-1725,39,151,H1
"Stark County, OH",2016-2017,373528,372542,-986,-0.264,86,-1072,39,151,H1
"Summit County, OH",2000-2001,543442,544554,1112,0.205,1627,-515,39,153,H1
"Summit County, OH",2001-2002,544554,544866,312,0.057,1597,-1285,39,153,H1
"Summit County, OH",2002-2003,544866,545163,297,0.055,1315,-1018,39,153,H1
"Summit County, OH",2003-2004,545163,545037,-126,-0.023,1172,-1298,39,153,H1
"Summit County, OH",2004-2005,545037,545029,-8,-0.001,1108,-1116,39,153,H1
"Summit County, OH",2005-2006,545029,544660,-369,-0.068,1318,-1687,39,153,H1
"Summit County, OH",2006-2007,544660,544275,-385,-0.071,1670,-2055,39,153,H1
"Summit County, OH",2007-2008,544275,543116,-1159,-0.213,1236,-2395,39,153,H1
"Summit County, OH",2008-2009,543116,542135,-981,-0.181,1132,-2113,39,153,H1
"Summit County, OH",2009-2010,542135,541612,-523,-0.096,756,-1279,39,153,H1
"Summit County, OH",2010-2011,541612,541111,-501,-0.093,694,-1195,39,153,H1
"Summit County, OH",2011-2012,541111,540867,-244,-0.045,523,-767,39,153,H1
"Summit County, OH",2012-2013,540867,541787,920,0.17,759,161,39,153,H1
"Summit County, OH",2013-2014,541787,541943,156,0.029,640,-484,39,153,H1
"Summit County, OH",2014-2015,542600,541968,-632,-0.116,535,-1167,39,153,H1
"Summit County, OH",2015-2016,541968,540394,-1574,-0.29,257,-1831,39,153,H1
"Summit County, OH",2016-2017,540394,541228,834,0.154,210,624,39,153,H1
"Trumbull County, OH",2000-2001,224912,223991,-921,-0.409,374,-1295,39,155,H1
"Trumbull County, OH",2001-2002,223991,222484,-1507,-0.673,-42,-1465,39,155,H1
"Trumbull County, OH",2002-2003,222484,220889,-1595,-0.717,9,-1604,39,155,H1
"Trumbull County, OH",2003-2004,220889,219540,-1349,-0.611,-40,-1309,39,155,H1
"Trumbull County, OH",2004-2005,219540,217926,-1614,-0.735,-13,-1601,39,155,H1
"Trumbull County, OH",2005-2006,217926,216185,-1741,-0.799,-125,-1616,39,155,H1
"Trumbull County, OH",2006-2007,216185,214296,-1889,-0.874,-45,-1844,39,155,H1
"Trumbull County, OH",2007-2008,214296,212191,-2105,-0.982,-25,-2080,39,155,H1
"Trumbull County, OH",2008-2009,212191,211290,-901,-0.425,-65,-836,39,155,H1
"Trumbull County, OH",2009-2010,211290,209897,-1393,-0.659,-249,-1144,39,155,H1
"Trumbull County, OH",2010-2011,209897,208991,-906,-0.432,-341,-565,39,155,H1
"Trumbull County, OH",2011-2012,208991,207439,-1552,-0.743,-531,-1021,39,155,H1
"Trumbull County, OH",2012-2013,207439,206480,-959,-0.462,-352,-607,39,155,H1
"Trumbull County, OH",2013-2014,206480,205175,-1305,-0.632,-337,-968,39,155,H1
"Trumbull County, OH",2014-2015,205255,203751,-1504,-0.733,-301,-1203,39,155,H1
"Trumbull County, OH",2015-2016,203751,201701,-2050,-1.006,-453,-1597,39,155,H1
"Trumbull County, OH",2016-2017,201701,200380,-1321,-0.655,-400,-921,39,155,H1
"Tuscarawas County, OH",2000-2001,91043,91319,276,0.303,313,-37,39,157,H1
"Tuscarawas County, OH",2001-2002,91319,91735,416,0.456,195,221,39,157,H1
"Tuscarawas County, OH",2002-2003,91735,92015,280,0.305,315,-35,39,157,H1
"Tuscarawas County, OH",2003-2004,92015,92348,333,0.362,253,80,39,157,H1
"Tuscarawas County, OH",2004-2005,92348,92286,-62,-0.067,266,-328,39,157,H1
"Tuscarawas County, OH",2005-2006,92286,92271,-15,-0.016,258,-273,39,157,H1
"Tuscarawas County, OH",2006-2007,92271,92511,240,0.26,248,-8,39,157,H1
"Tuscarawas County, OH",2007-2008,92511,92634,123,0.133,242,-119,39,157,H1
"Tuscarawas County, OH",2008-2009,92634,92584,-50,-0.054,235,-285,39,157,H1
"Tuscarawas County, OH",2009-2010,92584,92546,-38,-0.041,135,-173,39,157,H1
"Tuscarawas County, OH",2010-2011,92546,92492,-54,-0.058,134,-188,39,157,H1
"Tuscarawas County, OH",2011-2012,92492,92488,-4,-0.004,156,-160,39,157,H1
"Tuscarawas County, OH",2012-2013,92488,92767,279,0.302,91,188,39,157,H1
"Tuscarawas County, OH",2013-2014,92767,92788,21,0.023,128,-107,39,157,H1
"Tuscarawas County, OH",2014-2015,92774,92916,142,0.153,171,-29,39,157,H1
"Tuscarawas County, OH",2015-2016,92916,92485,-431,-0.464,146,-577,39,157,H1
"Tuscarawas County, OH",2016-2017,92485,92297,-188,-0.203,139,-327,39,157,H1
"Union County, OH",2000-2001,41338,42859,1521,3.679,384,1137,39,159,H1
"Union County, OH",2001-2002,42859,43517,658,1.535,300,358,39,159,H1
"Union County, OH",2002-2003,43517,44665,1148,2.638,329,819,39,159,H1
"Union County, OH",2003-2004,44665,45819,1154,2.584,339,815,39,159,H1
"Union County, OH",2004-2005,45819,46952,1133,2.473,438,695,39,159,H1
"Union County, OH",2005-2006,46952,48589,1637,3.487,342,1295,39,159,H1
"Union County, OH",2006-2007,48589,49906,1317,2.71,376,941,39,159,H1
"Union County, OH",2007-2008,49906,50856,950,1.904,441,509,39,159,H1
"Union County, OH",2008-2009,50856,51798,942,1.852,451,491,39,159,H1
"Union County, OH",2009-2010,51798,52391,593,1.145,384,209,39,159,H1
"Union County, OH",2010-2011,52391,53087,696,1.328,278,418,39,159,H1
"Union County, OH",2011-2012,53087,52815,-272,-0.512,285,-557,39,159,H1
"Union County, OH",2012-2013,52815,53380,565,1.07,259,306,39,159,H1
"Union County, OH",2013-2014,53380,53776,396,0.742,271,125,39,159,H1
"Union County, OH",2014-2015,53713,54277,564,1.05,299,265,39,159,H1
"Union County, OH",2015-2016,54277,55456,1179,2.172,301,878,39,159,H1
"Union County, OH",2016-2017,55456,56741,1285,2.317,334,951,39,159,H1
"Van Wert County, OH",2000-2001,29627,29430,-197,-0.665,10,-207,39,161,H1
"Van Wert County, OH",2001-2002,29430,29327,-103,-0.35,37,-140,39,161,H1
"Van Wert County, OH",2002-2003,29327,29288,-39,-0.133,42,-81,39,161,H1
"Van Wert County, OH",2003-2004,29288,29322,34,0.116,58,-24,39,161,H1
"Van Wert County, OH",2004-2005,29322,29264,-58,-0.198,102,-160,39,161,H1
"Van Wert County, OH",2005-2006,29264,29342,78,0.267,87,-9,39,161,H1
"Van Wert County, OH",2006-2007,29342,29182,-160,-0.545,84,-244,39,161,H1
"Van Wert County, OH",2007-2008,29182,29075,-107,-0.367,95,-202,39,161,H1
"Van Wert County, OH",2008-2009,29075,28849,-226,-0.777,68,-294,39,161,H1
"Van Wert County, OH",2009-2010,28849,28673,-176,-0.61,35,-211,39,161,H1
"Van Wert County, OH",2010-2011,28673,28703,30,0.105,44,-14,39,161,H1
"Van Wert County, OH",2011-2012,28703,28729,26,0.091,21,5,39,161,H1
"Van Wert County, OH",2012-2013,28729,28494,-235,-0.818,20,-255,39,161,H1
"Van Wert County, OH",2013-2014,28494,28462,-32,-0.112,29,-61,39,161,H1
"Van Wert County, OH",2014-2015,28442,28562,120,0.422,48,72,39,161,H1
"Van Wert County, OH",2015-2016,28562,28166,-396,-1.386,23,-419,39,161,H1
"Van Wert County, OH",2016-2017,28166,28217,51,0.181,22,29,39,161,H1
"Vinton County, OH",2000-2001,12825,12966,141,1.099,75,66,39,163,H1
"Vinton County, OH",2001-2002,12966,13076,110,0.848,27,83,39,163,H1
"Vinton County, OH",2002-2003,13076,13260,184,1.407,60,124,39,163,H1
"Vinton County, OH",2003-2004,13260,13308,48,0.362,60,-12,39,163,H1
"Vinton County, OH",2004-2005,13308,13370,62,0.466,36,26,39,163,H1
"Vinton County, OH",2005-2006,13370,13516,146,1.092,41,105,39,163,H1
"Vinton County, OH",2006-2007,13516,13566,50,0.37,64,-14,39,163,H1
"Vinton County, OH",2007-2008,13566,13452,-114,-0.84,23,-137,39,163,H1
"Vinton County, OH",2008-2009,13452,13474,22,0.164,19,3,39,163,H1
"Vinton County, OH",2009-2010,13474,13417,-57,-0.423,3,-60,39,163,H1
"Vinton County, OH",2010-2011,13417,13397,-20,-0.149,15,-35,39,163,H1
"Vinton County, OH",2011-2012,13397,13233,-164,-1.224,6,-170,39,163,H1
"Vinton County, OH",2012-2013,13233,13313,80,0.605,26,54,39,163,H1
"Vinton County, OH",2013-2014,13313,13234,-79,-0.593,15,-94,39,163,H1
"Vinton County, OH",2014-2015,13197,13048,-149,-1.129,-12,-137,39,163,H1
"Vinton County, OH",2015-2016,13048,13021,-27,-0.207,3,-30,39,163,H1
"Vinton County, OH",2016-2017,13021,13092,71,0.545,-3,74,39,163,H1
"Warren County, OH",2000-2001,161716,167851,6135,3.794,1438,4697,39,165,H1
"Warren County, OH",2001-2002,167851,174833,6982,4.16,1412,5570,39,165,H1
"Warren County, OH",2002-2003,174833,181976,7143,4.086,1499,5644,39,165,H1
"Warren County, OH",2003-2004,181976,188904,6928,3.807,1418,5510,39,165,H1
"Warren County, OH",2004-2005,188904,195499,6595,3.491,1591,5004,39,165,H1
"Warren County, OH",2005-2006,195499,200630,5131,2.625,1496,3635,39,165,H1
"Warren County, OH",2006-2007,200630,205258,4628,2.307,1521,3107,39,165,H1
"Warren County, OH",2007-2008,205258,208640,3382,1.648,1485,1897,39,165,H1
"Warren County, OH",2008-2009,208640,211231,2591,1.242,1599,992,39,165,H1
"Warren County, OH",2009-2010,211231,213485,2254,1.067,1052,1202,39,165,H1
"Warren County, OH",2010-2011,213485,215740,2255,1.056,1129,1126,39,165,H1
"Warren County, OH",2011-2012,215740,217653,1913,0.887,926,987,39,165,H1
"Warren County, OH",2012-2013,217653,219578,1925,0.884,809,1116,39,165,H1
"Warren County, OH",2013-2014,219578,221659,2081,0.948,760,1321,39,165,H1
"Warren County, OH",2014-2015,221816,224469,2653,1.196,734,1919,39,165,H1
"Warren County, OH",2015-2016,224469,226476,2007,0.894,817,1190,39,165,H1
"Warren County, OH",2016-2017,226476,228882,2406,1.062,591,1815,39,165,H1
"Washington County, OH",2000-2001,63180,62847,-333,-0.527,23,-356,39,167,H1
"Washington County, OH",2001-2002,62847,62638,-209,-0.333,22,-231,39,167,H1
"Washington County, OH",2002-2003,62638,62759,121,0.193,-6,127,39,167,H1
"Washington County, OH",2003-2004,62759,62924,165,0.263,24,141,39,167,H1
"Washington County, OH",2004-2005,62924,62547,-377,-0.599,-33,-344,39,167,H1
"Washington County, OH",2005-2006,62547,62387,-160,-0.256,78,-238,39,167,H1
"Washington County, OH",2006-2007,62387,62253,-134,-0.215,-21,-113,39,167,H1
"Washington County, OH",2007-2008,62253,62040,-213,-0.342,21,-234,39,167,H1
"Washington County, OH",2008-2009,62040,61968,-72,-0.116,-31,-41,39,167,H1
"Washington County, OH",2009-2010,61968,61691,-277,-0.447,-82,-195,39,167,H1
"Washington County, OH",2010-2011,61691,61559,-132,-0.214,-119,-13,39,167,H1
"Washington County, OH",2011-2012,61559,61508,-51,-0.083,-109,58,39,167,H1
"Washington County, OH",2012-2013,61508,61393,-115,-0.187,-49,-66,39,167,H1
"Washington County, OH",2013-2014,61393,61213,-180,-0.293,-70,-110,39,167,H1
"Washington County, OH",2014-2015,61172,61112,-60,-0.098,-75,15,39,167,H1
"Washington County, OH",2015-2016,61112,60535,-577,-0.944,-143,-434,39,167,H1
"Washington County, OH",2016-2017,60535,60418,-117,-0.193,-134,17,39,167,H1
"Wayne County, OH",2000-2001,111668,112161,493,0.441,595,-102,39,169,H1
"Wayne County, OH",2001-2002,112161,112684,523,0.466,706,-183,39,169,H1
"Wayne County, OH",2002-2003,112684,113067,383,0.34,672,-289,39,169,H1
"Wayne County, OH",2003-2004,113067,113240,173,0.153,626,-453,39,169,H1
"Wayne County, OH",2004-2005,113240,113603,363,0.321,606,-243,39,169,H1
"Wayne County, OH",2005-2006,113603,114263,660,0.581,658,2,39,169,H1
"Wayne County, OH",2006-2007,114263,114224,-39,-0.034,634,-673,39,169,H1
"Wayne County, OH",2007-2008,114224,114610,386,0.338,646,-260,39,169,H1
"Wayne County, OH",2008-2009,114610,114588,-22,-0.019,651,-673,39,169,H1
"Wayne County, OH",2009-2010,114588,114501,-87,-0.076,483,-570,39,169,H1
"Wayne County, OH",2010-2011,114501,114718,217,0.19,431,-214,39,169,H1
"Wayne County, OH",2011-2012,114718,114990,272,0.237,541,-269,39,169,H1
"Wayne County, OH",2012-2013,114990,115144,154,0.134,421,-267,39,169,H1
"Wayne County, OH",2013-2014,115144,115537,393,0.341,446,-53,39,169,H1
"Wayne County, OH",2014-2015,115742,116063,321,0.277,551,-230,39,169,H1
"Wayne County, OH",2015-2016,116063,116422,359,0.309,427,-68,39,169,H1
"Wayne County, OH",2016-2017,116422,116038,-384,-0.33,406,-790,39,169,H1
"Williams County, OH",2000-2001,39199,39085,-114,-0.291,63,-177,39,171,H1
"Williams County, OH",2001-2002,39085,38959,-126,-0.322,93,-219,39,171,H1
"Williams County, OH",2002-2003,38959,38753,-206,-0.529,110,-316,39,171,H1
"Williams County, OH",2003-2004,38753,38719,-34,-0.088,78,-112,39,171,H1
"Williams County, OH",2004-2005,38719,38546,-173,-0.447,67,-240,39,171,H1
"Williams County, OH",2005-2006,38546,38547,1,0.003,108,-107,39,171,H1
"Williams County, OH",2006-2007,38547,38532,-15,-0.039,78,-93,39,171,H1
"Williams County, OH",2007-2008,38532,38297,-235,-0.61,100,-335,39,171,H1
"Williams County, OH",2008-2009,38297,37950,-347,-0.906,101,-448,39,171,H1
"Williams County, OH",2009-2010,37950,37529,-421,-1.109,68,-489,39,171,H1
"Williams County, OH",2010-2011,37529,37594,65,0.173,94,-29,39,171,H1
"Williams County, OH",2011-2012,37594,37568,-26,-0.069,86,-112,39,171,H1
"Williams County, OH",2012-2013,37568,37485,-83,-0.221,31,-114,39,171,H1
"Williams County, OH",2013-2014,37485,37291,-194,-0.518,61,-255,39,171,H1
"Williams County, OH",2014-2015,37222,37120,-102,-0.274,62,-164,39,171,H1
"Williams County, OH",2015-2016,37120,36921,-199,-0.536,39,-238,39,171,H1
"Williams County, OH",2016-2017,36921,36784,-137,-0.371,32,-169,39,171,H1
"Wood County, OH",2000-2001,121199,122013,814,0.672,482,332,39,173,H1
"Wood County, OH",2001-2002,122013,122206,193,0.158,358,-165,39,173,H1
"Wood County, OH",2002-2003,122206,122826,620,0.507,438,182,39,173,H1
"Wood County, OH",2003-2004,122826,124149,1323,1.077,489,834,39,173,H1
"Wood County, OH",2004-2005,124149,124698,549,0.442,479,70,39,173,H1
"Wood County, OH",2005-2006,124698,125027,329,0.264,376,-47,39,173,H1
"Wood County, OH",2006-2007,125027,125285,258,0.206,360,-102,39,173,H1
"Wood County, OH",2007-2008,125285,125275,-10,-0.008,462,-472,39,173,H1
"Wood County, OH",2008-2009,125275,125384,109,0.087,511,-402,39,173,H1
"Wood County, OH",2009-2010,125384,125942,558,0.445,378,180,39,173,H1
"Wood County, OH",2010-2011,125942,127296,1354,1.075,282,1072,39,173,H1
"Wood County, OH",2011-2012,127296,128659,1363,1.071,398,965,39,173,H1
"Wood County, OH",2012-2013,128659,129209,550,0.427,364,186,39,173,H1
"Wood County, OH",2013-2014,129209,129590,381,0.295,359,22,39,173,H1
"Wood County, OH",2014-2015,129575,129730,155,0.12,347,-192,39,173,H1
"Wood County, OH",2015-2016,129730,129704,-26,-0.02,238,-264,39,173,H1
"Wood County, OH",2016-2017,129704,130492,788,0.608,277,511,39,173,H1
"Wyandot County, OH",2000-2001,22894,22787,-107,-0.467,32,-139,39,175,H1
"Wyandot County, OH",2001-2002,22787,22813,26,0.114,56,-30,39,175,H1
"Wyandot County, OH",2002-2003,22813,22816,3,0.013,22,-19,39,175,H1
"Wyandot County, OH",2003-2004,22816,22914,98,0.43,73,25,39,175,H1
"Wyandot County, OH",2004-2005,22914,22820,-94,-0.41,56,-150,39,175,H1
"Wyandot County, OH",2005-2006,22820,22729,-91,-0.399,39,-130,39,175,H1
"Wyandot County, OH",2006-2007,22729,22716,-13,-0.057,67,-80,39,175,H1
"Wyandot County, OH",2007-2008,22716,22642,-74,-0.326,58,-132,39,175,H1
"Wyandot County, OH",2008-2009,22642,22644,2,0.009,69,-67,39,175,H1
"Wyandot County, OH",2009-2010,22644,22583,-61,-0.269,42,-103,39,175,H1
"Wyandot County, OH",2010-2011,22583,22652,69,0.306,32,37,39,175,H1
"Wyandot County, OH",2011-2012,22652,22592,-60,-0.265,43,-103,39,175,H1
"Wyandot County, OH",2012-2013,22592,22497,-95,-0.421,53,-148,39,175,H1
"Wyandot County, OH",2013-2014,22497,22353,-144,-0.64,33,-177,39,175,H1
"Wyandot County, OH",2014-2015,22327,22243,-84,-0.376,14,-98,39,175,H1
"Wyandot County, OH",2015-2016,22243,22042,-201,-0.904,-1,-200,39,175,H1
"Wyandot County, OH",2016-2017,22042,22029,-13,-0.059,-6,-7,39,175,H1
Oklahoma,2000-2001,3454365,3467100,12735,0.369,14563,-1828,40,0,STATE
Oklahoma,2001-2002,3467100,3489080,21980,0.634,15291,6689,40,0,STATE
Oklahoma,2002-2003,3489080,3504892,15812,0.453,15612,200,40,0,STATE
Oklahoma,2003-2004,3504892,3525233,20341,0.58,15187,5154,40,0,STATE
Oklahoma,2004-2005,3525233,3548597,23364,0.663,16003,7361,40,0,STATE
Oklahoma,2005-2006,3548597,3594090,45493,1.282,16720,28773,40,0,STATE
Oklahoma,2006-2007,3594090,3634349,40259,1.12,19815,20444,40,0,STATE
Oklahoma,2007-2008,3634349,3668976,34627,0.953,19787,14840,40,0,STATE
Oklahoma,2008-2009,3668976,3717572,48596,1.325,19447,29149,40,0,STATE
Oklahoma,2009-2010,3717572,3759596,42024,1.13,19724,22300,40,0,STATE
Oklahoma,2010-2011,3759596,3786626,27030,0.719,14916,12114,40,0,STATE
Oklahoma,2011-2012,3786626,3817679,31053,0.82,15405,15648,40,0,STATE
Oklahoma,2012-2013,3817679,3853405,35726,0.936,14751,20975,40,0,STATE
Oklahoma,2013-2014,3853405,3879610,26205,0.68,15513,10692,40,0,STATE
Oklahoma,2014-2015,3879610,3911338,31728,0.818,15914,15814,40,0,STATE
Oklahoma,2015-2016,3911338,3921207,9869,0.252,13304,-3435,40,0,STATE
Oklahoma,2016-2017,3921207,3930864,9657,0.246,12864,-3207,40,0,STATE
"Adair County, OK",2000-2001,21031,21101,70,0.333,158,-88,40,1,H1
"Adair County, OK",2001-2002,21101,21271,170,0.806,145,25,40,1,H1
"Adair County, OK",2002-2003,21271,21445,174,0.818,117,57,40,1,H1
"Adair County, OK",2003-2004,21445,21589,144,0.671,161,-17,40,1,H1
"Adair County, OK",2004-2005,21589,21887,298,1.38,152,146,40,1,H1
"Adair County, OK",2005-2006,21887,22215,328,1.499,168,160,40,1,H1
"Adair County, OK",2006-2007,22215,22345,130,0.585,143,-13,40,1,H1
"Adair County, OK",2007-2008,22345,22346,1,0.004,151,-150,40,1,H1
"Adair County, OK",2008-2009,22346,22477,131,0.586,106,25,40,1,H1
"Adair County, OK",2009-2010,22477,22720,243,1.081,127,116,40,1,H1
"Adair County, OK",2010-2011,22720,22513,-207,-0.911,35,-242,40,1,H1
"Adair County, OK",2011-2012,22513,22248,-265,-1.177,30,-295,40,1,H1
"Adair County, OK",2012-2013,22248,22235,-13,-0.058,95,-108,40,1,H1
"Adair County, OK",2013-2014,22235,22186,-49,-0.22,68,-117,40,1,H1
"Adair County, OK",2014-2015,22153,22004,-149,-0.673,42,-191,40,1,H1
"Adair County, OK",2015-2016,22004,22111,107,0.486,20,87,40,1,H1
"Adair County, OK",2016-2017,22111,21909,-202,-0.914,28,-230,40,1,H1
"Alfalfa County, OK",2000-2001,6080,5933,-147,-2.418,-26,-121,40,3,H1
"Alfalfa County, OK",2001-2002,5933,5894,-39,-0.657,-14,-25,40,3,H1
"Alfalfa County, OK",2002-2003,5894,5827,-67,-1.137,-37,-30,40,3,H1
"Alfalfa County, OK",2003-2004,5827,5785,-42,-0.721,-32,-10,40,3,H1
"Alfalfa County, OK",2004-2005,5785,5706,-79,-1.366,-30,-49,40,3,H1
"Alfalfa County, OK",2005-2006,5706,5639,-67,-1.174,-25,-42,40,3,H1
"Alfalfa County, OK",2006-2007,5639,5618,-21,-0.372,-14,-7,40,3,H1
"Alfalfa County, OK",2007-2008,5618,5618,0,0,1,-1,40,3,H1
"Alfalfa County, OK",2008-2009,5618,5585,-33,-0.587,0,-33,40,3,H1
"Alfalfa County, OK",2009-2010,5585,5628,43,0.77,-8,51,40,3,H1
"Alfalfa County, OK",2010-2011,5628,5637,9,0.16,-28,37,40,3,H1
"Alfalfa County, OK",2011-2012,5637,5643,6,0.106,-11,17,40,3,H1
"Alfalfa County, OK",2012-2013,5643,5817,174,3.083,2,172,40,3,H1
"Alfalfa County, OK",2013-2014,5817,5790,-27,-0.464,18,-45,40,3,H1
"Alfalfa County, OK",2014-2015,5793,5868,75,1.295,14,61,40,3,H1
"Alfalfa County, OK",2015-2016,5868,5914,46,0.784,23,23,40,3,H1
"Alfalfa County, OK",2016-2017,5914,5907,-7,-0.118,16,-23,40,3,H1
"Atoka County, OK",2000-2001,13820,13816,-4,-0.029,-16,12,40,5,H1
"Atoka County, OK",2001-2002,13816,13836,20,0.145,-6,26,40,5,H1
"Atoka County, OK",2002-2003,13836,13973,137,0.99,13,124,40,5,H1
"Atoka County, OK",2003-2004,13973,14046,73,0.522,41,32,40,5,H1
"Atoka County, OK",2004-2005,14046,14034,-12,-0.085,-3,-9,40,5,H1
"Atoka County, OK",2005-2006,14034,14013,-21,-0.15,45,-66,40,5,H1
"Atoka County, OK",2006-2007,14013,14118,105,0.749,28,77,40,5,H1
"Atoka County, OK",2007-2008,14118,14220,102,0.722,30,72,40,5,H1
"Atoka County, OK",2008-2009,14220,14155,-65,-0.457,41,-106,40,5,H1
"Atoka County, OK",2009-2010,14155,14151,-4,-0.028,52,-56,40,5,H1
"Atoka County, OK",2010-2011,14151,14100,-51,-0.36,25,-76,40,5,H1
"Atoka County, OK",2011-2012,14100,13960,-140,-0.993,27,-167,40,5,H1
"Atoka County, OK",2012-2013,13960,13785,-175,-1.254,-13,-162,40,5,H1
"Atoka County, OK",2013-2014,13785,13796,11,0.08,20,-9,40,5,H1
"Atoka County, OK",2014-2015,13848,13793,-55,-0.397,62,-117,40,5,H1
"Atoka County, OK",2015-2016,13793,13925,132,0.957,6,126,40,5,H1
"Atoka County, OK",2016-2017,13925,13887,-38,-0.273,36,-74,40,5,H1
"Beaver County, OK",2000-2001,5782,5657,-125,-2.162,-3,-122,40,7,H1
"Beaver County, OK",2001-2002,5657,5617,-40,-0.707,12,-52,40,7,H1
"Beaver County, OK",2002-2003,5617,5609,-8,-0.142,19,-27,40,7,H1
"Beaver County, OK",2003-2004,5609,5577,-32,-0.571,17,-49,40,7,H1
"Beaver County, OK",2004-2005,5577,5569,-8,-0.143,12,-20,40,7,H1
"Beaver County, OK",2005-2006,5569,5514,-55,-0.988,14,-69,40,7,H1
"Beaver County, OK",2006-2007,5514,5571,57,1.034,9,48,40,7,H1
"Beaver County, OK",2007-2008,5571,5521,-50,-0.898,14,-64,40,7,H1
"Beaver County, OK",2008-2009,5521,5562,41,0.743,25,16,40,7,H1
"Beaver County, OK",2009-2010,5562,5648,86,1.546,51,35,40,7,H1
"Beaver County, OK",2010-2011,5648,5640,-8,-0.142,19,-27,40,7,H1
"Beaver County, OK",2011-2012,5640,5592,-48,-0.851,-3,-45,40,7,H1
"Beaver County, OK",2012-2013,5592,5540,-52,-0.93,14,-66,40,7,H1
"Beaver County, OK",2013-2014,5540,5486,-54,-0.975,13,-67,40,7,H1
"Beaver County, OK",2014-2015,5483,5427,-56,-1.021,27,-83,40,7,H1
"Beaver County, OK",2015-2016,5427,5400,-27,-0.498,3,-30,40,7,H1
"Beaver County, OK",2016-2017,5400,5315,-85,-1.574,-2,-83,40,7,H1
"Beckham County, OK",2000-2001,19777,19937,160,0.809,12,148,40,9,H1
"Beckham County, OK",2001-2002,19937,20142,205,1.028,25,180,40,9,H1
"Beckham County, OK",2002-2003,20142,19663,-479,-2.378,20,-499,40,9,H1
"Beckham County, OK",2003-2004,19663,18580,-1083,-5.508,51,-1134,40,9,H1
"Beckham County, OK",2004-2005,18580,19151,571,3.073,76,495,40,9,H1
"Beckham County, OK",2005-2006,19151,20040,889,4.642,29,860,40,9,H1
"Beckham County, OK",2006-2007,20040,21855,1815,9.057,96,1719,40,9,H1
"Beckham County, OK",2007-2008,21855,22817,962,4.402,142,820,40,9,H1
"Beckham County, OK",2008-2009,22817,22369,-448,-1.963,131,-579,40,9,H1
"Beckham County, OK",2009-2010,22369,22035,-334,-1.493,104,-438,40,9,H1
"Beckham County, OK",2010-2011,22035,22312,277,1.257,127,150,40,9,H1
"Beckham County, OK",2011-2012,22312,23117,805,3.608,104,701,40,9,H1
"Beckham County, OK",2012-2013,23117,23548,431,1.864,147,284,40,9,H1
"Beckham County, OK",2013-2014,23548,23691,143,0.607,123,20,40,9,H1
"Beckham County, OK",2014-2015,23733,23768,35,0.147,151,-116,40,9,H1
"Beckham County, OK",2015-2016,23768,22432,-1336,-5.621,86,-1422,40,9,H1
"Beckham County, OK",2016-2017,22432,21793,-639,-2.849,34,-673,40,9,H1
"Blaine County, OK",2000-2001,11959,11915,-44,-0.368,-38,-6,40,11,H1
"Blaine County, OK",2001-2002,11915,11574,-341,-2.862,-36,-305,40,11,H1
"Blaine County, OK",2002-2003,11574,11196,-378,-3.266,-8,-370,40,11,H1
"Blaine County, OK",2003-2004,11196,12277,1081,9.655,-4,1085,40,11,H1
"Blaine County, OK",2004-2005,12277,12264,-13,-0.106,27,-40,40,11,H1
"Blaine County, OK",2005-2006,12264,11965,-299,-2.438,-9,-290,40,11,H1
"Blaine County, OK",2006-2007,11965,12010,45,0.376,-5,50,40,11,H1
"Blaine County, OK",2007-2008,12010,12019,9,0.075,45,-36,40,11,H1
"Blaine County, OK",2008-2009,12019,11896,-123,-1.023,26,-149,40,11,H1
"Blaine County, OK",2009-2010,11896,9903,-1993,-16.754,22,-2015,40,11,H1
"Blaine County, OK",2010-2011,9903,9702,-201,-2.03,9,-210,40,11,H1
"Blaine County, OK",2011-2012,9702,9819,117,1.206,7,110,40,11,H1
"Blaine County, OK",2012-2013,9819,9819,0,0,71,-71,40,11,H1
"Blaine County, OK",2013-2014,9819,9917,98,0.998,69,29,40,11,H1
"Blaine County, OK",2014-2015,9896,9833,-63,-0.637,66,-129,40,11,H1
"Blaine County, OK",2015-2016,9833,9571,-262,-2.664,34,-296,40,11,H1
"Blaine County, OK",2016-2017,9571,9498,-73,-0.763,27,-100,40,11,H1
"Bryan County, OK",2000-2001,36604,36577,-27,-0.074,99,-126,40,13,H1
"Bryan County, OK",2001-2002,36577,37003,426,1.165,136,290,40,13,H1
"Bryan County, OK",2002-2003,37003,37260,257,0.695,44,213,40,13,H1
"Bryan County, OK",2003-2004,37260,37887,627,1.683,-14,641,40,13,H1
"Bryan County, OK",2004-2005,37887,38309,422,1.114,59,363,40,13,H1
"Bryan County, OK",2005-2006,38309,39739,1430,3.733,104,1326,40,13,H1
"Bryan County, OK",2006-2007,39739,40350,611,1.538,94,517,40,13,H1
"Bryan County, OK",2007-2008,40350,41453,1103,2.734,236,867,40,13,H1
"Bryan County, OK",2008-2009,41453,41859,406,0.979,190,216,40,13,H1
"Bryan County, OK",2009-2010,41859,42647,788,1.883,134,654,40,13,H1
"Bryan County, OK",2010-2011,42647,43163,516,1.21,146,370,40,13,H1
"Bryan County, OK",2011-2012,43163,43462,299,0.693,169,130,40,13,H1
"Bryan County, OK",2012-2013,43462,44217,755,1.737,133,622,40,13,H1
"Bryan County, OK",2013-2014,44217,44486,269,0.608,119,150,40,13,H1
"Bryan County, OK",2014-2015,44403,44884,481,1.083,41,440,40,13,H1
"Bryan County, OK",2015-2016,44884,45492,608,1.355,41,567,40,13,H1
"Bryan County, OK",2016-2017,45492,46319,827,1.818,41,786,40,13,H1
"Caddo County, OK",2000-2001,30037,29677,-360,-1.199,-1,-359,40,15,H1
"Caddo County, OK",2001-2002,29677,29532,-145,-0.489,70,-215,40,15,H1
"Caddo County, OK",2002-2003,29532,29550,18,0.061,97,-79,40,15,H1
"Caddo County, OK",2003-2004,29550,29470,-80,-0.271,47,-127,40,15,H1
"Caddo County, OK",2004-2005,29470,29202,-268,-0.909,78,-346,40,15,H1
"Caddo County, OK",2005-2006,29202,29087,-115,-0.394,53,-168,40,15,H1
"Caddo County, OK",2006-2007,29087,27932,-1155,-3.971,48,-1203,40,15,H1
"Caddo County, OK",2007-2008,27932,28612,680,2.434,121,559,40,15,H1
"Caddo County, OK",2008-2009,28612,29459,847,2.96,94,753,40,15,H1
"Caddo County, OK",2009-2010,29459,29671,212,0.72,69,143,40,15,H1
"Caddo County, OK",2010-2011,29671,29608,-63,-0.212,121,-184,40,15,H1
"Caddo County, OK",2011-2012,29608,29672,64,0.216,40,24,40,15,H1
"Caddo County, OK",2012-2013,29672,29487,-185,-0.623,1,-186,40,15,H1
"Caddo County, OK",2013-2014,29487,29317,-170,-0.577,-1,-169,40,15,H1
"Caddo County, OK",2014-2015,29372,29343,-29,-0.099,50,-79,40,15,H1
"Caddo County, OK",2015-2016,29343,29542,199,0.678,21,178,40,15,H1
"Caddo County, OK",2016-2017,29542,29173,-369,-1.249,6,-375,40,15,H1
"Canadian County, OK",2000-2001,88230,89931,1701,1.928,456,1245,40,17,H1
"Canadian County, OK",2001-2002,89931,91507,1576,1.752,470,1106,40,17,H1
"Canadian County, OK",2002-2003,91507,93449,1942,2.122,550,1392,40,17,H1
"Canadian County, OK",2003-2004,93449,96101,2652,2.838,517,2135,40,17,H1
"Canadian County, OK",2004-2005,96101,99176,3075,3.2,635,2440,40,17,H1
"Canadian County, OK",2005-2006,99176,102876,3700,3.731,681,3019,40,17,H1
"Canadian County, OK",2006-2007,102876,106804,3928,3.818,833,3095,40,17,H1
"Canadian County, OK",2007-2008,106804,109969,3165,2.963,847,2318,40,17,H1
"Canadian County, OK",2008-2009,109969,113186,3217,2.925,842,2375,40,17,H1
"Canadian County, OK",2009-2010,113186,116348,3162,2.794,768,2394,40,17,H1
"Canadian County, OK",2010-2011,116348,119487,3139,2.698,750,2389,40,17,H1
"Canadian County, OK",2011-2012,119487,122605,3118,2.609,772,2346,40,17,H1
"Canadian County, OK",2012-2013,122605,126136,3531,2.88,795,2736,40,17,H1
"Canadian County, OK",2013-2014,126136,129582,3446,2.732,812,2634,40,17,H1
"Canadian County, OK",2014-2015,129478,133378,3900,3.012,879,3021,40,17,H1
"Canadian County, OK",2015-2016,133378,136303,2925,2.193,775,2150,40,17,H1
"Canadian County, OK",2016-2017,136303,139926,3623,2.658,777,2846,40,17,H1
"Carter County, OK",2000-2001,45547,45455,-92,-0.202,44,-136,40,19,H1
"Carter County, OK",2001-2002,45455,45656,201,0.442,54,147,40,19,H1
"Carter County, OK",2002-2003,45656,45854,198,0.434,101,97,40,19,H1
"Carter County, OK",2003-2004,45854,46218,364,0.794,37,327,40,19,H1
"Carter County, OK",2004-2005,46218,46169,-49,-0.106,25,-74,40,19,H1
"Carter County, OK",2005-2006,46169,46430,261,0.565,43,218,40,19,H1
"Carter County, OK",2006-2007,46430,46582,152,0.327,130,22,40,19,H1
"Carter County, OK",2007-2008,46582,46910,328,0.704,149,179,40,19,H1
"Carter County, OK",2008-2009,46910,47421,511,1.089,173,338,40,19,H1
"Carter County, OK",2009-2010,47421,47778,357,0.753,167,190,40,19,H1
"Carter County, OK",2010-2011,47778,48074,296,0.62,-15,311,40,19,H1
"Carter County, OK",2011-2012,48074,48114,40,0.083,43,-3,40,19,H1
"Carter County, OK",2012-2013,48114,48655,541,1.124,85,456,40,19,H1
"Carter County, OK",2013-2014,48655,48821,166,0.341,56,110,40,19,H1
"Carter County, OK",2014-2015,48756,48689,-67,-0.137,47,-114,40,19,H1
"Carter County, OK",2015-2016,48689,48359,-330,-0.678,96,-426,40,19,H1
"Carter County, OK",2016-2017,48359,48190,-169,-0.349,40,-209,40,19,H1
"Cherokee County, OK",2000-2001,42635,43066,431,1.011,247,184,40,21,H1
"Cherokee County, OK",2001-2002,43066,43625,559,1.298,219,340,40,21,H1
"Cherokee County, OK",2002-2003,43625,44066,441,1.011,200,241,40,21,H1
"Cherokee County, OK",2003-2004,44066,44437,371,0.842,198,173,40,21,H1
"Cherokee County, OK",2004-2005,44437,44805,368,0.828,141,227,40,21,H1
"Cherokee County, OK",2005-2006,44805,45517,712,1.589,212,500,40,21,H1
"Cherokee County, OK",2006-2007,45517,45546,29,0.064,186,-157,40,21,H1
"Cherokee County, OK",2007-2008,45546,46217,671,1.473,225,446,40,21,H1
"Cherokee County, OK",2008-2009,46217,46492,275,0.595,234,41,40,21,H1
"Cherokee County, OK",2009-2010,46492,47138,646,1.389,258,388,40,21,H1
"Cherokee County, OK",2010-2011,47138,47764,626,1.328,176,450,40,21,H1
"Cherokee County, OK",2011-2012,47764,48085,321,0.672,200,121,40,21,H1
"Cherokee County, OK",2012-2013,48085,47973,-112,-0.233,74,-186,40,21,H1
"Cherokee County, OK",2013-2014,47973,48341,368,0.767,131,237,40,21,H1
"Cherokee County, OK",2014-2015,48302,48447,145,0.3,134,11,40,21,H1
"Cherokee County, OK",2015-2016,48447,48751,304,0.627,177,127,40,21,H1
"Cherokee County, OK",2016-2017,48751,48888,137,0.281,128,9,40,21,H1
"Choctaw County, OK",2000-2001,15325,15165,-160,-1.044,52,-212,40,23,H1
"Choctaw County, OK",2001-2002,15165,15307,142,0.936,22,120,40,23,H1
"Choctaw County, OK",2002-2003,15307,15236,-71,-0.464,-15,-56,40,23,H1
"Choctaw County, OK",2003-2004,15236,15292,56,0.368,-31,87,40,23,H1
"Choctaw County, OK",2004-2005,15292,15244,-48,-0.314,5,-53,40,23,H1
"Choctaw County, OK",2005-2006,15244,15277,33,0.216,-22,55,40,23,H1
"Choctaw County, OK",2006-2007,15277,15210,-67,-0.439,31,-98,40,23,H1
"Choctaw County, OK",2007-2008,15210,15112,-98,-0.644,43,-141,40,23,H1
"Choctaw County, OK",2008-2009,15112,15127,15,0.099,23,-8,40,23,H1
"Choctaw County, OK",2009-2010,15127,15229,102,0.674,21,81,40,23,H1
"Choctaw County, OK",2010-2011,15229,15241,12,0.079,17,-5,40,23,H1
"Choctaw County, OK",2011-2012,15241,15170,-71,-0.466,-31,-40,40,23,H1
"Choctaw County, OK",2012-2013,15170,15072,-98,-0.646,3,-101,40,23,H1
"Choctaw County, OK",2013-2014,15072,15161,89,0.59,-10,99,40,23,H1
"Choctaw County, OK",2014-2015,15143,14997,-146,-0.964,-17,-129,40,23,H1
"Choctaw County, OK",2015-2016,14997,14915,-82,-0.547,1,-83,40,23,H1
"Choctaw County, OK",2016-2017,14915,14863,-52,-0.349,-2,-50,40,23,H1
"Cimarron County, OK",2000-2001,3121,3009,-112,-3.589,-12,-100,40,25,H1
"Cimarron County, OK",2001-2002,3009,2914,-95,-3.157,-5,-90,40,25,H1
"Cimarron County, OK",2002-2003,2914,2822,-92,-3.157,-15,-77,40,25,H1
"Cimarron County, OK",2003-2004,2822,2707,-115,-4.075,-5,-110,40,25,H1
"Cimarron County, OK",2004-2005,2707,2610,-97,-3.583,-9,-88,40,25,H1
"Cimarron County, OK",2005-2006,2610,2572,-38,-1.456,-13,-25,40,25,H1
"Cimarron County, OK",2006-2007,2572,2530,-42,-1.633,0,-42,40,25,H1
"Cimarron County, OK",2007-2008,2530,2449,-81,-3.202,15,-96,40,25,H1
"Cimarron County, OK",2008-2009,2449,2495,46,1.878,10,36,40,25,H1
"Cimarron County, OK",2009-2010,2495,2456,-39,-1.563,8,-47,40,25,H1
"Cimarron County, OK",2010-2011,2456,2480,24,0.977,-3,27,40,25,H1
"Cimarron County, OK",2011-2012,2480,2392,-88,-3.548,-6,-82,40,25,H1
"Cimarron County, OK",2012-2013,2392,2330,-62,-2.592,1,-63,40,25,H1
"Cimarron County, OK",2013-2014,2330,2294,-36,-1.545,6,-42,40,25,H1
"Cimarron County, OK",2014-2015,2288,2216,-72,-3.147,11,-83,40,25,H1
"Cimarron County, OK",2015-2016,2216,2170,-46,-2.076,-7,-39,40,25,H1
"Cimarron County, OK",2016-2017,2170,2154,-16,-0.737,5,-21,40,25,H1
"Cleveland County, OK",2000-2001,208614,213414,4800,2.301,1140,3660,40,27,H1
"Cleveland County, OK",2001-2002,213414,217235,3821,1.79,1248,2573,40,27,H1
"Cleveland County, OK",2002-2003,217235,221714,4479,2.062,1267,3212,40,27,H1
"Cleveland County, OK",2003-2004,221714,225447,3733,1.684,1239,2494,40,27,H1
"Cleveland County, OK",2004-2005,225447,229743,4296,1.906,1295,3001,40,27,H1
"Cleveland County, OK",2005-2006,229743,237257,7514,3.271,1236,6278,40,27,H1
"Cleveland County, OK",2006-2007,237257,241409,4152,1.75,1458,2694,40,27,H1
"Cleveland County, OK",2007-2008,241409,246790,5381,2.229,1438,3943,40,27,H1
"Cleveland County, OK",2008-2009,246790,251803,5013,2.031,1562,3451,40,27,H1
"Cleveland County, OK",2009-2010,251803,256844,5041,2.002,1657,3384,40,27,H1
"Cleveland County, OK",2010-2011,256844,261905,5061,1.97,1262,3799,40,27,H1
"Cleveland County, OK",2011-2012,261905,266122,4217,1.61,1295,2922,40,27,H1
"Cleveland County, OK",2012-2013,266122,269890,3768,1.416,1252,2516,40,27,H1
"Cleveland County, OK",2013-2014,269890,269908,18,0.007,1211,-1193,40,27,H1
"Cleveland County, OK",2014-2015,270189,274458,4269,1.58,1083,3186,40,27,H1
"Cleveland County, OK",2015-2016,274458,277670,3212,1.17,904,2308,40,27,H1
"Cleveland County, OK",2016-2017,277670,279641,1971,0.71,884,1087,40,27,H1
"Coal County, OK",2000-2001,6009,6010,1,0.017,8,-7,40,29,H1
"Coal County, OK",2001-2002,6010,5954,-56,-0.932,2,-58,40,29,H1
"Coal County, OK",2002-2003,5954,5925,-29,-0.487,-18,-11,40,29,H1
"Coal County, OK",2003-2004,5925,5880,-45,-0.759,-27,-18,40,29,H1
"Coal County, OK",2004-2005,5880,5743,-137,-2.33,-20,-117,40,29,H1
"Coal County, OK",2005-2006,5743,5671,-72,-1.254,-23,-49,40,29,H1
"Coal County, OK",2006-2007,5671,5718,47,0.829,-8,55,40,29,H1
"Coal County, OK",2007-2008,5718,5745,27,0.472,-1,28,40,29,H1
"Coal County, OK",2008-2009,5745,5962,217,3.777,2,215,40,29,H1
"Coal County, OK",2009-2010,5962,5903,-59,-0.99,-6,-53,40,29,H1
"Coal County, OK",2010-2011,5903,5942,39,0.661,-24,63,40,29,H1
"Coal County, OK",2011-2012,5942,5918,-24,-0.404,-9,-15,40,29,H1
"Coal County, OK",2012-2013,5918,5817,-101,-1.707,4,-105,40,29,H1
"Coal County, OK",2013-2014,5817,5807,-10,-0.172,-14,4,40,29,H1
"Coal County, OK",2014-2015,5777,5651,-126,-2.181,-19,-107,40,29,H1
"Coal County, OK",2015-2016,5651,5642,-9,-0.159,-9,0,40,29,H1
"Coal County, OK",2016-2017,5642,5642,0,0,4,-4,40,29,H1
"Comanche County, OK",2000-2001,115082,113551,-1531,-1.33,1062,-2593,40,31,H1
"Comanche County, OK",2001-2002,113551,113551,0,0,1014,-1014,40,31,H1
"Comanche County, OK",2002-2003,113551,111098,-2453,-2.16,1.00E+03,-3453,40,31,H1
"Comanche County, OK",2003-2004,111098,1.16E+05,4902,4.412,959,3943,40,31,H1
"Comanche County, OK",2004-2005,1.16E+05,115085,-915,-0.789,1111,-2026,40,31,H1
"Comanche County, OK",2005-2006,115085,116653,1568,1.362,991,577,40,31,H1
"Comanche County, OK",2006-2007,116653,119534,2881,2.47,1086,1795,40,31,H1
"Comanche County, OK",2007-2008,119534,118001,-1533,-1.282,1174,-2707,40,31,H1
"Comanche County, OK",2008-2009,118001,119952,1951,1.653,953,998,40,31,H1
"Comanche County, OK",2009-2010,119952,125448,5496,4.582,1170,4326,40,31,H1
"Comanche County, OK",2010-2011,125448,126109,661,0.527,1244,-583,40,31,H1
"Comanche County, OK",2011-2012,126109,126611,502,0.398,1029,-527,40,31,H1
"Comanche County, OK",2012-2013,126611,125035,-1576,-1.245,944,-2520,40,31,H1
"Comanche County, OK",2013-2014,125035,125033,-2,-0.002,841,-843,40,31,H1
"Comanche County, OK",2014-2015,125225,124648,-577,-0.461,931,-1508,40,31,H1
"Comanche County, OK",2015-2016,124648,121398,-3250,-2.607,652,-3902,40,31,H1
"Comanche County, OK",2016-2017,121398,121526,128,0.105,635,-507,40,31,H1
"Cotton County, OK",2000-2001,6613,6404,-209,-3.16,-3,-206,40,33,H1
"Cotton County, OK",2001-2002,6404,6338,-66,-1.031,5,-71,40,33,H1
"Cotton County, OK",2002-2003,6338,6386,48,0.757,-7,55,40,33,H1
"Cotton County, OK",2003-2004,6386,6341,-45,-0.705,-7,-38,40,33,H1
"Cotton County, OK",2004-2005,6341,6390,49,0.773,-15,64,40,33,H1
"Cotton County, OK",2005-2006,6390,6327,-63,-0.986,-11,-52,40,33,H1
"Cotton County, OK",2006-2007,6327,6280,-47,-0.743,-4,-43,40,33,H1
"Cotton County, OK",2007-2008,6280,6165,-115,-1.831,-3,-112,40,33,H1
"Cotton County, OK",2008-2009,6165,6179,14,0.227,9,5,40,33,H1
"Cotton County, OK",2009-2010,6179,6177,-2,-0.032,28,-30,40,33,H1
"Cotton County, OK",2010-2011,6177,6158,-19,-0.308,-10,-9,40,33,H1
"Cotton County, OK",2011-2012,6158,6147,-11,-0.179,-8,-3,40,33,H1
"Cotton County, OK",2012-2013,6147,6153,6,0.098,-1,7,40,33,H1
"Cotton County, OK",2013-2014,6153,6150,-3,-0.049,3,-6,40,33,H1
"Cotton County, OK",2014-2015,6127,5996,-131,-2.138,-14,-117,40,33,H1
"Cotton County, OK",2015-2016,5996,5913,-83,-1.384,-31,-52,40,33,H1
"Cotton County, OK",2016-2017,5913,5823,-90,-1.522,-35,-55,40,33,H1
"Craig County, OK",2000-2001,14928,14768,-160,-1.072,36,-196,40,35,H1
"Craig County, OK",2001-2002,14768,14712,-56,-0.379,34,-90,40,35,H1
"Craig County, OK",2002-2003,14712,14736,24,0.163,8,16,40,35,H1
"Craig County, OK",2003-2004,14736,14739,3,0.02,-24,27,40,35,H1
"Craig County, OK",2004-2005,14739,14896,157,1.065,-3,160,40,35,H1
"Craig County, OK",2005-2006,14896,14881,-15,-0.101,1,-16,40,35,H1
"Craig County, OK",2006-2007,14881,14978,97,0.652,-2,99,40,35,H1
"Craig County, OK",2007-2008,14978,14910,-68,-0.454,-22,-46,40,35,H1
"Craig County, OK",2008-2009,14910,14914,4,0.027,11,-7,40,35,H1
"Craig County, OK",2009-2010,14914,15058,144,0.966,32,112,40,35,H1
"Craig County, OK",2010-2011,15058,14935,-123,-0.817,-53,-70,40,35,H1
"Craig County, OK",2011-2012,14935,14721,-214,-1.433,-53,-161,40,35,H1
"Craig County, OK",2012-2013,14721,14666,-55,-0.374,-30,-25,40,35,H1
"Craig County, OK",2013-2014,14666,14582,-84,-0.573,-60,-24,40,35,H1
"Craig County, OK",2014-2015,14577,14818,241,1.653,-48,289,40,35,H1
"Craig County, OK",2015-2016,14818,14460,-358,-2.416,-68,-290,40,35,H1
"Craig County, OK",2016-2017,14460,14327,-133,-0.92,-75,-58,40,35,H1
"Creek County, OK",2000-2001,67507,67768,261,0.387,153,108,40,37,H1
"Creek County, OK",2001-2002,67768,68148,380,0.561,211,169,40,37,H1
"Creek County, OK",2002-2003,68148,68094,-54,-0.079,124,-178,40,37,H1
"Creek County, OK",2003-2004,68094,67843,-251,-0.369,151,-402,40,37,H1
"Creek County, OK",2004-2005,67843,67715,-128,-0.189,188,-316,40,37,H1
"Creek County, OK",2005-2006,67715,67791,76,0.112,79,-3,40,37,H1
"Creek County, OK",2006-2007,67791,68292,501,0.739,133,368,40,37,H1
"Creek County, OK",2007-2008,68292,68817,525,0.769,114,411,40,37,H1
"Creek County, OK",2008-2009,68817,69535,718,1.043,182,536,40,37,H1
"Creek County, OK",2009-2010,69535,70199,664,0.955,143,521,40,37,H1
"Creek County, OK",2010-2011,70199,70650,451,0.642,107,344,40,37,H1
"Creek County, OK",2011-2012,70650,70854,204,0.289,58,146,40,37,H1
"Creek County, OK",2012-2013,70854,70698,-156,-0.22,-21,-135,40,37,H1
"Creek County, OK",2013-2014,70698,70632,-66,-0.093,-6,-60,40,37,H1
"Creek County, OK",2014-2015,70657,70892,235,0.333,-26,261,40,37,H1
"Creek County, OK",2015-2016,70892,71038,146,0.206,-57,203,40,37,H1
"Creek County, OK",2016-2017,71038,71704,666,0.938,-63,729,40,37,H1
"Custer County, OK",2000-2001,26066,25778,-288,-1.105,46,-334,40,39,H1
"Custer County, OK",2001-2002,25778,25347,-431,-1.672,54,-485,40,39,H1
"Custer County, OK",2002-2003,25347,25554,207,0.817,137,70,40,39,H1
"Custer County, OK",2003-2004,25554,25631,77,0.301,76,1,40,39,H1
"Custer County, OK",2004-2005,25631,25876,245,0.956,103,142,40,39,H1
"Custer County, OK",2005-2006,25876,26148,272,1.051,94,178,40,39,H1
"Custer County, OK",2006-2007,26148,26356,208,0.795,153,55,40,39,H1
"Custer County, OK",2007-2008,26356,26816,460,1.745,183,277,40,39,H1
"Custer County, OK",2008-2009,26816,27284,468,1.745,178,290,40,39,H1
"Custer County, OK",2009-2010,27284,27486,202,0.74,195,7,40,39,H1
"Custer County, OK",2010-2011,27486,27730,244,0.888,160,84,40,39,H1
"Custer County, OK",2011-2012,27730,28518,788,2.842,209,579,40,39,H1
"Custer County, OK",2012-2013,28518,29295,777,2.725,177,600,40,39,H1
"Custer County, OK",2013-2014,29295,29500,205,0.7,185,20,40,39,H1
"Custer County, OK",2014-2015,29587,29744,157,0.531,233,-76,40,39,H1
"Custer County, OK",2015-2016,29744,29045,-699,-2.35,142,-841,40,39,H1
"Custer County, OK",2016-2017,29045,28800,-245,-0.844,139,-384,40,39,H1
"Delaware County, OK",2000-2001,37108,37606,498,1.342,34,464,40,41,H1
"Delaware County, OK",2001-2002,37606,37970,364,0.968,-25,389,40,41,H1
"Delaware County, OK",2002-2003,37970,38634,664,1.749,-34,698,40,41,H1
"Delaware County, OK",2003-2004,38634,38998,364,0.942,-64,428,40,41,H1
"Delaware County, OK",2004-2005,38998,39277,279,0.715,7,272,40,41,H1
"Delaware County, OK",2005-2006,39277,40266,989,2.518,18,971,40,41,H1
"Delaware County, OK",2006-2007,40266,40984,718,1.783,19,699,40,41,H1
"Delaware County, OK",2007-2008,40984,41018,34,0.083,29,5,40,41,H1
"Delaware County, OK",2008-2009,41018,41290,272,0.663,-44,316,40,41,H1
"Delaware County, OK",2009-2010,41290,41527,237,0.574,-71,308,40,41,H1
"Delaware County, OK",2010-2011,41527,41356,-171,-0.412,-149,-22,40,41,H1
"Delaware County, OK",2011-2012,41356,41373,17,0.041,-154,171,40,41,H1
"Delaware County, OK",2012-2013,41373,41371,-2,-0.005,-126,124,40,41,H1
"Delaware County, OK",2013-2014,41371,41446,75,0.181,-100,175,40,41,H1
"Delaware County, OK",2014-2015,41448,41459,11,0.027,-92,103,40,41,H1
"Delaware County, OK",2015-2016,41459,41880,421,1.015,-122,543,40,41,H1
"Delaware County, OK",2016-2017,41880,42602,722,1.724,-110,832,40,41,H1
"Dewey County, OK",2000-2001,4714,4645,-69,-1.464,-54,-15,40,43,H1
"Dewey County, OK",2001-2002,4645,4601,-44,-0.947,-9,-35,40,43,H1
"Dewey County, OK",2002-2003,4601,4601,0,0,-11,11,40,43,H1
"Dewey County, OK",2003-2004,4601,4685,84,1.826,-46,130,40,43,H1
"Dewey County, OK",2004-2005,4685,4611,-74,-1.58,-23,-51,40,43,H1
"Dewey County, OK",2005-2006,4611,4621,10,0.217,-16,26,40,43,H1
"Dewey County, OK",2006-2007,4621,4660,39,0.844,-12,51,40,43,H1
"Dewey County, OK",2007-2008,4660,4737,77,1.652,-19,96,40,43,H1
"Dewey County, OK",2008-2009,4737,4770,33,0.697,-3,36,40,43,H1
"Dewey County, OK",2009-2010,4770,4818,48,1.006,-5,53,40,43,H1
"Dewey County, OK",2010-2011,4818,4755,-63,-1.308,-18,-45,40,43,H1
"Dewey County, OK",2011-2012,4755,4779,24,0.505,-4,28,40,43,H1
"Dewey County, OK",2012-2013,4779,4817,38,0.795,-7,45,40,43,H1
"Dewey County, OK",2013-2014,4817,4914,97,2.014,-12,109,40,43,H1
"Dewey County, OK",2014-2015,4948,4995,47,0.95,9,38,40,43,H1
"Dewey County, OK",2015-2016,4995,4886,-109,-2.182,13,-122,40,43,H1
"Dewey County, OK",2016-2017,4886,4878,-8,-0.164,-6,-2,40,43,H1
"Ellis County, OK",2000-2001,4050,3923,-127,-3.136,-18,-109,40,45,H1
"Ellis County, OK",2001-2002,3923,4002,79,2.014,-25,104,40,45,H1
"Ellis County, OK",2002-2003,4002,3979,-23,-0.575,-19,-4,40,45,H1
"Ellis County, OK",2003-2004,3979,3998,19,0.478,-6,25,40,45,H1
"Ellis County, OK",2004-2005,3998,3983,-15,-0.375,7,-22,40,45,H1
"Ellis County, OK",2005-2006,3983,3898,-85,-2.134,-23,-62,40,45,H1
"Ellis County, OK",2006-2007,3898,3982,84,2.155,1,83,40,45,H1
"Ellis County, OK",2007-2008,3982,4043,61,1.532,3,58,40,45,H1
"Ellis County, OK",2008-2009,4043,4127,84,2.078,2,82,40,45,H1
"Ellis County, OK",2009-2010,4127,4155,28,0.678,13,15,40,45,H1
"Ellis County, OK",2010-2011,4155,4047,-108,-2.599,-23,-85,40,45,H1
"Ellis County, OK",2011-2012,4047,4075,28,0.692,-8,36,40,45,H1
"Ellis County, OK",2012-2013,4075,4140,65,1.595,4,61,40,45,H1
"Ellis County, OK",2013-2014,4140,4150,10,0.242,0,10,40,45,H1
"Ellis County, OK",2014-2015,4129,4231,102,2.47,-16,118,40,45,H1
"Ellis County, OK",2015-2016,4231,4083,-148,-3.498,3,-151,40,45,H1
"Ellis County, OK",2016-2017,4083,3966,-117,-2.866,-10,-107,40,45,H1
"Garfield County, OK",2000-2001,57721,57279,-442,-0.766,154,-596,40,47,H1
"Garfield County, OK",2001-2002,57279,57249,-30,-0.052,68,-98,40,47,H1
"Garfield County, OK",2002-2003,57249,57230,-19,-0.033,236,-255,40,47,H1
"Garfield County, OK",2003-2004,57230,57459,229,0.4,149,80,40,47,H1
"Garfield County, OK",2004-2005,57459,57358,-101,-0.176,241,-342,40,47,H1
"Garfield County, OK",2005-2006,57358,57723,365,0.636,242,123,40,47,H1
"Garfield County, OK",2006-2007,57723,58153,430,0.745,368,62,40,47,H1
"Garfield County, OK",2007-2008,58153,58845,692,1.19,276,416,40,47,H1
"Garfield County, OK",2008-2009,58845,59989,1144,1.944,308,836,40,47,H1
"Garfield County, OK",2009-2010,59989,60730,741,1.235,318,423,40,47,H1
"Garfield County, OK",2010-2011,60730,60669,-61,-0.1,247,-308,40,47,H1
"Garfield County, OK",2011-2012,60669,61318,649,1.07,293,356,40,47,H1
"Garfield County, OK",2012-2013,61318,62509,1191,1.942,305,886,40,47,H1
"Garfield County, OK",2013-2014,62509,63091,582,0.931,312,270,40,47,H1
"Garfield County, OK",2014-2015,62977,63569,592,0.94,346,246,40,47,H1
"Garfield County, OK",2015-2016,63569,62384,-1185,-1.864,290,-1475,40,47,H1
"Garfield County, OK",2016-2017,62384,61581,-803,-1.287,304,-1107,40,47,H1
"Garvin County, OK",2000-2001,27258,27034,-224,-0.822,-4,-220,40,49,H1
"Garvin County, OK",2001-2002,27034,27083,49,0.181,-9,58,40,49,H1
"Garvin County, OK",2002-2003,27083,27068,-15,-0.055,0,-15,40,49,H1
"Garvin County, OK",2003-2004,27068,26942,-126,-0.465,-43,-83,40,49,H1
"Garvin County, OK",2004-2005,26942,27089,147,0.546,-35,182,40,49,H1
"Garvin County, OK",2005-2006,27089,27249,160,0.591,9,151,40,49,H1
"Garvin County, OK",2006-2007,27249,27399,150,0.55,40,110,40,49,H1
"Garvin County, OK",2007-2008,27399,27529,130,0.474,-2,132,40,49,H1
"Garvin County, OK",2008-2009,27529,27582,53,0.193,15,38,40,49,H1
"Garvin County, OK",2009-2010,27582,27533,-49,-0.178,17,-66,40,49,H1
"Garvin County, OK",2010-2011,27533,27364,-169,-0.614,-83,-86,40,49,H1
"Garvin County, OK",2011-2012,27364,27270,-94,-0.344,-23,-71,40,49,H1
"Garvin County, OK",2012-2013,27270,27376,106,0.389,62,44,40,49,H1
"Garvin County, OK",2013-2014,27376,27561,185,0.676,54,131,40,49,H1
"Garvin County, OK",2014-2015,27531,27755,224,0.814,82,142,40,49,H1
"Garvin County, OK",2015-2016,27755,27942,187,0.674,66,121,40,49,H1
"Garvin County, OK",2016-2017,27942,27909,-33,-0.118,40,-73,40,49,H1
"Grady County, OK",2000-2001,45534,45856,322,0.707,84,238,40,51,H1
"Grady County, OK",2001-2002,45856,46691,835,1.821,160,675,40,51,H1
"Grady County, OK",2002-2003,46691,47277,586,1.255,119,467,40,51,H1
"Grady County, OK",2003-2004,47277,48167,890,1.883,141,749,40,51,H1
"Grady County, OK",2004-2005,48167,49256,1089,2.261,151,938,40,51,H1
"Grady County, OK",2005-2006,49256,50462,1206,2.448,137,1069,40,51,H1
"Grady County, OK",2006-2007,50462,50931,469,0.929,205,264,40,51,H1
"Grady County, OK",2007-2008,50931,51621,690,1.355,215,475,40,51,H1
"Grady County, OK",2008-2009,51621,52231,610,1.182,222,388,40,51,H1
"Grady County, OK",2009-2010,52231,52485,254,0.486,162,92,40,51,H1
"Grady County, OK",2010-2011,52485,52775,290,0.553,91,199,40,51,H1
"Grady County, OK",2011-2012,52775,53054,279,0.529,67,212,40,51,H1
"Grady County, OK",2012-2013,53054,53635,581,1.095,120,461,40,51,H1
"Grady County, OK",2013-2014,53635,53854,219,0.408,117,102,40,51,H1
"Grady County, OK",2014-2015,53915,54648,733,1.36,128,605,40,51,H1
"Grady County, OK",2015-2016,54648,54727,79,0.145,54,25,40,51,H1
"Grady County, OK",2016-2017,54727,54943,216,0.395,83,133,40,51,H1
"Grant County, OK",2000-2001,5127,5047,-80,-1.56,-36,-44,40,53,H1
"Grant County, OK",2001-2002,5047,4979,-68,-1.347,-28,-40,40,53,H1
"Grant County, OK",2002-2003,4979,4939,-40,-0.803,-28,-12,40,53,H1
"Grant County, OK",2003-2004,4939,4789,-150,-3.037,-19,-131,40,53,H1
"Grant County, OK",2004-2005,4789,4771,-18,-0.376,-21,3,40,53,H1
"Grant County, OK",2005-2006,4771,4645,-126,-2.641,-27,-99,40,53,H1
"Grant County, OK",2006-2007,4645,4633,-12,-0.258,-25,13,40,53,H1
"Grant County, OK",2007-2008,4633,4598,-35,-0.755,0,-35,40,53,H1
"Grant County, OK",2008-2009,4598,4484,-114,-2.479,-20,-94,40,53,H1
"Grant County, OK",2009-2010,4484,4536,52,1.16,-25,77,40,53,H1
"Grant County, OK",2010-2011,4536,4547,11,0.243,-14,25,40,53,H1
"Grant County, OK",2011-2012,4547,4510,-37,-0.814,-11,-26,40,53,H1
"Grant County, OK",2012-2013,4510,4521,11,0.244,-7,18,40,53,H1
"Grant County, OK",2013-2014,4521,4501,-20,-0.442,6,-26,40,53,H1
"Grant County, OK",2014-2015,4496,4523,27,0.601,7,20,40,53,H1
"Grant County, OK",2015-2016,4523,4453,-70,-1.548,9,-79,40,53,H1
"Grant County, OK",2016-2017,4453,4395,-58,-1.302,-2,-56,40,53,H1
"Greer County, OK",2000-2001,6044,5894,-150,-2.482,-16,-134,40,55,H1
"Greer County, OK",2001-2002,5894,5970,76,1.289,-29,105,40,55,H1
"Greer County, OK",2002-2003,5970,5942,-28,-0.469,-22,-6,40,55,H1
"Greer County, OK",2003-2004,5942,6031,89,1.498,-20,109,40,55,H1
"Greer County, OK",2004-2005,6031,6082,51,0.846,-10,61,40,55,H1
"Greer County, OK",2005-2006,6082,6048,-34,-0.559,-47,13,40,55,H1
"Greer County, OK",2006-2007,6048,6160,112,1.852,-18,130,40,55,H1
"Greer County, OK",2007-2008,6160,6200,40,0.649,5,35,40,55,H1
"Greer County, OK",2008-2009,6200,6273,73,1.177,-7,80,40,55,H1
"Greer County, OK",2009-2010,6273,6203,-70,-1.116,-5,-65,40,55,H1
"Greer County, OK",2010-2011,6203,6149,-54,-0.871,-20,-34,40,55,H1
"Greer County, OK",2011-2012,6149,6056,-93,-1.512,-24,-69,40,55,H1
"Greer County, OK",2012-2013,6056,6162,106,1.75,8,98,40,55,H1
"Greer County, OK",2013-2014,6162,6151,-11,-0.179,12,-23,40,55,H1
"Greer County, OK",2014-2015,6149,6070,-79,-1.285,15,-94,40,55,H1
"Greer County, OK",2015-2016,6070,5965,-105,-1.73,14,-119,40,55,H1
"Greer County, OK",2016-2017,5965,5843,-122,-2.045,17,-139,40,55,H1
"Harmon County, OK",2000-2001,3272,3153,-119,-3.637,-18,-101,40,57,H1
"Harmon County, OK",2001-2002,3153,3051,-102,-3.235,-10,-92,40,57,H1
"Harmon County, OK",2002-2003,3051,2984,-67,-2.196,-27,-40,40,57,H1
"Harmon County, OK",2003-2004,2984,2936,-48,-1.609,-17,-31,40,57,H1
"Harmon County, OK",2004-2005,2936,2953,17,0.579,-10,27,40,57,H1
"Harmon County, OK",2005-2006,2953,2915,-38,-1.287,-8,-30,40,57,H1
"Harmon County, OK",2006-2007,2915,2829,-86,-2.95,5,-91,40,57,H1
"Harmon County, OK",2007-2008,2829,2827,-2,-0.071,5,-7,40,57,H1
"Harmon County, OK",2008-2009,2827,2861,34,1.203,16,18,40,57,H1
"Harmon County, OK",2009-2010,2861,2917,56,1.957,21,35,40,57,H1
"Harmon County, OK",2010-2011,2917,2929,12,0.411,3,9,40,57,H1
"Harmon County, OK",2011-2012,2929,2900,-29,-0.99,13,-42,40,57,H1
"Harmon County, OK",2012-2013,2900,2869,-31,-1.069,4,-35,40,57,H1
"Harmon County, OK",2013-2014,2869,2798,-71,-2.475,8,-79,40,57,H1
"Harmon County, OK",2014-2015,2815,2788,-27,-0.959,1,-28,40,57,H1
"Harmon County, OK",2015-2016,2788,2693,-95,-3.407,3,-98,40,57,H1
"Harmon County, OK",2016-2017,2693,2689,-4,-0.149,-5,1,40,57,H1
"Harper County, OK",2000-2001,3537,3444,-93,-2.629,-8,-85,40,59,H1
"Harper County, OK",2001-2002,3444,3469,25,0.726,-14,39,40,59,H1
"Harper County, OK",2002-2003,3469,3412,-57,-1.643,-24,-33,40,59,H1
"Harper County, OK",2003-2004,3412,3465,53,1.553,-29,82,40,59,H1
"Harper County, OK",2004-2005,3465,3458,-7,-0.202,-7,0,40,59,H1
"Harper County, OK",2005-2006,3458,3527,69,1.995,4,65,40,59,H1
"Harper County, OK",2006-2007,3527,3522,-5,-0.142,8,-13,40,59,H1
"Harper County, OK",2007-2008,3522,3645,123,3.492,21,102,40,59,H1
"Harper County, OK",2008-2009,3645,3654,9,0.247,13,-4,40,59,H1
"Harper County, OK",2009-2010,3654,3691,37,1.013,-7,44,40,59,H1
"Harper County, OK",2010-2011,3691,3706,15,0.406,7,8,40,59,H1
"Harper County, OK",2011-2012,3706,3693,-13,-0.351,-5,-8,40,59,H1
"Harper County, OK",2012-2013,3693,3833,140,3.791,-2,142,40,59,H1
"Harper County, OK",2013-2014,3833,3812,-21,-0.548,-19,-2,40,59,H1
"Harper County, OK",2014-2015,3840,3754,-86,-2.24,5,-91,40,59,H1
"Harper County, OK",2015-2016,3754,3794,40,1.066,-7,47,40,59,H1
"Harper County, OK",2016-2017,3794,3808,14,0.369,-16,30,40,59,H1
"Haskell County, OK",2000-2001,11818,11790,-28,-0.237,7,-35,40,61,H1
"Haskell County, OK",2001-2002,11790,11806,16,0.136,6,10,40,61,H1
"Haskell County, OK",2002-2003,11806,12002,196,1.66,-6,202,40,61,H1
"Haskell County, OK",2003-2004,12002,12129,127,1.058,0,127,40,61,H1
"Haskell County, OK",2004-2005,12129,12175,46,0.379,-17,63,40,61,H1
"Haskell County, OK",2005-2006,12175,12329,154,1.265,6,148,40,61,H1
"Haskell County, OK",2006-2007,12329,12411,82,0.665,35,47,40,61,H1
"Haskell County, OK",2007-2008,12411,12620,209,1.684,50,159,40,61,H1
"Haskell County, OK",2008-2009,12620,12772,152,1.204,11,141,40,61,H1
"Haskell County, OK",2009-2010,12772,12746,-26,-0.204,12,-38,40,61,H1
"Haskell County, OK",2010-2011,12746,12717,-29,-0.228,-38,9,40,61,H1
"Haskell County, OK",2011-2012,12717,12867,150,1.18,15,135,40,61,H1
"Haskell County, OK",2012-2013,12867,12970,103,0.8,30,73,40,61,H1
"Haskell County, OK",2013-2014,12970,12896,-74,-0.571,26,-100,40,61,H1
"Haskell County, OK",2014-2015,12888,12845,-43,-0.334,35,-78,40,61,H1
"Haskell County, OK",2015-2016,12845,12646,-199,-1.549,3,-202,40,61,H1
"Haskell County, OK",2016-2017,12646,12763,117,0.925,14,103,40,61,H1
"Hughes County, OK",2000-2001,14106,13821,-285,-2.02,-40,-245,40,63,H1
"Hughes County, OK",2001-2002,13821,13858,37,0.268,-33,70,40,63,H1
"Hughes County, OK",2002-2003,13858,13752,-106,-0.765,-32,-74,40,63,H1
"Hughes County, OK",2003-2004,13752,13660,-92,-0.669,-71,-21,40,63,H1
"Hughes County, OK",2004-2005,13660,13595,-65,-0.476,0,-65,40,63,H1
"Hughes County, OK",2005-2006,13595,13450,-145,-1.067,0,-145,40,63,H1
"Hughes County, OK",2006-2007,13450,13456,6,0.045,20,-14,40,63,H1
"Hughes County, OK",2007-2008,13456,13397,-59,-0.438,-25,-34,40,63,H1
"Hughes County, OK",2008-2009,13397,13705,308,2.299,-11,319,40,63,H1
"Hughes County, OK",2009-2010,13705,14014,309,2.255,4,305,40,63,H1
"Hughes County, OK",2010-2011,14014,13849,-165,-1.177,-36,-129,40,63,H1
"Hughes County, OK",2011-2012,13849,13785,-64,-0.462,-36,-28,40,63,H1
"Hughes County, OK",2012-2013,13785,13746,-39,-0.283,-60,21,40,63,H1
"Hughes County, OK",2013-2014,13746,13806,60,0.436,-34,94,40,63,H1
"Hughes County, OK",2014-2015,13808,13735,-73,-0.529,-23,-50,40,63,H1
"Hughes County, OK",2015-2016,13735,13422,-313,-2.279,-15,-298,40,63,H1
"Hughes County, OK",2016-2017,13422,13302,-120,-0.894,-21,-99,40,63,H1
"Jackson County, OK",2000-2001,28278,28036,-242,-0.856,186,-428,40,65,H1
"Jackson County, OK",2001-2002,28036,27513,-523,-1.865,189,-712,40,65,H1
"Jackson County, OK",2002-2003,27513,27242,-271,-0.985,191,-462,40,65,H1
"Jackson County, OK",2003-2004,27242,27480,238,0.874,174,64,40,65,H1
"Jackson County, OK",2004-2005,27480,26862,-618,-2.249,135,-753,40,65,H1
"Jackson County, OK",2005-2006,26862,26805,-57,-0.212,142,-199,40,65,H1
"Jackson County, OK",2006-2007,26805,26335,-470,-1.753,182,-652,40,65,H1
"Jackson County, OK",2007-2008,26335,26038,-297,-1.128,228,-525,40,65,H1
"Jackson County, OK",2008-2009,26038,26256,218,0.837,190,28,40,65,H1
"Jackson County, OK",2009-2010,26256,26472,216,0.823,261,-45,40,65,H1
"Jackson County, OK",2010-2011,26472,26420,-52,-0.196,178,-230,40,65,H1
"Jackson County, OK",2011-2012,26420,26261,-159,-0.602,196,-355,40,65,H1
"Jackson County, OK",2012-2013,26261,26224,-37,-0.141,231,-268,40,65,H1
"Jackson County, OK",2013-2014,26224,25998,-226,-0.862,264,-490,40,65,H1
"Jackson County, OK",2014-2015,25881,25574,-307,-1.186,224,-531,40,65,H1
"Jackson County, OK",2015-2016,25574,25397,-177,-0.692,164,-341,40,65,H1
"Jackson County, OK",2016-2017,25397,25125,-272,-1.071,183,-455,40,65,H1
"Jefferson County, OK",2000-2001,6773,6663,-110,-1.624,-33,-77,40,67,H1
"Jefferson County, OK",2001-2002,6663,6543,-120,-1.801,-50,-70,40,67,H1
"Jefferson County, OK",2002-2003,6543,6528,-15,-0.229,-44,29,40,67,H1
"Jefferson County, OK",2003-2004,6528,6498,-30,-0.46,-14,-16,40,67,H1
"Jefferson County, OK",2004-2005,6498,6483,-15,-0.231,-10,-5,40,67,H1
"Jefferson County, OK",2005-2006,6483,6418,-65,-1.003,-11,-54,40,67,H1
"Jefferson County, OK",2006-2007,6418,6385,-33,-0.514,-20,-13,40,67,H1
"Jefferson County, OK",2007-2008,6385,6408,23,0.36,15,8,40,67,H1
"Jefferson County, OK",2008-2009,6408,6521,113,1.763,-7,120,40,67,H1
"Jefferson County, OK",2009-2010,6521,6454,-67,-1.027,-14,-53,40,67,H1
"Jefferson County, OK",2010-2011,6454,6444,-10,-0.155,-37,27,40,67,H1
"Jefferson County, OK",2011-2012,6444,6335,-109,-1.691,-18,-91,40,67,H1
"Jefferson County, OK",2012-2013,6335,6358,23,0.363,0,23,40,67,H1
"Jefferson County, OK",2013-2014,6358,6292,-66,-1.038,-8,-58,40,67,H1
"Jefferson County, OK",2014-2015,6283,6276,-7,-0.111,-6,-1,40,67,H1
"Jefferson County, OK",2015-2016,6276,6250,-26,-0.414,-22,-4,40,67,H1
"Jefferson County, OK",2016-2017,6250,6183,-67,-1.072,-11,-56,40,67,H1
"Johnston County, OK",2000-2001,10521,10505,-16,-0.152,-19,3,40,69,H1
"Johnston County, OK",2001-2002,10505,10475,-30,-0.286,-10,-20,40,69,H1
"Johnston County, OK",2002-2003,10475,10526,51,0.487,-31,82,40,69,H1
"Johnston County, OK",2003-2004,10526,10459,-67,-0.637,-6,-61,40,69,H1
"Johnston County, OK",2004-2005,10459,10431,-28,-0.268,2,-30,40,69,H1
"Johnston County, OK",2005-2006,10431,10709,278,2.665,36,242,40,69,H1
"Johnston County, OK",2006-2007,10709,10779,70,0.654,41,29,40,69,H1
"Johnston County, OK",2007-2008,10779,10772,-7,-0.065,51,-58,40,69,H1
"Johnston County, OK",2008-2009,10772,10838,66,0.613,40,26,40,69,H1
"Johnston County, OK",2009-2010,10838,10996,158,1.458,9,149,40,69,H1
"Johnston County, OK",2010-2011,10996,11086,90,0.818,-42,132,40,69,H1
"Johnston County, OK",2011-2012,11086,11005,-81,-0.731,-7,-74,40,69,H1
"Johnston County, OK",2012-2013,11005,11026,21,0.191,-7,28,40,69,H1
"Johnston County, OK",2013-2014,11026,11103,77,0.698,-29,106,40,69,H1
"Johnston County, OK",2014-2015,11084,10980,-104,-0.938,-16,-88,40,69,H1
"Johnston County, OK",2015-2016,10980,11091,111,1.011,-44,155,40,69,H1
"Johnston County, OK",2016-2017,11091,11060,-31,-0.28,-56,25,40,69,H1
"Kay County, OK",2000-2001,47954,47518,-436,-0.909,71,-507,40,71,H1
"Kay County, OK",2001-2002,47518,47686,168,0.354,74,94,40,71,H1
"Kay County, OK",2002-2003,47686,47363,-323,-0.677,87,-410,40,71,H1
"Kay County, OK",2003-2004,47363,46903,-460,-0.971,35,-495,40,71,H1
"Kay County, OK",2004-2005,46903,46469,-434,-0.925,48,-482,40,71,H1
"Kay County, OK",2005-2006,46469,46220,-249,-0.536,178,-427,40,71,H1
"Kay County, OK",2006-2007,46220,46461,241,0.521,82,159,40,71,H1
"Kay County, OK",2007-2008,46461,46410,-51,-0.11,182,-233,40,71,H1
"Kay County, OK",2008-2009,46410,46814,404,0.871,150,254,40,71,H1
"Kay County, OK",2009-2010,46814,46428,-386,-0.825,177,-563,40,71,H1
"Kay County, OK",2010-2011,46428,45799,-629,-1.355,29,-658,40,71,H1
"Kay County, OK",2011-2012,45799,45657,-142,-0.31,89,-231,40,71,H1
"Kay County, OK",2012-2013,45657,45543,-114,-0.25,136,-250,40,71,H1
"Kay County, OK",2013-2014,45543,45478,-65,-0.143,94,-159,40,71,H1
"Kay County, OK",2014-2015,45510,45366,-144,-0.316,96,-240,40,71,H1
"Kay County, OK",2015-2016,45366,44983,-383,-0.844,71,-454,40,71,H1
"Kay County, OK",2016-2017,44983,44544,-439,-0.976,63,-502,40,71,H1
"Kingfisher County, OK",2000-2001,13898,13910,12,0.086,36,-24,40,73,H1
"Kingfisher County, OK",2001-2002,13910,13940,30,0.216,43,-13,40,73,H1
"Kingfisher County, OK",2002-2003,13940,14151,211,1.514,52,159,40,73,H1
"Kingfisher County, OK",2003-2004,14151,14223,72,0.509,10,62,40,73,H1
"Kingfisher County, OK",2004-2005,14223,14390,167,1.174,35,132,40,73,H1
"Kingfisher County, OK",2005-2006,14390,14464,74,0.514,18,56,40,73,H1
"Kingfisher County, OK",2006-2007,14464,14705,241,1.666,79,162,40,73,H1
"Kingfisher County, OK",2007-2008,14705,14748,43,0.292,58,-15,40,73,H1
"Kingfisher County, OK",2008-2009,14748,14901,153,1.037,54,99,40,73,H1
"Kingfisher County, OK",2009-2010,14901,15050,149,1,32,117,40,73,H1
"Kingfisher County, OK",2010-2011,15050,15112,62,0.412,38,24,40,73,H1
"Kingfisher County, OK",2011-2012,15112,14996,-116,-0.768,23,-139,40,73,H1
"Kingfisher County, OK",2012-2013,14996,15322,326,2.174,89,237,40,73,H1
"Kingfisher County, OK",2013-2014,15322,15532,210,1.371,94,116,40,73,H1
"Kingfisher County, OK",2014-2015,15509,15584,75,0.484,83,-8,40,73,H1
"Kingfisher County, OK",2015-2016,15584,15566,-18,-0.116,62,-80,40,73,H1
"Kingfisher County, OK",2016-2017,15566,15669,103,0.662,50,53,40,73,H1
"Kiowa County, OK",2000-2001,10201,10054,-147,-1.441,-30,-117,40,75,H1
"Kiowa County, OK",2001-2002,10054,10015,-39,-0.388,-44,5,40,75,H1
"Kiowa County, OK",2002-2003,10015,9965,-50,-0.499,-49,-1,40,75,H1
"Kiowa County, OK",2003-2004,9965,9885,-80,-0.803,-35,-45,40,75,H1
"Kiowa County, OK",2004-2005,9885,9955,70,0.708,-16,86,40,75,H1
"Kiowa County, OK",2005-2006,9955,9756,-199,-1.999,-76,-123,40,75,H1
"Kiowa County, OK",2006-2007,9756,9543,-213,-2.183,-85,-128,40,75,H1
"Kiowa County, OK",2007-2008,9543,9518,-25,-0.262,-24,-1,40,75,H1
"Kiowa County, OK",2008-2009,9518,9445,-73,-0.767,-26,-47,40,75,H1
"Kiowa County, OK",2009-2010,9445,9430,-15,-0.159,-7,-8,40,75,H1
"Kiowa County, OK",2010-2011,9430,9408,-22,-0.233,-44,22,40,75,H1
"Kiowa County, OK",2011-2012,9408,9343,-65,-0.691,-4,-61,40,75,H1
"Kiowa County, OK",2012-2013,9343,9376,33,0.353,3,30,40,75,H1
"Kiowa County, OK",2013-2014,9376,9336,-40,-0.427,16,-56,40,75,H1
"Kiowa County, OK",2014-2015,9273,9144,-129,-1.391,-11,-118,40,75,H1
"Kiowa County, OK",2015-2016,9144,9028,-116,-1.269,-4,-112,40,75,H1
"Kiowa County, OK",2016-2017,9028,8893,-135,-1.495,11,-146,40,75,H1
"Latimer County, OK",2000-2001,10661,10637,-24,-0.225,-2,-22,40,77,H1
"Latimer County, OK",2001-2002,10637,10703,66,0.62,-10,76,40,77,H1
"Latimer County, OK",2002-2003,10703,10689,-14,-0.131,16,-30,40,77,H1
"Latimer County, OK",2003-2004,10689,10763,74,0.692,-30,104,40,77,H1
"Latimer County, OK",2004-2005,10763,10796,33,0.307,-44,77,40,77,H1
"Latimer County, OK",2005-2006,10796,10841,45,0.417,-6,51,40,77,H1
"Latimer County, OK",2006-2007,10841,10875,34,0.314,-5,39,40,77,H1
"Latimer County, OK",2007-2008,10875,11068,193,1.775,-1,194,40,77,H1
"Latimer County, OK",2008-2009,11068,11155,87,0.786,19,68,40,77,H1
"Latimer County, OK",2009-2010,11155,11139,-16,-0.143,15,-31,40,77,H1
"Latimer County, OK",2010-2011,11139,11114,-25,-0.224,22,-47,40,77,H1
"Latimer County, OK",2011-2012,11114,10941,-173,-1.557,-5,-168,40,77,H1
"Latimer County, OK",2012-2013,10941,10718,-223,-2.038,4,-227,40,77,H1
"Latimer County, OK",2013-2014,10718,10693,-25,-0.233,16,-41,40,77,H1
"Latimer County, OK",2014-2015,10637,10483,-154,-1.448,-7,-147,40,77,H1
"Latimer County, OK",2015-2016,10483,10562,79,0.754,9,70,40,77,H1
"Latimer County, OK",2016-2017,10562,10411,-151,-1.43,34,-185,40,77,H1
"Le Flore County, OK",2000-2001,48104,48018,-86,-0.179,231,-317,40,79,H1
"Le Flore County, OK",2001-2002,48018,48321,303,0.631,184,119,40,79,H1
"Le Flore County, OK",2002-2003,48321,48437,116,0.24,153,-37,40,79,H1
"Le Flore County, OK",2003-2004,48437,48623,186,0.384,221,-35,40,79,H1
"Le Flore County, OK",2004-2005,48623,48869,246,0.506,159,87,40,79,H1
"Le Flore County, OK",2005-2006,48869,49209,340,0.696,182,158,40,79,H1
"Le Flore County, OK",2006-2007,49209,49589,380,0.772,221,159,40,79,H1
"Le Flore County, OK",2007-2008,49589,49802,213,0.43,127,86,40,79,H1
"Le Flore County, OK",2008-2009,49802,49989,187,0.375,118,69,40,79,H1
"Le Flore County, OK",2009-2010,49989,50470,481,0.962,152,329,40,79,H1
"Le Flore County, OK",2010-2011,50470,50227,-243,-0.481,-41,-202,40,79,H1
"Le Flore County, OK",2011-2012,50227,49935,-292,-0.581,-51,-241,40,79,H1
"Le Flore County, OK",2012-2013,49935,49847,-88,-0.176,48,-136,40,79,H1
"Le Flore County, OK",2013-2014,49847,49761,-86,-0.173,9,-95,40,79,H1
"Le Flore County, OK",2014-2015,49810,49605,-205,-0.412,8,-213,40,79,H1
"Le Flore County, OK",2015-2016,49605,49842,237,0.478,-99,336,40,79,H1
"Le Flore County, OK",2016-2017,49842,49731,-111,-0.223,-88,-23,40,79,H1
"Lincoln County, OK",2000-2001,32155,32295,140,0.435,52,88,40,81,H1
"Lincoln County, OK",2001-2002,32295,32489,194,0.601,85,109,40,81,H1
"Lincoln County, OK",2002-2003,32489,32672,183,0.563,23,160,40,81,H1
"Lincoln County, OK",2003-2004,32672,32875,203,0.621,20,183,40,81,H1
"Lincoln County, OK",2004-2005,32875,33011,136,0.414,67,69,40,81,H1
"Lincoln County, OK",2005-2006,33011,33441,430,1.303,58,372,40,81,H1
"Lincoln County, OK",2006-2007,33441,33636,195,0.583,65,130,40,81,H1
"Lincoln County, OK",2007-2008,33636,33710,74,0.22,39,35,40,81,H1
"Lincoln County, OK",2008-2009,33710,34027,317,0.94,86,231,40,81,H1
"Lincoln County, OK",2009-2010,34027,34328,301,0.885,66,235,40,81,H1
"Lincoln County, OK",2010-2011,34328,34329,1,0.003,4,-3,40,81,H1
"Lincoln County, OK",2011-2012,34329,34215,-114,-0.332,7,-121,40,81,H1
"Lincoln County, OK",2012-2013,34215,34339,124,0.362,65,59,40,81,H1
"Lincoln County, OK",2013-2014,34339,34619,280,0.815,66,214,40,81,H1
"Lincoln County, OK",2014-2015,34627,35042,415,1.198,110,305,40,81,H1
"Lincoln County, OK",2015-2016,35042,34954,-88,-0.251,68,-156,40,81,H1
"Lincoln County, OK",2016-2017,34954,35142,188,0.538,63,125,40,81,H1
"Logan County, OK",2000-2001,33967,34657,690,2.031,88,602,40,83,H1
"Logan County, OK",2001-2002,34657,35030,373,1.076,100,273,40,83,H1
"Logan County, OK",2002-2003,35030,35922,892,2.546,84,808,40,83,H1
"Logan County, OK",2003-2004,35922,35842,-80,-0.223,141,-221,40,83,H1
"Logan County, OK",2004-2005,35842,36501,659,1.839,166,493,40,83,H1
"Logan County, OK",2005-2006,36501,37060,559,1.531,125,434,40,83,H1
"Logan County, OK",2006-2007,37060,38709,1649,4.45,144,1505,40,83,H1
"Logan County, OK",2007-2008,38709,39964,1255,3.242,207,1048,40,83,H1
"Logan County, OK",2008-2009,39964,41116,1152,2.883,216,936,40,83,H1
"Logan County, OK",2009-2010,41116,42058,942,2.291,177,765,40,83,H1
"Logan County, OK",2010-2011,42058,43097,1039,2.47,124,915,40,83,H1
"Logan County, OK",2011-2012,43097,43668,571,1.325,150,421,40,83,H1
"Logan County, OK",2012-2013,43668,44401,733,1.679,134,599,40,83,H1
"Logan County, OK",2013-2014,44401,45276,875,1.971,117,758,40,83,H1
"Logan County, OK",2014-2015,45301,45996,695,1.534,127,568,40,83,H1
"Logan County, OK",2015-2016,45996,46002,6,0.013,184,-178,40,83,H1
"Logan County, OK",2016-2017,46002,46784,782,1.7,162,620,40,83,H1
"Love County, OK",2000-2001,8826,8749,-77,-0.872,-13,-64,40,85,H1
"Love County, OK",2001-2002,8749,8836,87,0.994,-2,89,40,85,H1
"Love County, OK",2002-2003,8836,8916,80,0.905,12,68,40,85,H1
"Love County, OK",2003-2004,8916,9044,128,1.436,12,116,40,85,H1
"Love County, OK",2004-2005,9044,9159,115,1.272,33,82,40,85,H1
"Love County, OK",2005-2006,9159,9207,48,0.524,2,46,40,85,H1
"Love County, OK",2006-2007,9207,9252,45,0.489,25,20,40,85,H1
"Love County, OK",2007-2008,9252,9291,39,0.422,24,15,40,85,H1
"Love County, OK",2008-2009,9291,9340,49,0.527,19,30,40,85,H1
"Love County, OK",2009-2010,9340,9434,94,1.006,11,83,40,85,H1
"Love County, OK",2010-2011,9434,9387,-47,-0.498,23,-70,40,85,H1
"Love County, OK",2011-2012,9387,9563,176,1.875,29,147,40,85,H1
"Love County, OK",2012-2013,9563,9713,150,1.569,30,120,40,85,H1
"Love County, OK",2013-2014,9713,9773,60,0.618,25,35,40,85,H1
"Love County, OK",2014-2015,9767,9870,103,1.055,16,87,40,85,H1
"Love County, OK",2015-2016,9870,9978,108,1.094,8,100,40,85,H1
"Love County, OK",2016-2017,9978,10034,56,0.561,1,55,40,85,H1
"McClain County, OK",2000-2001,27863,27871,8,0.029,102,-94,40,87,H1
"McClain County, OK",2001-2002,27871,28169,298,1.069,122,176,40,87,H1
"McClain County, OK",2002-2003,28169,28814,645,2.29,119,526,40,87,H1
"McClain County, OK",2003-2004,28814,29350,536,1.86,115,421,40,87,H1
"McClain County, OK",2004-2005,29350,30322,972,3.312,130,842,40,87,H1
"McClain County, OK",2005-2006,30322,31419,1097,3.618,145,952,40,87,H1
"McClain County, OK",2006-2007,31419,32470,1051,3.345,118,933,40,87,H1
"McClain County, OK",2007-2008,32470,33107,637,1.962,217,420,40,87,H1
"McClain County, OK",2008-2009,33107,33822,715,2.16,214,501,40,87,H1
"McClain County, OK",2009-2010,33822,34731,909,2.688,151,758,40,87,H1
"McClain County, OK",2010-2011,34731,35154,423,1.218,108,315,40,87,H1
"McClain County, OK",2011-2012,35154,35587,433,1.232,61,372,40,87,H1
"McClain County, OK",2012-2013,35587,36516,929,2.611,151,778,40,87,H1
"McClain County, OK",2013-2014,36516,37313,797,2.183,132,665,40,87,H1
"McClain County, OK",2014-2015,37264,38066,802,2.152,118,684,40,87,H1
"McClain County, OK",2015-2016,38066,38599,533,1.4,104,429,40,87,H1
"McClain County, OK",2016-2017,38599,39343,744,1.928,100,644,40,87,H1
"McCurtain County, OK",2000-2001,34348,33944,-404,-1.176,76,-480,40,89,H1
"McCurtain County, OK",2001-2002,33944,33788,-156,-0.46,68,-224,40,89,H1
"McCurtain County, OK",2002-2003,33788,33625,-163,-0.482,120,-283,40,89,H1
"McCurtain County, OK",2003-2004,33625,33282,-343,-1.02,31,-374,40,89,H1
"McCurtain County, OK",2004-2005,33282,33235,-47,-0.141,31,-78,40,89,H1
"McCurtain County, OK",2005-2006,33235,33198,-37,-0.111,81,-118,40,89,H1
"McCurtain County, OK",2006-2007,33198,33128,-70,-0.211,163,-233,40,89,H1
"McCurtain County, OK",2007-2008,33128,33112,-16,-0.048,153,-169,40,89,H1
"McCurtain County, OK",2008-2009,33112,33002,-110,-0.332,134,-244,40,89,H1
"McCurtain County, OK",2009-2010,33002,33182,180,0.545,117,63,40,89,H1
"McCurtain County, OK",2010-2011,33182,33248,66,0.199,108,-42,40,89,H1
"McCurtain County, OK",2011-2012,33248,33229,-19,-0.057,54,-73,40,89,H1
"McCurtain County, OK",2012-2013,33229,33110,-119,-0.358,73,-192,40,89,H1
"McCurtain County, OK",2013-2014,33110,33050,-60,-0.181,64,-124,40,89,H1
"McCurtain County, OK",2014-2015,33087,33048,-39,-0.118,81,-120,40,89,H1
"McCurtain County, OK",2015-2016,33048,32919,-129,-0.39,44,-173,40,89,H1
"McCurtain County, OK",2016-2017,32919,32808,-111,-0.337,-6,-105,40,89,H1
"McIntosh County, OK",2000-2001,19432,19451,19,0.098,-30,49,40,91,H1
"McIntosh County, OK",2001-2002,19451,19552,101,0.519,-49,150,40,91,H1
"McIntosh County, OK",2002-2003,19552,19582,30,0.153,-36,66,40,91,H1
"McIntosh County, OK",2003-2004,19582,19597,15,0.077,-78,93,40,91,H1
"McIntosh County, OK",2004-2005,19597,19595,-2,-0.01,-64,62,40,91,H1
"McIntosh County, OK",2005-2006,19595,19730,135,0.689,-49,184,40,91,H1
"McIntosh County, OK",2006-2007,19730,19952,222,1.125,-64,286,40,91,H1
"McIntosh County, OK",2007-2008,19952,19952,0,0,-61,61,40,91,H1
"McIntosh County, OK",2008-2009,19952,20160,208,1.043,-26,234,40,91,H1
"McIntosh County, OK",2009-2010,20160,20282,122,0.605,-37,159,40,91,H1
"McIntosh County, OK",2010-2011,20282,20306,24,0.118,-159,183,40,91,H1
"McIntosh County, OK",2011-2012,20306,20522,216,1.064,-114,330,40,91,H1
"McIntosh County, OK",2012-2013,20522,20472,-50,-0.244,-89,39,40,91,H1
"McIntosh County, OK",2013-2014,20472,20088,-384,-1.876,-131,-253,40,91,H1
"McIntosh County, OK",2014-2015,20119,19990,-129,-0.641,-72,-57,40,91,H1
"McIntosh County, OK",2015-2016,19990,19759,-231,-1.156,-49,-182,40,91,H1
"McIntosh County, OK",2016-2017,19759,19742,-17,-0.086,-75,58,40,91,H1
"Major County, OK",2000-2001,7536,7575,39,0.518,-27,66,40,93,H1
"Major County, OK",2001-2002,7575,7559,-16,-0.211,-27,11,40,93,H1
"Major County, OK",2002-2003,7559,7429,-130,-1.72,-32,-98,40,93,H1
"Major County, OK",2003-2004,7429,7423,-6,-0.081,-17,11,40,93,H1
"Major County, OK",2004-2005,7423,7379,-44,-0.593,-17,-27,40,93,H1
"Major County, OK",2005-2006,7379,7449,70,0.949,-20,90,40,93,H1
"Major County, OK",2006-2007,7449,7465,16,0.215,-6,22,40,93,H1
"Major County, OK",2007-2008,7465,7456,-9,-0.121,-9,0,40,93,H1
"Major County, OK",2008-2009,7456,7557,101,1.355,-11,112,40,93,H1
"Major County, OK",2009-2010,7557,7501,-56,-0.741,-6,-50,40,93,H1
"Major County, OK",2010-2011,7501,7611,110,1.466,7,103,40,93,H1
"Major County, OK",2011-2012,7611,7659,48,0.631,28,20,40,93,H1
"Major County, OK",2012-2013,7659,7673,14,0.183,31,-17,40,93,H1
"Major County, OK",2013-2014,7673,7750,77,1.004,41,36,40,93,H1
"Major County, OK",2014-2015,7758,7771,13,0.168,51,-38,40,93,H1
"Major County, OK",2015-2016,7771,7741,-30,-0.386,18,-48,40,93,H1
"Major County, OK",2016-2017,7741,7693,-48,-0.62,27,-75,40,93,H1
"Marshall County, OK",2000-2001,13170,13372,202,1.534,-21,223,40,95,H1
"Marshall County, OK",2001-2002,13372,13659,287,2.146,-22,309,40,95,H1
"Marshall County, OK",2002-2003,13659,13809,150,1.098,-2,152,40,95,H1
"Marshall County, OK",2003-2004,13809,14149,340,2.462,23,317,40,95,H1
"Marshall County, OK",2004-2005,14149,14686,537,3.795,-3,540,40,95,H1
"Marshall County, OK",2005-2006,14686,14988,302,2.056,55,247,40,95,H1
"Marshall County, OK",2006-2007,14988,15318,330,2.202,58,272,40,95,H1
"Marshall County, OK",2007-2008,15318,15482,164,1.071,12,152,40,95,H1
"Marshall County, OK",2008-2009,15482,15652,170,1.098,49,121,40,95,H1
"Marshall County, OK",2009-2010,15652,15844,192,1.227,60,132,40,95,H1
"Marshall County, OK",2010-2011,15844,15893,49,0.309,3,46,40,95,H1
"Marshall County, OK",2011-2012,15893,15913,20,0.126,1,19,40,95,H1
"Marshall County, OK",2012-2013,15913,15989,76,0.478,63,13,40,95,H1
"Marshall County, OK",2013-2014,15989,16182,193,1.207,76,117,40,95,H1
"Marshall County, OK",2014-2015,16083,16232,149,0.926,29,120,40,95,H1
"Marshall County, OK",2015-2016,16232,16249,17,0.105,9,8,40,95,H1
"Marshall County, OK",2016-2017,16249,16434,185,1.139,36,149,40,95,H1
"Mayes County, OK",2000-2001,38413,38554,141,0.367,121,20,40,97,H1
"Mayes County, OK",2001-2002,38554,38702,148,0.384,100,48,40,97,H1
"Mayes County, OK",2002-2003,38702,39030,328,0.848,83,245,40,97,H1
"Mayes County, OK",2003-2004,39030,39331,301,0.771,40,261,40,97,H1
"Mayes County, OK",2004-2005,39331,39670,339,0.862,133,206,40,97,H1
"Mayes County, OK",2005-2006,39670,40107,437,1.102,121,316,40,97,H1
"Mayes County, OK",2006-2007,40107,40569,462,1.152,226,236,40,97,H1
"Mayes County, OK",2007-2008,40569,40984,415,1.023,162,253,40,97,H1
"Mayes County, OK",2008-2009,40984,41093,109,0.266,131,-22,40,97,H1
"Mayes County, OK",2009-2010,41093,41296,203,0.494,93,110,40,97,H1
"Mayes County, OK",2010-2011,41296,41289,-7,-0.017,7,-14,40,97,H1
"Mayes County, OK",2011-2012,41289,41111,-178,-0.431,-35,-143,40,97,H1
"Mayes County, OK",2012-2013,41111,40908,-203,-0.494,37,-240,40,97,H1
"Mayes County, OK",2013-2014,40908,40816,-92,-0.225,-5,-87,40,97,H1
"Mayes County, OK",2014-2015,40855,40887,32,0.078,2,30,40,97,H1
"Mayes County, OK",2015-2016,40887,40972,85,0.208,-33,118,40,97,H1
"Mayes County, OK",2016-2017,40972,40921,-51,-0.124,-82,31,40,97,H1
"Murray County, OK",2000-2001,12582,12689,107,0.85,-6,113,40,99,H1
"Murray County, OK",2001-2002,12689,12665,-24,-0.189,-13,-11,40,99,H1
"Murray County, OK",2002-2003,12665,12707,42,0.332,-57,99,40,99,H1
"Murray County, OK",2003-2004,12707,12681,-26,-0.205,-32,6,40,99,H1
"Murray County, OK",2004-2005,12681,12803,122,0.962,-15,137,40,99,H1
"Murray County, OK",2005-2006,12803,12969,166,1.297,2,164,40,99,H1
"Murray County, OK",2006-2007,12969,12966,-3,-0.023,-29,26,40,99,H1
"Murray County, OK",2007-2008,12966,13144,178,1.373,5,173,40,99,H1
"Murray County, OK",2008-2009,13144,13373,229,1.742,4,225,40,99,H1
"Murray County, OK",2009-2010,13373,13514,141,1.054,-20,161,40,99,H1
"Murray County, OK",2010-2011,13514,13616,102,0.755,-47,149,40,99,H1
"Murray County, OK",2011-2012,13616,13640,24,0.176,-30,54,40,99,H1
"Murray County, OK",2012-2013,13640,13709,69,0.506,-23,92,40,99,H1
"Murray County, OK",2013-2014,13709,13803,94,0.686,-40,134,40,99,H1
"Murray County, OK",2014-2015,13794,13936,142,1.029,-16,158,40,99,H1
"Murray County, OK",2015-2016,13936,13862,-74,-0.531,-40,-34,40,99,H1
"Murray County, OK",2016-2017,13862,13853,-9,-0.065,-32,23,40,99,H1
"Muskogee County, OK",2000-2001,69418,69428,10,0.014,176,-166,40,101,H1
"Muskogee County, OK",2001-2002,69428,69334,-94,-0.135,174,-268,40,101,H1
"Muskogee County, OK",2002-2003,69334,69666,332,0.479,196,136,40,101,H1
"Muskogee County, OK",2003-2004,69666,69592,-74,-0.106,134,-208,40,101,H1
"Muskogee County, OK",2004-2005,69592,69806,214,0.308,158,56,40,101,H1
"Muskogee County, OK",2005-2006,69806,69958,152,0.218,190,-38,40,101,H1
"Muskogee County, OK",2006-2007,69958,70119,161,0.23,221,-60,40,101,H1
"Muskogee County, OK",2007-2008,70119,70050,-69,-0.098,185,-254,40,101,H1
"Muskogee County, OK",2008-2009,70050,70677,627,0.895,173,454,40,101,H1
"Muskogee County, OK",2009-2010,70677,71105,428,0.606,216,212,40,101,H1
"Muskogee County, OK",2010-2011,71105,70725,-380,-0.534,4,-384,40,101,H1
"Muskogee County, OK",2011-2012,70725,70528,-197,-0.279,145,-342,40,101,H1
"Muskogee County, OK",2012-2013,70528,70269,-259,-0.367,45,-304,40,101,H1
"Muskogee County, OK",2013-2014,70269,69966,-303,-0.431,33,-336,40,101,H1
"Muskogee County, OK",2014-2015,69913,69699,-214,-0.306,30,-244,40,101,H1
"Muskogee County, OK",2015-2016,69699,69046,-653,-0.937,-91,-562,40,101,H1
"Muskogee County, OK",2016-2017,69046,69086,40,0.058,-10,50,40,101,H1
"Noble County, OK",2000-2001,11385,11491,106,0.931,37,69,40,103,H1
"Noble County, OK",2001-2002,11491,11414,-77,-0.67,7,-84,40,103,H1
"Noble County, OK",2002-2003,11414,11462,48,0.421,21,27,40,103,H1
"Noble County, OK",2003-2004,11462,11475,13,0.113,33,-20,40,103,H1
"Noble County, OK",2004-2005,11475,11477,2,0.017,20,-18,40,103,H1
"Noble County, OK",2005-2006,11477,11462,-15,-0.131,15,-30,40,103,H1
"Noble County, OK",2006-2007,11462,11460,-2,-0.017,23,-25,40,103,H1
"Noble County, OK",2007-2008,11460,11537,77,0.672,34,43,40,103,H1
"Noble County, OK",2008-2009,11537,11536,-1,-0.009,48,-49,40,103,H1
"Noble County, OK",2009-2010,11536,11561,25,0.217,41,-16,40,103,H1
"Noble County, OK",2010-2011,11561,11549,-12,-0.104,10,-22,40,103,H1
"Noble County, OK",2011-2012,11549,11505,-44,-0.381,-6,-38,40,103,H1
"Noble County, OK",2012-2013,11505,11379,-126,-1.095,6,-132,40,103,H1
"Noble County, OK",2013-2014,11379,11494,115,1.011,10,105,40,103,H1
"Noble County, OK",2014-2015,11519,11554,35,0.304,24,11,40,103,H1
"Noble County, OK",2015-2016,11554,11364,-190,-1.644,-28,-162,40,103,H1
"Noble County, OK",2016-2017,11364,11277,-87,-0.766,-14,-73,40,103,H1
"Nowata County, OK",2000-2001,10583,10593,10,0.094,5,5,40,105,H1
"Nowata County, OK",2001-2002,10593,10561,-32,-0.302,-36,4,40,105,H1
"Nowata County, OK",2002-2003,10561,10802,241,2.282,26,215,40,105,H1
"Nowata County, OK",2003-2004,10802,10629,-173,-1.602,-10,-163,40,105,H1
"Nowata County, OK",2004-2005,10629,10666,37,0.348,-11,48,40,105,H1
"Nowata County, OK",2005-2006,10666,10705,39,0.366,20,19,40,105,H1
"Nowata County, OK",2006-2007,10705,10771,66,0.617,11,55,40,105,H1
"Nowata County, OK",2007-2008,10771,10788,17,0.158,2,15,40,105,H1
"Nowata County, OK",2008-2009,10788,10595,-193,-1.789,26,-219,40,105,H1
"Nowata County, OK",2009-2010,10595,10513,-82,-0.774,10,-92,40,105,H1
"Nowata County, OK",2010-2011,10513,10618,105,0.999,-16,121,40,105,H1
"Nowata County, OK",2011-2012,10618,10582,-36,-0.339,-17,-19,40,105,H1
"Nowata County, OK",2012-2013,10582,10539,-43,-0.406,-11,-32,40,105,H1
"Nowata County, OK",2013-2014,10539,10524,-15,-0.142,-5,-10,40,105,H1
"Nowata County, OK",2014-2015,10498,10539,41,0.391,-13,54,40,105,H1
"Nowata County, OK",2015-2016,10539,10401,-138,-1.309,-10,-128,40,105,H1
"Nowata County, OK",2016-2017,10401,10306,-95,-0.913,-24,-71,40,105,H1
"Okfuskee County, OK",2000-2001,11841,11858,17,0.144,-21,38,40,107,H1
"Okfuskee County, OK",2001-2002,11858,11817,-41,-0.346,-9,-32,40,107,H1
"Okfuskee County, OK",2002-2003,11817,11912,95,0.804,-30,125,40,107,H1
"Okfuskee County, OK",2003-2004,11912,11925,13,0.109,-25,38,40,107,H1
"Okfuskee County, OK",2004-2005,11925,11867,-58,-0.486,-7,-51,40,107,H1
"Okfuskee County, OK",2005-2006,11867,11895,28,0.236,-12,40,40,107,H1
"Okfuskee County, OK",2006-2007,11895,11981,86,0.723,23,63,40,107,H1
"Okfuskee County, OK",2007-2008,11981,12008,27,0.225,-4,31,40,107,H1
"Okfuskee County, OK",2008-2009,12008,12094,86,0.716,29,57,40,107,H1
"Okfuskee County, OK",2009-2010,12094,12222,128,1.058,19,109,40,107,H1
"Okfuskee County, OK",2010-2011,12222,12299,77,0.63,34,43,40,107,H1
"Okfuskee County, OK",2011-2012,12299,12303,4,0.033,12,-8,40,107,H1
"Okfuskee County, OK",2012-2013,12303,12291,-12,-0.098,5,-17,40,107,H1
"Okfuskee County, OK",2013-2014,12291,12186,-105,-0.854,-11,-94,40,107,H1
"Okfuskee County, OK",2014-2015,12194,12181,-13,-0.107,2,-15,40,107,H1
"Okfuskee County, OK",2015-2016,12181,12107,-74,-0.608,8,-82,40,107,H1
"Okfuskee County, OK",2016-2017,12107,12140,33,0.273,-8,41,40,107,H1
"Oklahoma County, OK",2000-2001,661769,664836,3067,0.463,4406,-1339,40,109,H1
"Oklahoma County, OK",2001-2002,664836,671120,6284,0.945,4884,1400,40,109,H1
"Oklahoma County, OK",2002-2003,671120,674571,3451,0.514,5253,-1802,40,109,H1
"Oklahoma County, OK",2003-2004,674571,677742,3171,0.47,5246,-2075,40,109,H1
"Oklahoma County, OK",2004-2005,677742,683299,5557,0.82,5387,170,40,109,H1
"Oklahoma County, OK",2005-2006,683299,690153,6854,1.003,5683,1171,40,109,H1
"Oklahoma County, OK",2006-2007,690153,695706,5553,0.805,6393,-840,40,109,H1
"Oklahoma County, OK",2007-2008,695706,701484,5778,0.831,5930,-152,40,109,H1
"Oklahoma County, OK",2008-2009,701484,711595,10111,1.441,5578,4533,40,109,H1
"Oklahoma County, OK",2009-2010,711595,721094,9499,1.335,5560,3939,40,109,H1
"Oklahoma County, OK",2010-2011,721094,730111,9017,1.25,5324,3693,40,109,H1
"Oklahoma County, OK",2011-2012,730111,742635,12524,1.715,5545,6979,40,109,H1
"Oklahoma County, OK",2012-2013,742635,755668,13033,1.755,5597,7436,40,109,H1
"Oklahoma County, OK",2013-2014,755668,766215,10547,1.396,5643,4904,40,109,H1
"Oklahoma County, OK",2014-2015,766845,776864,10019,1.307,5941,4078,40,109,H1
"Oklahoma County, OK",2015-2016,776864,784208,7344,0.945,5249,2095,40,109,H1
"Oklahoma County, OK",2016-2017,784208,787958,3750,0.478,5395,-1645,40,109,H1
"Okmulgee County, OK",2000-2001,39625,39618,-7,-0.018,80,-87,40,111,H1
"Okmulgee County, OK",2001-2002,39618,39594,-24,-0.061,52,-76,40,111,H1
"Okmulgee County, OK",2002-2003,39594,39732,138,0.349,59,79,40,111,H1
"Okmulgee County, OK",2003-2004,39732,39731,-1,-0.003,64,-65,40,111,H1
"Okmulgee County, OK",2004-2005,39731,39569,-162,-0.408,85,-247,40,111,H1
"Okmulgee County, OK",2005-2006,39569,39426,-143,-0.361,76,-219,40,111,H1
"Okmulgee County, OK",2006-2007,39426,39552,126,0.32,47,79,40,111,H1
"Okmulgee County, OK",2007-2008,39552,39379,-173,-0.437,82,-255,40,111,H1
"Okmulgee County, OK",2008-2009,39379,39817,438,1.112,99,339,40,111,H1
"Okmulgee County, OK",2009-2010,39817,40102,285,0.716,103,182,40,111,H1
"Okmulgee County, OK",2010-2011,40102,39795,-307,-0.766,1,-308,40,111,H1
"Okmulgee County, OK",2011-2012,39795,39587,-208,-0.523,40,-248,40,111,H1
"Okmulgee County, OK",2012-2013,39587,39451,-136,-0.344,-9,-127,40,111,H1
"Okmulgee County, OK",2013-2014,39451,39095,-356,-0.902,-18,-338,40,111,H1
"Okmulgee County, OK",2014-2015,39137,39187,50,0.128,-9,59,40,111,H1
"Okmulgee County, OK",2015-2016,39187,39104,-83,-0.212,-18,-65,40,111,H1
"Okmulgee County, OK",2016-2017,39104,38930,-174,-0.445,-27,-147,40,111,H1
"Osage County, OK",2000-2001,44579,45227,648,1.454,125,523,40,113,H1
"Osage County, OK",2001-2002,45227,45414,187,0.413,112,75,40,113,H1
"Osage County, OK",2002-2003,45414,45680,266,0.586,57,209,40,113,H1
"Osage County, OK",2003-2004,45680,45874,194,0.425,39,155,40,113,H1
"Osage County, OK",2004-2005,45874,46335,461,1.005,33,428,40,113,H1
"Osage County, OK",2005-2006,46335,46576,241,0.52,65,176,40,113,H1
"Osage County, OK",2006-2007,46576,47185,609,1.308,76,533,40,113,H1
"Osage County, OK",2007-2008,47185,47336,151,0.32,68,83,40,113,H1
"Osage County, OK",2008-2009,47336,47445,109,0.23,106,3,40,113,H1
"Osage County, OK",2009-2010,47445,47436,-9,-0.019,109,-118,40,113,H1
"Osage County, OK",2010-2011,47436,48332,896,1.889,50,846,40,113,H1
"Osage County, OK",2011-2012,48332,48010,-322,-0.666,-71,-251,40,113,H1
"Osage County, OK",2012-2013,48010,47924,-86,-0.179,-21,-65,40,113,H1
"Osage County, OK",2013-2014,47924,47981,57,0.119,-110,167,40,113,H1
"Osage County, OK",2014-2015,48075,47887,-188,-0.391,-76,-112,40,113,H1
"Osage County, OK",2015-2016,47887,47317,-570,-1.19,-63,-507,40,113,H1
"Osage County, OK",2016-2017,47317,47233,-84,-0.178,-98,14,40,113,H1
"Ottawa County, OK",2000-2001,33214,33047,-167,-0.503,-1,-166,40,115,H1
"Ottawa County, OK",2001-2002,33047,32660,-387,-1.171,-5,-382,40,115,H1
"Ottawa County, OK",2002-2003,32660,32495,-165,-0.505,-17,-148,40,115,H1
"Ottawa County, OK",2003-2004,32495,32530,35,0.108,-31,66,40,115,H1
"Ottawa County, OK",2004-2005,32530,32655,125,0.384,-24,149,40,115,H1
"Ottawa County, OK",2005-2006,32655,32971,316,0.968,54,262,40,115,H1
"Ottawa County, OK",2006-2007,32971,32441,-530,-1.607,29,-559,40,115,H1
"Ottawa County, OK",2007-2008,32441,31838,-603,-1.859,52,-655,40,115,H1
"Ottawa County, OK",2008-2009,31838,31883,45,0.141,29,16,40,115,H1
"Ottawa County, OK",2009-2010,31883,31863,-20,-0.063,60,-80,40,115,H1
"Ottawa County, OK",2010-2011,31863,31928,65,0.204,2,63,40,115,H1
"Ottawa County, OK",2011-2012,31928,32252,324,1.015,-33,357,40,115,H1
"Ottawa County, OK",2012-2013,32252,32280,28,0.087,2,26,40,115,H1
"Ottawa County, OK",2013-2014,32280,32105,-175,-0.542,-27,-148,40,115,H1
"Ottawa County, OK",2014-2015,32083,31981,-102,-0.318,-14,-88,40,115,H1
"Ottawa County, OK",2015-2016,31981,31523,-458,-1.432,-64,-394,40,115,H1
"Ottawa County, OK",2016-2017,31523,31312,-211,-0.669,-71,-140,40,115,H1
"Pawnee County, OK",2000-2001,16684,16779,95,0.569,24,71,40,117,H1
"Pawnee County, OK",2001-2002,16779,16764,-15,-0.089,1,-16,40,117,H1
"Pawnee County, OK",2002-2003,16764,16677,-87,-0.519,35,-122,40,117,H1
"Pawnee County, OK",2003-2004,16677,16547,-130,-0.78,-9,-121,40,117,H1
"Pawnee County, OK",2004-2005,16547,16565,18,0.109,19,-1,40,117,H1
"Pawnee County, OK",2005-2006,16565,16625,60,0.362,41,19,40,117,H1
"Pawnee County, OK",2006-2007,16625,16611,-14,-0.084,24,-38,40,117,H1
"Pawnee County, OK",2007-2008,16611,16447,-164,-0.987,4,-168,40,117,H1
"Pawnee County, OK",2008-2009,16447,16559,112,0.681,10,102,40,117,H1
"Pawnee County, OK",2009-2010,16559,16612,53,0.32,15,38,40,117,H1
"Pawnee County, OK",2010-2011,16612,16806,194,1.168,-28,222,40,117,H1
"Pawnee County, OK",2011-2012,16806,16483,-323,-1.922,-36,-287,40,117,H1
"Pawnee County, OK",2012-2013,16483,16527,44,0.267,24,20,40,117,H1
"Pawnee County, OK",2013-2014,16527,16401,-126,-0.762,23,-149,40,117,H1
"Pawnee County, OK",2014-2015,16336,16436,100,0.612,8,92,40,117,H1
"Pawnee County, OK",2015-2016,16436,16505,69,0.42,-3,72,40,117,H1
"Pawnee County, OK",2016-2017,16505,16472,-33,-0.2,9,-42,40,117,H1
"Payne County, OK",2000-2001,68350,70132,1782,2.607,258,1524,40,119,H1
"Payne County, OK",2001-2002,70132,70708,576,0.821,327,249,40,119,H1
"Payne County, OK",2002-2003,70708,71879,1171,1.656,281,890,40,119,H1
"Payne County, OK",2003-2004,71879,72244,365,0.508,320,45,40,119,H1
"Payne County, OK",2004-2005,72244,72578,334,0.462,362,-28,40,119,H1
"Payne County, OK",2005-2006,72578,74964,2386,3.287,393,1993,40,119,H1
"Payne County, OK",2006-2007,74964,74164,-800,-1.067,372,-1172,40,119,H1
"Payne County, OK",2007-2008,74164,7.50E+04,836,1.127,384,452,40,119,H1
"Payne County, OK",2008-2009,7.50E+04,76859,1859,2.479,428,1431,40,119,H1
"Payne County, OK",2009-2010,76859,77444,585,0.761,430,155,40,119,H1
"Payne County, OK",2010-2011,77444,77970,526,0.679,417,109,40,119,H1
"Payne County, OK",2011-2012,77970,78479,509,0.653,315,194,40,119,H1
"Payne County, OK",2012-2013,78479,79457,978,1.246,409,569,40,119,H1
"Payne County, OK",2013-2014,79457,80264,807,1.016,374,433,40,119,H1
"Payne County, OK",2014-2015,80305,80850,545,0.679,359,186,40,119,H1
"Payne County, OK",2015-2016,80850,81249,399,0.494,361,38,40,119,H1
"Payne County, OK",2016-2017,81249,81575,326,0.401,382,-56,40,119,H1
"Pittsburg County, OK",2000-2001,43982,43447,-535,-1.216,-95,-440,40,121,H1
"Pittsburg County, OK",2001-2002,43447,43933,486,1.119,-12,498,40,121,H1
"Pittsburg County, OK",2002-2003,43933,43983,50,0.114,-57,107,40,121,H1
"Pittsburg County, OK",2003-2004,43983,44029,46,0.105,10,36,40,121,H1
"Pittsburg County, OK",2004-2005,44029,44412,383,0.87,-19,402,40,121,H1
"Pittsburg County, OK",2005-2006,44412,44831,419,0.943,-60,479,40,121,H1
"Pittsburg County, OK",2006-2007,44831,45062,231,0.515,-42,273,40,121,H1
"Pittsburg County, OK",2007-2008,45062,45450,388,0.861,34,354,40,121,H1
"Pittsburg County, OK",2008-2009,45450,45887,437,0.961,58,379,40,121,H1
"Pittsburg County, OK",2009-2010,45887,45803,-84,-0.183,108,-192,40,121,H1
"Pittsburg County, OK",2010-2011,45803,45666,-137,-0.299,-81,-56,40,121,H1
"Pittsburg County, OK",2011-2012,45666,45131,-535,-1.172,-54,-481,40,121,H1
"Pittsburg County, OK",2012-2013,45131,44873,-258,-0.572,17,-275,40,121,H1
"Pittsburg County, OK",2013-2014,44873,44626,-247,-0.55,-19,-228,40,121,H1
"Pittsburg County, OK",2014-2015,44619,44610,-9,-0.02,2,-11,40,121,H1
"Pittsburg County, OK",2015-2016,44610,44395,-215,-0.482,-49,-166,40,121,H1
"Pittsburg County, OK",2016-2017,44395,44184,-211,-0.475,-72,-139,40,121,H1
"Pontotoc County, OK",2000-2001,35148,34866,-282,-0.802,52,-334,40,123,H1
"Pontotoc County, OK",2001-2002,34866,34929,63,0.181,74,-11,40,123,H1
"Pontotoc County, OK",2002-2003,34929,35048,119,0.341,76,43,40,123,H1
"Pontotoc County, OK",2003-2004,35048,35097,49,0.14,70,-21,40,123,H1
"Pontotoc County, OK",2004-2005,35097,35267,170,0.484,84,86,40,123,H1
"Pontotoc County, OK",2005-2006,35267,35525,258,0.732,107,151,40,123,H1
"Pontotoc County, OK",2006-2007,35525,36157,632,1.779,185,447,40,123,H1
"Pontotoc County, OK",2007-2008,36157,36687,530,1.466,144,386,40,123,H1
"Pontotoc County, OK",2008-2009,36687,37283,596,1.625,180,416,40,123,H1
"Pontotoc County, OK",2009-2010,37283,37584,301,0.807,154,147,40,123,H1
"Pontotoc County, OK",2010-2011,37584,37697,113,0.301,110,3,40,123,H1
"Pontotoc County, OK",2011-2012,37697,38006,309,0.82,157,152,40,123,H1
"Pontotoc County, OK",2012-2013,38006,38073,67,0.176,45,22,40,123,H1
"Pontotoc County, OK",2013-2014,38073,38005,-68,-0.179,22,-90,40,123,H1
"Pontotoc County, OK",2014-2015,38174,38194,20,0.052,62,-42,40,123,H1
"Pontotoc County, OK",2015-2016,38194,38443,249,0.652,13,236,40,123,H1
"Pontotoc County, OK",2016-2017,38443,38224,-219,-0.57,-8,-211,40,123,H1
"Pottawatomie County, OK",2000-2001,65647,66222,575,0.876,206,369,40,125,H1
"Pottawatomie County, OK",2001-2002,66222,66469,247,0.373,207,40,40,125,H1
"Pottawatomie County, OK",2002-2003,66469,67201,732,1.101,148,584,40,125,H1
"Pottawatomie County, OK",2003-2004,67201,67072,-129,-0.192,134,-263,40,125,H1
"Pottawatomie County, OK",2004-2005,67072,67264,192,0.286,182,10,40,125,H1
"Pottawatomie County, OK",2005-2006,67264,67696,432,0.642,186,246,40,125,H1
"Pottawatomie County, OK",2006-2007,67696,68698,1002,1.48,264,738,40,125,H1
"Pottawatomie County, OK",2007-2008,68698,68752,54,0.079,318,-264,40,125,H1
"Pottawatomie County, OK",2008-2009,68752,69002,250,0.364,252,-2,40,125,H1
"Pottawatomie County, OK",2009-2010,69002,69647,645,0.935,173,472,40,125,H1
"Pottawatomie County, OK",2010-2011,69647,70148,501,0.719,231,270,40,125,H1
"Pottawatomie County, OK",2011-2012,70148,70703,555,0.791,141,414,40,125,H1
"Pottawatomie County, OK",2012-2013,70703,71190,487,0.689,127,360,40,125,H1
"Pottawatomie County, OK",2013-2014,71190,71811,621,0.872,114,507,40,125,H1
"Pottawatomie County, OK",2014-2015,71802,71875,73,0.102,147,-74,40,125,H1
"Pottawatomie County, OK",2015-2016,71875,71982,107,0.149,35,72,40,125,H1
"Pottawatomie County, OK",2016-2017,71982,72226,244,0.339,38,206,40,125,H1
"Pushmataha County, OK",2000-2001,11638,11613,-25,-0.215,-13,-12,40,127,H1
"Pushmataha County, OK",2001-2002,11613,11551,-62,-0.534,-17,-45,40,127,H1
"Pushmataha County, OK",2002-2003,11551,11464,-87,-0.753,-61,-26,40,127,H1
"Pushmataha County, OK",2003-2004,11464,11470,6,0.052,-17,23,40,127,H1
"Pushmataha County, OK",2004-2005,11470,11361,-109,-0.95,-39,-70,40,127,H1
"Pushmataha County, OK",2005-2006,11361,11389,28,0.246,-1,29,40,127,H1
"Pushmataha County, OK",2006-2007,11389,11468,79,0.694,-8,87,40,127,H1
"Pushmataha County, OK",2007-2008,11468,11493,25,0.218,-5,30,40,127,H1
"Pushmataha County, OK",2008-2009,11493,11574,81,0.705,7,74,40,127,H1
"Pushmataha County, OK",2009-2010,11574,11585,11,0.095,3,8,40,127,H1
"Pushmataha County, OK",2010-2011,11585,11401,-184,-1.588,-69,-115,40,127,H1
"Pushmataha County, OK",2011-2012,11401,11233,-168,-1.474,-38,-130,40,127,H1
"Pushmataha County, OK",2012-2013,11233,11233,0,0,2,-2,40,127,H1
"Pushmataha County, OK",2013-2014,11233,11125,-108,-0.961,-37,-71,40,127,H1
"Pushmataha County, OK",2014-2015,11128,11183,55,0.494,-14,69,40,127,H1
"Pushmataha County, OK",2015-2016,11183,11064,-119,-1.064,3,-122,40,127,H1
"Pushmataha County, OK",2016-2017,11064,11173,109,0.985,4,105,40,127,H1
"Roger Mills County, OK",2000-2001,3426,3334,-92,-2.685,-2,-90,40,129,H1
"Roger Mills County, OK",2001-2002,3334,3242,-92,-2.759,6,-98,40,129,H1
"Roger Mills County, OK",2002-2003,3242,3226,-16,-0.494,-3,-13,40,129,H1
"Roger Mills County, OK",2003-2004,3226,3308,82,2.542,-2,84,40,129,H1
"Roger Mills County, OK",2004-2005,3308,3385,77,2.328,9,68,40,129,H1
"Roger Mills County, OK",2005-2006,3385,3387,2,0.059,13,-11,40,129,H1
"Roger Mills County, OK",2006-2007,3387,3438,51,1.506,16,35,40,129,H1
"Roger Mills County, OK",2007-2008,3438,3557,119,3.461,38,81,40,129,H1
"Roger Mills County, OK",2008-2009,3557,3615,58,1.631,34,24,40,129,H1
"Roger Mills County, OK",2009-2010,3615,3636,21,0.581,21,0,40,129,H1
"Roger Mills County, OK",2010-2011,3636,3796,160,4.4,13,147,40,129,H1
"Roger Mills County, OK",2011-2012,3796,3774,-22,-0.58,8,-30,40,129,H1
"Roger Mills County, OK",2012-2013,3774,3741,-33,-0.874,23,-56,40,129,H1
"Roger Mills County, OK",2013-2014,3741,3761,20,0.535,20,0,40,129,H1
"Roger Mills County, OK",2014-2015,3776,3788,12,0.318,36,-24,40,129,H1
"Roger Mills County, OK",2015-2016,3788,3690,-98,-2.587,44,-142,40,129,H1
"Roger Mills County, OK",2016-2017,3690,3716,26,0.705,37,-11,40,129,H1
"Rogers County, OK",2000-2001,71383,73091,1708,2.393,383,1325,40,131,H1
"Rogers County, OK",2001-2002,73091,75193,2102,2.876,296,1806,40,131,H1
"Rogers County, OK",2002-2003,75193,77288,2095,2.786,355,1740,40,131,H1
"Rogers County, OK",2003-2004,77288,79069,1781,2.304,368,1413,40,131,H1
"Rogers County, OK",2004-2005,79069,80313,1244,1.573,250,994,40,131,H1
"Rogers County, OK",2005-2006,80313,82234,1921,2.392,279,1642,40,131,H1
"Rogers County, OK",2006-2007,82234,84030,1796,2.184,290,1506,40,131,H1
"Rogers County, OK",2007-2008,84030,85390,1360,1.618,303,1057,40,131,H1
"Rogers County, OK",2008-2009,85390,86577,1187,1.39,335,852,40,131,H1
"Rogers County, OK",2009-2010,86577,87024,447,0.516,265,182,40,131,H1
"Rogers County, OK",2010-2011,87024,87753,729,0.838,216,513,40,131,H1
"Rogers County, OK",2011-2012,87753,88445,692,0.789,251,441,40,131,H1
"Rogers County, OK",2012-2013,88445,89183,738,0.834,184,554,40,131,H1
"Rogers County, OK",2013-2014,89183,89815,632,0.709,202,430,40,131,H1
"Rogers County, OK",2014-2015,89862,90802,940,1.046,263,677,40,131,H1
"Rogers County, OK",2015-2016,90802,90951,149,0.164,169,-20,40,131,H1
"Rogers County, OK",2016-2017,90951,91444,493,0.542,188,305,40,131,H1
"Seminole County, OK",2000-2001,24963,24719,-244,-0.977,5,-249,40,133,H1
"Seminole County, OK",2001-2002,24719,24540,-179,-0.724,4,-183,40,133,H1
"Seminole County, OK",2002-2003,24540,24584,44,0.179,83,-39,40,133,H1
"Seminole County, OK",2003-2004,24584,24801,217,0.883,66,151,40,133,H1
"Seminole County, OK",2004-2005,24801,24878,77,0.31,6,71,40,133,H1
"Seminole County, OK",2005-2006,24878,24997,119,0.478,-3,122,40,133,H1
"Seminole County, OK",2006-2007,24997,25030,33,0.132,27,6,40,133,H1
"Seminole County, OK",2007-2008,25030,25198,168,0.671,77,91,40,133,H1
"Seminole County, OK",2008-2009,25198,25428,230,0.913,104,126,40,133,H1
"Seminole County, OK",2009-2010,25428,25450,22,0.087,89,-67,40,133,H1
"Seminole County, OK",2010-2011,25450,25485,35,0.138,37,-2,40,133,H1
"Seminole County, OK",2011-2012,25485,25469,-16,-0.063,-34,18,40,133,H1
"Seminole County, OK",2012-2013,25469,25476,7,0.027,38,-31,40,133,H1
"Seminole County, OK",2013-2014,25476,25421,-55,-0.216,5,-60,40,133,H1
"Seminole County, OK",2014-2015,25423,25548,125,0.492,8,117,40,133,H1
"Seminole County, OK",2015-2016,25548,25164,-384,-1.503,44,-428,40,133,H1
"Seminole County, OK",2016-2017,25164,24878,-286,-1.137,0,-286,40,133,H1
"Sequoyah County, OK",2000-2001,39040,39308,268,0.686,124,144,40,135,H1
"Sequoyah County, OK",2001-2002,39308,39570,262,0.667,153,109,40,135,H1
"Sequoyah County, OK",2002-2003,39570,39905,335,0.847,132,203,40,135,H1
"Sequoyah County, OK",2003-2004,39905,40412,507,1.271,138,369,40,135,H1
"Sequoyah County, OK",2004-2005,40412,40634,222,0.549,98,124,40,135,H1
"Sequoyah County, OK",2005-2006,40634,41248,614,1.511,119,495,40,135,H1
"Sequoyah County, OK",2006-2007,41248,41560,312,0.756,170,142,40,135,H1
"Sequoyah County, OK",2007-2008,41560,41825,265,0.638,91,174,40,135,H1
"Sequoyah County, OK",2008-2009,41825,42208,383,0.916,37,346,40,135,H1
"Sequoyah County, OK",2009-2010,42208,42448,240,0.569,110,130,40,135,H1
"Sequoyah County, OK",2010-2011,42448,42021,-427,-1.006,-136,-291,40,135,H1
"Sequoyah County, OK",2011-2012,42021,41466,-555,-1.321,-92,-463,40,135,H1
"Sequoyah County, OK",2012-2013,41466,41307,-159,-0.383,35,-194,40,135,H1
"Sequoyah County, OK",2013-2014,41307,41358,51,0.123,4,47,40,135,H1
"Sequoyah County, OK",2014-2015,41351,41153,-198,-0.479,-26,-172,40,135,H1
"Sequoyah County, OK",2015-2016,41153,41364,211,0.513,-122,333,40,135,H1
"Sequoyah County, OK",2016-2017,41364,41252,-112,-0.271,-79,-33,40,135,H1
"Stephens County, OK",2000-2001,43116,42796,-320,-0.742,-126,-194,40,137,H1
"Stephens County, OK",2001-2002,42796,42771,-25,-0.058,-40,15,40,137,H1
"Stephens County, OK",2002-2003,42771,42725,-46,-0.108,-28,-18,40,137,H1
"Stephens County, OK",2003-2004,42725,43061,336,0.786,-40,376,40,137,H1
"Stephens County, OK",2004-2005,43061,43318,257,0.597,-12,269,40,137,H1
"Stephens County, OK",2005-2006,43318,43670,352,0.813,-3,355,40,137,H1
"Stephens County, OK",2006-2007,43670,44196,526,1.204,-23,549,40,137,H1
"Stephens County, OK",2007-2008,44196,44508,312,0.706,65,247,40,137,H1
"Stephens County, OK",2008-2009,44508,44799,291,0.654,51,240,40,137,H1
"Stephens County, OK",2009-2010,44799,45089,290,0.647,78,212,40,137,H1
"Stephens County, OK",2010-2011,45089,45104,15,0.033,-5,20,40,137,H1
"Stephens County, OK",2011-2012,45104,44837,-267,-0.592,-6,-261,40,137,H1
"Stephens County, OK",2012-2013,44837,44977,140,0.312,-4,144,40,137,H1
"Stephens County, OK",2013-2014,44977,44493,-484,-1.076,30,-514,40,137,H1
"Stephens County, OK",2014-2015,44501,44581,80,0.18,17,63,40,137,H1
"Stephens County, OK",2015-2016,44581,43993,-588,-1.319,-1,-587,40,137,H1
"Stephens County, OK",2016-2017,43993,43332,-661,-1.503,-44,-617,40,137,H1
"Texas County, OK",2000-2001,20161,19945,-216,-1.071,271,-487,40,139,H1
"Texas County, OK",2001-2002,19945,19734,-211,-1.058,211,-422,40,139,H1
"Texas County, OK",2002-2003,19734,19469,-265,-1.343,235,-500,40,139,H1
"Texas County, OK",2003-2004,19469,19693,224,1.151,270,-46,40,139,H1
"Texas County, OK",2004-2005,19693,19408,-285,-1.447,244,-529,40,139,H1
"Texas County, OK",2005-2006,19408,19361,-47,-0.242,212,-259,40,139,H1
"Texas County, OK",2006-2007,19361,19258,-103,-0.532,273,-376,40,139,H1
"Texas County, OK",2007-2008,19258,19539,281,1.459,273,8,40,139,H1
"Texas County, OK",2008-2009,19539,20128,589,3.014,296,293,40,139,H1
"Texas County, OK",2009-2010,20128,20811,683,3.393,300,383,40,139,H1
"Texas County, OK",2010-2011,20811,21203,392,1.884,184,208,40,139,H1
"Texas County, OK",2011-2012,21203,21533,330,1.556,198,132,40,139,H1
"Texas County, OK",2012-2013,21533,22073,540,2.508,249,291,40,139,H1
"Texas County, OK",2013-2014,22073,21853,-220,-0.997,259,-479,40,139,H1
"Texas County, OK",2014-2015,21757,21489,-268,-1.232,222,-490,40,139,H1
"Texas County, OK",2015-2016,21489,21131,-358,-1.666,221,-579,40,139,H1
"Texas County, OK",2016-2017,21131,20900,-231,-1.093,212,-443,40,139,H1
"Tillman County, OK",2000-2001,9247,9203,-44,-0.476,-6,-38,40,141,H1
"Tillman County, OK",2001-2002,9203,8841,-362,-3.933,-31,-331,40,141,H1
"Tillman County, OK",2002-2003,8841,8802,-39,-0.441,-10,-29,40,141,H1
"Tillman County, OK",2003-2004,8802,8668,-134,-1.522,-23,-111,40,141,H1
"Tillman County, OK",2004-2005,8668,8464,-204,-2.353,-10,-194,40,141,H1
"Tillman County, OK",2005-2006,8464,8394,-70,-0.827,-1,-69,40,141,H1
"Tillman County, OK",2006-2007,8394,8271,-123,-1.465,-19,-104,40,141,H1
"Tillman County, OK",2007-2008,8271,8112,-159,-1.922,19,-178,40,141,H1
"Tillman County, OK",2008-2009,8112,8016,-96,-1.183,20,-116,40,141,H1
"Tillman County, OK",2009-2010,8016,7981,-35,-0.437,18,-53,40,141,H1
"Tillman County, OK",2010-2011,7981,7983,2,0.025,11,-9,40,141,H1
"Tillman County, OK",2011-2012,7983,7784,-199,-2.493,4,-203,40,141,H1
"Tillman County, OK",2012-2013,7784,7681,-103,-1.323,20,-123,40,141,H1
"Tillman County, OK",2013-2014,7681,7628,-53,-0.69,29,-82,40,141,H1
"Tillman County, OK",2014-2015,7613,7515,-98,-1.287,22,-120,40,141,H1
"Tillman County, OK",2015-2016,7515,7530,15,0.2,7,8,40,141,H1
"Tillman County, OK",2016-2017,7530,7433,-97,-1.288,12,-109,40,141,H1
"Tulsa County, OK",2000-2001,563748,566175,2427,0.431,4011,-1584,40,143,H1
"Tulsa County, OK",2001-2002,566175,569170,2995,0.529,4072,-1077,40,143,H1
"Tulsa County, OK",2002-2003,569170,568406,-764,-0.134,4006,-4770,40,143,H1
"Tulsa County, OK",2003-2004,568406,566140,-2266,-0.399,4071,-6337,40,143,H1
"Tulsa County, OK",2004-2005,566140,568199,2059,0.364,3922,-1863,40,143,H1
"Tulsa County, OK",2005-2006,568199,575014,6815,1.199,4034,2781,40,143,H1
"Tulsa County, OK",2006-2007,575014,582094,7080,1.231,4552,2528,40,143,H1
"Tulsa County, OK",2007-2008,582094,588510,6416,1.102,4105,2311,40,143,H1
"Tulsa County, OK",2008-2009,588510,597748,9238,1.57,4094,5144,40,143,H1
"Tulsa County, OK",2009-2010,597748,605092,7344,1.229,4499,2845,40,143,H1
"Tulsa County, OK",2010-2011,605092,608522,3430,0.567,3837,-407,40,143,H1
"Tulsa County, OK",2011-2012,608522,614460,5938,0.976,4169,1769,40,143,H1
"Tulsa County, OK",2012-2013,614460,622966,8506,1.384,3614,4892,40,143,H1
"Tulsa County, OK",2013-2014,622966,629598,6632,1.065,3701,2931,40,143,H1
"Tulsa County, OK",2014-2015,630428,639242,8814,1.398,3674,5140,40,143,H1
"Tulsa County, OK",2015-2016,639242,645042,5800,0.907,3691,2109,40,143,H1
"Tulsa County, OK",2016-2017,645042,646266,1224,0.19,3569,-2345,40,143,H1
"Wagoner County, OK",2000-2001,57711,58944,1233,2.137,376,857,40,145,H1
"Wagoner County, OK",2001-2002,58944,60561,1617,2.743,386,1231,40,145,H1
"Wagoner County, OK",2002-2003,60561,61700,1139,1.881,354,785,40,145,H1
"Wagoner County, OK",2003-2004,61700,62800,1100,1.783,299,801,40,145,H1
"Wagoner County, OK",2004-2005,62800,64165,1365,2.174,318,1047,40,145,H1
"Wagoner County, OK",2005-2006,64165,66345,2180,3.397,311,1869,40,145,H1
"Wagoner County, OK",2006-2007,66345,68677,2332,3.515,466,1866,40,145,H1
"Wagoner County, OK",2007-2008,68677,70646,1969,2.867,476,1493,40,145,H1
"Wagoner County, OK",2008-2009,70646,72143,1497,2.119,513,984,40,145,H1
"Wagoner County, OK",2009-2010,72143,73393,1250,1.733,455,795,40,145,H1
"Wagoner County, OK",2010-2011,73393,74069,676,0.921,266,410,40,145,H1
"Wagoner County, OK",2011-2012,74069,74997,928,1.253,295,633,40,145,H1
"Wagoner County, OK",2012-2013,74997,75675,678,0.904,314,364,40,145,H1
"Wagoner County, OK",2013-2014,75675,75702,27,0.036,270,-243,40,145,H1
"Wagoner County, OK",2014-2015,75612,76559,947,1.252,184,763,40,145,H1
"Wagoner County, OK",2015-2016,76559,77508,949,1.24,156,793,40,145,H1
"Wagoner County, OK",2016-2017,77508,78657,1149,1.482,146,1003,40,145,H1
"Washington County, OK",2000-2001,48987,48897,-90,-0.184,26,-116,40,147,H1
"Washington County, OK",2001-2002,48897,49032,135,0.276,17,118,40,147,H1
"Washington County, OK",2002-2003,49032,49004,-28,-0.057,-19,-9,40,147,H1
"Washington County, OK",2003-2004,49004,48997,-7,-0.014,66,-73,40,147,H1
"Washington County, OK",2004-2005,48997,48885,-112,-0.229,-10,-102,40,147,H1
"Washington County, OK",2005-2006,48885,49216,331,0.677,18,313,40,147,H1
"Washington County, OK",2006-2007,49216,50038,822,1.67,60,762,40,147,H1
"Washington County, OK",2007-2008,50038,50641,603,1.205,133,470,40,147,H1
"Washington County, OK",2008-2009,50641,50754,113,0.223,165,-52,40,147,H1
"Washington County, OK",2009-2010,50754,51080,326,0.642,104,222,40,147,H1
"Washington County, OK",2010-2011,51080,51524,444,0.869,80,364,40,147,H1
"Washington County, OK",2011-2012,51524,51710,186,0.361,35,151,40,147,H1
"Washington County, OK",2012-2013,51710,51567,-143,-0.277,-4,-139,40,147,H1
"Washington County, OK",2013-2014,51567,51937,370,0.718,-5,375,40,147,H1
"Washington County, OK",2014-2015,51967,52021,54,0.104,1,53,40,147,H1
"Washington County, OK",2015-2016,52021,51914,-107,-0.206,69,-176,40,147,H1
"Washington County, OK",2016-2017,51914,51932,18,0.035,11,7,40,147,H1
"Washita County, OK",2000-2001,11497,11362,-135,-1.174,-17,-118,40,149,H1
"Washita County, OK",2001-2002,11362,11243,-119,-1.047,-41,-78,40,149,H1
"Washita County, OK",2002-2003,11243,11204,-39,-0.347,17,-56,40,149,H1
"Washita County, OK",2003-2004,11204,11202,-2,-0.018,-1,-1,40,149,H1
"Washita County, OK",2004-2005,11202,11228,26,0.232,26,0,40,149,H1
"Washita County, OK",2005-2006,11228,11422,194,1.728,30,164,40,149,H1
"Washita County, OK",2006-2007,11422,11555,133,1.164,28,105,40,149,H1
"Washita County, OK",2007-2008,11555,11595,40,0.346,27,13,40,149,H1
"Washita County, OK",2008-2009,11595,11664,69,0.595,22,47,40,149,H1
"Washita County, OK",2009-2010,11664,11595,-69,-0.592,14,-83,40,149,H1
"Washita County, OK",2010-2011,11595,11608,13,0.112,8,5,40,149,H1
"Washita County, OK",2011-2012,11608,11638,30,0.258,-5,35,40,149,H1
"Washita County, OK",2012-2013,11638,11717,79,0.679,13,66,40,149,H1
"Washita County, OK",2013-2014,11717,11547,-170,-1.451,7,-177,40,149,H1
"Washita County, OK",2014-2015,11570,11661,91,0.787,-7,98,40,149,H1
"Washita County, OK",2015-2016,11661,11474,-187,-1.604,2,-189,40,149,H1
"Washita County, OK",2016-2017,11474,11134,-340,-2.963,3,-343,40,149,H1
"Woods County, OK",2000-2001,9049,8882,-167,-1.846,-49,-118,40,151,H1
"Woods County, OK",2001-2002,8882,8896,14,0.158,-55,69,40,151,H1
"Woods County, OK",2002-2003,8896,8729,-167,-1.877,-18,-149,40,151,H1
"Woods County, OK",2003-2004,8729,8676,-53,-0.607,-27,-26,40,151,H1
"Woods County, OK",2004-2005,8676,8679,3,0.035,-41,44,40,151,H1
"Woods County, OK",2005-2006,8679,8550,-129,-1.486,-42,-87,40,151,H1
"Woods County, OK",2006-2007,8550,8593,43,0.503,15,28,40,151,H1
"Woods County, OK",2007-2008,8593,8533,-60,-0.698,-9,-51,40,151,H1
"Woods County, OK",2008-2009,8533,8708,175,2.051,-14,189,40,151,H1
"Woods County, OK",2009-2010,8708,8892,184,2.113,-5,189,40,151,H1
"Woods County, OK",2010-2011,8892,8765,-127,-1.428,8,-135,40,151,H1
"Woods County, OK",2011-2012,8765,8832,67,0.764,-2,69,40,151,H1
"Woods County, OK",2012-2013,8832,9015,183,2.072,9,174,40,151,H1
"Woods County, OK",2013-2014,9015,9288,273,3.028,16,257,40,151,H1
"Woods County, OK",2014-2015,9264,9304,40,0.432,14,26,40,151,H1
"Woods County, OK",2015-2016,9304,9134,-170,-1.827,13,-183,40,151,H1
"Woods County, OK",2016-2017,9134,9031,-103,-1.128,-4,-99,40,151,H1
"Woodward County, OK",2000-2001,18436,18365,-71,-0.385,47,-118,40,153,H1
"Woodward County, OK",2001-2002,18365,18482,117,0.637,104,13,40,153,H1
"Woodward County, OK",2002-2003,18482,18594,112,0.606,83,29,40,153,H1
"Woodward County, OK",2003-2004,18594,18935,341,1.834,109,232,40,153,H1
"Woodward County, OK",2004-2005,18935,19122,187,0.988,93,94,40,153,H1
"Woodward County, OK",2005-2006,19122,19341,219,1.145,71,148,40,153,H1
"Woodward County, OK",2006-2007,19341,19939,598,3.092,106,492,40,153,H1
"Woodward County, OK",2007-2008,19939,20120,181,0.908,116,65,40,153,H1
"Woodward County, OK",2008-2009,20120,20467,347,1.725,119,228,40,153,H1
"Woodward County, OK",2009-2010,20467,19988,-479,-2.34,112,-591,40,153,H1
"Woodward County, OK",2010-2011,19988,20096,108,0.54,108,0,40,153,H1
"Woodward County, OK",2011-2012,20096,20647,551,2.742,131,420,40,153,H1
"Woodward County, OK",2012-2013,20647,21225,578,2.799,133,445,40,153,H1
"Woodward County, OK",2013-2014,21225,21529,304,1.432,103,201,40,153,H1
"Woodward County, OK",2014-2015,21485,21559,74,0.344,96,-22,40,153,H1
"Woodward County, OK",2015-2016,21559,20924,-635,-2.945,98,-733,40,153,H1
"Woodward County, OK",2016-2017,20924,20459,-465,-2.222,26,-491,40,153,H1
Oregon,2000-2001,3429708,3467937,38229,1.115,15633,22596,41,0,STATE
Oregon,2001-2002,3467937,3513424,45487,1.312,14156,31331,41,0,STATE
Oregon,2002-2003,3513424,3547376,33952,0.966,15086,18866,41,0,STATE
Oregon,2003-2004,3547376,3569463,22087,0.623,14845,7242,41,0,STATE
Oregon,2004-2005,3569463,3613202,43739,1.225,15102,28637,41,0,STATE
Oregon,2005-2006,3613202,3670883,57681,1.596,16525,41156,41,0,STATE
Oregon,2006-2007,3670883,3722417,51534,1.404,18240,33294,41,0,STATE
Oregon,2007-2008,3722417,3768748,46331,1.245,17956,28375,41,0,STATE
Oregon,2008-2009,3768748,3808600,39852,1.057,17442,22410,41,0,STATE
Oregon,2009-2010,3808600,3837972,29372,0.771,15807,13565,41,0,STATE
Oregon,2010-2011,3837972,3868509,30537,0.796,12858,17679,41,0,STATE
Oregon,2011-2012,3868509,3899444,30935,0.8,11973,18962,41,0,STATE
Oregon,2012-2013,3899444,3928030,28586,0.733,11581,17005,41,0,STATE
Oregon,2013-2014,3928030,3971202,43172,1.099,11690,31482,41,0,STATE
Oregon,2014-2015,3971202,4028977,57775,1.455,12391,45384,41,0,STATE
Oregon,2015-2016,4028977,4085989,57012,1.415,10421,46591,41,0,STATE
Oregon,2016-2017,4085989,4142776,56787,1.39,11024,45763,41,0,STATE
"Baker County, OR",2000-2001,16714,16618,-96,-0.574,-39,-57,41,1,H1
"Baker County, OR",2001-2002,16618,16376,-242,-1.456,-34,-208,41,1,H1
"Baker County, OR",2002-2003,16376,16312,-64,-0.391,-36,-28,41,1,H1
"Baker County, OR",2003-2004,16312,16272,-40,-0.245,-79,39,41,1,H1
"Baker County, OR",2004-2005,16272,16086,-186,-1.143,-67,-119,41,1,H1
"Baker County, OR",2005-2006,16086,16094,8,0.05,-22,30,41,1,H1
"Baker County, OR",2006-2007,16094,16139,45,0.28,-31,76,41,1,H1
"Baker County, OR",2007-2008,16139,16195,56,0.347,-11,67,41,1,H1
"Baker County, OR",2008-2009,16195,16225,30,0.185,-18,48,41,1,H1
"Baker County, OR",2009-2010,16225,16089,-136,-0.838,-47,-89,41,1,H1
"Baker County, OR",2010-2011,16089,16041,-48,-0.298,-38,-10,41,1,H1
"Baker County, OR",2011-2012,16041,15961,-80,-0.499,-19,-61,41,1,H1
"Baker County, OR",2012-2013,15961,16096,135,0.846,-26,161,41,1,H1
"Baker County, OR",2013-2014,16096,16059,-37,-0.23,-22,-15,41,1,H1
"Baker County, OR",2014-2015,16082,16005,-77,-0.479,-24,-53,41,1,H1
"Baker County, OR",2015-2016,16005,15948,-57,-0.356,-58,1,41,1,H1
"Baker County, OR",2016-2017,15948,16054,106,0.665,-44,150,41,1,H1
"Benton County, OR",2000-2001,78236,78491,255,0.326,316,-61,41,3,H1
"Benton County, OR",2001-2002,78491,80203,1712,2.181,362,1350,41,3,H1
"Benton County, OR",2002-2003,80203,80322,119,0.148,252,-133,41,3,H1
"Benton County, OR",2003-2004,80322,80149,-173,-0.215,256,-429,41,3,H1
"Benton County, OR",2004-2005,80149,80943,794,0.991,319,475,41,3,H1
"Benton County, OR",2005-2006,80943,81957,1014,1.253,303,711,41,3,H1
"Benton County, OR",2006-2007,81957,83718,1761,2.149,277,1484,41,3,H1
"Benton County, OR",2007-2008,83718,84150,432,0.516,221,211,41,3,H1
"Benton County, OR",2008-2009,84150,85390,1240,1.474,305,935,41,3,H1
"Benton County, OR",2009-2010,85390,85531,141,0.165,347,-206,41,3,H1
"Benton County, OR",2010-2011,85531,85983,452,0.528,213,239,41,3,H1
"Benton County, OR",2011-2012,85983,86380,397,0.462,161,236,41,3,H1
"Benton County, OR",2012-2013,86380,85960,-420,-0.486,193,-613,41,3,H1
"Benton County, OR",2013-2014,85960,86316,356,0.414,203,153,41,3,H1
"Benton County, OR",2014-2015,86414,87572,1158,1.34,127,1031,41,3,H1
"Benton County, OR",2015-2016,87572,89296,1724,1.969,184,1540,41,3,H1
"Benton County, OR",2016-2017,89296,90951,1655,1.853,178,1477,41,3,H1
"Clackamas County, OR",2000-2001,339223,343444,4221,1.244,1527,2694,41,5,H1
"Clackamas County, OR",2001-2002,343444,348951,5507,1.603,1384,4123,41,5,H1
"Clackamas County, OR",2002-2003,348951,352032,3081,0.883,1387,1694,41,5,H1
"Clackamas County, OR",2003-2004,352032,355758,3726,1.058,1337,2389,41,5,H1
"Clackamas County, OR",2004-2005,355758,359308,3550,0.998,1188,2362,41,5,H1
"Clackamas County, OR",2005-2006,359308,363508,4200,1.169,958,3242,41,5,H1
"Clackamas County, OR",2006-2007,363508,366808,3300,0.908,1165,2135,41,5,H1
"Clackamas County, OR",2007-2008,366808,371103,4295,1.171,1228,3067,41,5,H1
"Clackamas County, OR",2008-2009,371103,374085,2982,0.804,1364,1618,41,5,H1
"Clackamas County, OR",2009-2010,374085,376846,2761,0.738,697,2064,41,5,H1
"Clackamas County, OR",2010-2011,376846,379671,2825,0.75,737,2088,41,5,H1
"Clackamas County, OR",2011-2012,379671,383540,3869,1.019,937,2932,41,5,H1
"Clackamas County, OR",2012-2013,383540,388457,4917,1.282,877,4040,41,5,H1
"Clackamas County, OR",2013-2014,388457,394972,6515,1.677,857,5658,41,5,H1
"Clackamas County, OR",2014-2015,394504,401515,7011,1.777,934,6077,41,5,H1
"Clackamas County, OR",2015-2016,401515,406680,5165,1.286,897,4268,41,5,H1
"Clackamas County, OR",2016-2017,406680,412672,5992,1.473,784,5208,41,5,H1
"Clatsop County, OR",2000-2001,35560,35509,-51,-0.143,-39,-12,41,7,H1
"Clatsop County, OR",2001-2002,35509,35519,10,0.028,6,4,41,7,H1
"Clatsop County, OR",2002-2003,35519,35612,93,0.262,18,75,41,7,H1
"Clatsop County, OR",2003-2004,35612,35912,300,0.842,21,279,41,7,H1
"Clatsop County, OR",2004-2005,35912,36282,370,1.03,7,363,41,7,H1
"Clatsop County, OR",2005-2006,36282,36603,321,0.885,56,265,41,7,H1
"Clatsop County, OR",2006-2007,36603,36818,215,0.587,104,111,41,7,H1
"Clatsop County, OR",2007-2008,36818,36825,7,0.019,39,-32,41,7,H1
"Clatsop County, OR",2008-2009,36825,36972,147,0.399,40,107,41,7,H1
"Clatsop County, OR",2009-2010,36972,37058,86,0.233,0,86,41,7,H1
"Clatsop County, OR",2010-2011,37058,37183,125,0.337,58,67,41,7,H1
"Clatsop County, OR",2011-2012,37183,37343,160,0.43,63,97,41,7,H1
"Clatsop County, OR",2012-2013,37343,37121,-222,-0.594,22,-244,41,7,H1
"Clatsop County, OR",2013-2014,37121,37474,353,0.951,26,327,41,7,H1
"Clatsop County, OR",2014-2015,37425,37831,406,1.085,29,377,41,7,H1
"Clatsop County, OR",2015-2016,37831,38637,806,2.131,21,785,41,7,H1
"Clatsop County, OR",2016-2017,38637,39182,545,1.411,36,509,41,7,H1
"Columbia County, OR",2000-2001,43634,44196,562,1.288,160,402,41,9,H1
"Columbia County, OR",2001-2002,44196,45104,908,2.054,113,795,41,9,H1
"Columbia County, OR",2002-2003,45104,45636,532,1.179,125,407,41,9,H1
"Columbia County, OR",2003-2004,45636,46192,556,1.218,109,447,41,9,H1
"Columbia County, OR",2004-2005,46192,46955,763,1.652,110,653,41,9,H1
"Columbia County, OR",2005-2006,46955,48184,1229,2.617,197,1032,41,9,H1
"Columbia County, OR",2006-2007,48184,48898,714,1.482,130,584,41,9,H1
"Columbia County, OR",2007-2008,48898,49209,311,0.636,153,158,41,9,H1
"Columbia County, OR",2008-2009,49209,49394,185,0.376,150,35,41,9,H1
"Columbia County, OR",2009-2010,49394,49340,-54,-0.109,66,-120,41,9,H1
"Columbia County, OR",2010-2011,49340,49360,20,0.041,106,-86,41,9,H1
"Columbia County, OR",2011-2012,49360,49208,-152,-0.308,21,-173,41,9,H1
"Columbia County, OR",2012-2013,49208,49257,49,0.1,114,-65,41,9,H1
"Columbia County, OR",2013-2014,49257,49459,202,0.41,29,173,41,9,H1
"Columbia County, OR",2014-2015,49488,49600,112,0.226,63,49,41,9,H1
"Columbia County, OR",2015-2016,49600,50886,1286,2.593,42,1244,41,9,H1
"Columbia County, OR",2016-2017,50886,51782,896,1.761,80,816,41,9,H1
"Coos County, OR",2000-2001,62662,62190,-472,-0.753,-192,-280,41,11,H1
"Coos County, OR",2001-2002,62190,62286,96,0.154,-300,396,41,11,H1
"Coos County, OR",2002-2003,62286,62625,339,0.544,-230,569,41,11,H1
"Coos County, OR",2003-2004,62625,63208,583,0.931,-244,827,41,11,H1
"Coos County, OR",2004-2005,63208,63843,635,1.005,-264,899,41,11,H1
"Coos County, OR",2005-2006,63843,63844,1,0.002,-220,221,41,11,H1
"Coos County, OR",2006-2007,63844,63420,-424,-0.664,-220,-204,41,11,H1
"Coos County, OR",2007-2008,63420,63226,-194,-0.306,-116,-78,41,11,H1
"Coos County, OR",2008-2009,63226,63079,-147,-0.232,-201,54,41,11,H1
"Coos County, OR",2009-2010,63079,63010,-69,-0.109,-257,188,41,11,H1
"Coos County, OR",2010-2011,63010,62782,-228,-0.362,-228,0,41,11,H1
"Coos County, OR",2011-2012,62782,62690,-92,-0.147,-294,202,41,11,H1
"Coos County, OR",2012-2013,62690,62433,-257,-0.41,-198,-59,41,11,H1
"Coos County, OR",2013-2014,62433,62475,42,0.067,-237,279,41,11,H1
"Coos County, OR",2014-2015,62623,63121,498,0.795,-237,735,41,11,H1
"Coos County, OR",2015-2016,63121,63375,254,0.402,-265,519,41,11,H1
"Coos County, OR",2016-2017,63375,63888,513,0.809,-253,766,41,11,H1
"Crook County, OR",2000-2001,19262,19705,443,2.3,27,416,41,13,H1
"Crook County, OR",2001-2002,19705,19779,74,0.376,36,38,41,13,H1
"Crook County, OR",2002-2003,19779,20011,232,1.173,25,207,41,13,H1
"Crook County, OR",2003-2004,20011,20643,632,3.158,58,574,41,13,H1
"Crook County, OR",2004-2005,20643,21019,376,1.821,40,336,41,13,H1
"Crook County, OR",2005-2006,21019,21673,654,3.111,31,623,41,13,H1
"Crook County, OR",2006-2007,21673,21818,145,0.669,56,89,41,13,H1
"Crook County, OR",2007-2008,21818,21811,-7,-0.032,56,-63,41,13,H1
"Crook County, OR",2008-2009,21811,21410,-401,-1.839,27,-428,41,13,H1
"Crook County, OR",2009-2010,21410,20891,-519,-2.424,-26,-493,41,13,H1
"Crook County, OR",2010-2011,20891,20673,-218,-1.044,-86,-132,41,13,H1
"Crook County, OR",2011-2012,20673,20636,-37,-0.179,-44,7,41,13,H1
"Crook County, OR",2012-2013,20636,20790,154,0.746,-27,181,41,13,H1
"Crook County, OR",2013-2014,20790,20998,208,1,-49,257,41,13,H1
"Crook County, OR",2014-2015,21039,21630,591,2.809,-16,607,41,13,H1
"Crook County, OR",2015-2016,21630,22344,714,3.301,-13,727,41,13,H1
"Crook County, OR",2016-2017,22344,23123,779,3.486,-8,787,41,13,H1
"Curry County, OR",2000-2001,21133,21250,117,0.554,-152,269,41,15,H1
"Curry County, OR",2001-2002,21250,21653,403,1.896,-186,589,41,15,H1
"Curry County, OR",2002-2003,21653,21899,246,1.136,-197,443,41,15,H1
"Curry County, OR",2003-2004,21899,22473,574,2.621,-151,725,41,15,H1
"Curry County, OR",2004-2005,22473,22750,277,1.233,-128,405,41,15,H1
"Curry County, OR",2005-2006,22750,22626,-124,-0.545,-146,22,41,15,H1
"Curry County, OR",2006-2007,22626,22447,-179,-0.791,-168,-11,41,15,H1
"Curry County, OR",2007-2008,22447,22305,-142,-0.633,-181,39,41,15,H1
"Curry County, OR",2008-2009,22305,22341,36,0.161,-199,235,41,15,H1
"Curry County, OR",2009-2010,22341,22364,23,0.103,-191,214,41,15,H1
"Curry County, OR",2010-2011,22364,22457,93,0.416,-163,256,41,15,H1
"Curry County, OR",2011-2012,22457,22249,-208,-0.926,-159,-49,41,15,H1
"Curry County, OR",2012-2013,22249,22299,50,0.225,-161,211,41,15,H1
"Curry County, OR",2013-2014,22299,22335,36,0.161,-149,185,41,15,H1
"Curry County, OR",2014-2015,22265,22483,218,0.979,-183,401,41,15,H1
"Curry County, OR",2015-2016,22483,22588,105,0.467,-221,326,41,15,H1
"Curry County, OR",2016-2017,22588,22669,81,0.359,-181,262,41,15,H1
"Deschutes County, OR",2000-2001,116566,120526,3960,3.397,509,3451,41,17,H1
"Deschutes County, OR",2001-2002,120526,125247,4721,3.917,478,4243,41,17,H1
"Deschutes County, OR",2002-2003,125247,129094,3847,3.072,566,3281,41,17,H1
"Deschutes County, OR",2003-2004,129094,133756,4662,3.611,650,4012,41,17,H1
"Deschutes County, OR",2004-2005,133756,140567,6811,5.092,669,6142,41,17,H1
"Deschutes County, OR",2005-2006,140567,148149,7582,5.394,815,6767,41,17,H1
"Deschutes County, OR",2006-2007,148149,152633,4484,3.027,1021,3463,41,17,H1
"Deschutes County, OR",2007-2008,152633,156820,4187,2.743,853,3334,41,17,H1
"Deschutes County, OR",2008-2009,156820,157345,525,0.335,878,-353,41,17,H1
"Deschutes County, OR",2009-2010,157345,157828,483,0.307,577,-94,41,17,H1
"Deschutes County, OR",2010-2011,157828,159786,1958,1.241,490,1468,41,17,H1
"Deschutes County, OR",2011-2012,159786,161746,1960,1.227,353,1607,41,17,H1
"Deschutes County, OR",2012-2013,161746,165955,4209,2.602,347,3862,41,17,H1
"Deschutes County, OR",2013-2014,165955,170388,4433,2.671,403,4030,41,17,H1
"Deschutes County, OR",2014-2015,170398,175268,4870,2.858,479,4391,41,17,H1
"Deschutes County, OR",2015-2016,175268,180675,5407,3.085,318,5089,41,17,H1
"Deschutes County, OR",2016-2017,180675,186875,6200,3.432,391,5809,41,17,H1
"Douglas County, OR",2000-2001,100485,100562,77,0.077,-101,178,41,19,H1
"Douglas County, OR",2001-2002,100562,101529,967,0.962,-99,1066,41,19,H1
"Douglas County, OR",2002-2003,101529,102776,1247,1.228,-179,1426,41,19,H1
"Douglas County, OR",2003-2004,102776,103965,1189,1.157,-120,1309,41,19,H1
"Douglas County, OR",2004-2005,103965,105285,1320,1.27,-117,1437,41,19,H1
"Douglas County, OR",2005-2006,105285,106658,1373,1.304,-88,1461,41,19,H1
"Douglas County, OR",2006-2007,106658,107057,399,0.374,-31,430,41,19,H1
"Douglas County, OR",2007-2008,107057,107316,259,0.242,-88,347,41,19,H1
"Douglas County, OR",2008-2009,107316,107378,62,0.058,-161,223,41,19,H1
"Douglas County, OR",2009-2010,107378,107651,273,0.254,-301,574,41,19,H1
"Douglas County, OR",2010-2011,107651,107267,-384,-0.357,-327,-57,41,19,H1
"Douglas County, OR",2011-2012,107267,107082,-185,-0.172,-317,132,41,19,H1
"Douglas County, OR",2012-2013,107082,106810,-272,-0.254,-212,-60,41,19,H1
"Douglas County, OR",2013-2014,106810,106972,162,0.152,-249,411,41,19,H1
"Douglas County, OR",2014-2015,106998,107685,687,0.642,-264,951,41,19,H1
"Douglas County, OR",2015-2016,107685,108100,415,0.385,-369,784,41,19,H1
"Douglas County, OR",2016-2017,108100,109405,1305,1.207,-294,1599,41,19,H1
"Gilliam County, OR",2000-2001,1908,1901,-7,-0.367,1,-8,41,21,H1
"Gilliam County, OR",2001-2002,1901,1877,-24,-1.262,-10,-14,41,21,H1
"Gilliam County, OR",2002-2003,1877,1823,-54,-2.877,-6,-48,41,21,H1
"Gilliam County, OR",2003-2004,1823,1860,37,2.03,-7,44,41,21,H1
"Gilliam County, OR",2004-2005,1860,1863,3,0.161,-7,10,41,21,H1
"Gilliam County, OR",2005-2006,1863,1834,-29,-1.557,-6,-23,41,21,H1
"Gilliam County, OR",2006-2007,1834,1816,-18,-0.981,-5,-13,41,21,H1
"Gilliam County, OR",2007-2008,1816,1886,70,3.855,3,67,41,21,H1
"Gilliam County, OR",2008-2009,1886,1856,-30,-1.591,0,-30,41,21,H1
"Gilliam County, OR",2009-2010,1856,1870,14,0.754,1,13,41,21,H1
"Gilliam County, OR",2010-2011,1870,1947,77,4.118,-1,78,41,21,H1
"Gilliam County, OR",2011-2012,1947,1941,-6,-0.308,-5,-1,41,21,H1
"Gilliam County, OR",2012-2013,1941,1938,-3,-0.155,5,-8,41,21,H1
"Gilliam County, OR",2013-2014,1938,1932,-6,-0.31,1,-7,41,21,H1
"Gilliam County, OR",2014-2015,1924,1859,-65,-3.378,-3,-62,41,21,H1
"Gilliam County, OR",2015-2016,1859,1859,0,0,0,0,41,21,H1
"Gilliam County, OR",2016-2017,1859,1855,-4,-0.215,-7,3,41,21,H1
"Grant County, OR",2000-2001,7906,7498,-408,-5.161,-38,-370,41,23,H1
"Grant County, OR",2001-2002,7498,7438,-60,-0.8,-30,-30,41,23,H1
"Grant County, OR",2002-2003,7438,7472,34,0.457,-17,51,41,23,H1
"Grant County, OR",2003-2004,7472,7415,-57,-0.763,-19,-38,41,23,H1
"Grant County, OR",2004-2005,7415,7389,-26,-0.351,-16,-10,41,23,H1
"Grant County, OR",2005-2006,7389,7373,-16,-0.217,-40,24,41,23,H1
"Grant County, OR",2006-2007,7373,7267,-106,-1.438,-28,-78,41,23,H1
"Grant County, OR",2007-2008,7267,7303,36,0.495,-15,51,41,23,H1
"Grant County, OR",2008-2009,7303,7343,40,0.548,-17,57,41,23,H1
"Grant County, OR",2009-2010,7343,7451,108,1.471,-38,146,41,23,H1
"Grant County, OR",2010-2011,7451,7404,-47,-0.631,-15,-32,41,23,H1
"Grant County, OR",2011-2012,7404,7317,-87,-1.175,-26,-61,41,23,H1
"Grant County, OR",2012-2013,7317,7273,-44,-0.601,-9,-35,41,23,H1
"Grant County, OR",2013-2014,7273,7180,-93,-1.279,-17,-76,41,23,H1
"Grant County, OR",2014-2015,7190,7185,-5,-0.07,-11,6,41,23,H1
"Grant County, OR",2015-2016,7185,7184,-1,-0.014,-20,19,41,23,H1
"Grant County, OR",2016-2017,7184,7190,6,0.084,-22,28,41,23,H1
"Harney County, OR",2000-2001,7661,7491,-170,-2.219,19,-189,41,25,H1
"Harney County, OR",2001-2002,7491,7417,-74,-0.988,-1,-73,41,25,H1
"Harney County, OR",2002-2003,7417,7360,-57,-0.769,6,-63,41,25,H1
"Harney County, OR",2003-2004,7360,7312,-48,-0.652,7,-55,41,25,H1
"Harney County, OR",2004-2005,7312,7211,-101,-1.381,3,-104,41,25,H1
"Harney County, OR",2005-2006,7211,7286,75,1.04,5,70,41,25,H1
"Harney County, OR",2006-2007,7286,7327,41,0.563,-11,52,41,25,H1
"Harney County, OR",2007-2008,7327,7375,48,0.655,24,24,41,25,H1
"Harney County, OR",2008-2009,7375,7432,57,0.773,-6,63,41,25,H1
"Harney County, OR",2009-2010,7432,7397,-35,-0.471,-7,-28,41,25,H1
"Harney County, OR",2010-2011,7397,7362,-35,-0.473,-18,-17,41,25,H1
"Harney County, OR",2011-2012,7362,7228,-134,-1.82,12,-146,41,25,H1
"Harney County, OR",2012-2013,7228,7152,-76,-1.051,1,-77,41,25,H1
"Harney County, OR",2013-2014,7152,7126,-26,-0.364,9,-35,41,25,H1
"Harney County, OR",2014-2015,7160,7200,40,0.559,22,18,41,25,H1
"Harney County, OR",2015-2016,7200,7261,61,0.847,8,53,41,25,H1
"Harney County, OR",2016-2017,7261,7289,28,0.386,6,22,41,25,H1
"Hood River County, OR",2000-2001,20461,20397,-64,-0.313,148,-212,41,27,H1
"Hood River County, OR",2001-2002,20397,20615,218,1.069,145,73,41,27,H1
"Hood River County, OR",2002-2003,20615,20621,6,0.029,106,-100,41,27,H1
"Hood River County, OR",2003-2004,20621,20835,214,1.038,107,107,41,27,H1
"Hood River County, OR",2004-2005,20835,21022,187,0.898,137,50,41,27,H1
"Hood River County, OR",2005-2006,21022,21200,178,0.847,145,33,41,27,H1
"Hood River County, OR",2006-2007,21200,21276,76,0.358,129,-53,41,27,H1
"Hood River County, OR",2007-2008,21276,21589,313,1.471,132,181,41,27,H1
"Hood River County, OR",2008-2009,21589,22015,426,1.973,129,297,41,27,H1
"Hood River County, OR",2009-2010,22015,22442,427,1.94,166,261,41,27,H1
"Hood River County, OR",2010-2011,22442,22434,-8,-0.036,123,-131,41,27,H1
"Hood River County, OR",2011-2012,22434,22628,194,0.865,95,99,41,27,H1
"Hood River County, OR",2012-2013,22628,22711,83,0.367,123,-40,41,27,H1
"Hood River County, OR",2013-2014,22711,22885,174,0.766,137,37,41,27,H1
"Hood River County, OR",2014-2015,22854,23137,283,1.238,123,160,41,27,H1
"Hood River County, OR",2015-2016,23137,23064,-73,-0.316,120,-193,41,27,H1
"Hood River County, OR",2016-2017,23064,23377,313,1.357,118,195,41,27,H1
"Jackson County, OR",2000-2001,181775,183835,2060,1.133,176,1884,41,29,H1
"Jackson County, OR",2001-2002,183835,186704,2869,1.561,219,2650,41,29,H1
"Jackson County, OR",2002-2003,186704,189838,3134,1.679,86,3048,41,29,H1
"Jackson County, OR",2003-2004,189838,192185,2347,1.236,199,2148,41,29,H1
"Jackson County, OR",2004-2005,192185,194701,2516,1.309,333,2183,41,29,H1
"Jackson County, OR",2005-2006,194701,196858,2157,1.108,171,1986,41,29,H1
"Jackson County, OR",2006-2007,196858,199152,2294,1.165,294,2.00E+03,41,29,H1
"Jackson County, OR",2007-2008,199152,201162,2010,1.009,510,1500,41,29,H1
"Jackson County, OR",2008-2009,201162,202301,1139,0.566,372,767,41,29,H1
"Jackson County, OR",2009-2010,202301,203421,1120,0.554,101,1019,41,29,H1
"Jackson County, OR",2010-2011,203421,204754,1333,0.655,223,1110,41,29,H1
"Jackson County, OR",2011-2012,204754,206363,1609,0.786,44,1565,41,29,H1
"Jackson County, OR",2012-2013,206363,208091,1728,0.837,123,1605,41,29,H1
"Jackson County, OR",2013-2014,208091,210287,2196,1.055,144,2052,41,29,H1
"Jackson County, OR",2014-2015,210151,212567,2416,1.15,180,2236,41,29,H1
"Jackson County, OR",2015-2016,212567,214706,2139,1.006,15,2124,41,29,H1
"Jackson County, OR",2016-2017,214706,217479,2773,1.292,82,2691,41,29,H1
"Jefferson County, OR",2000-2001,19113,19653,540,2.825,140,400,41,31,H1
"Jefferson County, OR",2001-2002,19653,19941,288,1.465,127,161,41,31,H1
"Jefferson County, OR",2002-2003,19941,20212,271,1.359,131,140,41,31,H1
"Jefferson County, OR",2003-2004,20212,20339,127,0.628,151,-24,41,31,H1
"Jefferson County, OR",2004-2005,20339,20622,283,1.391,128,155,41,31,H1
"Jefferson County, OR",2005-2006,20622,21113,491,2.381,182,309,41,31,H1
"Jefferson County, OR",2006-2007,21113,21861,748,3.543,186,562,41,31,H1
"Jefferson County, OR",2007-2008,21861,21885,24,0.11,144,-120,41,31,H1
"Jefferson County, OR",2008-2009,21885,21730,-155,-0.708,180,-335,41,31,H1
"Jefferson County, OR",2009-2010,21730,21685,-45,-0.207,137,-182,41,31,H1
"Jefferson County, OR",2010-2011,21685,21688,3,0.014,112,-109,41,31,H1
"Jefferson County, OR",2011-2012,21688,21759,71,0.327,104,-33,41,31,H1
"Jefferson County, OR",2012-2013,21759,21827,68,0.313,104,-36,41,31,H1
"Jefferson County, OR",2013-2014,21827,22192,365,1.672,77,288,41,31,H1
"Jefferson County, OR",2014-2015,22283,22666,383,1.719,80,303,41,31,H1
"Jefferson County, OR",2015-2016,22666,23119,453,1.999,82,371,41,31,H1
"Jefferson County, OR",2016-2017,23119,23758,639,2.764,70,569,41,31,H1
"Josephine County, OR",2000-2001,75851,76452,601,0.792,-184,785,41,33,H1
"Josephine County, OR",2001-2002,76452,77712,1260,1.648,-298,1558,41,33,H1
"Josephine County, OR",2002-2003,77712,78779,1067,1.373,-306,1373,41,33,H1
"Josephine County, OR",2003-2004,78779,79729,950,1.206,-254,1204,41,33,H1
"Josephine County, OR",2004-2005,79729,80660,931,1.168,-202,1133,41,33,H1
"Josephine County, OR",2005-2006,80660,81601,941,1.167,-258,1199,41,33,H1
"Josephine County, OR",2006-2007,81601,81746,145,0.178,-234,379,41,33,H1
"Josephine County, OR",2007-2008,81746,82389,643,0.787,-185,828,41,33,H1
"Josephine County, OR",2008-2009,82389,82315,-74,-0.09,-190,116,41,33,H1
"Josephine County, OR",2009-2010,82315,82835,520,0.632,-330,850,41,33,H1
"Josephine County, OR",2010-2011,82835,82618,-217,-0.262,-433,216,41,33,H1
"Josephine County, OR",2011-2012,82618,82782,164,0.199,-377,541,41,33,H1
"Josephine County, OR",2012-2013,82782,83271,489,0.591,-319,808,41,33,H1
"Josephine County, OR",2013-2014,83271,83599,328,0.394,-293,621,41,33,H1
"Josephine County, OR",2014-2015,83606,84745,1139,1.362,-236,1375,41,33,H1
"Josephine County, OR",2015-2016,84745,85338,593,0.7,-346,939,41,33,H1
"Josephine County, OR",2016-2017,85338,86352,1014,1.188,-304,1318,41,33,H1
"Klamath County, OR",2000-2001,63885,64139,254,0.398,171,83,41,35,H1
"Klamath County, OR",2001-2002,64139,64150,11,0.017,102,-91,41,35,H1
"Klamath County, OR",2002-2003,64150,64582,432,0.673,92,340,41,35,H1
"Klamath County, OR",2003-2004,64582,64841,259,0.401,97,162,41,35,H1
"Klamath County, OR",2004-2005,64841,65553,712,1.098,75,637,41,35,H1
"Klamath County, OR",2005-2006,65553,66294,741,1.13,94,647,41,35,H1
"Klamath County, OR",2006-2007,66294,66767,473,0.713,119,354,41,35,H1
"Klamath County, OR",2007-2008,66767,66732,-35,-0.052,180,-215,41,35,H1
"Klamath County, OR",2008-2009,66732,66460,-272,-0.408,151,-423,41,35,H1
"Klamath County, OR",2009-2010,66460,66286,-174,-0.262,104,-278,41,35,H1
"Klamath County, OR",2010-2011,66286,66292,6,0.009,114,-108,41,35,H1
"Klamath County, OR",2011-2012,66292,66042,-250,-0.377,32,-282,41,35,H1
"Klamath County, OR",2012-2013,66042,65848,-194,-0.294,98,-292,41,35,H1
"Klamath County, OR",2013-2014,65848,65455,-393,-0.597,47,-440,41,35,H1
"Klamath County, OR",2014-2015,65520,66016,496,0.757,27,469,41,35,H1
"Klamath County, OR",2015-2016,66016,66283,267,0.404,56,211,41,35,H1
"Klamath County, OR",2016-2017,66283,66935,652,0.984,42,610,41,35,H1
"Lake County, OR",2000-2001,7428,7538,110,1.481,-13,123,41,37,H1
"Lake County, OR",2001-2002,7538,7522,-16,-0.212,-8,-8,41,37,H1
"Lake County, OR",2002-2003,7522,7578,56,0.744,-10,66,41,37,H1
"Lake County, OR",2003-2004,7578,7576,-2,-0.026,-19,17,41,37,H1
"Lake County, OR",2004-2005,7576,7558,-18,-0.238,-23,5,41,37,H1
"Lake County, OR",2005-2006,7558,7796,238,3.149,-25,263,41,37,H1
"Lake County, OR",2006-2007,7796,7880,84,1.077,-20,104,41,37,H1
"Lake County, OR",2007-2008,7880,7961,81,1.028,-17,98,41,37,H1
"Lake County, OR",2008-2009,7961,7901,-60,-0.754,-10,-50,41,37,H1
"Lake County, OR",2009-2010,7901,7883,-18,-0.228,-30,12,41,37,H1
"Lake County, OR",2010-2011,7883,7921,38,0.482,-17,55,41,37,H1
"Lake County, OR",2011-2012,7921,7790,-131,-1.654,-7,-124,41,37,H1
"Lake County, OR",2012-2013,7790,7837,47,0.603,-1,48,41,37,H1
"Lake County, OR",2013-2014,7837,7838,1,0.013,-9,10,41,37,H1
"Lake County, OR",2014-2015,7843,7829,-14,-0.179,2,-16,41,37,H1
"Lake County, OR",2015-2016,7829,7820,-9,-0.115,-12,3,41,37,H1
"Lake County, OR",2016-2017,7820,7863,43,0.55,-17,60,41,37,H1
"Lane County, OR",2000-2001,323492,324855,1363,0.421,825,538,41,39,H1
"Lane County, OR",2001-2002,324855,327506,2651,0.816,579,2072,41,39,H1
"Lane County, OR",2002-2003,327506,330845,3339,1.02,761,2578,41,39,H1
"Lane County, OR",2003-2004,330845,332327,1482,0.448,643,839,41,39,H1
"Lane County, OR",2004-2005,332327,335831,3504,1.054,483,3021,41,39,H1
"Lane County, OR",2005-2006,335831,339926,4095,1.219,581,3514,41,39,H1
"Lane County, OR",2006-2007,339926,344844,4918,1.447,704,4214,41,39,H1
"Lane County, OR",2007-2008,344844,348176,3332,0.966,771,2561,41,39,H1
"Lane County, OR",2008-2009,348176,350850,2674,0.768,830,1844,41,39,H1
"Lane County, OR",2009-2010,350850,351852,1002,0.286,760,242,41,39,H1
"Lane County, OR",2010-2011,351852,353491,1639,0.466,342,1297,41,39,H1
"Lane County, OR",2011-2012,353491,354481,990,0.28,70,920,41,39,H1
"Lane County, OR",2012-2013,354481,355661,1180,0.333,215,965,41,39,H1
"Lane County, OR",2013-2014,355661,358337,2676,0.752,184,2492,41,39,H1
"Lane County, OR",2014-2015,358506,362895,4389,1.224,292,4097,41,39,H1
"Lane County, OR",2015-2016,362895,368283,5388,1.485,1,5387,41,39,H1
"Lane County, OR",2016-2017,368283,374748,6465,1.755,204,6261,41,39,H1
"Lincoln County, OR",2000-2001,44317,43854,-463,-1.045,-142,-321,41,41,H1
"Lincoln County, OR",2001-2002,43854,44270,416,0.949,-159,575,41,41,H1
"Lincoln County, OR",2002-2003,44270,44421,151,0.341,-110,261,41,41,H1
"Lincoln County, OR",2003-2004,44421,44877,456,1.027,-68,524,41,41,H1
"Lincoln County, OR",2004-2005,44877,45347,470,1.047,-109,579,41,41,H1
"Lincoln County, OR",2005-2006,45347,45529,182,0.401,-79,261,41,41,H1
"Lincoln County, OR",2006-2007,45529,45798,269,0.591,-68,337,41,41,H1
"Lincoln County, OR",2007-2008,45798,45915,117,0.255,-26,143,41,41,H1
"Lincoln County, OR",2008-2009,45915,45989,74,0.161,-76,150,41,41,H1
"Lincoln County, OR",2009-2010,45989,45990,1,0.002,-107,108,41,41,H1
"Lincoln County, OR",2010-2011,45990,45844,-146,-0.317,-156,10,41,41,H1
"Lincoln County, OR",2011-2012,45844,46152,308,0.672,-151,459,41,41,H1
"Lincoln County, OR",2012-2013,46152,46300,148,0.321,-68,216,41,41,H1
"Lincoln County, OR",2013-2014,46300,46406,106,0.229,-95,201,41,41,H1
"Lincoln County, OR",2014-2015,46386,47038,652,1.406,-110,762,41,41,H1
"Lincoln County, OR",2015-2016,47038,47897,859,1.826,-150,1009,41,41,H1
"Lincoln County, OR",2016-2017,47897,48920,1023,2.136,-147,1170,41,41,H1
"Linn County, OR",2000-2001,103020,103544,524,0.509,345,179,41,43,H1
"Linn County, OR",2001-2002,103544,104561,1017,0.982,368,649,41,43,H1
"Linn County, OR",2002-2003,104561,106035,1474,1.41,388,1086,41,43,H1
"Linn County, OR",2003-2004,106035,106799,764,0.721,339,425,41,43,H1
"Linn County, OR",2004-2005,106799,108132,1333,1.248,273,1060,41,43,H1
"Linn County, OR",2005-2006,108132,110764,2632,2.434,375,2257,41,43,H1
"Linn County, OR",2006-2007,110764,112932,2168,1.957,432,1736,41,43,H1
"Linn County, OR",2007-2008,112932,114967,2035,1.802,357,1678,41,43,H1
"Linn County, OR",2008-2009,114967,116001,1034,0.899,421,613,41,43,H1
"Linn County, OR",2009-2010,116001,116871,870,0.75,301,569,41,43,H1
"Linn County, OR",2010-2011,116871,118117,1246,1.066,323,923,41,43,H1
"Linn County, OR",2011-2012,118117,118360,243,0.206,320,-77,41,43,H1
"Linn County, OR",2012-2013,118360,118644,284,0.24,304,-20,41,43,H1
"Linn County, OR",2013-2014,118644,119356,712,0.6,226,486,41,43,H1
"Linn County, OR",2014-2015,119269,120547,1278,1.072,193,1085,41,43,H1
"Linn County, OR",2015-2016,120547,122700,2153,1.786,225,1928,41,43,H1
"Linn County, OR",2016-2017,122700,125047,2347,1.913,254,2093,41,43,H1
"Malheur County, OR",2000-2001,31540,31532,-8,-0.025,251,-259,41,45,H1
"Malheur County, OR",2001-2002,31532,31455,-77,-0.244,222,-299,41,45,H1
"Malheur County, OR",2002-2003,31455,31335,-120,-0.381,185,-305,41,45,H1
"Malheur County, OR",2003-2004,31335,31250,-85,-0.271,157,-242,41,45,H1
"Malheur County, OR",2004-2005,31250,31273,23,0.074,185,-162,41,45,H1
"Malheur County, OR",2005-2006,31273,31303,30,0.096,211,-181,41,45,H1
"Malheur County, OR",2006-2007,31303,31434,131,0.418,194,-63,41,45,H1
"Malheur County, OR",2007-2008,31434,31311,-123,-0.391,199,-322,41,45,H1
"Malheur County, OR",2008-2009,31311,31265,-46,-0.147,210,-256,41,45,H1
"Malheur County, OR",2009-2010,31265,31332,67,0.214,154,-87,41,45,H1
"Malheur County, OR",2010-2011,31332,30780,-552,-1.762,121,-673,41,45,H1
"Malheur County, OR",2011-2012,30780,30606,-174,-0.565,107,-281,41,45,H1
"Malheur County, OR",2012-2013,30606,30624,18,0.059,181,-163,41,45,H1
"Malheur County, OR",2013-2014,30624,30359,-265,-0.865,154,-419,41,45,H1
"Malheur County, OR",2014-2015,30349,30380,31,0.102,178,-147,41,45,H1
"Malheur County, OR",2015-2016,30380,30393,13,0.043,171,-158,41,45,H1
"Malheur County, OR",2016-2017,30393,30480,87,0.286,186,-99,41,45,H1
"Marion County, OR",2000-2001,285411,288136,2725,0.955,2051,674,41,47,H1
"Marion County, OR",2001-2002,288136,292533,4397,1.526,2019,2378,41,47,H1
"Marion County, OR",2002-2003,292533,295317,2784,0.952,2023,761,41,47,H1
"Marion County, OR",2003-2004,295317,297139,1822,0.617,2069,-247,41,47,H1
"Marion County, OR",2004-2005,297139,299461,2322,0.781,2293,29,41,47,H1
"Marion County, OR",2005-2006,299461,303290,3829,1.279,2399,1430,41,47,H1
"Marion County, OR",2006-2007,303290,306964,3674,1.211,2595,1079,41,47,H1
"Marion County, OR",2007-2008,306964,309729,2765,0.901,2525,240,41,47,H1
"Marion County, OR",2008-2009,309729,313389,3660,1.182,2362,1298,41,47,H1
"Marion County, OR",2009-2010,313389,315910,2521,0.804,2247,274,41,47,H1
"Marion County, OR",2010-2011,315910,317908,1998,0.632,1916,82,41,47,H1
"Marion County, OR",2011-2012,317908,320085,2177,0.685,1755,422,41,47,H1
"Marion County, OR",2012-2013,320085,322228,2143,0.67,1690,453,41,47,H1
"Marion County, OR",2013-2014,322228,326110,3882,1.205,1652,2230,41,47,H1
"Marion County, OR",2014-2015,325838,330700,4862,1.492,1761,3101,41,47,H1
"Marion County, OR",2015-2016,330700,335766,5066,1.532,1734,3332,41,47,H1
"Marion County, OR",2016-2017,335766,341286,5520,1.644,1743,3777,41,47,H1
"Morrow County, OR",2000-2001,10995,11043,48,0.437,65,-17,41,49,H1
"Morrow County, OR",2001-2002,11043,11313,270,2.445,99,171,41,49,H1
"Morrow County, OR",2002-2003,11313,11317,4,0.035,87,-83,41,49,H1
"Morrow County, OR",2003-2004,11317,11275,-42,-0.371,101,-143,41,49,H1
"Morrow County, OR",2004-2005,11275,11162,-113,-1.002,91,-204,41,49,H1
"Morrow County, OR",2005-2006,11162,11203,41,0.367,91,-50,41,49,H1
"Morrow County, OR",2006-2007,11203,11048,-155,-1.384,107,-262,41,49,H1
"Morrow County, OR",2007-2008,11048,11002,-46,-0.416,68,-114,41,49,H1
"Morrow County, OR",2008-2009,11002,11102,100,0.909,87,13,41,49,H1
"Morrow County, OR",2009-2010,11102,11200,98,0.883,82,16,41,49,H1
"Morrow County, OR",2010-2011,11200,11192,-8,-0.071,111,-119,41,49,H1
"Morrow County, OR",2011-2012,11192,11240,48,0.429,79,-31,41,49,H1
"Morrow County, OR",2012-2013,11240,11266,26,0.231,65,-39,41,49,H1
"Morrow County, OR",2013-2014,11266,11187,-79,-0.701,68,-147,41,49,H1
"Morrow County, OR",2014-2015,11156,11190,34,0.305,69,-35,41,49,H1
"Morrow County, OR",2015-2016,11190,11219,29,0.259,103,-74,41,49,H1
"Morrow County, OR",2016-2017,11219,11166,-53,-0.472,95,-148,41,49,H1
"Multnomah County, OR",2000-2001,661654,669690,8036,1.215,3618,4418,41,51,H1
"Multnomah County, OR",2001-2002,669690,676653,6963,1.04,3272,3691,41,51,H1
"Multnomah County, OR",2002-2003,676653,679348,2695,0.398,3713,-1018,41,51,H1
"Multnomah County, OR",2003-2004,679348,672526,-6822,-1.004,3610,-10432,41,51,H1
"Multnomah County, OR",2004-2005,672526,674862,2336,0.347,3856,-1520,41,51,H1
"Multnomah County, OR",2005-2006,674862,683767,8905,1.32,4523,4382,41,51,H1
"Multnomah County, OR",2006-2007,683767,697799,14032,2.052,4810,9222,41,51,H1
"Multnomah County, OR",2007-2008,697799,712989,15190,2.177,4854,10336,41,51,H1
"Multnomah County, OR",2008-2009,712989,727721,14732,2.066,4571,10161,41,51,H1
"Multnomah County, OR",2009-2010,727721,737268,9547,1.312,5219,4328,41,51,H1
"Multnomah County, OR",2010-2011,737268,747977,10709,1.453,4123,6586,41,51,H1
"Multnomah County, OR",2011-2012,747977,758817,10840,1.449,4023,6817,41,51,H1
"Multnomah County, OR",2012-2013,758817,766082,7265,0.957,3719,3546,41,51,H1
"Multnomah County, OR",2013-2014,766082,776712,10630,1.388,3665,6965,41,51,H1
"Multnomah County, OR",2014-2015,777880,790294,12414,1.596,3945,8469,41,51,H1
"Multnomah County, OR",2015-2016,790294,801539,11245,1.423,3358,7887,41,51,H1
"Multnomah County, OR",2016-2017,801539,807555,6016,0.751,3493,2523,41,51,H1
"Polk County, OR",2000-2001,62596,63445,849,1.356,245,604,41,53,H1
"Polk County, OR",2001-2002,63445,64135,690,1.088,175,515,41,53,H1
"Polk County, OR",2002-2003,64135,65060,925,1.442,217,708,41,53,H1
"Polk County, OR",2003-2004,65060,66569,1509,2.319,262,1247,41,53,H1
"Polk County, OR",2004-2005,66569,68585,2016,3.028,226,1790,41,53,H1
"Polk County, OR",2005-2006,68585,71027,2442,3.561,361,2081,41,53,H1
"Polk County, OR",2006-2007,71027,72791,1764,2.484,226,1538,41,53,H1
"Polk County, OR",2007-2008,72791,74346,1555,2.136,293,1262,41,53,H1
"Polk County, OR",2008-2009,74346,74934,588,0.791,339,249,41,53,H1
"Polk County, OR",2009-2010,74934,75577,643,0.858,225,418,41,53,H1
"Polk County, OR",2010-2011,75577,75955,378,0.5,270,108,41,53,H1
"Polk County, OR",2011-2012,75955,76254,299,0.394,273,26,41,53,H1
"Polk County, OR",2012-2013,76254,76618,364,0.477,183,181,41,53,H1
"Polk County, OR",2013-2014,76618,77916,1298,1.694,217,1081,41,53,H1
"Polk County, OR",2014-2015,77983,79391,1408,1.806,205,1203,41,53,H1
"Polk County, OR",2015-2016,79391,81442,2051,2.583,252,1799,41,53,H1
"Polk County, OR",2016-2017,81442,83696,2254,2.768,261,1993,41,53,H1
"Sherman County, OR",2000-2001,1921,1848,-73,-3.8,-3,-70,41,55,H1
"Sherman County, OR",2001-2002,1848,1763,-85,-4.6,-8,-77,41,55,H1
"Sherman County, OR",2002-2003,1763,1758,-5,-0.284,5,-10,41,55,H1
"Sherman County, OR",2003-2004,1758,1682,-76,-4.323,-2,-74,41,55,H1
"Sherman County, OR",2004-2005,1682,1678,-4,-0.238,-6,2,41,55,H1
"Sherman County, OR",2005-2006,1678,1682,4,0.238,-5,9,41,55,H1
"Sherman County, OR",2006-2007,1682,1713,31,1.843,2,29,41,55,H1
"Sherman County, OR",2007-2008,1713,1691,-22,-1.284,3,-25,41,55,H1
"Sherman County, OR",2008-2009,1691,1733,42,2.484,0,42,41,55,H1
"Sherman County, OR",2009-2010,1733,1772,39,2.25,18,21,41,55,H1
"Sherman County, OR",2010-2011,1772,1735,-37,-2.088,7,-44,41,55,H1
"Sherman County, OR",2011-2012,1735,1735,0,0,-1,1,41,55,H1
"Sherman County, OR",2012-2013,1735,1718,-17,-0.98,6,-23,41,55,H1
"Sherman County, OR",2013-2014,1718,1710,-8,-0.466,2,-10,41,55,H1
"Sherman County, OR",2014-2015,1702,1680,-22,-1.293,2,-24,41,55,H1
"Sherman County, OR",2015-2016,1680,1717,37,2.202,2,35,41,55,H1
"Sherman County, OR",2016-2017,1717,1758,41,2.388,5,36,41,55,H1
"Tillamook County, OR",2000-2001,24253,24359,106,0.437,-30,136,41,57,H1
"Tillamook County, OR",2001-2002,24359,24396,37,0.152,-62,99,41,57,H1
"Tillamook County, OR",2002-2003,24396,24565,169,0.693,-36,205,41,57,H1
"Tillamook County, OR",2003-2004,24565,24780,215,0.875,-24,239,41,57,H1
"Tillamook County, OR",2004-2005,24780,24974,194,0.783,-19,213,41,57,H1
"Tillamook County, OR",2005-2006,24974,25160,186,0.745,-16,202,41,57,H1
"Tillamook County, OR",2006-2007,25160,25243,83,0.33,20,63,41,57,H1
"Tillamook County, OR",2007-2008,25243,25151,-92,-0.364,-25,-67,41,57,H1
"Tillamook County, OR",2008-2009,25151,25179,28,0.111,-13,41,41,57,H1
"Tillamook County, OR",2009-2010,25179,25251,72,0.286,-57,129,41,57,H1
"Tillamook County, OR",2010-2011,25251,25416,165,0.653,-31,196,41,57,H1
"Tillamook County, OR",2011-2012,25416,25326,-90,-0.354,-28,-62,41,57,H1
"Tillamook County, OR",2012-2013,25326,25333,7,0.028,-22,29,41,57,H1
"Tillamook County, OR",2013-2014,25333,25342,9,0.036,-22,31,41,57,H1
"Tillamook County, OR",2014-2015,25378,25653,275,1.084,-34,309,41,57,H1
"Tillamook County, OR",2015-2016,25653,26209,556,2.167,-43,599,41,57,H1
"Tillamook County, OR",2016-2017,26209,26690,481,1.835,-44,525,41,57,H1
"Umatilla County, OR",2000-2001,70728,70682,-46,-0.065,514,-560,41,59,H1
"Umatilla County, OR",2001-2002,70682,72150,1468,2.077,411,1057,41,59,H1
"Umatilla County, OR",2002-2003,72150,72820,670,0.929,463,207,41,59,H1
"Umatilla County, OR",2003-2004,72820,73463,643,0.883,474,169,41,59,H1
"Umatilla County, OR",2004-2005,73463,73765,302,0.411,459,-157,41,59,H1
"Umatilla County, OR",2005-2006,73765,73984,219,0.297,598,-379,41,59,H1
"Umatilla County, OR",2006-2007,73984,74269,285,0.385,651,-366,41,59,H1
"Umatilla County, OR",2007-2008,74269,74488,219,0.295,356,-137,41,59,H1
"Umatilla County, OR",2008-2009,74488,75199,711,0.955,370,341,41,59,H1
"Umatilla County, OR",2009-2010,75199,76045,846,1.125,475,371,41,59,H1
"Umatilla County, OR",2010-2011,76045,76689,644,0.847,417,227,41,59,H1
"Umatilla County, OR",2011-2012,76689,76920,231,0.301,495,-264,41,59,H1
"Umatilla County, OR",2012-2013,76920,76868,-52,-0.068,523,-575,41,59,H1
"Umatilla County, OR",2013-2014,76868,76705,-163,-0.212,483,-646,41,59,H1
"Umatilla County, OR",2014-2015,76648,76531,-117,-0.153,482,-599,41,59,H1
"Umatilla County, OR",2015-2016,76531,76649,118,0.154,351,-233,41,59,H1
"Umatilla County, OR",2016-2017,76649,76985,336,0.438,336,0,41,59,H1
"Union County, OR",2000-2001,24537,24353,-184,-0.75,32,-216,41,61,H1
"Union County, OR",2001-2002,24353,24472,119,0.489,58,61,41,61,H1
"Union County, OR",2002-2003,24472,24607,135,0.552,70,65,41,61,H1
"Union County, OR",2003-2004,24607,24513,-94,-0.382,50,-144,41,61,H1
"Union County, OR",2004-2005,24513,24675,162,0.661,66,96,41,61,H1
"Union County, OR",2005-2006,24675,24754,79,0.32,101,-22,41,61,H1
"Union County, OR",2006-2007,24754,25263,509,2.056,125,384,41,61,H1
"Union County, OR",2007-2008,25263,25473,210,0.831,74,136,41,61,H1
"Union County, OR",2008-2009,25473,25580,107,0.42,104,3,41,61,H1
"Union County, OR",2009-2010,25580,25746,166,0.649,102,64,41,61,H1
"Union County, OR",2010-2011,25746,25888,142,0.552,43,99,41,61,H1
"Union County, OR",2011-2012,25888,25818,-70,-0.27,61,-131,41,61,H1
"Union County, OR",2012-2013,25818,25539,-279,-1.081,52,-331,41,61,H1
"Union County, OR",2013-2014,25539,25691,152,0.595,40,112,41,61,H1
"Union County, OR",2014-2015,25688,25790,102,0.397,44,58,41,61,H1
"Union County, OR",2015-2016,25790,26043,253,0.981,47,206,41,61,H1
"Union County, OR",2016-2017,26043,26222,179,0.687,40,139,41,61,H1
"Wallowa County, OR",2000-2001,7220,7112,-108,-1.496,-15,-93,41,63,H1
"Wallowa County, OR",2001-2002,7112,7042,-70,-0.984,-10,-60,41,63,H1
"Wallowa County, OR",2002-2003,7042,7008,-34,-0.483,-16,-18,41,63,H1
"Wallowa County, OR",2003-2004,7008,6899,-109,-1.555,-14,-95,41,63,H1
"Wallowa County, OR",2004-2005,6899,6877,-22,-0.319,-5,-17,41,63,H1
"Wallowa County, OR",2005-2006,6877,6835,-42,-0.611,-14,-28,41,63,H1
"Wallowa County, OR",2006-2007,6835,6884,49,0.717,2,47,41,63,H1
"Wallowa County, OR",2007-2008,6884,6900,16,0.232,-12,28,41,63,H1
"Wallowa County, OR",2008-2009,6900,6948,48,0.696,-10,58,41,63,H1
"Wallowa County, OR",2009-2010,6948,7026,78,1.123,-11,89,41,63,H1
"Wallowa County, OR",2010-2011,7026,7.00E+03,-26,-0.37,-24,-2,41,63,H1
"Wallowa County, OR",2011-2012,7.00E+03,6814,-186,-2.657,-40,-146,41,63,H1
"Wallowa County, OR",2012-2013,6814,6805,-9,-0.132,-12,3,41,63,H1
"Wallowa County, OR",2013-2014,6805,6820,15,0.22,-4,19,41,63,H1
"Wallowa County, OR",2014-2015,6817,6856,39,0.572,-8,47,41,63,H1
"Wallowa County, OR",2015-2016,6856,6916,60,0.875,-13,73,41,63,H1
"Wallowa County, OR",2016-2017,6916,7051,135,1.952,-3,138,41,63,H1
"Wasco County, OR",2000-2001,23837,23808,-29,-0.122,4,-33,41,65,H1
"Wasco County, OR",2001-2002,23808,23699,-109,-0.458,-28,-81,41,65,H1
"Wasco County, OR",2002-2003,23699,23885,186,0.785,6,180,41,65,H1
"Wasco County, OR",2003-2004,23885,23817,-68,-0.285,-6,-62,41,65,H1
"Wasco County, OR",2004-2005,23817,23929,112,0.47,1,111,41,65,H1
"Wasco County, OR",2005-2006,23929,24159,230,0.961,31,199,41,65,H1
"Wasco County, OR",2006-2007,24159,24451,292,1.209,-11,303,41,65,H1
"Wasco County, OR",2007-2008,24451,24617,166,0.679,-1,167,41,65,H1
"Wasco County, OR",2008-2009,24617,24981,364,1.479,13,351,41,65,H1
"Wasco County, OR",2009-2010,24981,25259,278,1.113,9,269,41,65,H1
"Wasco County, OR",2010-2011,25259,25231,-28,-0.111,-42,14,41,65,H1
"Wasco County, OR",2011-2012,25231,25457,226,0.896,-1,227,41,65,H1
"Wasco County, OR",2012-2013,25457,25475,18,0.071,8,10,41,65,H1
"Wasco County, OR",2013-2014,25475,25515,40,0.157,28,12,41,65,H1
"Wasco County, OR",2014-2015,25507,25775,268,1.051,22,246,41,65,H1
"Wasco County, OR",2015-2016,25775,25871,96,0.372,30,66,41,65,H1
"Wasco County, OR",2016-2017,25871,26437,566,2.188,36,530,41,65,H1
"Washington County, OR",2000-2001,447980,460622,12642,2.822,4941,7701,41,67,H1
"Washington County, OR",2001-2002,460622,468549,7927,1.721,4737,3190,41,67,H1
"Washington County, OR",2002-2003,468549,474336,5787,1.235,4999,788,41,67,H1
"Washington County, OR",2003-2004,474336,480207,5871,1.238,4784,1087,41,67,H1
"Washington County, OR",2004-2005,480207,490773,10566,2.2,4774,5792,41,67,H1
"Washington County, OR",2005-2006,490773,502226,11453,2.334,4820,6633,41,67,H1
"Washington County, OR",2006-2007,502226,508842,6616,1.317,5181,1435,41,67,H1
"Washington County, OR",2007-2008,508842,515815,6973,1.37,5002,1971,41,67,H1
"Washington County, OR",2008-2009,515815,524699,8884,1.722,4883,4001,41,67,H1
"Washington County, OR",2009-2010,524699,531345,6646,1.267,5059,1587,41,67,H1
"Washington County, OR",2010-2011,531345,539627,8282,1.559,4270,4012,41,67,H1
"Washington County, OR",2011-2012,539627,547737,8110,1.503,4176,3934,41,67,H1
"Washington County, OR",2012-2013,547737,555547,7810,1.426,4100,3710,41,67,H1
"Washington County, OR",2013-2014,555547,562998,7451,1.341,4106,3345,41,67,H1
"Washington County, OR",2014-2015,563273,574326,11053,1.962,3996,7057,41,67,H1
"Washington County, OR",2015-2016,574326,582739,8413,1.465,3671,4742,41,67,H1
"Washington County, OR",2016-2017,582739,588957,6218,1.067,3618,2600,41,67,H1
"Wheeler County, OR",2000-2001,1546,1503,-43,-2.781,-5,-38,41,69,H1
"Wheeler County, OR",2001-2002,1503,1534,31,2.063,-5,36,41,69,H1
"Wheeler County, OR",2002-2003,1534,1516,-18,-1.173,-12,-6,41,69,H1
"Wheeler County, OR",2003-2004,1516,1473,-43,-2.836,-9,-34,41,69,H1
"Wheeler County, OR",2004-2005,1473,1414,-59,-4.005,-20,-39,41,69,H1
"Wheeler County, OR",2005-2006,1414,1425,11,0.778,-10,21,41,69,H1
"Wheeler County, OR",2006-2007,1425,1419,-6,-0.421,-19,13,41,69,H1
"Wheeler County, OR",2007-2008,1419,1399,-20,-1.409,-7,-13,41,69,H1
"Wheeler County, OR",2008-2009,1399,1411,12,0.858,-2,14,41,69,H1
"Wheeler County, OR",2009-2010,1411,1449,38,2.693,3,35,41,69,H1
"Wheeler County, OR",2010-2011,1449,1420,-29,-2.001,-11,-18,41,69,H1
"Wheeler County, OR",2011-2012,1420,1426,6,0.423,-19,25,41,69,H1
"Wheeler County, OR",2012-2013,1426,1397,-29,-2.034,0,-29,41,69,H1
"Wheeler County, OR",2013-2014,1397,1375,-22,-1.575,-1,-21,41,69,H1
"Wheeler County, OR",2014-2015,1372,1358,-14,-1.02,-3,-11,41,69,H1
"Wheeler County, OR",2015-2016,1358,1326,-32,-2.356,3,-35,41,69,H1
"Wheeler County, OR",2016-2017,1326,1357,31,2.338,-4,35,41,69,H1
"Yamhill County, OR",2000-2001,85198,86156,958,1.124,501,457,41,71,H1
"Yamhill County, OR",2001-2002,86156,87370,1214,1.409,482,732,41,71,H1
"Yamhill County, OR",2002-2003,87370,88619,1249,1.43,530,719,41,71,H1
"Yamhill County, OR",2003-2004,88619,89447,828,0.934,380,448,41,71,H1
"Yamhill County, OR",2004-2005,89447,90847,1400,1.565,369,1031,41,71,H1
"Yamhill County, OR",2005-2006,90847,93198,2351,2.588,406,1945,41,71,H1
"Yamhill County, OR",2006-2007,93198,95875,2677,2.872,556,2121,41,71,H1
"Yamhill County, OR",2007-2008,95875,97537,1662,1.734,595,1067,41,71,H1
"Yamhill County, OR",2008-2009,97537,98647,1110,1.138,559,551,41,71,H1
"Yamhill County, OR",2009-2010,98647,99312,665,0.674,359,306,41,71,H1
"Yamhill County, OR",2010-2011,99312,99751,439,0.442,311,128,41,71,H1
"Yamhill County, OR",2011-2012,99751,100771,1020,1.023,289,731,41,71,H1
"Yamhill County, OR",2012-2013,100771,100837,66,0.065,312,-246,41,71,H1
"Yamhill County, OR",2013-2014,100837,101758,921,0.913,303,618,41,71,H1
"Yamhill County, OR",2014-2015,101683,102659,976,0.96,265,711,41,71,H1
"Yamhill County, OR",2015-2016,102659,104117,1458,1.42,240,1218,41,71,H1
"Yamhill County, OR",2016-2017,104117,105722,1605,1.542,294,1311,41,71,H1
Pennsylvania,2000-2001,12284173,12298970,14797,0.12,14326,471,42,0,STATE
Pennsylvania,2001-2002,12298970,12331031,32061,0.261,12417,19644,42,0,STATE
Pennsylvania,2002-2003,12331031,12374658,43627,0.354,15063,28564,42,0,STATE
Pennsylvania,2003-2004,12374658,12410722,36064,0.291,15703,20361,42,0,STATE
Pennsylvania,2004-2005,12410722,12449990,39268,0.316,15125,24143,42,0,STATE
Pennsylvania,2005-2006,12449990,12510809,60819,0.489,21442,39377,42,0,STATE
Pennsylvania,2006-2007,12510809,12563937,53128,0.425,24245,28883,42,0,STATE
Pennsylvania,2007-2008,12563937,12612285,48348,0.385,22814,25534,42,0,STATE
Pennsylvania,2008-2009,12612285,12666858,54573,0.433,19712,34861,42,0,STATE
Pennsylvania,2009-2010,12666858,12712014,45156,0.356,15929,29227,42,0,STATE
Pennsylvania,2010-2011,12712014,12745202,33188,0.261,15192,17996,42,0,STATE
Pennsylvania,2011-2012,12745202,12772789,27587,0.216,16541,11046,42,0,STATE
Pennsylvania,2012-2013,12772789,12783536,10747,0.084,10832,-85,42,0,STATE
Pennsylvania,2013-2014,12783536,12793767,10231,0.08,13557,-3326,42,0,STATE
Pennsylvania,2014-2015,12793767,12802503,8736,0.068,13326,-4590,42,0,STATE
Pennsylvania,2015-2016,12802503,12787085,-15418,-0.12,8649,-24067,42,0,STATE
Pennsylvania,2016-2017,12787085,12805537,18452,0.144,7360,11092,42,0,STATE
"Adams County, PA",2000-2001,91457,92591,1134,1.24,291,843,42,1,H1
"Adams County, PA",2001-2002,92591,93934,1343,1.45,155,1188,42,1,H1
"Adams County, PA",2002-2003,93934,95503,1569,1.67,120,1449,42,1,H1
"Adams County, PA",2003-2004,95503,97300,1797,1.882,181,1616,42,1,H1
"Adams County, PA",2004-2005,97300,98606,1306,1.342,181,1125,42,1,H1
"Adams County, PA",2005-2006,98606,99899,1293,1.311,214,1079,42,1,H1
"Adams County, PA",2006-2007,99899,100502,603,0.604,239,364,42,1,H1
"Adams County, PA",2007-2008,100502,101056,554,0.551,210,344,42,1,H1
"Adams County, PA",2008-2009,101056,101252,196,0.194,172,24,42,1,H1
"Adams County, PA",2009-2010,101252,101470,218,0.215,29,189,42,1,H1
"Adams County, PA",2010-2011,101470,101649,179,0.176,129,50,42,1,H1
"Adams County, PA",2011-2012,101649,101538,-111,-0.109,13,-124,42,1,H1
"Adams County, PA",2012-2013,101538,101457,-81,-0.08,42,-123,42,1,H1
"Adams County, PA",2013-2014,101457,101714,257,0.253,43,214,42,1,H1
"Adams County, PA",2014-2015,101787,102295,508,0.499,99,409,42,1,H1
"Adams County, PA",2015-2016,102295,101684,-611,-0.597,-20,-591,42,1,H1
"Adams County, PA",2016-2017,101684,102336,652,0.641,18,634,42,1,H1
"Allegheny County, PA",2000-2001,1279651,1272416,-7235,-0.565,-1131,-6104,42,3,H1
"Allegheny County, PA",2001-2002,1272416,1265577,-6839,-0.537,-1848,-4991,42,3,H1
"Allegheny County, PA",2002-2003,1265577,1258420,-7157,-0.566,-1400,-5757,42,3,H1
"Allegheny County, PA",2003-2004,1258420,1247531,-10889,-0.865,-1555,-9334,42,3,H1
"Allegheny County, PA",2004-2005,1247531,1234787,-12744,-1.022,-1916,-10828,42,3,H1
"Allegheny County, PA",2005-2006,1234787,1226025,-8762,-0.71,-1210,-7552,42,3,H1
"Allegheny County, PA",2006-2007,1226025,1222482,-3543,-0.289,-794,-2749,42,3,H1
"Allegheny County, PA",2007-2008,1222482,1221071,-1411,-0.115,-1065,-346,42,3,H1
"Allegheny County, PA",2008-2009,1221071,1222171,1100,0.09,-1389,2489,42,3,H1
"Allegheny County, PA",2009-2010,1222171,1223797,1626,0.133,-358,1984,42,3,H1
"Allegheny County, PA",2010-2011,1223797,1227472,3675,0.3,-815,4490,42,3,H1
"Allegheny County, PA",2011-2012,1227472,1230383,2911,0.237,-431,3342,42,3,H1
"Allegheny County, PA",2012-2013,1230383,1232953,2570,0.209,-406,2976,42,3,H1
"Allegheny County, PA",2013-2014,1232953,1231255,-1698,-0.138,-512,-1186,42,3,H1
"Allegheny County, PA",2014-2015,1232896,1230459,-2437,-0.198,-127,-2310,42,3,H1
"Allegheny County, PA",2015-2016,1230459,1227553,-2906,-0.236,-343,-2563,42,3,H1
"Allegheny County, PA",2016-2017,1227553,1223048,-4505,-0.367,-550,-3955,42,3,H1
"Armstrong County, PA",2000-2001,72268,71956,-312,-0.432,-147,-165,42,5,H1
"Armstrong County, PA",2001-2002,71956,71747,-209,-0.29,-188,-21,42,5,H1
"Armstrong County, PA",2002-2003,71747,71645,-102,-0.142,-176,74,42,5,H1
"Armstrong County, PA",2003-2004,71645,71404,-241,-0.336,-121,-120,42,5,H1
"Armstrong County, PA",2004-2005,71404,70602,-802,-1.123,-186,-616,42,5,H1
"Armstrong County, PA",2005-2006,70602,70030,-572,-0.81,-103,-469,42,5,H1
"Armstrong County, PA",2006-2007,70030,69845,-185,-0.264,-91,-94,42,5,H1
"Armstrong County, PA",2007-2008,69845,69611,-234,-0.335,-142,-92,42,5,H1
"Armstrong County, PA",2008-2009,69611,69120,-491,-0.705,-154,-337,42,5,H1
"Armstrong County, PA",2009-2010,69120,68822,-298,-0.431,-208,-90,42,5,H1
"Armstrong County, PA",2010-2011,68822,68636,-186,-0.27,-121,-65,42,5,H1
"Armstrong County, PA",2011-2012,68636,68362,-274,-0.399,-152,-122,42,5,H1
"Armstrong County, PA",2012-2013,68362,68110,-252,-0.369,-163,-89,42,5,H1
"Armstrong County, PA",2013-2014,68110,67785,-325,-0.477,-178,-147,42,5,H1
"Armstrong County, PA",2014-2015,67693,67052,-641,-0.947,-217,-424,42,5,H1
"Armstrong County, PA",2015-2016,67052,66132,-920,-1.372,-245,-675,42,5,H1
"Armstrong County, PA",2016-2017,66132,65642,-490,-0.741,-323,-167,42,5,H1
"Beaver County, PA",2000-2001,181054,179391,-1663,-0.919,-327,-1336,42,7,H1
"Beaver County, PA",2001-2002,179391,178277,-1114,-0.621,-390,-724,42,7,H1
"Beaver County, PA",2002-2003,178277,177523,-754,-0.423,-310,-444,42,7,H1
"Beaver County, PA",2003-2004,177523,176395,-1128,-0.635,-361,-767,42,7,H1
"Beaver County, PA",2004-2005,176395,174820,-1575,-0.893,-326,-1249,42,7,H1
"Beaver County, PA",2005-2006,174820,173259,-1561,-0.893,-269,-1292,42,7,H1
"Beaver County, PA",2006-2007,173259,172161,-1098,-0.634,-400,-698,42,7,H1
"Beaver County, PA",2007-2008,172161,171336,-825,-0.479,-276,-549,42,7,H1
"Beaver County, PA",2008-2009,171336,170524,-812,-0.474,-322,-490,42,7,H1
"Beaver County, PA",2009-2010,170524,170590,66,0.039,-357,423,42,7,H1
"Beaver County, PA",2010-2011,170590,170352,-238,-0.14,-279,41,42,7,H1
"Beaver County, PA",2011-2012,170352,170224,-128,-0.075,-418,290,42,7,H1
"Beaver County, PA",2012-2013,170224,170060,-164,-0.096,-369,205,42,7,H1
"Beaver County, PA",2013-2014,170060,169392,-668,-0.393,-353,-315,42,7,H1
"Beaver County, PA",2014-2015,169338,168871,-467,-0.276,-354,-113,42,7,H1
"Beaver County, PA",2015-2016,168871,167123,-1748,-1.035,-390,-1358,42,7,H1
"Beaver County, PA",2016-2017,167123,166140,-983,-0.588,-450,-533,42,7,H1
"Bedford County, PA",2000-2001,49928,49778,-150,-0.3,54,-204,42,9,H1
"Bedford County, PA",2001-2002,49778,49742,-36,-0.072,80,-116,42,9,H1
"Bedford County, PA",2002-2003,49742,49812,70,0.141,37,33,42,9,H1
"Bedford County, PA",2003-2004,49812,49829,17,0.034,35,-18,42,9,H1
"Bedford County, PA",2004-2005,49829,49691,-138,-0.277,2,-140,42,9,H1
"Bedford County, PA",2005-2006,49691,49871,180,0.362,37,143,42,9,H1
"Bedford County, PA",2006-2007,49871,49889,18,0.036,-21,39,42,9,H1
"Bedford County, PA",2007-2008,49889,50052,163,0.327,36,127,42,9,H1
"Bedford County, PA",2008-2009,50052,49889,-163,-0.326,5,-168,42,9,H1
"Bedford County, PA",2009-2010,49889,49740,-149,-0.299,-41,-108,42,9,H1
"Bedford County, PA",2010-2011,49740,49444,-296,-0.595,-65,-231,42,9,H1
"Bedford County, PA",2011-2012,49444,49399,-45,-0.091,-22,-23,42,9,H1
"Bedford County, PA",2012-2013,49399,49133,-266,-0.538,-21,-245,42,9,H1
"Bedford County, PA",2013-2014,49133,48946,-187,-0.381,-41,-146,42,9,H1
"Bedford County, PA",2014-2015,48939,48586,-353,-0.721,-27,-326,42,9,H1
"Bedford County, PA",2015-2016,48586,48652,66,0.136,-114,180,42,9,H1
"Bedford County, PA",2016-2017,48652,48480,-172,-0.354,-84,-88,42,9,H1
"Berks County, PA",2000-2001,374546,377487,2941,0.785,992,1949,42,11,H1
"Berks County, PA",2001-2002,377487,381338,3851,1.02,1097,2754,42,11,H1
"Berks County, PA",2002-2003,381338,385846,4508,1.182,1083,3425,42,11,H1
"Berks County, PA",2003-2004,385846,390848,5002,1.296,1443,3559,42,11,H1
"Berks County, PA",2004-2005,390848,395933,5085,1.301,1393,3692,42,11,H1
"Berks County, PA",2005-2006,395933,401834,5901,1.49,1589,4312,42,11,H1
"Berks County, PA",2006-2007,401834,405223,3389,0.843,1596,1793,42,11,H1
"Berks County, PA",2007-2008,405223,407737,2514,0.62,1665,849,42,11,H1
"Berks County, PA",2008-2009,407737,409904,2167,0.531,1628,539,42,11,H1
"Berks County, PA",2009-2010,409904,411905,2001,0.488,1203,798,42,11,H1
"Berks County, PA",2010-2011,411905,412580,675,0.164,1206,-531,42,11,H1
"Berks County, PA",2011-2012,412580,413252,672,0.163,1216,-544,42,11,H1
"Berks County, PA",2012-2013,413252,413652,400,0.097,1166,-766,42,11,H1
"Berks County, PA",2013-2014,413652,413691,39,0.009,1146,-1107,42,11,H1
"Berks County, PA",2014-2015,414360,415271,911,0.22,1226,-315,42,11,H1
"Berks County, PA",2015-2016,415271,415732,461,0.111,838,-377,42,11,H1
"Berks County, PA",2016-2017,415732,417854,2122,0.51,922,1200,42,11,H1
"Blair County, PA",2000-2001,128981,128471,-510,-0.395,-175,-335,42,13,H1
"Blair County, PA",2001-2002,128471,127631,-840,-0.654,-270,-570,42,13,H1
"Blair County, PA",2002-2003,127631,127353,-278,-0.218,-120,-158,42,13,H1
"Blair County, PA",2003-2004,127353,127194,-159,-0.125,-150,-9,42,13,H1
"Blair County, PA",2004-2005,127194,126730,-464,-0.365,-208,-256,42,13,H1
"Blair County, PA",2005-2006,126730,127002,272,0.215,-163,435,42,13,H1
"Blair County, PA",2006-2007,127002,127048,46,0.036,-103,149,42,13,H1
"Blair County, PA",2007-2008,127048,127112,64,0.05,-80,144,42,13,H1
"Blair County, PA",2008-2009,127112,127161,49,0.039,-143,192,42,13,H1
"Blair County, PA",2009-2010,127161,127030,-131,-0.103,-260,129,42,13,H1
"Blair County, PA",2010-2011,127030,127175,145,0.114,-209,354,42,13,H1
"Blair County, PA",2011-2012,127175,126999,-176,-0.138,-163,-13,42,13,H1
"Blair County, PA",2012-2013,126999,126379,-620,-0.488,-318,-302,42,13,H1
"Blair County, PA",2013-2014,126379,125955,-424,-0.335,-300,-124,42,13,H1
"Blair County, PA",2014-2015,126016,125593,-423,-0.336,-250,-173,42,13,H1
"Blair County, PA",2015-2016,125593,123927,-1666,-1.327,-329,-1337,42,13,H1
"Blair County, PA",2016-2017,123927,123457,-470,-0.379,-364,-106,42,13,H1
"Bradford County, PA",2000-2001,62756,62616,-140,-0.223,46,-186,42,15,H1
"Bradford County, PA",2001-2002,62616,62585,-31,-0.05,99,-130,42,15,H1
"Bradford County, PA",2002-2003,62585,62388,-197,-0.315,56,-253,42,15,H1
"Bradford County, PA",2003-2004,62388,62386,-2,-0.003,13,-15,42,15,H1
"Bradford County, PA",2004-2005,62386,62501,115,0.184,126,-11,42,15,H1
"Bradford County, PA",2005-2006,62501,62345,-156,-0.25,26,-182,42,15,H1
"Bradford County, PA",2006-2007,62345,62343,-2,-0.003,146,-148,42,15,H1
"Bradford County, PA",2007-2008,62343,62318,-25,-0.04,148,-173,42,15,H1
"Bradford County, PA",2008-2009,62318,62418,100,0.16,67,33,42,15,H1
"Bradford County, PA",2009-2010,62418,62588,170,0.272,9,161,42,15,H1
"Bradford County, PA",2010-2011,62588,63007,419,0.669,4,415,42,15,H1
"Bradford County, PA",2011-2012,63007,62813,-194,-0.308,109,-303,42,15,H1
"Bradford County, PA",2012-2013,62813,62356,-457,-0.728,96,-553,42,15,H1
"Bradford County, PA",2013-2014,62356,61784,-572,-0.917,37,-609,42,15,H1
"Bradford County, PA",2014-2015,61673,61281,-392,-0.636,-26,-366,42,15,H1
"Bradford County, PA",2015-2016,61281,60986,-295,-0.481,-7,-288,42,15,H1
"Bradford County, PA",2016-2017,60986,60853,-133,-0.218,-12,-121,42,15,H1
"Bucks County, PA",2000-2001,599085,602883,3798,0.634,2242,1556,42,17,H1
"Bucks County, PA",2001-2002,602883,607157,4274,0.709,1964,2310,42,17,H1
"Bucks County, PA",2002-2003,607157,610174,3017,0.497,1978,1039,42,17,H1
"Bucks County, PA",2003-2004,610174,613763,3589,0.588,1826,1763,42,17,H1
"Bucks County, PA",2004-2005,613763,616302,2539,0.414,1638,901,42,17,H1
"Bucks County, PA",2005-2006,616302,619544,3242,0.526,1893,1349,42,17,H1
"Bucks County, PA",2006-2007,619544,621336,1792,0.289,1922,-130,42,17,H1
"Bucks County, PA",2007-2008,621336,623297,1961,0.316,1655,306,42,17,H1
"Bucks County, PA",2008-2009,623297,624648,1351,0.217,1348,3,42,17,H1
"Bucks County, PA",2009-2010,624648,625326,678,0.109,690,-12,42,17,H1
"Bucks County, PA",2010-2011,625326,626369,1043,0.167,533,510,42,17,H1
"Bucks County, PA",2011-2012,626369,626189,-180,-0.029,434,-614,42,17,H1
"Bucks County, PA",2012-2013,626189,626456,267,0.043,311,-44,42,17,H1
"Bucks County, PA",2013-2014,626456,626685,229,0.037,166,63,42,17,H1
"Bucks County, PA",2014-2015,626608,627367,759,0.121,93,666,42,17,H1
"Bucks County, PA",2015-2016,627367,626751,-616,-0.098,55,-671,42,17,H1
"Bucks County, PA",2016-2017,626751,628341,1590,0.254,-21,1611,42,17,H1
"Butler County, PA",2000-2001,174444,175621,1177,0.675,343,834,42,19,H1
"Butler County, PA",2001-2002,175621,177146,1525,0.868,397,1128,42,19,H1
"Butler County, PA",2002-2003,177146,178289,1143,0.645,290,853,42,19,H1
"Butler County, PA",2003-2004,178289,178912,623,0.349,228,395,42,19,H1
"Butler County, PA",2004-2005,178912,179522,610,0.341,148,462,42,19,H1
"Butler County, PA",2005-2006,179522,181009,1487,0.828,433,1054,42,19,H1
"Butler County, PA",2006-2007,181009,181690,681,0.376,118,563,42,19,H1
"Butler County, PA",2007-2008,181690,182673,983,0.541,191,792,42,19,H1
"Butler County, PA",2008-2009,182673,183337,664,0.363,249,415,42,19,H1
"Butler County, PA",2009-2010,183337,184047,710,0.387,15,695,42,19,H1
"Butler County, PA",2010-2011,184047,184721,674,0.366,-107,781,42,19,H1
"Butler County, PA",2011-2012,184721,185089,368,0.199,-30,398,42,19,H1
"Butler County, PA",2012-2013,185089,185369,280,0.151,-125,405,42,19,H1
"Butler County, PA",2013-2014,185369,185943,574,0.31,-109,683,42,19,H1
"Butler County, PA",2014-2015,186386,186818,432,0.232,-41,473,42,19,H1
"Butler County, PA",2015-2016,186818,186207,-611,-0.327,-50,-561,42,19,H1
"Butler County, PA",2016-2017,186207,187108,901,0.484,-131,1032,42,19,H1
"Cambria County, PA",2000-2001,152107,150902,-1205,-0.792,-506,-699,42,21,H1
"Cambria County, PA",2001-2002,150902,149831,-1071,-0.71,-406,-665,42,21,H1
"Cambria County, PA",2002-2003,149831,148836,-995,-0.664,-471,-524,42,21,H1
"Cambria County, PA",2003-2004,148836,147886,-950,-0.638,-340,-610,42,21,H1
"Cambria County, PA",2004-2005,147886,146975,-911,-0.616,-397,-514,42,21,H1
"Cambria County, PA",2005-2006,146975,146093,-882,-0.6,-426,-456,42,21,H1
"Cambria County, PA",2006-2007,146093,145283,-810,-0.554,-418,-392,42,21,H1
"Cambria County, PA",2007-2008,145283,144646,-637,-0.438,-234,-403,42,21,H1
"Cambria County, PA",2008-2009,144646,144186,-460,-0.318,-304,-156,42,21,H1
"Cambria County, PA",2009-2010,144186,143444,-742,-0.515,-361,-381,42,21,H1
"Cambria County, PA",2010-2011,143444,142566,-878,-0.612,-503,-375,42,21,H1
"Cambria County, PA",2011-2012,142566,141531,-1035,-0.726,-402,-633,42,21,H1
"Cambria County, PA",2012-2013,141531,138900,-2631,-1.859,-448,-2183,42,21,H1
"Cambria County, PA",2013-2014,138900,137732,-1168,-0.841,-471,-697,42,21,H1
"Cambria County, PA",2014-2015,137534,136411,-1123,-0.817,-478,-645,42,21,H1
"Cambria County, PA",2015-2016,136411,134313,-2098,-1.538,-453,-1645,42,21,H1
"Cambria County, PA",2016-2017,134313,133054,-1259,-0.937,-469,-790,42,21,H1
"Cameron County, PA",2000-2001,5930,5875,-55,-0.927,-5,-50,42,23,H1
"Cameron County, PA",2001-2002,5875,5775,-100,-1.702,-33,-67,42,23,H1
"Cameron County, PA",2002-2003,5775,5702,-73,-1.264,-11,-62,42,23,H1
"Cameron County, PA",2003-2004,5702,5535,-167,-2.929,-23,-144,42,23,H1
"Cameron County, PA",2004-2005,5535,5431,-104,-1.879,-31,-73,42,23,H1
"Cameron County, PA",2005-2006,5431,5341,-90,-1.657,-15,-75,42,23,H1
"Cameron County, PA",2006-2007,5341,5274,-67,-1.254,-13,-54,42,23,H1
"Cameron County, PA",2007-2008,5274,5186,-88,-1.669,-16,-72,42,23,H1
"Cameron County, PA",2008-2009,5186,5106,-80,-1.543,-20,-60,42,23,H1
"Cameron County, PA",2009-2010,5106,5067,-39,-0.764,-17,-22,42,23,H1
"Cameron County, PA",2010-2011,5067,4987,-80,-1.579,-33,-47,42,23,H1
"Cameron County, PA",2011-2012,4987,4942,-45,-0.902,-21,-24,42,23,H1
"Cameron County, PA",2012-2013,4942,4894,-48,-0.971,-6,-42,42,23,H1
"Cameron County, PA",2013-2014,4894,4805,-89,-1.819,-10,-79,42,23,H1
"Cameron County, PA",2014-2015,4785,4732,-53,-1.108,-17,-36,42,23,H1
"Cameron County, PA",2015-2016,4732,4683,-49,-1.036,-28,-21,42,23,H1
"Cameron County, PA",2016-2017,4683,4592,-91,-1.943,-26,-65,42,23,H1
"Carbon County, PA",2000-2001,58807,59318,511,0.869,-178,689,42,25,H1
"Carbon County, PA",2001-2002,59318,59820,502,0.846,-193,695,42,25,H1
"Carbon County, PA",2002-2003,59820,60452,632,1.057,-134,766,42,25,H1
"Carbon County, PA",2003-2004,60452,61274,822,1.36,-100,922,42,25,H1
"Carbon County, PA",2004-2005,61274,62358,1084,1.769,-150,1234,42,25,H1
"Carbon County, PA",2005-2006,62358,63105,747,1.198,-243,990,42,25,H1
"Carbon County, PA",2006-2007,63105,64339,1234,1.955,-138,1372,42,25,H1
"Carbon County, PA",2007-2008,64339,64947,608,0.945,-51,659,42,25,H1
"Carbon County, PA",2008-2009,64947,65204,257,0.396,-90,347,42,25,H1
"Carbon County, PA",2009-2010,65204,65207,3,0.005,-191,194,42,25,H1
"Carbon County, PA",2010-2011,65207,65106,-101,-0.155,-251,150,42,25,H1
"Carbon County, PA",2011-2012,65106,64927,-179,-0.275,-214,35,42,25,H1
"Carbon County, PA",2012-2013,64927,64690,-237,-0.365,-177,-60,42,25,H1
"Carbon County, PA",2013-2014,64690,64441,-249,-0.385,-206,-43,42,25,H1
"Carbon County, PA",2014-2015,64418,63960,-458,-0.711,-188,-270,42,25,H1
"Carbon County, PA",2015-2016,63960,63515,-445,-0.696,-201,-244,42,25,H1
"Carbon County, PA",2016-2017,63515,63853,338,0.532,-195,533,42,25,H1
"Centre County, PA",2000-2001,135965,137620,1655,1.217,412,1243,42,27,H1
"Centre County, PA",2001-2002,137620,140821,3201,2.326,333,2868,42,27,H1
"Centre County, PA",2002-2003,140821,142926,2105,1.495,388,1717,42,27,H1
"Centre County, PA",2003-2004,142926,144238,1312,0.918,469,843,42,27,H1
"Centre County, PA",2004-2005,144238,145543,1305,0.905,350,955,42,27,H1
"Centre County, PA",2005-2006,145543,148734,3191,2.192,434,2757,42,27,H1
"Centre County, PA",2006-2007,148734,149498,764,0.514,497,267,42,27,H1
"Centre County, PA",2007-2008,149498,151645,2147,1.436,412,1735,42,27,H1
"Centre County, PA",2008-2009,151645,153052,1407,0.928,409,998,42,27,H1
"Centre County, PA",2009-2010,153052,154182,1130,0.738,287,843,42,27,H1
"Centre County, PA",2010-2011,154182,154847,665,0.431,296,369,42,27,H1
"Centre County, PA",2011-2012,154847,155582,735,0.475,388,347,42,27,H1
"Centre County, PA",2012-2013,155582,157847,2265,1.456,341,1924,42,27,H1
"Centre County, PA",2013-2014,157847,158742,895,0.567,346,549,42,27,H1
"Centre County, PA",2014-2015,159506,160580,1074,0.673,295,779,42,27,H1
"Centre County, PA",2015-2016,160580,162083,1503,0.936,284,1219,42,27,H1
"Centre County, PA",2016-2017,162083,162660,577,0.356,222,355,42,27,H1
"Chester County, PA",2000-2001,435303,441024,5721,1.314,2476,3245,42,29,H1
"Chester County, PA",2001-2002,441024,447842,6818,1.546,2549,4269,42,29,H1
"Chester County, PA",2002-2003,447842,455111,7269,1.623,2589,4680,42,29,H1
"Chester County, PA",2003-2004,455111,462902,7791,1.712,2827,4964,42,29,H1
"Chester County, PA",2004-2005,462902,470506,7604,1.643,2673,4931,42,29,H1
"Chester County, PA",2005-2006,470506,479137,8631,1.834,2893,5738,42,29,H1
"Chester County, PA",2006-2007,479137,486156,7019,1.465,2778,4241,42,29,H1
"Chester County, PA",2007-2008,486156,491473,5317,1.094,2768,2549,42,29,H1
"Chester County, PA",2008-2009,491473,496291,4818,0.98,2867,1951,42,29,H1
"Chester County, PA",2009-2010,496291,499883,3592,0.724,2295,1297,42,29,H1
"Chester County, PA",2010-2011,499883,503626,3743,0.749,1926,1817,42,29,H1
"Chester County, PA",2011-2012,503626,506317,2691,0.534,1927,764,42,29,H1
"Chester County, PA",2012-2013,506317,509500,3183,0.629,1713,1470,42,29,H1
"Chester County, PA",2013-2014,509500,512784,3284,0.645,1690,1594,42,29,H1
"Chester County, PA",2014-2015,513291,515939,2648,0.516,1626,1022,42,29,H1
"Chester County, PA",2015-2016,515939,516489,550,0.107,1365,-815,42,29,H1
"Chester County, PA",2016-2017,516489,519293,2804,0.543,1366,1438,42,29,H1
"Clarion County, PA",2000-2001,41735,41547,-188,-0.45,14,-202,42,31,H1
"Clarion County, PA",2001-2002,41547,41220,-327,-0.787,-100,-227,42,31,H1
"Clarion County, PA",2002-2003,41220,41293,73,0.177,-34,107,42,31,H1
"Clarion County, PA",2003-2004,41293,40509,-784,-1.899,-22,-762,42,31,H1
"Clarion County, PA",2004-2005,40509,40458,-51,-0.126,-68,17,42,31,H1
"Clarion County, PA",2005-2006,40458,40615,157,0.388,-4,161,42,31,H1
"Clarion County, PA",2006-2007,40615,40399,-216,-0.532,-12,-204,42,31,H1
"Clarion County, PA",2007-2008,40399,40355,-44,-0.109,-42,-2,42,31,H1
"Clarion County, PA",2008-2009,40355,40173,-182,-0.451,-53,-129,42,31,H1
"Clarion County, PA",2009-2010,40173,39935,-238,-0.592,-89,-149,42,31,H1
"Clarion County, PA",2010-2011,39935,39888,-47,-0.118,-10,-37,42,31,H1
"Clarion County, PA",2011-2012,39888,39450,-438,-1.098,-49,-389,42,31,H1
"Clarion County, PA",2012-2013,39450,39092,-358,-0.907,-9,-349,42,31,H1
"Clarion County, PA",2013-2014,39092,38821,-271,-0.693,-47,-224,42,31,H1
"Clarion County, PA",2014-2015,39428,39498,70,0.178,-30,100,42,31,H1
"Clarion County, PA",2015-2016,39498,38558,-940,-2.38,0,-940,42,31,H1
"Clarion County, PA",2016-2017,38558,38458,-100,-0.259,-18,-82,42,31,H1
"Clearfield County, PA",2000-2001,83465,82987,-478,-0.573,-102,-376,42,33,H1
"Clearfield County, PA",2001-2002,82987,82925,-62,-0.075,-101,39,42,33,H1
"Clearfield County, PA",2002-2003,82925,82422,-503,-0.607,-140,-363,42,33,H1
"Clearfield County, PA",2003-2004,82422,82040,-382,-0.463,-87,-295,42,33,H1
"Clearfield County, PA",2004-2005,82040,81816,-224,-0.273,-107,-117,42,33,H1
"Clearfield County, PA",2005-2006,81816,82461,645,0.788,-122,767,42,33,H1
"Clearfield County, PA",2006-2007,82461,82558,97,0.118,-183,280,42,33,H1
"Clearfield County, PA",2007-2008,82558,82130,-428,-0.518,-119,-309,42,33,H1
"Clearfield County, PA",2008-2009,82130,81942,-188,-0.229,-139,-49,42,33,H1
"Clearfield County, PA",2009-2010,81942,81560,-382,-0.466,-205,-177,42,33,H1
"Clearfield County, PA",2010-2011,81560,81516,-44,-0.054,-183,139,42,33,H1
"Clearfield County, PA",2011-2012,81516,81503,-13,-0.016,-196,183,42,33,H1
"Clearfield County, PA",2012-2013,81503,81589,86,0.106,-155,241,42,33,H1
"Clearfield County, PA",2013-2014,81589,81191,-398,-0.488,-181,-217,42,33,H1
"Clearfield County, PA",2014-2015,81126,80994,-132,-0.163,-187,55,42,33,H1
"Clearfield County, PA",2015-2016,80994,80035,-959,-1.184,-225,-734,42,33,H1
"Clearfield County, PA",2016-2017,80035,79685,-350,-0.437,-236,-114,42,33,H1
"Clinton County, PA",2000-2001,37926,37945,19,0.05,3,16,42,35,H1
"Clinton County, PA",2001-2002,37945,38007,62,0.163,17,45,42,35,H1
"Clinton County, PA",2002-2003,38007,38143,136,0.358,21,115,42,35,H1
"Clinton County, PA",2003-2004,38143,38227,84,0.22,-4,88,42,35,H1
"Clinton County, PA",2004-2005,38227,38418,191,0.5,-7,198,42,35,H1
"Clinton County, PA",2005-2006,38418,38730,312,0.812,64,248,42,35,H1
"Clinton County, PA",2006-2007,38730,38859,129,0.333,51,78,42,35,H1
"Clinton County, PA",2007-2008,38859,38955,96,0.247,19,77,42,35,H1
"Clinton County, PA",2008-2009,38955,39074,119,0.305,26,93,42,35,H1
"Clinton County, PA",2009-2010,39074,39230,156,0.399,-3,159,42,35,H1
"Clinton County, PA",2010-2011,39230,39515,285,0.726,24,261,42,35,H1
"Clinton County, PA",2011-2012,39515,39730,215,0.544,26,189,42,35,H1
"Clinton County, PA",2012-2013,39730,39834,104,0.262,48,56,42,35,H1
"Clinton County, PA",2013-2014,39834,39745,-89,-0.223,36,-125,42,35,H1
"Clinton County, PA",2014-2015,39511,39441,-70,-0.177,42,-112,42,35,H1
"Clinton County, PA",2015-2016,39441,38985,-456,-1.156,7,-463,42,35,H1
"Clinton County, PA",2016-2017,38985,38998,13,0.033,24,-11,42,35,H1
"Columbia County, PA",2000-2001,63936,64298,362,0.566,-50,412,42,37,H1
"Columbia County, PA",2001-2002,64298,64601,303,0.471,-25,328,42,37,H1
"Columbia County, PA",2002-2003,64601,65001,400,0.619,-54,454,42,37,H1
"Columbia County, PA",2003-2004,65001,65337,336,0.517,-125,461,42,37,H1
"Columbia County, PA",2004-2005,65337,65535,198,0.303,-23,221,42,37,H1
"Columbia County, PA",2005-2006,65535,65882,347,0.529,-3,350,42,37,H1
"Columbia County, PA",2006-2007,65882,66196,314,0.477,-44,358,42,37,H1
"Columbia County, PA",2007-2008,66196,66645,449,0.678,-31,480,42,37,H1
"Columbia County, PA",2008-2009,66645,67220,575,0.863,-44,619,42,37,H1
"Columbia County, PA",2009-2010,67220,67329,109,0.162,-106,215,42,37,H1
"Columbia County, PA",2010-2011,67329,66930,-399,-0.593,-67,-332,42,37,H1
"Columbia County, PA",2011-2012,66930,66924,-6,-0.009,-55,49,42,37,H1
"Columbia County, PA",2012-2013,66924,67139,215,0.321,-25,240,42,37,H1
"Columbia County, PA",2013-2014,67139,67122,-17,-0.025,-47,30,42,37,H1
"Columbia County, PA",2014-2015,66969,66672,-297,-0.443,-90,-207,42,37,H1
"Columbia County, PA",2015-2016,66672,66152,-520,-0.78,-144,-376,42,37,H1
"Columbia County, PA",2016-2017,66152,65932,-220,-0.333,-138,-82,42,37,H1
"Crawford County, PA",2000-2001,90306,90105,-201,-0.223,149,-350,42,39,H1
"Crawford County, PA",2001-2002,90105,90031,-74,-0.082,91,-165,42,39,H1
"Crawford County, PA",2002-2003,90031,89846,-185,-0.205,89,-274,42,39,H1
"Crawford County, PA",2003-2004,89846,89682,-164,-0.183,90,-254,42,39,H1
"Crawford County, PA",2004-2005,89682,89452,-230,-0.256,96,-326,42,39,H1
"Crawford County, PA",2005-2006,89452,89496,44,0.049,136,-92,42,39,H1
"Crawford County, PA",2006-2007,89496,89544,48,0.054,80,-32,42,39,H1
"Crawford County, PA",2007-2008,89544,89023,-521,-0.582,62,-583,42,39,H1
"Crawford County, PA",2008-2009,89023,89044,21,0.024,84,-63,42,39,H1
"Crawford County, PA",2009-2010,89044,88672,-372,-0.418,5,-377,42,39,H1
"Crawford County, PA",2010-2011,88672,88085,-587,-0.662,-105,-482,42,39,H1
"Crawford County, PA",2011-2012,88085,87660,-425,-0.482,24,-449,42,39,H1
"Crawford County, PA",2012-2013,87660,87411,-249,-0.284,10,-259,42,39,H1
"Crawford County, PA",2013-2014,87411,87175,-236,-0.27,3,-239,42,39,H1
"Crawford County, PA",2014-2015,87057,86484,-573,-0.658,-9,-564,42,39,H1
"Crawford County, PA",2015-2016,86484,86505,21,0.024,-31,52,42,39,H1
"Crawford County, PA",2016-2017,86505,86159,-346,-0.4,-26,-320,42,39,H1
"Cumberland County, PA",2000-2001,213906,215087,1181,0.552,199,982,42,41,H1
"Cumberland County, PA",2001-2002,215087,217318,2231,1.037,247,1984,42,41,H1
"Cumberland County, PA",2002-2003,217318,219351,2033,0.935,151,1882,42,41,H1
"Cumberland County, PA",2003-2004,219351,221225,1874,0.854,226,1648,42,41,H1
"Cumberland County, PA",2004-2005,221225,223361,2136,0.966,212,1924,42,41,H1
"Cumberland County, PA",2005-2006,223361,226835,3474,1.555,327,3147,42,41,H1
"Cumberland County, PA",2006-2007,226835,228718,1883,0.83,272,1611,42,41,H1
"Cumberland County, PA",2007-2008,228718,231357,2639,1.154,456,2183,42,41,H1
"Cumberland County, PA",2008-2009,231357,233910,2553,1.103,321,2232,42,41,H1
"Cumberland County, PA",2009-2010,233910,235953,2043,0.873,147,1896,42,41,H1
"Cumberland County, PA",2010-2011,235953,236920,967,0.41,363,604,42,41,H1
"Cumberland County, PA",2011-2012,236920,239198,2278,0.962,269,2009,42,41,H1
"Cumberland County, PA",2012-2013,239198,241268,2070,0.865,386,1684,42,41,H1
"Cumberland County, PA",2013-2014,241268,243762,2494,1.034,434,2060,42,41,H1
"Cumberland County, PA",2014-2015,243533,246338,2805,1.152,460,2345,42,41,H1
"Cumberland County, PA",2015-2016,246338,247901,1563,0.634,362,1201,42,41,H1
"Cumberland County, PA",2016-2017,247901,250066,2165,0.873,364,1801,42,41,H1
"Dauphin County, PA",2000-2001,251911,252500,589,0.234,720,-131,42,43,H1
"Dauphin County, PA",2001-2002,252500,254339,1839,0.728,724,1115,42,43,H1
"Dauphin County, PA",2002-2003,254339,255585,1246,0.49,690,556,42,43,H1
"Dauphin County, PA",2003-2004,255585,256194,609,0.238,721,-112,42,43,H1
"Dauphin County, PA",2004-2005,256194,257673,1479,0.577,874,605,42,43,H1
"Dauphin County, PA",2005-2006,257673,260312,2639,1.024,984,1655,42,43,H1
"Dauphin County, PA",2006-2007,260312,263096,2784,1.069,1180,1604,42,43,H1
"Dauphin County, PA",2007-2008,263096,265395,2299,0.874,1166,1133,42,43,H1
"Dauphin County, PA",2008-2009,265395,267090,1695,0.639,945,750,42,43,H1
"Dauphin County, PA",2009-2010,267090,268281,1191,0.446,1040,151,42,43,H1
"Dauphin County, PA",2010-2011,268281,269124,843,0.314,966,-123,42,43,H1
"Dauphin County, PA",2011-2012,269124,269857,733,0.272,973,-240,42,43,H1
"Dauphin County, PA",2012-2013,269857,271017,1160,0.43,1063,97,42,43,H1
"Dauphin County, PA",2013-2014,271017,271453,436,0.161,986,-550,42,43,H1
"Dauphin County, PA",2014-2015,272078,272983,905,0.333,1028,-123,42,43,H1
"Dauphin County, PA",2015-2016,272983,274121,1138,0.417,837,301,42,43,H1
"Dauphin County, PA",2016-2017,274121,275710,1589,0.58,813,776,42,43,H1
"Delaware County, PA",2000-2001,551536,552041,505,0.092,1012,-507,42,45,H1
"Delaware County, PA",2001-2002,552041,551929,-112,-0.02,912,-1024,42,45,H1
"Delaware County, PA",2002-2003,551929,552111,182,0.033,1033,-851,42,45,H1
"Delaware County, PA",2003-2004,552111,551508,-603,-0.109,1105,-1708,42,45,H1
"Delaware County, PA",2004-2005,551508,552153,645,0.117,1307,-662,42,45,H1
"Delaware County, PA",2005-2006,552153,553806,1653,0.299,1477,176,42,45,H1
"Delaware County, PA",2006-2007,553806,554916,1110,0.2,1405,-295,42,45,H1
"Delaware County, PA",2007-2008,554916,556246,1330,0.24,1143,187,42,45,H1
"Delaware County, PA",2008-2009,556246,558094,1848,0.332,1205,643,42,45,H1
"Delaware County, PA",2009-2010,558094,559026,932,0.167,1522,-590,42,45,H1
"Delaware County, PA",2010-2011,559026,559128,102,0.018,1403,-1301,42,45,H1
"Delaware County, PA",2011-2012,559128,560916,1788,0.32,1402,386,42,45,H1
"Delaware County, PA",2012-2013,560916,561844,928,0.165,1195,-267,42,45,H1
"Delaware County, PA",2013-2014,561844,562960,1116,0.199,1268,-152,42,45,H1
"Delaware County, PA",2014-2015,562957,563894,937,0.166,1335,-398,42,45,H1
"Delaware County, PA",2015-2016,563894,563995,101,0.018,1020,-919,42,45,H1
"Delaware County, PA",2016-2017,563995,564696,701,0.124,993,-292,42,45,H1
"Elk County, PA",2000-2001,35033,34778,-255,-0.728,4,-259,42,47,H1
"Elk County, PA",2001-2002,34778,34413,-365,-1.05,-8,-357,42,47,H1
"Elk County, PA",2002-2003,34413,34144,-269,-0.782,-76,-193,42,47,H1
"Elk County, PA",2003-2004,34144,33835,-309,-0.905,-80,-229,42,47,H1
"Elk County, PA",2004-2005,33835,33385,-450,-1.33,-26,-424,42,47,H1
"Elk County, PA",2005-2006,33385,33006,-379,-1.135,-67,-312,42,47,H1
"Elk County, PA",2006-2007,33006,32833,-173,-0.524,-13,-160,42,47,H1
"Elk County, PA",2007-2008,32833,32504,-329,-1.002,-82,-247,42,47,H1
"Elk County, PA",2008-2009,32504,32208,-296,-0.911,-83,-213,42,47,H1
"Elk County, PA",2009-2010,32208,31851,-357,-1.108,-97,-260,42,47,H1
"Elk County, PA",2010-2011,31851,31797,-54,-0.17,-109,55,42,47,H1
"Elk County, PA",2011-2012,31797,31623,-174,-0.547,-85,-89,42,47,H1
"Elk County, PA",2012-2013,31623,31455,-168,-0.531,-38,-130,42,47,H1
"Elk County, PA",2013-2014,31455,31194,-261,-0.83,-62,-199,42,47,H1
"Elk County, PA",2014-2015,31119,30872,-247,-0.794,-87,-160,42,47,H1
"Elk County, PA",2015-2016,30872,30423,-449,-1.454,-82,-367,42,47,H1
"Elk County, PA",2016-2017,30423,30197,-226,-0.743,-80,-146,42,47,H1
"Erie County, PA",2000-2001,280803,280647,-156,-0.056,794,-950,42,49,H1
"Erie County, PA",2001-2002,280647,280379,-268,-0.095,602,-870,42,49,H1
"Erie County, PA",2002-2003,280379,280153,-226,-0.081,665,-891,42,49,H1
"Erie County, PA",2003-2004,280153,277864,-2289,-0.817,641,-2930,42,49,H1
"Erie County, PA",2004-2005,277864,277211,-653,-0.235,508,-1161,42,49,H1
"Erie County, PA",2005-2006,277211,278389,1178,0.425,673,505,42,49,H1
"Erie County, PA",2006-2007,278389,278573,184,0.066,732,-548,42,49,H1
"Erie County, PA",2007-2008,278573,278686,113,0.041,864,-751,42,49,H1
"Erie County, PA",2008-2009,278686,279838,1152,0.413,655,497,42,49,H1
"Erie County, PA",2009-2010,279838,280720,882,0.315,505,377,42,49,H1
"Erie County, PA",2010-2011,280720,280938,218,0.078,477,-259,42,49,H1
"Erie County, PA",2011-2012,280938,280801,-137,-0.049,372,-509,42,49,H1
"Erie County, PA",2012-2013,280801,279760,-1041,-0.371,309,-1350,42,49,H1
"Erie County, PA",2013-2014,279760,278443,-1317,-0.471,378,-1695,42,49,H1
"Erie County, PA",2014-2015,278936,278045,-891,-0.319,437,-1328,42,49,H1
"Erie County, PA",2015-2016,278045,276321,-1724,-0.62,376,-2100,42,49,H1
"Erie County, PA",2016-2017,276321,274541,-1780,-0.644,275,-2055,42,49,H1
"Fayette County, PA",2000-2001,148214,146219,-1995,-1.346,-354,-1641,42,51,H1
"Fayette County, PA",2001-2002,146219,144817,-1402,-0.959,-329,-1073,42,51,H1
"Fayette County, PA",2002-2003,144817,143596,-1221,-0.843,-289,-932,42,51,H1
"Fayette County, PA",2003-2004,143596,143494,-102,-0.071,-450,348,42,51,H1
"Fayette County, PA",2004-2005,143494,142447,-1047,-0.73,-259,-788,42,51,H1
"Fayette County, PA",2005-2006,142447,141165,-1282,-0.9,-395,-887,42,51,H1
"Fayette County, PA",2006-2007,141165,140159,-1006,-0.713,-328,-678,42,51,H1
"Fayette County, PA",2007-2008,140159,138813,-1346,-0.96,-276,-1070,42,51,H1
"Fayette County, PA",2008-2009,138813,137450,-1363,-0.982,-260,-1103,42,51,H1
"Fayette County, PA",2009-2010,137450,136468,-982,-0.714,-397,-585,42,51,H1
"Fayette County, PA",2010-2011,136468,136046,-422,-0.309,-446,24,42,51,H1
"Fayette County, PA",2011-2012,136046,135479,-567,-0.417,-426,-141,42,51,H1
"Fayette County, PA",2012-2013,135479,134799,-680,-0.502,-442,-238,42,51,H1
"Fayette County, PA",2013-2014,134799,134086,-713,-0.529,-498,-215,42,51,H1
"Fayette County, PA",2014-2015,134255,133628,-627,-0.467,-388,-239,42,51,H1
"Fayette County, PA",2015-2016,133628,132392,-1236,-0.925,-394,-842,42,51,H1
"Fayette County, PA",2016-2017,132392,131504,-888,-0.671,-447,-441,42,51,H1
"Forest County, PA",2000-2001,5021,5355,334,6.652,-20,354,42,53,H1
"Forest County, PA",2001-2002,5355,5627,272,5.079,-38,310,42,53,H1
"Forest County, PA",2002-2003,5627,5909,282,5.012,-46,328,42,53,H1
"Forest County, PA",2003-2004,5909,6118,209,3.537,-44,253,42,53,H1
"Forest County, PA",2004-2005,6118,6964,846,13.828,-29,875,42,53,H1
"Forest County, PA",2005-2006,6964,7519,555,7.97,-49,604,42,53,H1
"Forest County, PA",2006-2007,7519,7512,-7,-0.093,-57,50,42,53,H1
"Forest County, PA",2007-2008,7512,7470,-42,-0.559,-32,-10,42,53,H1
"Forest County, PA",2008-2009,7470,7737,267,3.574,-37,304,42,53,H1
"Forest County, PA",2009-2010,7737,7710,-27,-0.349,-46,19,42,53,H1
"Forest County, PA",2010-2011,7710,7746,36,0.467,-64,100,42,53,H1
"Forest County, PA",2011-2012,7746,7670,-76,-0.981,-54,-22,42,53,H1
"Forest County, PA",2012-2013,7670,7602,-68,-0.887,-39,-29,42,53,H1
"Forest County, PA",2013-2014,7602,7518,-84,-1.105,-38,-46,42,53,H1
"Forest County, PA",2014-2015,7515,7410,-105,-1.397,-40,-65,42,53,H1
"Forest County, PA",2015-2016,7410,7306,-104,-1.404,-41,-63,42,53,H1
"Forest County, PA",2016-2017,7306,7297,-9,-0.123,-53,44,42,53,H1
"Franklin County, PA",2000-2001,129745,130604,859,0.662,321,538,42,55,H1
"Franklin County, PA",2001-2002,130604,131998,1394,1.067,324,1070,42,55,H1
"Franklin County, PA",2002-2003,131998,133583,1585,1.201,328,1257,42,55,H1
"Franklin County, PA",2003-2004,133583,135742,2159,1.616,271,1888,42,55,H1
"Franklin County, PA",2004-2005,135742,138927,3185,2.346,492,2693,42,55,H1
"Franklin County, PA",2005-2006,138927,142421,3494,2.515,615,2879,42,55,H1
"Franklin County, PA",2006-2007,142421,144840,2419,1.698,674,1745,42,55,H1
"Franklin County, PA",2007-2008,144840,147032,2192,1.513,553,1639,42,55,H1
"Franklin County, PA",2008-2009,147032,148662,1630,1.109,444,1186,42,55,H1
"Franklin County, PA",2009-2010,148662,149908,1246,0.838,335,911,42,55,H1
"Franklin County, PA",2010-2011,149908,151004,1096,0.731,500,596,42,55,H1
"Franklin County, PA",2011-2012,151004,151589,585,0.387,502,83,42,55,H1
"Franklin County, PA",2012-2013,151589,152191,602,0.397,317,285,42,55,H1
"Franklin County, PA",2013-2014,152191,152892,701,0.461,324,377,42,55,H1
"Franklin County, PA",2014-2015,152951,153638,687,0.449,321,366,42,55,H1
"Franklin County, PA",2015-2016,153638,153564,-74,-0.048,272,-346,42,55,H1
"Franklin County, PA",2016-2017,153564,154234,670,0.436,223,447,42,55,H1
"Fulton County, PA",2000-2001,14296,14201,-95,-0.665,7,-102,42,57,H1
"Fulton County, PA",2001-2002,14201,14251,50,0.352,36,14,42,57,H1
"Fulton County, PA",2002-2003,14251,14416,165,1.158,23,142,42,57,H1
"Fulton County, PA",2003-2004,14416,14471,55,0.382,33,22,42,57,H1
"Fulton County, PA",2004-2005,14471,14540,69,0.477,14,55,42,57,H1
"Fulton County, PA",2005-2006,14540,14714,174,1.197,55,119,42,57,H1
"Fulton County, PA",2006-2007,14714,14900,186,1.264,63,123,42,57,H1
"Fulton County, PA",2007-2008,14900,14900,0,0,53,-53,42,57,H1
"Fulton County, PA",2008-2009,14900,14828,-72,-0.483,19,-91,42,57,H1
"Fulton County, PA",2009-2010,14828,14868,40,0.27,4,36,42,57,H1
"Fulton County, PA",2010-2011,14868,14778,-90,-0.605,5,-95,42,57,H1
"Fulton County, PA",2011-2012,14778,14764,-14,-0.095,25,-39,42,57,H1
"Fulton County, PA",2012-2013,14764,14694,-70,-0.474,27,-97,42,57,H1
"Fulton County, PA",2013-2014,14694,14632,-62,-0.422,19,-81,42,57,H1
"Fulton County, PA",2014-2015,14615,14629,14,0.096,10,4,42,57,H1
"Fulton County, PA",2015-2016,14629,14617,-12,-0.082,-42,30,42,57,H1
"Fulton County, PA",2016-2017,14617,14590,-27,-0.185,-16,-11,42,57,H1
"Greene County, PA",2000-2001,40591,40251,-340,-0.838,-81,-259,42,59,H1
"Greene County, PA",2001-2002,40251,40096,-155,-0.385,-47,-108,42,59,H1
"Greene County, PA",2002-2003,40096,39798,-298,-0.743,-85,-213,42,59,H1
"Greene County, PA",2003-2004,39798,39464,-334,-0.839,-38,-296,42,59,H1
"Greene County, PA",2004-2005,39464,39806,342,0.867,15,327,42,59,H1
"Greene County, PA",2005-2006,39806,39342,-464,-1.166,26,-490,42,59,H1
"Greene County, PA",2006-2007,39342,39096,-246,-0.625,-11,-235,42,59,H1
"Greene County, PA",2007-2008,39096,39074,-22,-0.056,4,-26,42,59,H1
"Greene County, PA",2008-2009,39074,38862,-212,-0.543,-17,-195,42,59,H1
"Greene County, PA",2009-2010,38862,38612,-250,-0.643,-58,-192,42,59,H1
"Greene County, PA",2010-2011,38612,38432,-180,-0.466,-50,-130,42,59,H1
"Greene County, PA",2011-2012,38432,38084,-348,-0.905,-72,-276,42,59,H1
"Greene County, PA",2012-2013,38084,37882,-202,-0.53,-70,-132,42,59,H1
"Greene County, PA",2013-2014,37882,37843,-39,-0.103,-87,48,42,59,H1
"Greene County, PA",2014-2015,37805,37519,-286,-0.757,-39,-247,42,59,H1
"Greene County, PA",2015-2016,37519,37158,-361,-0.962,-37,-324,42,59,H1
"Greene County, PA",2016-2017,37158,36770,-388,-1.044,-46,-342,42,59,H1
"Huntingdon County, PA",2000-2001,45620,45594,-26,-0.057,95,-121,42,61,H1
"Huntingdon County, PA",2001-2002,45594,45705,111,0.243,79,32,42,61,H1
"Huntingdon County, PA",2002-2003,45705,45797,92,0.201,21,71,42,61,H1
"Huntingdon County, PA",2003-2004,45797,45790,-7,-0.015,-60,53,42,61,H1
"Huntingdon County, PA",2004-2005,45790,45771,-19,-0.041,9,-28,42,61,H1
"Huntingdon County, PA",2005-2006,45771,45684,-87,-0.19,18,-105,42,61,H1
"Huntingdon County, PA",2006-2007,45684,45802,118,0.258,49,69,42,61,H1
"Huntingdon County, PA",2007-2008,45802,45853,51,0.111,-27,78,42,61,H1
"Huntingdon County, PA",2008-2009,45853,45896,43,0.094,-6,49,42,61,H1
"Huntingdon County, PA",2009-2010,45896,45998,102,0.222,-47,149,42,61,H1
"Huntingdon County, PA",2010-2011,45998,46115,117,0.254,2,115,42,61,H1
"Huntingdon County, PA",2011-2012,46115,46018,-97,-0.21,-26,-71,42,61,H1
"Huntingdon County, PA",2012-2013,46018,45871,-147,-0.319,-62,-85,42,61,H1
"Huntingdon County, PA",2013-2014,45871,45750,-121,-0.264,-60,-61,42,61,H1
"Huntingdon County, PA",2014-2015,45791,45668,-123,-0.269,-61,-62,42,61,H1
"Huntingdon County, PA",2015-2016,45668,45503,-165,-0.361,-78,-87,42,61,H1
"Huntingdon County, PA",2016-2017,45503,45491,-12,-0.026,-118,106,42,61,H1
"Indiana County, PA",2000-2001,89518,89265,-253,-0.283,-16,-237,42,63,H1
"Indiana County, PA",2001-2002,89265,89133,-132,-0.148,-68,-64,42,63,H1
"Indiana County, PA",2002-2003,89133,89346,213,0.239,-25,238,42,63,H1
"Indiana County, PA",2003-2004,89346,89041,-305,-0.341,25,-330,42,63,H1
"Indiana County, PA",2004-2005,89041,88760,-281,-0.316,-41,-240,42,63,H1
"Indiana County, PA",2005-2006,88760,88716,-44,-0.05,-32,-12,42,63,H1
"Indiana County, PA",2006-2007,88716,88520,-196,-0.221,46,-242,42,63,H1
"Indiana County, PA",2007-2008,88520,88807,287,0.324,-13,300,42,63,H1
"Indiana County, PA",2008-2009,88807,88836,29,0.033,-14,43,42,63,H1
"Indiana County, PA",2009-2010,88836,88810,-26,-0.029,-67,41,42,63,H1
"Indiana County, PA",2010-2011,88810,88536,-274,-0.309,-58,-216,42,63,H1
"Indiana County, PA",2011-2012,88536,88209,-327,-0.369,-30,-297,42,63,H1
"Indiana County, PA",2012-2013,88209,88246,37,0.042,69,-32,42,63,H1
"Indiana County, PA",2013-2014,88246,87706,-540,-0.612,14,-554,42,63,H1
"Indiana County, PA",2014-2015,87487,86966,-521,-0.596,-52,-469,42,63,H1
"Indiana County, PA",2015-2016,86966,85256,-1710,-1.966,-108,-1602,42,63,H1
"Indiana County, PA",2016-2017,85256,84953,-303,-0.355,-140,-163,42,63,H1
"Jefferson County, PA",2000-2001,45872,45644,-228,-0.497,-45,-183,42,65,H1
"Jefferson County, PA",2001-2002,45644,45507,-137,-0.3,-45,-92,42,65,H1
"Jefferson County, PA",2002-2003,45507,45537,30,0.066,-69,99,42,65,H1
"Jefferson County, PA",2003-2004,45537,45418,-119,-0.261,-51,-68,42,65,H1
"Jefferson County, PA",2004-2005,45418,45353,-65,-0.143,-55,-10,42,65,H1
"Jefferson County, PA",2005-2006,45353,45323,-30,-0.066,-42,12,42,65,H1
"Jefferson County, PA",2006-2007,45323,45335,12,0.026,0,12,42,65,H1
"Jefferson County, PA",2007-2008,45335,45260,-75,-0.165,-62,-13,42,65,H1
"Jefferson County, PA",2008-2009,45260,45073,-187,-0.413,-49,-138,42,65,H1
"Jefferson County, PA",2009-2010,45073,45228,155,0.344,-84,239,42,65,H1
"Jefferson County, PA",2010-2011,45228,44958,-270,-0.597,-69,-201,42,65,H1
"Jefferson County, PA",2011-2012,44958,44872,-86,-0.191,-50,-36,42,65,H1
"Jefferson County, PA",2012-2013,44872,44977,105,0.234,-28,133,42,65,H1
"Jefferson County, PA",2013-2014,44977,44638,-339,-0.754,-28,-311,42,65,H1
"Jefferson County, PA",2014-2015,44609,44430,-179,-0.401,-31,-148,42,65,H1
"Jefferson County, PA",2015-2016,44430,43955,-475,-1.069,-54,-421,42,65,H1
"Jefferson County, PA",2016-2017,43955,43804,-151,-0.344,-34,-117,42,65,H1
"Juniata County, PA",2000-2001,22850,22892,42,0.184,52,-10,42,67,H1
"Juniata County, PA",2001-2002,22892,23129,237,1.035,79,158,42,67,H1
"Juniata County, PA",2002-2003,23129,23434,305,1.319,101,204,42,67,H1
"Juniata County, PA",2003-2004,23434,23767,333,1.421,110,223,42,67,H1
"Juniata County, PA",2004-2005,23767,23986,219,0.921,73,146,42,67,H1
"Juniata County, PA",2005-2006,23986,24107,121,0.504,44,77,42,67,H1
"Juniata County, PA",2006-2007,24107,24238,131,0.543,61,70,42,67,H1
"Juniata County, PA",2007-2008,24238,24409,171,0.706,62,109,42,67,H1
"Juniata County, PA",2008-2009,24409,24549,140,0.574,63,77,42,67,H1
"Juniata County, PA",2009-2010,24549,24541,-8,-0.033,30,-38,42,67,H1
"Juniata County, PA",2010-2011,24541,24923,382,1.557,47,335,42,67,H1
"Juniata County, PA",2011-2012,24923,24915,-8,-0.032,25,-33,42,67,H1
"Juniata County, PA",2012-2013,24915,24790,-125,-0.502,4,-129,42,67,H1
"Juniata County, PA",2013-2014,24790,24796,6,0.024,-4,10,42,67,H1
"Juniata County, PA",2014-2015,24806,24737,-69,-0.278,8,-77,42,67,H1
"Juniata County, PA",2015-2016,24737,24475,-262,-1.059,-7,-255,42,67,H1
"Juniata County, PA",2016-2017,24475,24514,39,0.159,0,39,42,67,H1
"Lackawanna County, PA",2000-2001,212999,212692,-307,-0.144,-634,327,42,69,H1
"Lackawanna County, PA",2001-2002,212692,211980,-712,-0.335,-866,154,42,69,H1
"Lackawanna County, PA",2002-2003,211980,211769,-211,-0.1,-656,445,42,69,H1
"Lackawanna County, PA",2003-2004,211769,211861,92,0.043,-824,916,42,69,H1
"Lackawanna County, PA",2004-2005,211861,212305,444,0.21,-498,942,42,69,H1
"Lackawanna County, PA",2005-2006,212305,212595,290,0.137,-535,825,42,69,H1
"Lackawanna County, PA",2006-2007,212595,213513,918,0.432,-286,1204,42,69,H1
"Lackawanna County, PA",2007-2008,213513,214044,531,0.249,-323,854,42,69,H1
"Lackawanna County, PA",2008-2009,214044,214138,94,0.044,-329,423,42,69,H1
"Lackawanna County, PA",2009-2010,214138,214471,333,0.156,-321,654,42,69,H1
"Lackawanna County, PA",2010-2011,214471,214582,111,0.052,-459,570,42,69,H1
"Lackawanna County, PA",2011-2012,214582,214510,-72,-0.034,-493,421,42,69,H1
"Lackawanna County, PA",2012-2013,214510,213834,-676,-0.315,-538,-138,42,69,H1
"Lackawanna County, PA",2013-2014,213834,212719,-1115,-0.521,-460,-655,42,69,H1
"Lackawanna County, PA",2014-2015,212561,211917,-644,-0.303,-320,-324,42,69,H1
"Lackawanna County, PA",2015-2016,211917,210872,-1045,-0.493,-399,-646,42,69,H1
"Lackawanna County, PA",2016-2017,210872,210761,-111,-0.053,-400,289,42,69,H1
"Lancaster County, PA",2000-2001,471955,475483,3528,0.748,2519,1009,42,71,H1
"Lancaster County, PA",2001-2002,475483,480118,4635,0.975,2405,2230,42,71,H1
"Lancaster County, PA",2002-2003,480118,485119,5001,1.042,2393,2608,42,71,H1
"Lancaster County, PA",2003-2004,485119,489977,4858,1.001,2252,2606,42,71,H1
"Lancaster County, PA",2004-2005,489977,494722,4745,0.968,2216,2529,42,71,H1
"Lancaster County, PA",2005-2006,494722,500922,6200,1.253,2568,3632,42,71,H1
"Lancaster County, PA",2006-2007,500922,506639,5717,1.141,2994,2723,42,71,H1
"Lancaster County, PA",2007-2008,506639,511957,5318,1.05,2722,2596,42,71,H1
"Lancaster County, PA",2008-2009,511957,516577,4620,0.902,2544,2076,42,71,H1
"Lancaster County, PA",2009-2010,516577,520317,3740,0.724,2074,1666,42,71,H1
"Lancaster County, PA",2010-2011,520317,523670,3353,0.644,2484,869,42,71,H1
"Lancaster County, PA",2011-2012,523670,526766,3096,0.591,2522,574,42,71,H1
"Lancaster County, PA",2012-2013,526766,530122,3356,0.637,2190,1166,42,71,H1
"Lancaster County, PA",2013-2014,530122,533320,3198,0.603,2293,905,42,71,H1
"Lancaster County, PA",2014-2015,533645,536624,2979,0.558,2431,548,42,71,H1
"Lancaster County, PA",2015-2016,536624,539137,2513,0.468,2194,319,42,71,H1
"Lancaster County, PA",2016-2017,539137,542903,3766,0.699,2198,1568,42,71,H1
"Lawrence County, PA",2000-2001,94547,94085,-462,-0.489,-211,-251,42,73,H1
"Lawrence County, PA",2001-2002,94085,93938,-147,-0.156,-195,48,42,73,H1
"Lawrence County, PA",2002-2003,93938,93696,-242,-0.258,-175,-67,42,73,H1
"Lawrence County, PA",2003-2004,93696,93250,-446,-0.476,-277,-169,42,73,H1
"Lawrence County, PA",2004-2005,93250,92741,-509,-0.546,-257,-252,42,73,H1
"Lawrence County, PA",2005-2006,92741,92248,-493,-0.532,-151,-342,42,73,H1
"Lawrence County, PA",2006-2007,92248,92007,-241,-0.261,-113,-128,42,73,H1
"Lawrence County, PA",2007-2008,92007,91798,-209,-0.227,-158,-51,42,73,H1
"Lawrence County, PA",2008-2009,91798,91391,-407,-0.443,-160,-247,42,73,H1
"Lawrence County, PA",2009-2010,91391,91033,-358,-0.392,-216,-142,42,73,H1
"Lawrence County, PA",2010-2011,91033,90386,-647,-0.711,-239,-408,42,73,H1
"Lawrence County, PA",2011-2012,90386,89797,-589,-0.652,-132,-457,42,73,H1
"Lawrence County, PA",2012-2013,89797,89306,-491,-0.547,-134,-357,42,73,H1
"Lawrence County, PA",2013-2014,89306,88771,-535,-0.599,-110,-425,42,73,H1
"Lawrence County, PA",2014-2015,88514,88082,-432,-0.488,-180,-252,42,73,H1
"Lawrence County, PA",2015-2016,88082,87631,-451,-0.512,-174,-277,42,73,H1
"Lawrence County, PA",2016-2017,87631,87069,-562,-0.641,-157,-405,42,73,H1
"Lebanon County, PA",2000-2001,120309,120954,645,0.536,182,463,42,75,H1
"Lebanon County, PA",2001-2002,120954,121698,744,0.615,145,599,42,75,H1
"Lebanon County, PA",2002-2003,121698,123154,1456,1.196,217,1239,42,75,H1
"Lebanon County, PA",2003-2004,123154,124644,1490,1.21,149,1341,42,75,H1
"Lebanon County, PA",2004-2005,124644,126197,1553,1.246,220,1333,42,75,H1
"Lebanon County, PA",2005-2006,126197,128302,2105,1.668,218,1887,42,75,H1
"Lebanon County, PA",2006-2007,128302,130182,1880,1.465,298,1582,42,75,H1
"Lebanon County, PA",2007-2008,130182,131574,1392,1.069,305,1087,42,75,H1
"Lebanon County, PA",2008-2009,131574,132959,1385,1.053,231,1154,42,75,H1
"Lebanon County, PA",2009-2010,132959,133728,769,0.578,108,661,42,75,H1
"Lebanon County, PA",2010-2011,133728,134544,816,0.61,284,532,42,75,H1
"Lebanon County, PA",2011-2012,134544,135582,1038,0.771,217,821,42,75,H1
"Lebanon County, PA",2012-2013,135582,135707,125,0.092,302,-177,42,75,H1
"Lebanon County, PA",2013-2014,135707,136359,652,0.48,206,446,42,75,H1
"Lebanon County, PA",2014-2015,136196,137067,871,0.64,160,711,42,75,H1
"Lebanon County, PA",2015-2016,137067,138557,1490,1.087,87,1403,42,75,H1
"Lebanon County, PA",2016-2017,138557,139754,1197,0.864,99,1098,42,75,H1
"Lehigh County, PA",2000-2001,312368,314823,2455,0.786,533,1922,42,77,H1
"Lehigh County, PA",2001-2002,314823,317252,2429,0.772,642,1787,42,77,H1
"Lehigh County, PA",2002-2003,317252,321588,4336,1.367,793,3543,42,77,H1
"Lehigh County, PA",2003-2004,321588,326138,4550,1.415,836,3714,42,77,H1
"Lehigh County, PA",2004-2005,326138,331327,5189,1.591,1025,4164,42,77,H1
"Lehigh County, PA",2005-2006,331327,336794,5467,1.65,1048,4419,42,77,H1
"Lehigh County, PA",2006-2007,336794,340848,4054,1.204,1283,2771,42,77,H1
"Lehigh County, PA",2007-2008,340848,344743,3895,1.143,1307,2588,42,77,H1
"Lehigh County, PA",2008-2009,344743,347237,2494,0.723,1078,1416,42,77,H1
"Lehigh County, PA",2009-2010,347237,350172,2935,0.845,1016,1919,42,77,H1
"Lehigh County, PA",2010-2011,350172,353653,3481,0.994,933,2548,42,77,H1
"Lehigh County, PA",2011-2012,353653,355269,1616,0.457,836,780,42,77,H1
"Lehigh County, PA",2012-2013,355269,355768,499,0.14,788,-289,42,77,H1
"Lehigh County, PA",2013-2014,355768,357823,2055,0.578,864,1191,42,77,H1
"Lehigh County, PA",2014-2015,358286,360685,2399,0.67,983,1416,42,77,H1
"Lehigh County, PA",2015-2016,360685,363113,2428,0.673,910,1518,42,77,H1
"Lehigh County, PA",2016-2017,363113,366494,3381,0.931,865,2516,42,77,H1
"Luzerne County, PA",2000-2001,318842,316665,-2177,-0.683,-1470,-707,42,79,H1
"Luzerne County, PA",2001-2002,316665,315711,-954,-0.301,-1409,455,42,79,H1
"Luzerne County, PA",2002-2003,315711,315640,-71,-0.022,-1441,1370,42,79,H1
"Luzerne County, PA",2003-2004,315640,315439,-201,-0.064,-1339,1138,42,79,H1
"Luzerne County, PA",2004-2005,315439,316187,748,0.237,-1120,1868,42,79,H1
"Luzerne County, PA",2005-2006,316187,316837,650,0.206,-947,1597,42,79,H1
"Luzerne County, PA",2006-2007,316837,318232,1395,0.44,-882,2277,42,79,H1
"Luzerne County, PA",2007-2008,318232,319210,978,0.307,-722,1700,42,79,H1
"Luzerne County, PA",2008-2009,319210,320527,1317,0.413,-746,2063,42,79,H1
"Luzerne County, PA",2009-2010,320527,320952,425,0.133,-899,1324,42,79,H1
"Luzerne County, PA",2010-2011,320952,321041,89,0.028,-948,1037,42,79,H1
"Luzerne County, PA",2011-2012,321041,321276,235,0.073,-605,840,42,79,H1
"Luzerne County, PA",2012-2013,321276,319862,-1414,-0.44,-884,-530,42,79,H1
"Luzerne County, PA",2013-2014,319862,318829,-1033,-0.323,-914,-119,42,79,H1
"Luzerne County, PA",2014-2015,319337,318449,-888,-0.278,-772,-116,42,79,H1
"Luzerne County, PA",2015-2016,318449,316801,-1648,-0.518,-806,-842,42,79,H1
"Luzerne County, PA",2016-2017,316801,317343,542,0.171,-855,1397,42,79,H1
"Lycoming County, PA",2000-2001,119851,118930,-921,-0.768,76,-997,42,81,H1
"Lycoming County, PA",2001-2002,118930,118344,-586,-0.493,88,-674,42,81,H1
"Lycoming County, PA",2002-2003,118344,118108,-236,-0.199,56,-292,42,81,H1
"Lycoming County, PA",2003-2004,118108,117911,-197,-0.167,108,-305,42,81,H1
"Lycoming County, PA",2004-2005,117911,117530,-381,-0.323,41,-422,42,81,H1
"Lycoming County, PA",2005-2006,117530,116983,-547,-0.465,154,-701,42,81,H1
"Lycoming County, PA",2006-2007,116983,116524,-459,-0.392,108,-567,42,81,H1
"Lycoming County, PA",2007-2008,116524,116147,-377,-0.324,74,-451,42,81,H1
"Lycoming County, PA",2008-2009,116147,116081,-66,-0.057,139,-205,42,81,H1
"Lycoming County, PA",2009-2010,116081,116173,92,0.079,53,39,42,81,H1
"Lycoming County, PA",2010-2011,116173,116669,496,0.427,-98,594,42,81,H1
"Lycoming County, PA",2011-2012,116669,117296,627,0.537,94,533,42,81,H1
"Lycoming County, PA",2012-2013,117296,116732,-564,-0.481,54,-618,42,81,H1
"Lycoming County, PA",2013-2014,116732,116508,-224,-0.192,-9,-215,42,81,H1
"Lycoming County, PA",2014-2015,116503,116048,-455,-0.391,-14,-441,42,81,H1
"Lycoming County, PA",2015-2016,116048,114708,-1340,-1.155,-161,-1179,42,81,H1
"Lycoming County, PA",2016-2017,114708,113841,-867,-0.756,-153,-714,42,81,H1
"McKean County, PA",2000-2001,45748,45263,-485,-1.06,-109,-376,42,83,H1
"McKean County, PA",2001-2002,45263,45419,156,0.345,17,139,42,83,H1
"McKean County, PA",2002-2003,45419,44980,-439,-0.967,-59,-380,42,83,H1
"McKean County, PA",2003-2004,44980,44582,-398,-0.885,-67,-331,42,83,H1
"McKean County, PA",2004-2005,44582,44187,-395,-0.886,-70,-325,42,83,H1
"McKean County, PA",2005-2006,44187,44309,122,0.276,18,104,42,83,H1
"McKean County, PA",2006-2007,44309,44045,-264,-0.596,-104,-160,42,83,H1
"McKean County, PA",2007-2008,44045,43856,-189,-0.429,-3,-186,42,83,H1
"McKean County, PA",2008-2009,43856,43701,-155,-0.353,-33,-122,42,83,H1
"McKean County, PA",2009-2010,43701,43354,-347,-0.794,-37,-310,42,83,H1
"McKean County, PA",2010-2011,43354,43190,-164,-0.378,-88,-76,42,83,H1
"McKean County, PA",2011-2012,43190,43234,44,0.102,-88,132,42,83,H1
"McKean County, PA",2012-2013,43234,42788,-446,-1.032,-138,-308,42,83,H1
"McKean County, PA",2013-2014,42788,42554,-234,-0.547,-137,-97,42,83,H1
"McKean County, PA",2014-2015,42708,42412,-296,-0.693,-62,-234,42,83,H1
"McKean County, PA",2015-2016,42412,41518,-894,-2.108,-98,-796,42,83,H1
"McKean County, PA",2016-2017,41518,41330,-188,-0.453,-121,-67,42,83,H1
"Mercer County, PA",2000-2001,120211,119861,-350,-0.291,-135,-215,42,85,H1
"Mercer County, PA",2001-2002,119861,119476,-385,-0.321,-121,-264,42,85,H1
"Mercer County, PA",2002-2003,119476,119431,-45,-0.038,-94,49,42,85,H1
"Mercer County, PA",2003-2004,119431,119113,-318,-0.266,-119,-199,42,85,H1
"Mercer County, PA",2004-2005,119113,118594,-519,-0.436,-256,-263,42,85,H1
"Mercer County, PA",2005-2006,118594,118123,-471,-0.397,-142,-329,42,85,H1
"Mercer County, PA",2006-2007,118123,117794,-329,-0.279,-204,-125,42,85,H1
"Mercer County, PA",2007-2008,117794,117189,-605,-0.514,-224,-381,42,85,H1
"Mercer County, PA",2008-2009,117189,116816,-373,-0.318,-166,-207,42,85,H1
"Mercer County, PA",2009-2010,116816,116571,-245,-0.21,-226,-19,42,85,H1
"Mercer County, PA",2010-2011,116571,116182,-389,-0.334,-253,-136,42,85,H1
"Mercer County, PA",2011-2012,116182,115747,-435,-0.374,-243,-192,42,85,H1
"Mercer County, PA",2012-2013,115747,115313,-434,-0.375,-250,-184,42,85,H1
"Mercer County, PA",2013-2014,115313,114884,-429,-0.372,-300,-129,42,85,H1
"Mercer County, PA",2014-2015,114957,114234,-723,-0.629,-305,-418,42,85,H1
"Mercer County, PA",2015-2016,114234,112673,-1561,-1.366,-282,-1279,42,85,H1
"Mercer County, PA",2016-2017,112673,111750,-923,-0.819,-332,-591,42,85,H1
"Mifflin County, PA",2000-2001,46479,46535,56,0.12,35,21,42,87,H1
"Mifflin County, PA",2001-2002,46535,46558,23,0.049,61,-38,42,87,H1
"Mifflin County, PA",2002-2003,46558,46420,-138,-0.296,99,-237,42,87,H1
"Mifflin County, PA",2003-2004,46420,46313,-107,-0.231,30,-137,42,87,H1
"Mifflin County, PA",2004-2005,46313,46377,64,0.138,4,60,42,87,H1
"Mifflin County, PA",2005-2006,46377,46435,58,0.125,94,-36,42,87,H1
"Mifflin County, PA",2006-2007,46435,46551,116,0.25,82,34,42,87,H1
"Mifflin County, PA",2007-2008,46551,46600,49,0.105,91,-42,42,87,H1
"Mifflin County, PA",2008-2009,46600,46662,62,0.133,59,3,42,87,H1
"Mifflin County, PA",2009-2010,46662,46657,-5,-0.011,4,-9,42,87,H1
"Mifflin County, PA",2010-2011,46657,46787,130,0.279,27,103,42,87,H1
"Mifflin County, PA",2011-2012,46787,46829,42,0.09,94,-52,42,87,H1
"Mifflin County, PA",2012-2013,46829,46701,-128,-0.273,85,-213,42,87,H1
"Mifflin County, PA",2013-2014,46701,46552,-149,-0.319,75,-224,42,87,H1
"Mifflin County, PA",2014-2015,46535,46500,-35,-0.075,52,-87,42,87,H1
"Mifflin County, PA",2015-2016,46500,46316,-184,-0.396,49,-233,42,87,H1
"Mifflin County, PA",2016-2017,46316,46388,72,0.155,73,-1,42,87,H1
"Monroe County, PA",2000-2001,139710,143775,4065,2.91,314,3751,42,89,H1
"Monroe County, PA",2001-2002,143775,148833,5058,3.518,365,4693,42,89,H1
"Monroe County, PA",2002-2003,148833,154027,5194,3.49,365,4829,42,89,H1
"Monroe County, PA",2003-2004,154027,158181,4154,2.697,359,3795,42,89,H1
"Monroe County, PA",2004-2005,158181,162045,3864,2.443,434,3430,42,89,H1
"Monroe County, PA",2005-2006,162045,165185,3140,1.938,432,2708,42,89,H1
"Monroe County, PA",2006-2007,165185,167352,2167,1.312,357,1810,42,89,H1
"Monroe County, PA",2007-2008,167352,168576,1224,0.731,450,774,42,89,H1
"Monroe County, PA",2008-2009,168576,169390,814,0.483,415,399,42,89,H1
"Monroe County, PA",2009-2010,169390,169940,550,0.325,147,403,42,89,H1
"Monroe County, PA",2010-2011,169940,169860,-80,-0.047,188,-268,42,89,H1
"Monroe County, PA",2011-2012,169860,168465,-1395,-0.821,58,-1453,42,89,H1
"Monroe County, PA",2012-2013,168465,167130,-1335,-0.792,58,-1393,42,89,H1
"Monroe County, PA",2013-2014,167130,166314,-816,-0.488,-30,-786,42,89,H1
"Monroe County, PA",2014-2015,167242,166397,-845,-0.505,-34,-811,42,89,H1
"Monroe County, PA",2015-2016,166397,166516,119,0.072,-121,240,42,89,H1
"Monroe County, PA",2016-2017,166516,168046,1530,0.919,-109,1639,42,89,H1
"Montgomery County, PA",2000-2001,751335,759392,8057,1.072,2353,5704,42,91,H1
"Montgomery County, PA",2001-2002,759392,766056,6664,0.878,2421,4243,42,91,H1
"Montgomery County, PA",2002-2003,766056,772666,6610,0.863,2638,3972,42,91,H1
"Montgomery County, PA",2003-2004,772666,776493,3827,0.495,2537,1290,42,91,H1
"Montgomery County, PA",2004-2005,776493,779401,2908,0.375,2270,638,42,91,H1
"Montgomery County, PA",2005-2006,779401,781519,2118,0.272,2357,-239,42,91,H1
"Montgomery County, PA",2006-2007,781519,785170,3651,0.467,2467,1184,42,91,H1
"Montgomery County, PA",2007-2008,785170,789250,4080,0.52,2169,1911,42,91,H1
"Montgomery County, PA",2008-2009,789250,795494,6244,0.791,2088,4156,42,91,H1
"Montgomery County, PA",2009-2010,795494,801066,5572,0.7,2187,3385,42,91,H1
"Montgomery County, PA",2010-2011,801066,805487,4421,0.552,1956,2465,42,91,H1
"Montgomery County, PA",2011-2012,805487,809618,4131,0.513,1846,2285,42,91,H1
"Montgomery County, PA",2012-2013,809618,813832,4214,0.52,1549,2665,42,91,H1
"Montgomery County, PA",2013-2014,813832,816857,3025,0.372,1457,1568,42,91,H1
"Montgomery County, PA",2014-2015,816608,819264,2656,0.325,1353,1303,42,91,H1
"Montgomery County, PA",2015-2016,819264,820656,1392,0.17,1331,61,42,91,H1
"Montgomery County, PA",2016-2017,820656,826075,5419,0.66,1011,4408,42,91,H1
"Montour County, PA",2000-2001,18275,18294,19,0.104,-48,67,42,93,H1
"Montour County, PA",2001-2002,18294,18237,-57,-0.312,-6,-51,42,93,H1
"Montour County, PA",2002-2003,18237,18239,2,0.011,5,-3,42,93,H1
"Montour County, PA",2003-2004,18239,18174,-65,-0.356,16,-81,42,93,H1
"Montour County, PA",2004-2005,18174,18183,9,0.05,-51,60,42,93,H1
"Montour County, PA",2005-2006,18183,18114,-69,-0.379,-43,-26,42,93,H1
"Montour County, PA",2006-2007,18114,18107,-7,-0.039,-27,20,42,93,H1
"Montour County, PA",2007-2008,18107,18090,-17,-0.094,9,-26,42,93,H1
"Montour County, PA",2008-2009,18090,18165,75,0.415,-35,110,42,93,H1
"Montour County, PA",2009-2010,18165,18327,162,0.892,-16,178,42,93,H1
"Montour County, PA",2010-2011,18327,18379,52,0.284,22,30,42,93,H1
"Montour County, PA",2011-2012,18379,18491,112,0.609,-16,128,42,93,H1
"Montour County, PA",2012-2013,18491,18535,44,0.238,13,31,42,93,H1
"Montour County, PA",2013-2014,18535,18641,106,0.572,11,95,42,93,H1
"Montour County, PA",2014-2015,18609,18557,-52,-0.279,-25,-27,42,93,H1
"Montour County, PA",2015-2016,18557,18230,-327,-1.762,-7,-320,42,93,H1
"Montour County, PA",2016-2017,18230,18272,42,0.23,-6,48,42,93,H1
"Northampton County, PA",2000-2001,267740,269363,1623,0.606,432,1191,42,95,H1
"Northampton County, PA",2001-2002,269363,272782,3419,1.269,242,3177,42,95,H1
"Northampton County, PA",2002-2003,272782,276735,3953,1.449,381,3572,42,95,H1
"Northampton County, PA",2003-2004,276735,281374,4639,1.676,544,4095,42,95,H1
"Northampton County, PA",2004-2005,281374,285198,3824,1.359,331,3493,42,95,H1
"Northampton County, PA",2005-2006,285198,289628,4430,1.553,506,3924,42,95,H1
"Northampton County, PA",2006-2007,289628,293212,3584,1.237,770,2814,42,95,H1
"Northampton County, PA",2007-2008,293212,295096,1884,0.643,676,1208,42,95,H1
"Northampton County, PA",2008-2009,295096,296645,1549,0.525,679,870,42,95,H1
"Northampton County, PA",2009-2010,296645,298028,1383,0.466,362,1021,42,95,H1
"Northampton County, PA",2010-2011,298028,298332,304,0.102,105,199,42,95,H1
"Northampton County, PA",2011-2012,298332,299363,1031,0.346,314,717,42,95,H1
"Northampton County, PA",2012-2013,299363,299747,384,0.128,254,130,42,95,H1
"Northampton County, PA",2013-2014,299747,300654,907,0.303,250,657,42,95,H1
"Northampton County, PA",2014-2015,300172,300813,641,0.214,16,625,42,95,H1
"Northampton County, PA",2015-2016,300813,301760,947,0.315,-129,1076,42,95,H1
"Northampton County, PA",2016-2017,301760,303405,1645,0.545,-119,1764,42,95,H1
"Northumberland County, PA",2000-2001,94823,94176,-647,-0.682,-241,-406,42,97,H1
"Northumberland County, PA",2001-2002,94176,94024,-152,-0.161,-232,80,42,97,H1
"Northumberland County, PA",2002-2003,94024,93910,-114,-0.121,-195,81,42,97,H1
"Northumberland County, PA",2003-2004,93910,93692,-218,-0.232,-252,34,42,97,H1
"Northumberland County, PA",2004-2005,93692,93543,-149,-0.159,-279,130,42,97,H1
"Northumberland County, PA",2005-2006,93543,93475,-68,-0.073,-84,16,42,97,H1
"Northumberland County, PA",2006-2007,93475,93728,253,0.271,-145,398,42,97,H1
"Northumberland County, PA",2007-2008,93728,94150,422,0.45,-167,589,42,97,H1
"Northumberland County, PA",2008-2009,94150,94774,624,0.663,-168,792,42,97,H1
"Northumberland County, PA",2009-2010,94774,94351,-423,-0.446,-192,-231,42,97,H1
"Northumberland County, PA",2010-2011,94351,94480,129,0.137,-229,358,42,97,H1
"Northumberland County, PA",2011-2012,94480,94556,76,0.08,-221,297,42,97,H1
"Northumberland County, PA",2012-2013,94556,94138,-418,-0.442,-97,-321,42,97,H1
"Northumberland County, PA",2013-2014,94138,93944,-194,-0.206,-86,-108,42,97,H1
"Northumberland County, PA",2014-2015,93770,93246,-524,-0.559,-143,-381,42,97,H1
"Northumberland County, PA",2015-2016,93246,92479,-767,-0.823,-167,-600,42,97,H1
"Northumberland County, PA",2016-2017,92479,92029,-450,-0.487,-168,-282,42,97,H1
"Perry County, PA",2000-2001,43634,43804,170,0.39,205,-35,42,99,H1
"Perry County, PA",2001-2002,43804,43896,92,0.21,121,-29,42,99,H1
"Perry County, PA",2002-2003,43896,44216,320,0.729,125,195,42,99,H1
"Perry County, PA",2003-2004,44216,44463,247,0.559,143,104,42,99,H1
"Perry County, PA",2004-2005,44463,44741,278,0.625,163,115,42,99,H1
"Perry County, PA",2005-2006,44741,45121,380,0.849,143,237,42,99,H1
"Perry County, PA",2006-2007,45121,45454,333,0.738,165,168,42,99,H1
"Perry County, PA",2007-2008,45454,45549,95,0.209,148,-53,42,99,H1
"Perry County, PA",2008-2009,45549,45874,325,0.714,157,168,42,99,H1
"Perry County, PA",2009-2010,45874,46024,150,0.327,118,32,42,99,H1
"Perry County, PA",2010-2011,46024,45891,-133,-0.289,189,-322,42,99,H1
"Perry County, PA",2011-2012,45891,45772,-119,-0.259,100,-219,42,99,H1
"Perry County, PA",2012-2013,45772,45621,-151,-0.33,146,-297,42,99,H1
"Perry County, PA",2013-2014,45621,45634,13,0.028,124,-111,42,99,H1
"Perry County, PA",2014-2015,45523,45685,162,0.356,100,62,42,99,H1
"Perry County, PA",2015-2016,45685,45986,301,0.659,90,211,42,99,H1
"Perry County, PA",2016-2017,45986,46127,141,0.307,99,42,42,99,H1
"Philadelphia County, PA",2000-2001,1514563,1505455,-9108,-0.601,4070,-13178,42,101,H6
"Philadelphia County, PA",2001-2002,1505455,1498493,-6962,-0.462,4260,-11222,42,101,H6
"Philadelphia County, PA",2002-2003,1498493,1493802,-4691,-0.313,4996,-9687,42,101,H6
"Philadelphia County, PA",2003-2004,1493802,1492882,-920,-0.062,5798,-6718,42,101,H6
"Philadelphia County, PA",2004-2005,1492882,1490861,-2021,-0.135,6001,-8022,42,101,H6
"Philadelphia County, PA",2005-2006,1490861,1488710,-2151,-0.144,7110,-9261,42,101,H6
"Philadelphia County, PA",2006-2007,1488710,1493309,4599,0.309,8312,-3713,42,101,H6
"Philadelphia County, PA",2007-2008,1493309,1499731,6422,0.43,7638,-1216,42,101,H6
"Philadelphia County, PA",2008-2009,1499731,1514694,14963,0.998,6865,8098,42,101,H6
"Philadelphia County, PA",2009-2010,1514694,1528544,13850,0.914,8703,5147,42,101,H6
"Philadelphia County, PA",2010-2011,1528544,1539313,10769,0.705,8886,1883,42,101,H6
"Philadelphia County, PA",2011-2012,1539313,1550396,11083,0.72,8904,2179,42,101,H6
"Philadelphia County, PA",2012-2013,1550396,1556052,5656,0.365,8619,-2963,42,101,H6
"Philadelphia County, PA",2013-2014,1556052,1560297,4245,0.273,8277,-4032,42,101,H6
"Philadelphia County, PA",2014-2015,1561562,1567442,5880,0.377,7522,-1642,42,101,H6
"Philadelphia County, PA",2015-2016,1567442,1574765,7323,0.467,7038,285,42,101,H6
"Philadelphia County, PA",2016-2017,1574765,1580863,6098,0.387,6750,-652,42,101,H6
"Pike County, PA",2000-2001,46380,47594,1214,2.618,45,1169,42,103,H1
"Pike County, PA",2001-2002,47594,49063,1469,3.087,27,1442,42,103,H1
"Pike County, PA",2002-2003,49063,50837,1774,3.616,37,1737,42,103,H1
"Pike County, PA",2003-2004,50837,52293,1456,2.864,62,1394,42,103,H1
"Pike County, PA",2004-2005,52293,5.40E+04,1707,3.264,23,1684,42,103,H1
"Pike County, PA",2005-2006,5.40E+04,55601,1601,2.965,73,1528,42,103,H1
"Pike County, PA",2006-2007,55601,56627,1026,1.845,99,927,42,103,H1
"Pike County, PA",2007-2008,56627,57739,1112,1.964,20,1092,42,103,H1
"Pike County, PA",2008-2009,57739,57671,-68,-0.118,-7,-61,42,103,H1
"Pike County, PA",2009-2010,57671,57331,-340,-0.59,-137,-203,42,103,H1
"Pike County, PA",2010-2011,57331,57515,184,0.321,-29,213,42,103,H1
"Pike County, PA",2011-2012,57515,56762,-753,-1.309,-91,-662,42,103,H1
"Pike County, PA",2012-2013,56762,56614,-148,-0.261,-45,-103,42,103,H1
"Pike County, PA",2013-2014,56614,56191,-423,-0.747,-46,-377,42,103,H1
"Pike County, PA",2014-2015,56238,55949,-289,-0.514,-70,-219,42,103,H1
"Pike County, PA",2015-2016,55949,55191,-758,-1.355,-94,-664,42,103,H1
"Pike County, PA",2016-2017,55191,55691,500,0.906,-102,602,42,103,H1
"Potter County, PA",2000-2001,18123,18146,23,0.127,19,4,42,105,H1
"Potter County, PA",2001-2002,18146,18273,127,0.7,8,119,42,105,H1
"Potter County, PA",2002-2003,18273,18168,-105,-0.575,-6,-99,42,105,H1
"Potter County, PA",2003-2004,18168,18067,-101,-0.556,14,-115,42,105,H1
"Potter County, PA",2004-2005,18067,17914,-153,-0.847,-26,-127,42,105,H1
"Potter County, PA",2005-2006,17914,17944,30,0.167,24,6,42,105,H1
"Potter County, PA",2006-2007,17944,17659,-285,-1.588,-8,-277,42,105,H1
"Potter County, PA",2007-2008,17659,17464,-195,-1.104,-15,-180,42,105,H1
"Potter County, PA",2008-2009,17464,17382,-82,-0.47,-20,-62,42,105,H1
"Potter County, PA",2009-2010,17382,17474,92,0.529,-36,128,42,105,H1
"Potter County, PA",2010-2011,17474,17457,-17,-0.097,2,-19,42,105,H1
"Potter County, PA",2011-2012,17457,17625,168,0.962,-7,175,42,105,H1
"Potter County, PA",2012-2013,17625,17491,-134,-0.76,-11,-123,42,105,H1
"Potter County, PA",2013-2014,17491,17206,-285,-1.629,-9,-276,42,105,H1
"Potter County, PA",2014-2015,17220,17093,-127,-0.738,-9,-118,42,105,H1
"Potter County, PA",2015-2016,17093,16925,-168,-0.983,-26,-142,42,105,H1
"Potter County, PA",2016-2017,16925,16802,-123,-0.727,-29,-94,42,105,H1
"Schuylkill County, PA",2000-2001,149994,149175,-819,-0.546,-722,-97,42,107,H1
"Schuylkill County, PA",2001-2002,149175,148705,-470,-0.315,-666,196,42,107,H1
"Schuylkill County, PA",2002-2003,148705,147792,-913,-0.614,-629,-284,42,107,H1
"Schuylkill County, PA",2003-2004,147792,147081,-711,-0.481,-765,54,42,107,H1
"Schuylkill County, PA",2004-2005,147081,146976,-105,-0.071,-664,559,42,107,H1
"Schuylkill County, PA",2005-2006,146976,148005,1029,0.7,-420,1449,42,107,H1
"Schuylkill County, PA",2006-2007,148005,148387,382,0.258,-522,904,42,107,H1
"Schuylkill County, PA",2007-2008,148387,148463,76,0.051,-409,485,42,107,H1
"Schuylkill County, PA",2008-2009,148463,148358,-105,-0.071,-418,313,42,107,H1
"Schuylkill County, PA",2009-2010,148358,148225,-133,-0.09,-563,430,42,107,H1
"Schuylkill County, PA",2010-2011,148225,147623,-602,-0.406,-531,-71,42,107,H1
"Schuylkill County, PA",2011-2012,147623,147288,-335,-0.227,-538,203,42,107,H1
"Schuylkill County, PA",2012-2013,147288,146798,-490,-0.333,-512,22,42,107,H1
"Schuylkill County, PA",2013-2014,146798,145797,-1001,-0.682,-505,-496,42,107,H1
"Schuylkill County, PA",2014-2015,145546,144590,-956,-0.657,-480,-476,42,107,H1
"Schuylkill County, PA",2015-2016,144590,143335,-1255,-0.868,-549,-706,42,107,H1
"Schuylkill County, PA",2016-2017,143335,142569,-766,-0.534,-517,-249,42,107,H1
"Snyder County, PA",2000-2001,37502,37955,453,1.208,169,284,42,109,H1
"Snyder County, PA",2001-2002,37955,38104,149,0.393,117,32,42,109,H1
"Snyder County, PA",2002-2003,38104,38319,215,0.564,149,66,42,109,H1
"Snyder County, PA",2003-2004,38319,38519,200,0.522,133,67,42,109,H1
"Snyder County, PA",2004-2005,38519,38448,-71,-0.184,125,-196,42,109,H1
"Snyder County, PA",2005-2006,38448,38946,498,1.295,195,303,42,109,H1
"Snyder County, PA",2006-2007,38946,39295,349,0.896,143,206,42,109,H1
"Snyder County, PA",2007-2008,39295,39481,186,0.473,155,31,42,109,H1
"Snyder County, PA",2008-2009,39481,39550,69,0.175,136,-67,42,109,H1
"Snyder County, PA",2009-2010,39550,39741,191,0.483,98,93,42,109,H1
"Snyder County, PA",2010-2011,39741,39659,-82,-0.206,79,-161,42,109,H1
"Snyder County, PA",2011-2012,39659,39796,137,0.345,105,32,42,109,H1
"Snyder County, PA",2012-2013,39796,40093,297,0.746,130,167,42,109,H1
"Snyder County, PA",2013-2014,40093,40323,230,0.574,134,96,42,109,H1
"Snyder County, PA",2014-2015,40255,40444,189,0.47,114,75,42,109,H1
"Snyder County, PA",2015-2016,40444,40667,223,0.551,100,123,42,109,H1
"Snyder County, PA",2016-2017,40667,40801,134,0.33,92,42,42,109,H1
"Somerset County, PA",2000-2001,80034,79523,-511,-0.638,-106,-405,42,111,H1
"Somerset County, PA",2001-2002,79523,79621,98,0.123,-167,265,42,111,H1
"Somerset County, PA",2002-2003,79621,79754,133,0.167,-171,304,42,111,H1
"Somerset County, PA",2003-2004,79754,79402,-352,-0.441,-201,-151,42,111,H1
"Somerset County, PA",2004-2005,79402,79015,-387,-0.487,-168,-219,42,111,H1
"Somerset County, PA",2005-2006,79015,78834,-181,-0.229,-269,88,42,111,H1
"Somerset County, PA",2006-2007,78834,78490,-344,-0.436,-208,-136,42,111,H1
"Somerset County, PA",2007-2008,78490,78120,-370,-0.471,-223,-147,42,111,H1
"Somerset County, PA",2008-2009,78120,78025,-95,-0.122,-231,136,42,111,H1
"Somerset County, PA",2009-2010,78025,77693,-332,-0.426,-310,-22,42,111,H1
"Somerset County, PA",2010-2011,77693,77313,-380,-0.489,-353,-27,42,111,H1
"Somerset County, PA",2011-2012,77313,77110,-203,-0.263,-160,-43,42,111,H1
"Somerset County, PA",2012-2013,77110,76722,-388,-0.503,-228,-160,42,111,H1
"Somerset County, PA",2013-2014,76722,76218,-504,-0.657,-255,-249,42,111,H1
"Somerset County, PA",2014-2015,76226,75522,-704,-0.924,-281,-423,42,111,H1
"Somerset County, PA",2015-2016,75522,75070,-452,-0.599,-259,-193,42,111,H1
"Somerset County, PA",2016-2017,75070,74501,-569,-0.758,-266,-303,42,111,H1
"Sullivan County, PA",2000-2001,6577,6625,48,0.73,-47,95,42,113,H1
"Sullivan County, PA",2001-2002,6625,6592,-33,-0.498,-59,26,42,113,H1
"Sullivan County, PA",2002-2003,6592,6574,-18,-0.273,-54,36,42,113,H1
"Sullivan County, PA",2003-2004,6574,6554,-20,-0.304,-58,38,42,113,H1
"Sullivan County, PA",2004-2005,6554,6513,-41,-0.626,-60,19,42,113,H1
"Sullivan County, PA",2005-2006,6513,6487,-26,-0.399,-38,12,42,113,H1
"Sullivan County, PA",2006-2007,6487,6525,38,0.586,-51,89,42,113,H1
"Sullivan County, PA",2007-2008,6525,6462,-63,-0.966,-37,-26,42,113,H1
"Sullivan County, PA",2008-2009,6462,6449,-13,-0.201,-56,43,42,113,H1
"Sullivan County, PA",2009-2010,6449,6405,-44,-0.682,-60,16,42,113,H1
"Sullivan County, PA",2010-2011,6405,6450,45,0.703,-73,118,42,113,H1
"Sullivan County, PA",2011-2012,6450,6453,3,0.047,-44,47,42,113,H1
"Sullivan County, PA",2012-2013,6453,6352,-101,-1.565,-56,-45,42,113,H1
"Sullivan County, PA",2013-2014,6352,6339,-13,-0.205,-53,40,42,113,H1
"Sullivan County, PA",2014-2015,6336,6328,-8,-0.126,-49,41,42,113,H1
"Sullivan County, PA",2015-2016,6328,6089,-239,-3.777,-68,-171,42,113,H1
"Sullivan County, PA",2016-2017,6089,6089,0,0,-60,60,42,113,H1
"Susquehanna County, PA",2000-2001,42260,42483,223,0.528,17,206,42,115,H1
"Susquehanna County, PA",2001-2002,42483,42410,-73,-0.172,-73,0,42,115,H1
"Susquehanna County, PA",2002-2003,42410,42685,275,0.648,16,259,42,115,H1
"Susquehanna County, PA",2003-2004,42685,42930,245,0.574,-24,269,42,115,H1
"Susquehanna County, PA",2004-2005,42930,43219,289,0.673,-51,340,42,115,H1
"Susquehanna County, PA",2005-2006,43219,43376,157,0.363,-76,233,42,115,H1
"Susquehanna County, PA",2006-2007,43376,43310,-66,-0.152,-33,-33,42,115,H1
"Susquehanna County, PA",2007-2008,43310,43405,95,0.219,-32,127,42,115,H1
"Susquehanna County, PA",2008-2009,43405,43346,-59,-0.136,-15,-44,42,115,H1
"Susquehanna County, PA",2009-2010,43346,43392,46,0.106,-70,116,42,115,H1
"Susquehanna County, PA",2010-2011,43392,43119,-273,-0.629,-109,-164,42,115,H1
"Susquehanna County, PA",2011-2012,43119,42773,-346,-0.802,-34,-312,42,115,H1
"Susquehanna County, PA",2012-2013,42773,42334,-439,-1.026,-30,-409,42,115,H1
"Susquehanna County, PA",2013-2014,42334,41920,-414,-0.978,-17,-397,42,115,H1
"Susquehanna County, PA",2014-2015,41947,41666,-281,-0.67,-11,-270,42,115,H1
"Susquehanna County, PA",2015-2016,41666,41238,-428,-1.027,-99,-329,42,115,H1
"Susquehanna County, PA",2016-2017,41238,40985,-253,-0.614,-73,-180,42,115,H1
"Tioga County, PA",2000-2001,41309,41496,187,0.453,53,134,42,117,H1
"Tioga County, PA",2001-2002,41496,41638,142,0.342,13,129,42,117,H1
"Tioga County, PA",2002-2003,41638,41676,38,0.091,39,-1,42,117,H1
"Tioga County, PA",2003-2004,41676,41724,48,0.115,29,19,42,117,H1
"Tioga County, PA",2004-2005,41724,41579,-145,-0.348,2,-147,42,117,H1
"Tioga County, PA",2005-2006,41579,41347,-232,-0.558,-43,-189,42,117,H1
"Tioga County, PA",2006-2007,41347,41371,24,0.058,-7,31,42,117,H1
"Tioga County, PA",2007-2008,41371,41609,238,0.575,29,209,42,117,H1
"Tioga County, PA",2008-2009,41609,41818,209,0.502,-11,220,42,117,H1
"Tioga County, PA",2009-2010,41818,42028,210,0.502,-42,252,42,117,H1
"Tioga County, PA",2010-2011,42028,42417,389,0.926,-22,411,42,117,H1
"Tioga County, PA",2011-2012,42417,42611,194,0.457,63,131,42,117,H1
"Tioga County, PA",2012-2013,42611,42458,-153,-0.359,56,-209,42,117,H1
"Tioga County, PA",2013-2014,42458,42274,-184,-0.433,44,-228,42,117,H1
"Tioga County, PA",2014-2015,42078,41877,-201,-0.478,-34,-167,42,117,H1
"Tioga County, PA",2015-2016,41877,41227,-650,-1.552,-45,-605,42,117,H1
"Tioga County, PA",2016-2017,41227,40793,-434,-1.053,-38,-396,42,117,H1
"Union County, PA",2000-2001,41622,42098,476,1.144,37,439,42,119,H1
"Union County, PA",2001-2002,42098,42372,274,0.651,53,221,42,119,H1
"Union County, PA",2002-2003,42372,42622,250,0.59,54,196,42,119,H1
"Union County, PA",2003-2004,42622,43287,665,1.56,88,577,42,119,H1
"Union County, PA",2004-2005,43287,43690,403,0.931,8,395,42,119,H1
"Union County, PA",2005-2006,43690,44666,976,2.234,50,926,42,119,H1
"Union County, PA",2006-2007,44666,44846,180,0.403,41,139,42,119,H1
"Union County, PA",2007-2008,44846,45057,211,0.47,42,169,42,119,H1
"Union County, PA",2008-2009,45057,44795,-262,-0.581,59,-321,42,119,H1
"Union County, PA",2009-2010,44795,44972,177,0.395,14,163,42,119,H1
"Union County, PA",2010-2011,44972,45069,97,0.216,19,78,42,119,H1
"Union County, PA",2011-2012,45069,45139,70,0.155,20,50,42,119,H1
"Union County, PA",2012-2013,45139,44719,-420,-0.93,54,-474,42,119,H1
"Union County, PA",2013-2014,44719,44874,155,0.347,17,138,42,119,H1
"Union County, PA",2014-2015,44908,44954,46,0.102,21,25,42,119,H1
"Union County, PA",2015-2016,44954,45440,486,1.081,-26,512,42,119,H1
"Union County, PA",2016-2017,45440,44595,-845,-1.86,-13,-832,42,119,H1
"Venango County, PA",2000-2001,57405,57091,-314,-0.547,-34,-280,42,121,H1
"Venango County, PA",2001-2002,57091,56789,-302,-0.529,-61,-241,42,121,H1
"Venango County, PA",2002-2003,56789,56590,-199,-0.35,-92,-107,42,121,H1
"Venango County, PA",2003-2004,56590,56196,-394,-0.696,-130,-264,42,121,H1
"Venango County, PA",2004-2005,56196,56016,-180,-0.32,-117,-63,42,121,H1
"Venango County, PA",2005-2006,56016,55761,-255,-0.455,17,-272,42,121,H1
"Venango County, PA",2006-2007,55761,55510,-251,-0.45,-12,-239,42,121,H1
"Venango County, PA",2007-2008,55510,55315,-195,-0.351,-14,-181,42,121,H1
"Venango County, PA",2008-2009,55315,55087,-228,-0.412,-68,-160,42,121,H1
"Venango County, PA",2009-2010,55087,54945,-142,-0.258,-135,-7,42,121,H1
"Venango County, PA",2010-2011,54945,54707,-238,-0.433,-124,-114,42,121,H1
"Venango County, PA",2011-2012,54707,54235,-472,-0.863,-111,-361,42,121,H1
"Venango County, PA",2012-2013,54235,53908,-327,-0.603,-100,-227,42,121,H1
"Venango County, PA",2013-2014,53908,53529,-379,-0.703,-86,-293,42,121,H1
"Venango County, PA",2014-2015,53503,53119,-384,-0.718,-130,-254,42,121,H1
"Venango County, PA",2015-2016,53119,52469,-650,-1.224,-122,-528,42,121,H1
"Venango County, PA",2016-2017,52469,51762,-707,-1.347,-162,-545,42,121,H1
"Warren County, PA",2000-2001,43716,43562,-154,-0.352,16,-170,42,123,H1
"Warren County, PA",2001-2002,43562,43184,-378,-0.868,-70,-308,42,123,H1
"Warren County, PA",2002-2003,43184,42896,-288,-0.667,-64,-224,42,123,H1
"Warren County, PA",2003-2004,42896,42667,-229,-0.534,-80,-149,42,123,H1
"Warren County, PA",2004-2005,42667,42218,-449,-1.052,-67,-382,42,123,H1
"Warren County, PA",2005-2006,42218,41972,-246,-0.583,-98,-148,42,123,H1
"Warren County, PA",2006-2007,41972,41963,-9,-0.021,-72,63,42,123,H1
"Warren County, PA",2007-2008,41963,41853,-110,-0.262,-102,-8,42,123,H1
"Warren County, PA",2008-2009,41853,41831,-22,-0.053,-90,68,42,123,H1
"Warren County, PA",2009-2010,41831,41753,-78,-0.186,-113,35,42,123,H1
"Warren County, PA",2010-2011,41753,41476,-277,-0.663,-73,-204,42,123,H1
"Warren County, PA",2011-2012,41476,41212,-264,-0.637,-112,-152,42,123,H1
"Warren County, PA",2012-2013,41212,40944,-268,-0.65,-91,-177,42,123,H1
"Warren County, PA",2013-2014,40944,40703,-241,-0.589,-102,-139,42,123,H1
"Warren County, PA",2014-2015,40720,40396,-324,-0.796,-89,-235,42,123,H1
"Warren County, PA",2015-2016,40396,39998,-398,-0.985,-152,-246,42,123,H1
"Warren County, PA",2016-2017,39998,39659,-339,-0.848,-139,-200,42,123,H1
"Washington County, PA",2000-2001,203008,203179,171,0.084,-468,639,42,125,H1
"Washington County, PA",2001-2002,203179,203104,-75,-0.037,-552,477,42,125,H1
"Washington County, PA",2002-2003,203104,203859,755,0.372,-192,947,42,125,H1
"Washington County, PA",2003-2004,203859,204090,231,0.113,-358,589,42,125,H1
"Washington County, PA",2004-2005,204090,205359,1269,0.622,-506,1775,42,125,H1
"Washington County, PA",2005-2006,205359,205992,633,0.308,-266,899,42,125,H1
"Washington County, PA",2006-2007,205992,206259,267,0.13,-294,561,42,125,H1
"Washington County, PA",2007-2008,206259,207240,981,0.476,-245,1226,42,125,H1
"Washington County, PA",2008-2009,207240,207571,331,0.16,-244,575,42,125,H1
"Washington County, PA",2009-2010,207571,207891,320,0.154,-467,787,42,125,H1
"Washington County, PA",2010-2011,207891,208080,189,0.091,-594,783,42,125,H1
"Washington County, PA",2011-2012,208080,208431,351,0.169,-414,765,42,125,H1
"Washington County, PA",2012-2013,208431,208194,-237,-0.114,-510,273,42,125,H1
"Washington County, PA",2013-2014,208194,208187,-7,-0.003,-498,491,42,125,H1
"Washington County, PA",2014-2015,208175,208261,86,0.041,-431,517,42,125,H1
"Washington County, PA",2015-2016,208261,207341,-920,-0.442,-614,-306,42,125,H1
"Washington County, PA",2016-2017,207341,207298,-43,-0.021,-556,513,42,125,H1
"Wayne County, PA",2000-2001,47843,47994,151,0.316,-30,181,42,127,H1
"Wayne County, PA",2001-2002,47994,48330,336,0.7,-153,489,42,127,H1
"Wayne County, PA",2002-2003,48330,48938,608,1.258,-129,737,42,127,H1
"Wayne County, PA",2003-2004,48938,49423,485,0.991,-109,594,42,127,H1
"Wayne County, PA",2004-2005,49423,50409,986,1.995,-159,1145,42,127,H1
"Wayne County, PA",2005-2006,50409,52031,1622,3.218,-94,1716,42,127,H1
"Wayne County, PA",2006-2007,52031,52341,310,0.596,-106,416,42,127,H1
"Wayne County, PA",2007-2008,52341,51692,-649,-1.24,-145,-504,42,127,H1
"Wayne County, PA",2008-2009,51692,52552,860,1.664,-168,1028,42,127,H1
"Wayne County, PA",2009-2010,52552,52883,331,0.63,-241,572,42,127,H1
"Wayne County, PA",2010-2011,52883,52217,-666,-1.259,-172,-494,42,127,H1
"Wayne County, PA",2011-2012,52217,51685,-532,-1.019,-187,-345,42,127,H1
"Wayne County, PA",2012-2013,51685,51649,-36,-0.07,-161,125,42,127,H1
"Wayne County, PA",2013-2014,51649,51401,-248,-0.48,-153,-95,42,127,H1
"Wayne County, PA",2014-2015,51436,51198,-238,-0.463,-130,-108,42,127,H1
"Wayne County, PA",2015-2016,51198,51230,32,0.063,-171,203,42,127,H1
"Wayne County, PA",2016-2017,51230,51205,-25,-0.049,-163,138,42,127,H1
"Westmoreland County, PA",2000-2001,369664,368698,-966,-0.261,-821,-145,42,129,H1
"Westmoreland County, PA",2001-2002,368698,367680,-1018,-0.276,-1040,22,42,129,H1
"Westmoreland County, PA",2002-2003,367680,367836,156,0.042,-925,1081,42,129,H1
"Westmoreland County, PA",2003-2004,367836,367281,-555,-0.151,-985,430,42,129,H1
"Westmoreland County, PA",2004-2005,367281,366946,-335,-0.091,-1118,783,42,129,H1
"Westmoreland County, PA",2005-2006,366946,366559,-387,-0.105,-841,454,42,129,H1
"Westmoreland County, PA",2006-2007,366559,366318,-241,-0.066,-956,715,42,129,H1
"Westmoreland County, PA",2007-2008,366318,366058,-260,-0.071,-974,714,42,129,H1
"Westmoreland County, PA",2008-2009,366058,365259,-799,-0.218,-996,197,42,129,H1
"Westmoreland County, PA",2009-2010,365259,365063,-196,-0.054,-1332,1136,42,129,H1
"Westmoreland County, PA",2010-2011,365063,364373,-690,-0.189,-1202,512,42,129,H1
"Westmoreland County, PA",2011-2012,364373,363100,-1273,-0.349,-1173,-100,42,129,H1
"Westmoreland County, PA",2012-2013,363100,361080,-2020,-0.556,-1196,-824,42,129,H1
"Westmoreland County, PA",2013-2014,361080,359320,-1760,-0.487,-1296,-464,42,129,H1
"Westmoreland County, PA",2014-2015,359353,357956,-1397,-0.389,-1230,-167,42,129,H1
"Westmoreland County, PA",2015-2016,357956,354788,-3168,-0.885,-1321,-1847,42,129,H1
"Westmoreland County, PA",2016-2017,354788,352627,-2161,-0.609,-1368,-793,42,129,H1
"Wyoming County, PA",2000-2001,28038,28119,81,0.289,64,17,42,131,H1
"Wyoming County, PA",2001-2002,28119,28011,-108,-0.384,37,-145,42,131,H1
"Wyoming County, PA",2002-2003,28011,28074,63,0.225,40,23,42,131,H1
"Wyoming County, PA",2003-2004,28074,28195,121,0.431,41,80,42,131,H1
"Wyoming County, PA",2004-2005,28195,28160,-35,-0.124,28,-63,42,131,H1
"Wyoming County, PA",2005-2006,28160,28194,34,0.121,16,18,42,131,H1
"Wyoming County, PA",2006-2007,28194,28287,93,0.33,50,43,42,131,H1
"Wyoming County, PA",2007-2008,28287,28294,7,0.025,24,-17,42,131,H1
"Wyoming County, PA",2008-2009,28294,28268,-26,-0.092,22,-48,42,131,H1
"Wyoming County, PA",2009-2010,28268,28232,-36,-0.127,-9,-27,42,131,H1
"Wyoming County, PA",2010-2011,28232,28290,58,0.205,30,28,42,131,H1
"Wyoming County, PA",2011-2012,28290,28348,58,0.205,7,51,42,131,H1
"Wyoming County, PA",2012-2013,28348,28142,-206,-0.727,-18,-188,42,131,H1
"Wyoming County, PA",2013-2014,28142,28131,-11,-0.039,-31,20,42,131,H1
"Wyoming County, PA",2014-2015,28143,27800,-343,-1.219,-29,-314,42,131,H1
"Wyoming County, PA",2015-2016,27800,27498,-302,-1.086,-64,-238,42,131,H1
"Wyoming County, PA",2016-2017,27498,27322,-176,-0.64,-67,-109,42,131,H1
"York County, PA",2000-2001,382743,385773,3030,0.792,1174,1856,42,133,H1
"York County, PA",2001-2002,385773,389692,3919,1.016,1369,2550,42,133,H1
"York County, PA",2002-2003,389692,395093,5401,1.386,1319,4082,42,133,H1
"York County, PA",2003-2004,395093,401403,6310,1.597,1519,4791,42,133,H1
"York County, PA",2004-2005,401403,409066,7663,1.909,1419,6244,42,133,H1
"York County, PA",2005-2006,409066,418043,8977,2.195,1671,7306,42,133,H1
"York County, PA",2006-2007,418043,424919,6876,1.645,1823,5053,42,133,H1
"York County, PA",2007-2008,424919,429399,4480,1.054,1829,2651,42,133,H1
"York County, PA",2008-2009,429399,433022,3623,0.844,1818,1805,42,133,H1
"York County, PA",2009-2010,433022,435543,2521,0.582,1343,1178,42,133,H1
"York County, PA",2010-2011,435543,436868,1325,0.304,1263,62,42,133,H1
"York County, PA",2011-2012,436868,437699,831,0.19,1222,-391,42,133,H1
"York County, PA",2012-2013,437699,439393,1694,0.387,1170,524,42,133,H1
"York County, PA",2013-2014,439393,440755,1362,0.31,1119,243,42,133,H1
"York County, PA",2014-2015,441177,442867,1690,0.383,1161,529,42,133,H1
"York County, PA",2015-2016,442867,443809,942,0.213,811,131,42,133,H1
"York County, PA",2016-2017,443809,446078,2269,0.511,903,1366,42,133,H1
Rhode Island,2000-2001,1050268,1057142,6874,0.654,2574,4300,44,0,STATE
Rhode Island,2001-2002,1057142,1065995,8853,0.837,2613,6240,44,0,STATE
Rhode Island,2002-2003,1065995,1071342,5347,0.502,2770,2577,44,0,STATE
Rhode Island,2003-2004,1071342,1074579,3237,0.302,3340,-103,44,0,STATE
Rhode Island,2004-2005,1074579,1067916,-6663,-0.62,2384,-9047,44,0,STATE
Rhode Island,2005-2006,1067916,1063096,-4820,-0.451,2822,-7642,44,0,STATE
Rhode Island,2006-2007,1063096,1057315,-5781,-0.544,2769,-8550,44,0,STATE
Rhode Island,2007-2008,1057315,1055003,-2312,-0.219,2810,-5122,44,0,STATE
Rhode Island,2008-2009,1055003,1053646,-1357,-0.129,2846,-4203,44,0,STATE
Rhode Island,2009-2010,1053646,1053219,-427,-0.041,2364,-2791,44,0,STATE
Rhode Island,2010-2011,1053219,1051856,-1363,-0.129,1241,-2604,44,0,STATE
Rhode Island,2011-2012,1051856,1052393,537,0.051,1696,-1159,44,0,STATE
Rhode Island,2012-2013,1052393,1052856,463,0.044,1233,-770,44,0,STATE
Rhode Island,2013-2014,1052856,1054907,2051,0.195,1145,906,44,0,STATE
Rhode Island,2014-2015,1054907,1056298,1391,0.132,1451,-60,44,0,STATE
Rhode Island,2015-2016,1056298,1057566,1268,0.12,1096,172,44,0,STATE
Rhode Island,2016-2017,1057566,1059639,2073,0.196,1155,918,44,0,STATE
"Bristol County, RI",2000-2001,50697,50942,245,0.483,-59,304,44,1,H4
"Bristol County, RI",2001-2002,50942,51850,908,1.782,-21,929,44,1,H4
"Bristol County, RI",2002-2003,51850,51658,-192,-0.37,-51,-141,44,1,H4
"Bristol County, RI",2003-2004,51658,52213,555,1.074,-1,556,44,1,H4
"Bristol County, RI",2004-2005,52213,51667,-546,-1.046,-67,-479,44,1,H4
"Bristol County, RI",2005-2006,51667,50996,-671,-1.299,-74,-597,44,1,H4
"Bristol County, RI",2006-2007,50996,50914,-82,-0.161,-96,14,44,1,H4
"Bristol County, RI",2007-2008,50914,50668,-246,-0.483,-126,-120,44,1,H4
"Bristol County, RI",2008-2009,50668,50075,-593,-1.17,-55,-538,44,1,H4
"Bristol County, RI",2009-2010,50075,49846,-229,-0.457,-112,-117,44,1,H4
"Bristol County, RI",2010-2011,49846,49284,-562,-1.127,-111,-451,44,1,H4
"Bristol County, RI",2011-2012,49284,49238,-46,-0.093,-101,55,44,1,H4
"Bristol County, RI",2012-2013,49238,49263,25,0.051,-142,167,44,1,H4
"Bristol County, RI",2013-2014,49263,49060,-203,-0.412,-155,-48,44,1,H4
"Bristol County, RI",2014-2015,49047,49084,37,0.075,-178,215,44,1,H4
"Bristol County, RI",2015-2016,49084,48878,-206,-0.42,-217,11,44,1,H4
"Bristol County, RI",2016-2017,48878,48912,34,0.07,-178,212,44,1,H4
"Kent County, RI",2000-2001,167516,168516,1.00E+03,0.597,162,838,44,3,H4
"Kent County, RI",2001-2002,168516,169478,962,0.571,137,825,44,3,H4
"Kent County, RI",2002-2003,169478,170641,1163,0.686,94,1069,44,3,H4
"Kent County, RI",2003-2004,170641,170539,-102,-0.06,156,-258,44,3,H4
"Kent County, RI",2004-2005,170539,169815,-724,-0.425,-1,-723,44,3,H4
"Kent County, RI",2005-2006,169815,168522,-1293,-0.761,36,-1329,44,3,H4
"Kent County, RI",2006-2007,168522,167515,-1007,-0.598,-35,-972,44,3,H4
"Kent County, RI",2007-2008,167515,167269,-246,-0.147,7,-253,44,3,H4
"Kent County, RI",2008-2009,167269,166766,-503,-0.301,46,-549,44,3,H4
"Kent County, RI",2009-2010,166766,166009,-757,-0.454,9,-766,44,3,H4
"Kent County, RI",2010-2011,166009,165306,-703,-0.423,-173,-530,44,3,H4
"Kent County, RI",2011-2012,165306,164900,-406,-0.246,-80,-326,44,3,H4
"Kent County, RI",2012-2013,164900,164923,23,0.014,-134,157,44,3,H4
"Kent County, RI",2013-2014,164923,165128,205,0.124,-114,319,44,3,H4
"Kent County, RI",2014-2015,164957,164801,-156,-0.095,-54,-102,44,3,H4
"Kent County, RI",2015-2016,164801,163690,-1111,-0.674,-106,-1005,44,3,H4
"Kent County, RI",2016-2017,163690,163760,70,0.043,-75,145,44,3,H4
"Newport County, RI",2000-2001,85734,85754,20,0.023,204,-184,44,5,H4
"Newport County, RI",2001-2002,85754,85953,199,0.232,159,40,44,5,H4
"Newport County, RI",2002-2003,85953,85646,-307,-0.357,126,-433,44,5,H4
"Newport County, RI",2003-2004,85646,85509,-137,-0.16,221,-358,44,5,H4
"Newport County, RI",2004-2005,85509,83962,-1547,-1.809,65,-1612,44,5,H4
"Newport County, RI",2005-2006,83962,85130,1168,1.391,131,1037,44,5,H4
"Newport County, RI",2006-2007,85130,82881,-2249,-2.642,163,-2412,44,5,H4
"Newport County, RI",2007-2008,82881,82505,-376,-0.454,105,-481,44,5,H4
"Newport County, RI",2008-2009,82505,82896,391,0.474,60,331,44,5,H4
"Newport County, RI",2009-2010,82896,83158,262,0.316,16,246,44,5,H4
"Newport County, RI",2010-2011,83158,83003,-155,-0.186,59,-214,44,5,H4
"Newport County, RI",2011-2012,83003,82884,-119,-0.143,32,-151,44,5,H4
"Newport County, RI",2012-2013,82884,82457,-427,-0.515,27,-454,44,5,H4
"Newport County, RI",2013-2014,82457,82358,-99,-0.12,15,-114,44,5,H4
"Newport County, RI",2014-2015,82448,82423,-25,-0.03,-3,-22,44,5,H4
"Newport County, RI",2015-2016,82423,83495,1072,1.301,-53,1125,44,5,H4
"Newport County, RI",2016-2017,83495,83460,-35,-0.042,-15,-20,44,5,H4
"Providence County, RI",2000-2001,622378,626935,4557,0.732,1865,2692,44,7,H4
"Providence County, RI",2001-2002,626935,632252,5317,0.848,1988,3329,44,7,H4
"Providence County, RI",2002-2003,632252,636149,3897,0.616,2209,1688,44,7,H4
"Providence County, RI",2003-2004,636149,638358,2209,0.347,2668,-459,44,7,H4
"Providence County, RI",2004-2005,638358,635060,-3298,-0.517,2186,-5484,44,7,H4
"Providence County, RI",2005-2006,635060,631691,-3369,-0.531,2542,-5911,44,7,H4
"Providence County, RI",2006-2007,631691,629110,-2581,-0.409,2724,-5305,44,7,H4
"Providence County, RI",2007-2008,629110,627889,-1221,-0.194,2605,-3826,44,7,H4
"Providence County, RI",2008-2009,627889,626304,-1585,-0.252,2567,-4152,44,7,H4
"Providence County, RI",2009-2010,626304,626965,661,0.106,2415,-1754,44,7,H4
"Providence County, RI",2010-2011,626965,627922,957,0.153,1590,-633,44,7,H4
"Providence County, RI",2011-2012,627922,629368,1446,0.23,1919,-473,44,7,H4
"Providence County, RI",2012-2013,629368,630171,803,0.128,1849,-1046,44,7,H4
"Providence County, RI",2013-2014,630171,631974,1803,0.286,1801,2,44,7,H4
"Providence County, RI",2014-2015,632025,633473,1448,0.229,1912,-464,44,7,H4
"Providence County, RI",2015-2016,633473,635522,2049,0.323,1817,232,44,7,H4
"Providence County, RI",2016-2017,635522,637357,1835,0.289,1759,76,44,7,H4
"Washington County, RI",2000-2001,123943,124995,1052,0.849,402,650,44,9,H4
"Washington County, RI",2001-2002,124995,126462,1467,1.174,350,1117,44,9,H4
"Washington County, RI",2002-2003,126462,127248,786,0.622,392,394,44,9,H4
"Washington County, RI",2003-2004,127248,127960,712,0.56,296,416,44,9,H4
"Washington County, RI",2004-2005,127960,127412,-548,-0.428,201,-749,44,9,H4
"Washington County, RI",2005-2006,127412,126757,-655,-0.514,187,-842,44,9,H4
"Washington County, RI",2006-2007,126757,126895,138,0.109,13,125,44,9,H4
"Washington County, RI",2007-2008,126895,126672,-223,-0.176,219,-442,44,9,H4
"Washington County, RI",2008-2009,126672,127605,933,0.737,228,705,44,9,H4
"Washington County, RI",2009-2010,127605,127100,-505,-0.396,36,-541,44,9,H4
"Washington County, RI",2010-2011,127100,126505,-595,-0.468,-124,-471,44,9,H4
"Washington County, RI",2011-2012,126505,126247,-258,-0.204,-78,-180,44,9,H4
"Washington County, RI",2012-2013,126247,126540,293,0.232,-154,447,44,9,H4
"Washington County, RI",2013-2014,126540,126653,113,0.089,-172,285,44,9,H4
"Washington County, RI",2014-2015,126430,126517,87,0.069,-226,313,44,9,H4
"Washington County, RI",2015-2016,126517,125981,-536,-0.424,-345,-191,44,9,H4
"Washington County, RI",2016-2017,125981,126150,169,0.134,-336,505,44,9,H4
South Carolina,2000-2001,4024223,4064995,40772,1.013,19120,21652,45,0,STATE
South Carolina,2001-2002,4064995,4107795,42800,1.053,18106,24694,45,0,STATE
South Carolina,2002-2003,4107795,4150297,42502,1.035,17151,25351,45,0,STATE
South Carolina,2003-2004,4150297,4210921,60624,1.461,18300,42324,45,0,STATE
South Carolina,2004-2005,4210921,4270150,59229,1.407,18644,40585,45,0,STATE
South Carolina,2005-2006,4270150,4357847,87697,2.054,20938,66759,45,0,STATE
South Carolina,2006-2007,4357847,4444110,86263,1.979,24757,61506,45,0,STATE
South Carolina,2007-2008,4444110,4528996,84886,1.91,21420,63466,45,0,STATE
South Carolina,2008-2009,4528996,4589872,60876,1.344,18446,42430,45,0,STATE
South Carolina,2009-2010,4589872,4635894,46022,1.003,17417,28605,45,0,STATE
South Carolina,2010-2011,4635894,4672733,36839,0.795,15440,21399,45,0,STATE
South Carolina,2011-2012,4672733,4721341,48608,1.04,15440,33168,45,0,STATE
South Carolina,2012-2013,4721341,4768498,47157,0.999,11909,35248,45,0,STATE
South Carolina,2013-2014,4768498,4829160,60662,1.272,12442,48220,45,0,STATE
South Carolina,2014-2015,4829160,4896146,66986,1.387,12808,54178,45,0,STATE
South Carolina,2015-2016,4896146,4959822,63676,1.301,10083,53593,45,0,STATE
South Carolina,2016-2017,4959822,5024369,64547,1.301,9925,54622,45,0,STATE
"Abbeville County, SC",2000-2001,26229,26330,101,0.385,74,27,45,1,H1
"Abbeville County, SC",2001-2002,26330,26311,-19,-0.072,78,-97,45,1,H1
"Abbeville County, SC",2002-2003,26311,26306,-5,-0.019,38,-43,45,1,H1
"Abbeville County, SC",2003-2004,26306,26235,-71,-0.27,81,-152,45,1,H1
"Abbeville County, SC",2004-2005,26235,25995,-240,-0.915,44,-284,45,1,H1
"Abbeville County, SC",2005-2006,25995,25821,-174,-0.669,33,-207,45,1,H1
"Abbeville County, SC",2006-2007,25821,25745,-76,-0.294,27,-103,45,1,H1
"Abbeville County, SC",2007-2008,25745,25699,-46,-0.179,51,-97,45,1,H1
"Abbeville County, SC",2008-2009,25699,25614,-85,-0.331,26,-111,45,1,H1
"Abbeville County, SC",2009-2010,25614,25345,-269,-1.05,14,-283,45,1,H1
"Abbeville County, SC",2010-2011,25345,25117,-228,-0.9,-62,-166,45,1,H1
"Abbeville County, SC",2011-2012,25117,25065,-52,-0.207,29,-81,45,1,H1
"Abbeville County, SC",2012-2013,25065,25008,-57,-0.227,8,-65,45,1,H1
"Abbeville County, SC",2013-2014,25008,24965,-43,-0.172,-1,-42,45,1,H1
"Abbeville County, SC",2014-2015,24926,24932,6,0.024,0,6,45,1,H1
"Abbeville County, SC",2015-2016,24932,24717,-215,-0.862,-34,-181,45,1,H1
"Abbeville County, SC",2016-2017,24717,24722,5,0.02,-36,41,45,1,H1
"Aiken County, SC",2000-2001,142742,143676,934,0.654,480,454,45,3,H1
"Aiken County, SC",2001-2002,143676,145226,1550,1.079,411,1139,45,3,H1
"Aiken County, SC",2002-2003,145226,146793,1567,1.079,348,1219,45,3,H1
"Aiken County, SC",2003-2004,146793,148746,1953,1.33,407,1546,45,3,H1
"Aiken County, SC",2004-2005,148746,150152,1406,0.945,494,912,45,3,H1
"Aiken County, SC",2005-2006,150152,152577,2425,1.615,578,1847,45,3,H1
"Aiken County, SC",2006-2007,152577,154814,2237,1.466,930,1307,45,3,H1
"Aiken County, SC",2007-2008,154814,156896,2082,1.345,358,1724,45,3,H1
"Aiken County, SC",2008-2009,156896,158499,1603,1.022,288,1315,45,3,H1
"Aiken County, SC",2009-2010,158499,160589,2090,1.319,221,1869,45,3,H1
"Aiken County, SC",2010-2011,160589,161894,1305,0.813,393,912,45,3,H1
"Aiken County, SC",2011-2012,161894,163426,1532,0.946,404,1128,45,3,H1
"Aiken County, SC",2012-2013,163426,164294,868,0.531,54,814,45,3,H1
"Aiken County, SC",2013-2014,164294,164753,459,0.279,110,349,45,3,H1
"Aiken County, SC",2014-2015,164537,165829,1292,0.785,138,1154,45,3,H1
"Aiken County, SC",2015-2016,165829,166922,1093,0.659,202,891,45,3,H1
"Aiken County, SC",2016-2017,166922,168179,1257,0.753,203,1054,45,3,H1
"Allendale County, SC",2000-2001,11193,11022,-171,-1.528,67,-238,45,5,H1
"Allendale County, SC",2001-2002,11022,11114,92,0.835,66,26,45,5,H1
"Allendale County, SC",2002-2003,11114,11092,-22,-0.198,59,-81,45,5,H1
"Allendale County, SC",2003-2004,11092,11049,-43,-0.388,10,-53,45,5,H1
"Allendale County, SC",2004-2005,11049,11021,-28,-0.253,11,-39,45,5,H1
"Allendale County, SC",2005-2006,11021,10882,-139,-1.261,33,-172,45,5,H1
"Allendale County, SC",2006-2007,10882,10787,-95,-0.873,10,-105,45,5,H1
"Allendale County, SC",2007-2008,10787,10803,16,0.148,34,-18,45,5,H1
"Allendale County, SC",2008-2009,10803,10619,-184,-1.703,16,-200,45,5,H1
"Allendale County, SC",2009-2010,10619,10353,-266,-2.505,8,-274,45,5,H1
"Allendale County, SC",2010-2011,10353,10260,-93,-0.898,10,-103,45,5,H1
"Allendale County, SC",2011-2012,10260,10004,-256,-2.495,-15,-241,45,5,H1
"Allendale County, SC",2012-2013,10004,9822,-182,-1.819,-4,-178,45,5,H1
"Allendale County, SC",2013-2014,9822,9695,-127,-1.293,-14,-113,45,5,H1
"Allendale County, SC",2014-2015,9693,9433,-260,-2.682,-16,-244,45,5,H1
"Allendale County, SC",2015-2016,9433,9059,-374,-3.965,-25,-349,45,5,H1
"Allendale County, SC",2016-2017,9059,9002,-57,-0.629,-36,-21,45,5,H1
"Anderson County, SC",2000-2001,166304,168881,2577,1.55,521,2056,45,7,H1
"Anderson County, SC",2001-2002,168881,170287,1406,0.833,349,1057,45,7,H1
"Anderson County, SC",2002-2003,170287,171862,1575,0.925,386,1189,45,7,H1
"Anderson County, SC",2003-2004,171862,173539,1677,0.976,376,1301,45,7,H1
"Anderson County, SC",2004-2005,173539,175467,1928,1.111,397,1531,45,7,H1
"Anderson County, SC",2005-2006,175467,178579,3112,1.774,499,2613,45,7,H1
"Anderson County, SC",2006-2007,178579,181543,2964,1.66,695,2269,45,7,H1
"Anderson County, SC",2007-2008,181543,184520,2977,1.64,450,2527,45,7,H1
"Anderson County, SC",2008-2009,184520,186544,2024,1.097,399,1625,45,7,H1
"Anderson County, SC",2009-2010,186544,187322,778,0.417,280,498,45,7,H1
"Anderson County, SC",2010-2011,187322,188563,1241,0.662,285,956,45,7,H1
"Anderson County, SC",2011-2012,188563,189365,802,0.425,230,572,45,7,H1
"Anderson County, SC",2012-2013,189365,190754,1389,0.734,250,1139,45,7,H1
"Anderson County, SC",2013-2014,190754,192810,2056,1.078,234,1822,45,7,H1
"Anderson County, SC",2014-2015,192836,194692,1856,0.962,302,1554,45,7,H1
"Anderson County, SC",2015-2016,194692,195968,1276,0.655,122,1154,45,7,H1
"Anderson County, SC",2016-2017,195968,198759,2791,1.424,185,2606,45,7,H1
"Bamberg County, SC",2000-2001,16680,16580,-100,-0.6,71,-171,45,9,H1
"Bamberg County, SC",2001-2002,16580,16548,-32,-0.193,27,-59,45,9,H1
"Bamberg County, SC",2002-2003,16548,16342,-206,-1.245,16,-222,45,9,H1
"Bamberg County, SC",2003-2004,16342,16322,-20,-0.122,34,-54,45,9,H1
"Bamberg County, SC",2004-2005,16322,16360,38,0.233,-14,52,45,9,H1
"Bamberg County, SC",2005-2006,16360,16392,32,0.196,35,-3,45,9,H1
"Bamberg County, SC",2006-2007,16392,16226,-166,-1.013,37,-203,45,9,H1
"Bamberg County, SC",2007-2008,16226,16104,-122,-0.752,1,-123,45,9,H1
"Bamberg County, SC",2008-2009,16104,16022,-82,-0.509,-4,-78,45,9,H1
"Bamberg County, SC",2009-2010,16022,15970,-52,-0.325,-3,-49,45,9,H1
"Bamberg County, SC",2010-2011,15970,15864,-106,-0.664,-38,-68,45,9,H1
"Bamberg County, SC",2011-2012,15864,15790,-74,-0.466,-13,-61,45,9,H1
"Bamberg County, SC",2012-2013,15790,15440,-350,-2.217,-16,-334,45,9,H1
"Bamberg County, SC",2013-2014,15440,15182,-258,-1.671,-30,-228,45,9,H1
"Bamberg County, SC",2014-2015,15191,14880,-311,-2.047,-14,-297,45,9,H1
"Bamberg County, SC",2015-2016,14880,14530,-350,-2.352,-45,-305,45,9,H1
"Bamberg County, SC",2016-2017,14530,14381,-149,-1.025,-61,-88,45,9,H1
"Barnwell County, SC",2000-2001,23478,23406,-72,-0.307,98,-170,45,11,H1
"Barnwell County, SC",2001-2002,23406,23177,-229,-0.978,95,-324,45,11,H1
"Barnwell County, SC",2002-2003,23177,23211,34,0.147,83,-49,45,11,H1
"Barnwell County, SC",2003-2004,23211,22980,-231,-0.995,86,-317,45,11,H1
"Barnwell County, SC",2004-2005,22980,22965,-15,-0.065,97,-112,45,11,H1
"Barnwell County, SC",2005-2006,22965,22886,-79,-0.344,52,-131,45,11,H1
"Barnwell County, SC",2006-2007,22886,22851,-35,-0.153,127,-162,45,11,H1
"Barnwell County, SC",2007-2008,22851,22761,-90,-0.394,105,-195,45,11,H1
"Barnwell County, SC",2008-2009,22761,22611,-150,-0.659,40,-190,45,11,H1
"Barnwell County, SC",2009-2010,22611,22614,3,0.013,31,-28,45,11,H1
"Barnwell County, SC",2010-2011,22614,22404,-210,-0.929,56,-266,45,11,H1
"Barnwell County, SC",2011-2012,22404,22294,-110,-0.491,68,-178,45,11,H1
"Barnwell County, SC",2012-2013,22294,22164,-130,-0.583,24,-154,45,11,H1
"Barnwell County, SC",2013-2014,22164,21959,-205,-0.925,26,-231,45,11,H1
"Barnwell County, SC",2014-2015,21935,21725,-210,-0.957,17,-227,45,11,H1
"Barnwell County, SC",2015-2016,21725,21591,-134,-0.617,-28,-106,45,11,H1
"Barnwell County, SC",2016-2017,21591,21345,-246,-1.139,-27,-219,45,11,H1
"Beaufort County, SC",2000-2001,122306,125550,3244,2.652,951,2293,45,13,H1
"Beaufort County, SC",2001-2002,125550,129290,3740,2.979,984,2756,45,13,H1
"Beaufort County, SC",2002-2003,129290,130998,1708,1.321,981,727,45,13,H1
"Beaufort County, SC",2003-2004,130998,136331,5333,4.071,1178,4155,45,13,H1
"Beaufort County, SC",2004-2005,136331,141498,5167,3.79,993,4174,45,13,H1
"Beaufort County, SC",2005-2006,141498,147213,5715,4.039,1210,4505,45,13,H1
"Beaufort County, SC",2006-2007,147213,151411,4198,2.852,1344,2854,45,13,H1
"Beaufort County, SC",2007-2008,151411,156399,4988,3.294,1161,3827,45,13,H1
"Beaufort County, SC",2008-2009,156399,159737,3338,2.134,1026,2312,45,13,H1
"Beaufort County, SC",2009-2010,159737,162958,3221,2.016,1036,2185,45,13,H1
"Beaufort County, SC",2010-2011,162958,164106,1148,0.704,774,374,45,13,H1
"Beaufort County, SC",2011-2012,164106,167782,3676,2.24,760,2916,45,13,H1
"Beaufort County, SC",2012-2013,167782,171569,3787,2.257,671,3116,45,13,H1
"Beaufort County, SC",2013-2014,171569,175852,4283,2.496,676,3607,45,13,H1
"Beaufort County, SC",2014-2015,175118,179589,4471,2.553,612,3859,45,13,H1
"Beaufort County, SC",2015-2016,179589,183497,3908,2.176,449,3459,45,13,H1
"Beaufort County, SC",2016-2017,183497,186844,3347,1.824,398,2949,45,13,H1
"Berkeley County, SC",2000-2001,143410,145153,1743,1.215,1179,564,45,15,H1
"Berkeley County, SC",2001-2002,145153,146733,1580,1.089,1114,466,45,15,H1
"Berkeley County, SC",2002-2003,146733,148035,1302,0.887,1136,166,45,15,H1
"Berkeley County, SC",2003-2004,148035,151789,3754,2.536,1281,2473,45,15,H1
"Berkeley County, SC",2004-2005,151789,153489,1700,1.12,1144,556,45,15,H1
"Berkeley County, SC",2005-2006,153489,159501,6012,3.917,1282,4730,45,15,H1
"Berkeley County, SC",2006-2007,159501,164913,5412,3.393,1507,3905,45,15,H1
"Berkeley County, SC",2007-2008,164913,171099,6186,3.751,1508,4678,45,15,H1
"Berkeley County, SC",2008-2009,171099,175092,3993,2.334,1523,2470,45,15,H1
"Berkeley County, SC",2009-2010,175092,178934,3842,2.194,1540,2302,45,15,H1
"Berkeley County, SC",2010-2011,178934,183664,4730,2.643,1350,3380,45,15,H1
"Berkeley County, SC",2011-2012,183664,189493,5829,3.174,1410,4419,45,15,H1
"Berkeley County, SC",2012-2013,189493,193881,4388,2.316,1392,2996,45,15,H1
"Berkeley County, SC",2013-2014,193881,198205,4324,2.23,1356,2968,45,15,H1
"Berkeley County, SC",2014-2015,198209,202786,4577,2.309,1316,3261,45,15,H1
"Berkeley County, SC",2015-2016,202786,211863,9077,4.476,1274,7803,45,15,H1
"Berkeley County, SC",2016-2017,211863,217937,6074,2.867,1338,4736,45,15,H1
"Calhoun County, SC",2000-2001,15192,15301,109,0.717,33,76,45,17,H1
"Calhoun County, SC",2001-2002,15301,15257,-44,-0.288,32,-76,45,17,H1
"Calhoun County, SC",2002-2003,15257,15309,52,0.341,15,37,45,17,H1
"Calhoun County, SC",2003-2004,15309,15247,-62,-0.405,4,-66,45,17,H1
"Calhoun County, SC",2004-2005,15247,15212,-35,-0.23,-21,-14,45,17,H1
"Calhoun County, SC",2005-2006,15212,15229,17,0.112,3,14,45,17,H1
"Calhoun County, SC",2006-2007,15229,15260,31,0.204,21,10,45,17,H1
"Calhoun County, SC",2007-2008,15260,15175,-85,-0.557,28,-113,45,17,H1
"Calhoun County, SC",2008-2009,15175,15268,93,0.613,-18,111,45,17,H1
"Calhoun County, SC",2009-2010,15268,15106,-162,-1.061,-22,-140,45,17,H1
"Calhoun County, SC",2010-2011,15106,15170,64,0.424,-12,76,45,17,H1
"Calhoun County, SC",2011-2012,15170,14922,-248,-1.635,13,-261,45,17,H1
"Calhoun County, SC",2012-2013,14922,15078,156,1.045,-18,174,45,17,H1
"Calhoun County, SC",2013-2014,15078,14878,-200,-1.326,-40,-160,45,17,H1
"Calhoun County, SC",2014-2015,14868,14781,-87,-0.585,-53,-34,45,17,H1
"Calhoun County, SC",2015-2016,14781,14751,-30,-0.203,-15,-15,45,17,H1
"Calhoun County, SC",2016-2017,14751,14704,-47,-0.319,-48,1,45,17,H1
"Charleston County, SC",2000-2001,310749,313065,2316,0.745,1760,556,45,19,H1
"Charleston County, SC",2001-2002,313065,317379,4314,1.378,1782,2532,45,19,H1
"Charleston County, SC",2002-2003,317379,321222,3843,1.211,1792,2051,45,19,H1
"Charleston County, SC",2003-2004,321222,328105,6883,2.143,2.00E+03,4883,45,19,H1
"Charleston County, SC",2004-2005,328105,331589,3484,1.062,2059,1425,45,19,H1
"Charleston County, SC",2005-2006,331589,334826,3237,0.976,2125,1112,45,19,H1
"Charleston County, SC",2006-2007,334826,337147,2321,0.693,2422,-101,45,19,H1
"Charleston County, SC",2007-2008,337147,341921,4774,1.416,2150,2624,45,19,H1
"Charleston County, SC",2008-2009,341921,346795,4874,1.425,1911,2963,45,19,H1
"Charleston County, SC",2009-2010,346795,351235,4440,1.28,2132,2308,45,19,H1
"Charleston County, SC",2010-2011,351235,357737,6502,1.851,1898,4604,45,19,H1
"Charleston County, SC",2011-2012,357737,365472,7735,2.162,1944,5791,45,19,H1
"Charleston County, SC",2012-2013,365472,372913,7441,2.036,1814,5627,45,19,H1
"Charleston County, SC",2013-2014,372913,381015,8102,2.173,1785,6317,45,19,H1
"Charleston County, SC",2014-2015,380338,389262,8924,2.346,1847,7077,45,19,H1
"Charleston County, SC",2015-2016,389262,396570,7308,1.877,1578,5730,45,19,H1
"Charleston County, SC",2016-2017,396570,401438,4868,1.228,1575,3293,45,19,H1
"Cherokee County, SC",2000-2001,52649,53020,371,0.705,265,106,45,21,H1
"Cherokee County, SC",2001-2002,53020,53407,387,0.73,154,233,45,21,H1
"Cherokee County, SC",2002-2003,53407,53437,30,0.056,127,-97,45,21,H1
"Cherokee County, SC",2003-2004,53437,53642,205,0.384,103,102,45,21,H1
"Cherokee County, SC",2004-2005,53642,53772,130,0.242,30,100,45,21,H1
"Cherokee County, SC",2005-2006,53772,54166,394,0.733,86,308,45,21,H1
"Cherokee County, SC",2006-2007,54166,54467,301,0.556,182,119,45,21,H1
"Cherokee County, SC",2007-2008,54467,54981,514,0.944,115,399,45,21,H1
"Cherokee County, SC",2008-2009,54981,55149,168,0.306,78,90,45,21,H1
"Cherokee County, SC",2009-2010,55149,55511,362,0.656,60,302,45,21,H1
"Cherokee County, SC",2010-2011,55511,55588,77,0.139,112,-35,45,21,H1
"Cherokee County, SC",2011-2012,55588,55671,83,0.149,144,-61,45,21,H1
"Cherokee County, SC",2012-2013,55671,55743,72,0.129,33,39,45,21,H1
"Cherokee County, SC",2013-2014,55743,56024,281,0.504,100,181,45,21,H1
"Cherokee County, SC",2014-2015,56039,56194,155,0.277,96,59,45,21,H1
"Cherokee County, SC",2015-2016,56194,56725,531,0.945,43,488,45,21,H1
"Cherokee County, SC",2016-2017,56725,57105,380,0.67,74,306,45,21,H1
"Chester County, SC",2000-2001,34159,34064,-95,-0.278,142,-237,45,23,H1
"Chester County, SC",2001-2002,34064,34083,19,0.056,193,-174,45,23,H1
"Chester County, SC",2002-2003,34083,33920,-163,-0.478,104,-267,45,23,H1
"Chester County, SC",2003-2004,33920,33633,-287,-0.846,46,-333,45,23,H1
"Chester County, SC",2004-2005,33633,33373,-260,-0.773,68,-328,45,23,H1
"Chester County, SC",2005-2006,33373,33222,-151,-0.452,64,-215,45,23,H1
"Chester County, SC",2006-2007,33222,33247,25,0.075,162,-137,45,23,H1
"Chester County, SC",2007-2008,33247,33454,207,0.623,86,121,45,23,H1
"Chester County, SC",2008-2009,33454,33210,-244,-0.729,33,-277,45,23,H1
"Chester County, SC",2009-2010,33210,33116,-94,-0.283,33,-127,45,23,H1
"Chester County, SC",2010-2011,33116,32841,-275,-0.83,-1,-274,45,23,H1
"Chester County, SC",2011-2012,32841,32645,-196,-0.597,98,-294,45,23,H1
"Chester County, SC",2012-2013,32645,32601,-44,-0.135,-9,-35,45,23,H1
"Chester County, SC",2013-2014,32601,32337,-264,-0.81,4,-268,45,23,H1
"Chester County, SC",2014-2015,32349,32267,-82,-0.253,-41,-41,45,23,H1
"Chester County, SC",2015-2016,32267,32280,13,0.04,-50,63,45,23,H1
"Chester County, SC",2016-2017,32280,32301,21,0.065,-44,65,45,23,H1
"Chesterfield County, SC",2000-2001,42911,43339,428,0.997,216,212,45,25,H1
"Chesterfield County, SC",2001-2002,43339,43834,495,1.142,169,326,45,25,H1
"Chesterfield County, SC",2002-2003,43834,44107,273,0.623,95,178,45,25,H1
"Chesterfield County, SC",2003-2004,44107,44348,241,0.546,88,153,45,25,H1
"Chesterfield County, SC",2004-2005,44348,44766,418,0.943,74,344,45,25,H1
"Chesterfield County, SC",2005-2006,44766,45103,337,0.753,134,203,45,25,H1
"Chesterfield County, SC",2006-2007,45103,45708,605,1.341,166,439,45,25,H1
"Chesterfield County, SC",2007-2008,45708,46319,611,1.337,85,526,45,25,H1
"Chesterfield County, SC",2008-2009,46319,46638,319,0.689,61,258,45,25,H1
"Chesterfield County, SC",2009-2010,46638,46647,9,0.019,58,-49,45,25,H1
"Chesterfield County, SC",2010-2011,46647,46605,-42,-0.09,44,-86,45,25,H1
"Chesterfield County, SC",2011-2012,46605,46100,-505,-1.084,33,-538,45,25,H1
"Chesterfield County, SC",2012-2013,46100,46189,89,0.193,60,29,45,25,H1
"Chesterfield County, SC",2013-2014,46189,46125,-64,-0.139,9,-73,45,25,H1
"Chesterfield County, SC",2014-2015,46109,46017,-92,-0.2,2,-94,45,25,H1
"Chesterfield County, SC",2015-2016,46017,46170,153,0.332,-48,201,45,25,H1
"Chesterfield County, SC",2016-2017,46170,45948,-222,-0.481,-54,-168,45,25,H1
"Clarendon County, SC",2000-2001,32528,32887,359,1.104,111,248,45,27,H1
"Clarendon County, SC",2001-2002,32887,33094,207,0.629,104,103,45,27,H1
"Clarendon County, SC",2002-2003,33094,33305,211,0.638,47,164,45,27,H1
"Clarendon County, SC",2003-2004,33305,33622,317,0.952,88,229,45,27,H1
"Clarendon County, SC",2004-2005,33622,33847,225,0.669,81,144,45,27,H1
"Clarendon County, SC",2005-2006,33847,34094,247,0.73,54,193,45,27,H1
"Clarendon County, SC",2006-2007,34094,34250,156,0.458,71,85,45,27,H1
"Clarendon County, SC",2007-2008,34250,34875,625,1.825,71,554,45,27,H1
"Clarendon County, SC",2008-2009,34875,34942,67,0.192,42,25,45,27,H1
"Clarendon County, SC",2009-2010,34942,34949,7,0.02,30,-23,45,27,H1
"Clarendon County, SC",2010-2011,34949,34652,-297,-0.85,-22,-275,45,27,H1
"Clarendon County, SC",2011-2012,34652,34269,-383,-1.105,-18,-365,45,27,H1
"Clarendon County, SC",2012-2013,34269,34211,-58,-0.169,-5,-53,45,27,H1
"Clarendon County, SC",2013-2014,34211,34113,-98,-0.286,3,-101,45,27,H1
"Clarendon County, SC",2014-2015,34051,33775,-276,-0.811,-29,-247,45,27,H1
"Clarendon County, SC",2015-2016,33775,34239,464,1.374,-72,536,45,27,H1
"Clarendon County, SC",2016-2017,34239,34057,-182,-0.532,-55,-127,45,27,H1
"Colleton County, SC",2000-2001,38304,38339,35,0.091,206,-171,45,29,H1
"Colleton County, SC",2001-2002,38339,38463,124,0.323,168,-44,45,29,H1
"Colleton County, SC",2002-2003,38463,38543,80,0.208,90,-10,45,29,H1
"Colleton County, SC",2003-2004,38543,38672,129,0.335,97,32,45,29,H1
"Colleton County, SC",2004-2005,38672,38728,56,0.145,108,-52,45,29,H1
"Colleton County, SC",2005-2006,38728,38608,-120,-0.31,145,-265,45,29,H1
"Colleton County, SC",2006-2007,38608,38765,157,0.407,179,-22,45,29,H1
"Colleton County, SC",2007-2008,38765,39014,249,0.642,110,139,45,29,H1
"Colleton County, SC",2008-2009,39014,38864,-150,-0.384,97,-247,45,29,H1
"Colleton County, SC",2009-2010,38864,38911,47,0.121,66,-19,45,29,H1
"Colleton County, SC",2010-2011,38911,38488,-423,-1.087,7,-430,45,29,H1
"Colleton County, SC",2011-2012,38488,38230,-258,-0.67,-3,-255,45,29,H1
"Colleton County, SC",2012-2013,38230,37834,-396,-1.036,-43,-353,45,29,H1
"Colleton County, SC",2013-2014,37834,37771,-63,-0.167,-90,27,45,29,H1
"Colleton County, SC",2014-2015,37776,37731,-45,-0.119,-112,67,45,29,H1
"Colleton County, SC",2015-2016,37731,37599,-132,-0.35,-52,-80,45,29,H1
"Colleton County, SC",2016-2017,37599,37611,12,0.032,-116,128,45,29,H1
"Darlington County, SC",2000-2001,67523,67863,340,0.504,146,194,45,31,H1
"Darlington County, SC",2001-2002,67863,68247,384,0.566,245,139,45,31,H1
"Darlington County, SC",2002-2003,68247,68382,135,0.198,136,-1,45,31,H1
"Darlington County, SC",2003-2004,68382,68155,-227,-0.332,100,-327,45,31,H1
"Darlington County, SC",2004-2005,68155,68185,30,0.044,162,-132,45,31,H1
"Darlington County, SC",2005-2006,68185,68424,239,0.351,189,50,45,31,H1
"Darlington County, SC",2006-2007,68424,68489,65,0.095,123,-58,45,31,H1
"Darlington County, SC",2007-2008,68489,68773,284,0.415,100,184,45,31,H1
"Darlington County, SC",2008-2009,68773,68705,-68,-0.099,72,-140,45,31,H1
"Darlington County, SC",2009-2010,68705,68636,-69,-0.1,40,-109,45,31,H1
"Darlington County, SC",2010-2011,68636,68258,-378,-0.551,0,-378,45,31,H1
"Darlington County, SC",2011-2012,68258,68165,-93,-0.136,31,-124,45,31,H1
"Darlington County, SC",2012-2013,68165,67946,-219,-0.321,-4,-215,45,31,H1
"Darlington County, SC",2013-2014,67946,67799,-147,-0.216,-22,-125,45,31,H1
"Darlington County, SC",2014-2015,67768,67548,-220,-0.325,-37,-183,45,31,H1
"Darlington County, SC",2015-2016,67548,67370,-178,-0.264,19,-197,45,31,H1
"Darlington County, SC",2016-2017,67370,67265,-105,-0.156,-21,-84,45,31,H1
"Dillon County, SC",2000-2001,30699,30995,296,0.964,241,55,45,33,H1
"Dillon County, SC",2001-2002,30995,3.10E+04,5,0.016,158,-153,45,33,H1
"Dillon County, SC",2002-2003,3.10E+04,31093,93,0.3,146,-53,45,33,H1
"Dillon County, SC",2003-2004,31093,31241,148,0.476,87,61,45,33,H1
"Dillon County, SC",2004-2005,31241,31239,-2,-0.006,168,-170,45,33,H1
"Dillon County, SC",2005-2006,31239,31373,134,0.429,134,0,45,33,H1
"Dillon County, SC",2006-2007,31373,31433,60,0.191,154,-94,45,33,H1
"Dillon County, SC",2007-2008,31433,31585,152,0.484,168,-16,45,33,H1
"Dillon County, SC",2008-2009,31585,31817,232,0.735,108,124,45,33,H1
"Dillon County, SC",2009-2010,31817,32087,270,0.849,84,186,45,33,H1
"Dillon County, SC",2010-2011,32087,31730,-357,-1.113,115,-472,45,33,H1
"Dillon County, SC",2011-2012,31730,31447,-283,-0.892,72,-355,45,33,H1
"Dillon County, SC",2012-2013,31447,31255,-192,-0.611,88,-280,45,33,H1
"Dillon County, SC",2013-2014,31255,31127,-128,-0.41,80,-208,45,33,H1
"Dillon County, SC",2014-2015,31279,31234,-45,-0.144,71,-116,45,33,H1
"Dillon County, SC",2015-2016,31234,30817,-417,-1.335,26,-443,45,33,H1
"Dillon County, SC",2016-2017,30817,30666,-151,-0.49,22,-173,45,33,H1
"Dorchester County, SC",2000-2001,96757,98683,1926,1.991,570,1356,45,35,H1
"Dorchester County, SC",2001-2002,98683,101067,2384,2.416,513,1871,45,35,H1
"Dorchester County, SC",2002-2003,101067,104119,3052,3.02,542,2510,45,35,H1
"Dorchester County, SC",2003-2004,104119,107337,3218,3.091,620,2598,45,35,H1
"Dorchester County, SC",2004-2005,107337,113235,5898,5.495,796,5102,45,35,H1
"Dorchester County, SC",2005-2006,113235,120136,6901,6.094,886,6015,45,35,H1
"Dorchester County, SC",2006-2007,120136,126324,6188,5.151,1072,5116,45,35,H1
"Dorchester County, SC",2007-2008,126324,130593,4269,3.379,1047,3222,45,35,H1
"Dorchester County, SC",2008-2009,130593,133560,2967,2.272,929,2038,45,35,H1
"Dorchester County, SC",2009-2010,133560,137555,3995,2.991,824,3171,45,35,H1
"Dorchester County, SC",2010-2011,137555,140081,2526,1.836,897,1629,45,35,H1
"Dorchester County, SC",2011-2012,140081,142470,2389,1.705,935,1454,45,35,H1
"Dorchester County, SC",2012-2013,142470,145287,2817,1.977,884,1933,45,35,H1
"Dorchester County, SC",2013-2014,145287,148469,3182,2.19,905,2277,45,35,H1
"Dorchester County, SC",2014-2015,148422,152478,4056,2.733,904,3152,45,35,H1
"Dorchester County, SC",2015-2016,152478,153471,993,0.651,655,338,45,35,H1
"Dorchester County, SC",2016-2017,153471,156456,2985,1.945,682,2303,45,35,H1
"Edgefield County, SC",2000-2001,24586,24690,104,0.423,89,15,45,37,H1
"Edgefield County, SC",2001-2002,24690,24962,272,1.102,54,218,45,37,H1
"Edgefield County, SC",2002-2003,24962,25404,442,1.771,67,375,45,37,H1
"Edgefield County, SC",2003-2004,25404,25819,415,1.634,16,399,45,37,H1
"Edgefield County, SC",2004-2005,25819,26196,377,1.46,63,314,45,37,H1
"Edgefield County, SC",2005-2006,26196,26135,-61,-0.233,2,-63,45,37,H1
"Edgefield County, SC",2006-2007,26135,26493,358,1.37,54,304,45,37,H1
"Edgefield County, SC",2007-2008,26493,26774,281,1.061,38,243,45,37,H1
"Edgefield County, SC",2008-2009,26774,27032,258,0.964,24,234,45,37,H1
"Edgefield County, SC",2009-2010,27032,26951,-81,-0.3,8,-89,45,37,H1
"Edgefield County, SC",2010-2011,26951,26727,-224,-0.831,-30,-194,45,37,H1
"Edgefield County, SC",2011-2012,26727,26328,-399,-1.493,-21,-378,45,37,H1
"Edgefield County, SC",2012-2013,26328,26308,-20,-0.076,28,-48,45,37,H1
"Edgefield County, SC",2013-2014,26308,26553,245,0.931,96,149,45,37,H1
"Edgefield County, SC",2014-2015,26457,26514,57,0.215,-30,87,45,37,H1
"Edgefield County, SC",2015-2016,26514,26580,66,0.249,-27,93,45,37,H1
"Edgefield County, SC",2016-2017,26580,26693,113,0.425,-69,182,45,37,H1
"Fairfield County, SC",2000-2001,23479,23614,135,0.575,50,85,45,39,H1
"Fairfield County, SC",2001-2002,23614,23890,276,1.169,60,216,45,39,H1
"Fairfield County, SC",2002-2003,23890,23904,14,0.059,15,-1,45,39,H1
"Fairfield County, SC",2003-2004,23904,24273,369,1.544,-8,377,45,39,H1
"Fairfield County, SC",2004-2005,24273,24132,-141,-0.581,9,-150,45,39,H1
"Fairfield County, SC",2005-2006,24132,24177,45,0.186,19,26,45,39,H1
"Fairfield County, SC",2006-2007,24177,23917,-260,-1.075,-26,-234,45,39,H1
"Fairfield County, SC",2007-2008,23917,24131,214,0.895,21,193,45,39,H1
"Fairfield County, SC",2008-2009,24131,24084,-47,-0.195,14,-61,45,39,H1
"Fairfield County, SC",2009-2010,24084,23843,-241,-1.001,-17,-224,45,39,H1
"Fairfield County, SC",2010-2011,23843,23576,-267,-1.12,-38,-229,45,39,H1
"Fairfield County, SC",2011-2012,23576,23371,-205,-0.87,-22,-183,45,39,H1
"Fairfield County, SC",2012-2013,23371,23143,-228,-0.976,-51,-177,45,39,H1
"Fairfield County, SC",2013-2014,23143,22976,-167,-0.722,-58,-109,45,39,H1
"Fairfield County, SC",2014-2015,22890,22747,-143,-0.625,-84,-59,45,39,H1
"Fairfield County, SC",2015-2016,22747,22630,-117,-0.514,-106,-11,45,39,H1
"Fairfield County, SC",2016-2017,22630,22607,-23,-0.102,-85,62,45,39,H1
"Florence County, SC",2000-2001,125767,126377,610,0.485,557,53,45,41,H1
"Florence County, SC",2001-2002,126377,127343,966,0.764,496,470,45,41,H1
"Florence County, SC",2002-2003,127343,128671,1328,1.043,640,688,45,41,H1
"Florence County, SC",2003-2004,128671,129855,1184,0.92,607,577,45,41,H1
"Florence County, SC",2004-2005,129855,130982,1127,0.868,536,591,45,41,H1
"Florence County, SC",2005-2006,130982,132489,1507,1.151,569,938,45,41,H1
"Florence County, SC",2006-2007,132489,133757,1268,0.957,738,530,45,41,H1
"Florence County, SC",2007-2008,133757,135032,1275,0.953,558,717,45,41,H1
"Florence County, SC",2008-2009,135032,136120,1088,0.806,524,564,45,41,H1
"Florence County, SC",2009-2010,136120,137077,957,0.703,493,464,45,41,H1
"Florence County, SC",2010-2011,137077,137488,411,0.3,343,68,45,41,H1
"Florence County, SC",2011-2012,137488,138060,572,0.416,396,176,45,41,H1
"Florence County, SC",2012-2013,138060,138434,374,0.271,291,83,45,41,H1
"Florence County, SC",2013-2014,138434,139231,797,0.576,353,444,45,41,H1
"Florence County, SC",2014-2015,138988,138900,-88,-0.063,289,-377,45,41,H1
"Florence County, SC",2015-2016,138900,138448,-452,-0.325,122,-574,45,41,H1
"Florence County, SC",2016-2017,138448,138566,118,0.085,124,-6,45,41,H1
"Georgetown County, SC",2000-2001,56080,56800,720,1.284,185,535,45,43,H1
"Georgetown County, SC",2001-2002,56800,57688,888,1.563,203,685,45,43,H1
"Georgetown County, SC",2002-2003,57688,58387,699,1.212,128,571,45,43,H1
"Georgetown County, SC",2003-2004,58387,59176,789,1.351,183,606,45,43,H1
"Georgetown County, SC",2004-2005,59176,59521,345,0.583,84,261,45,43,H1
"Georgetown County, SC",2005-2006,59521,59821,300,0.504,133,167,45,43,H1
"Georgetown County, SC",2006-2007,59821,60277,456,0.762,129,327,45,43,H1
"Georgetown County, SC",2007-2008,60277,60621,344,0.571,127,217,45,43,H1
"Georgetown County, SC",2008-2009,60621,60369,-252,-0.416,133,-385,45,43,H1
"Georgetown County, SC",2009-2010,60369,60173,-196,-0.325,68,-264,45,43,H1
"Georgetown County, SC",2010-2011,60173,60196,23,0.038,-81,104,45,43,H1
"Georgetown County, SC",2011-2012,60196,60284,88,0.146,-114,202,45,43,H1
"Georgetown County, SC",2012-2013,60284,60520,236,0.391,-99,335,45,43,H1
"Georgetown County, SC",2013-2014,60520,60773,253,0.418,-141,394,45,43,H1
"Georgetown County, SC",2014-2015,60727,61298,571,0.94,-133,704,45,43,H1
"Georgetown County, SC",2015-2016,61298,61374,76,0.124,-272,348,45,43,H1
"Georgetown County, SC",2016-2017,61374,61607,233,0.38,-270,503,45,43,H1
"Greenville County, SC",2000-2001,380949,385780,4831,1.268,1880,2951,45,45,H1
"Greenville County, SC",2001-2002,385780,390197,4417,1.145,2121,2296,45,45,H1
"Greenville County, SC",2002-2003,390197,394242,4045,1.037,2098,1947,45,45,H1
"Greenville County, SC",2003-2004,394242,399319,5077,1.288,2390,2687,45,45,H1
"Greenville County, SC",2004-2005,399319,405608,6289,1.575,2493,3796,45,45,H1
"Greenville County, SC",2005-2006,405608,415957,10349,2.551,2631,7718,45,45,H1
"Greenville County, SC",2006-2007,415957,427970,12013,2.888,3019,8994,45,45,H1
"Greenville County, SC",2007-2008,427970,438742,10772,2.517,2940,7832,45,45,H1
"Greenville County, SC",2008-2009,438742,446655,7913,1.804,2603,5310,45,45,H1
"Greenville County, SC",2009-2010,446655,452695,6040,1.352,2708,3332,45,45,H1
"Greenville County, SC",2010-2011,452695,459009,6314,1.395,2318,3996,45,45,H1
"Greenville County, SC",2011-2012,459009,466758,7749,1.688,2337,5412,45,45,H1
"Greenville County, SC",2012-2013,466758,474223,7465,1.599,2266,5199,45,45,H1
"Greenville County, SC",2013-2014,474223,482752,8529,1.799,2299,6230,45,45,H1
"Greenville County, SC",2014-2015,482577,491863,9286,1.924,2332,6954,45,45,H1
"Greenville County, SC",2015-2016,491863,499034,7171,1.458,2133,5038,45,45,H1
"Greenville County, SC",2016-2017,499034,506837,7803,1.564,2160,5643,45,45,H1
"Greenwood County, SC",2000-2001,66303,66544,241,0.363,287,-46,45,47,H1
"Greenwood County, SC",2001-2002,66544,66996,452,0.679,243,209,45,47,H1
"Greenwood County, SC",2002-2003,66996,67288,292,0.436,145,147,45,47,H1
"Greenwood County, SC",2003-2004,67288,67255,-33,-0.049,147,-180,45,47,H1
"Greenwood County, SC",2004-2005,67255,67630,375,0.558,205,170,45,47,H1
"Greenwood County, SC",2005-2006,67630,68091,461,0.682,237,224,45,47,H1
"Greenwood County, SC",2006-2007,68091,68198,107,0.157,319,-212,45,47,H1
"Greenwood County, SC",2007-2008,68198,68862,664,0.974,236,428,45,47,H1
"Greenwood County, SC",2008-2009,68862,69598,736,1.069,145,591,45,47,H1
"Greenwood County, SC",2009-2010,69598,69713,115,0.165,86,29,45,47,H1
"Greenwood County, SC",2010-2011,69713,69785,72,0.103,243,-171,45,47,H1
"Greenwood County, SC",2011-2012,69785,69833,48,0.069,230,-182,45,47,H1
"Greenwood County, SC",2012-2013,69833,69689,-144,-0.206,170,-314,45,47,H1
"Greenwood County, SC",2013-2014,69689,69520,-169,-0.243,141,-310,45,47,H1
"Greenwood County, SC",2014-2015,69544,69838,294,0.423,138,156,45,47,H1
"Greenwood County, SC",2015-2016,69838,70172,334,0.478,42,292,45,47,H1
"Greenwood County, SC",2016-2017,70172,70355,183,0.261,26,157,45,47,H1
"Hampton County, SC",2000-2001,21344,21262,-82,-0.384,92,-174,45,49,H1
"Hampton County, SC",2001-2002,21262,21186,-76,-0.357,67,-143,45,49,H1
"Hampton County, SC",2002-2003,21186,21267,81,0.382,79,2,45,49,H1
"Hampton County, SC",2003-2004,21267,21072,-195,-0.917,71,-266,45,49,H1
"Hampton County, SC",2004-2005,21072,21109,37,0.176,52,-15,45,49,H1
"Hampton County, SC",2005-2006,21109,21104,-5,-0.024,129,-134,45,49,H1
"Hampton County, SC",2006-2007,21104,21295,191,0.905,98,93,45,49,H1
"Hampton County, SC",2007-2008,21295,21212,-83,-0.39,81,-164,45,49,H1
"Hampton County, SC",2008-2009,21212,21205,-7,-0.033,77,-84,45,49,H1
"Hampton County, SC",2009-2010,21205,21056,-149,-0.703,71,-220,45,49,H1
"Hampton County, SC",2010-2011,21056,20774,-282,-1.339,37,-319,45,49,H1
"Hampton County, SC",2011-2012,20774,20719,-55,-0.265,27,-82,45,49,H1
"Hampton County, SC",2012-2013,20719,20395,-324,-1.564,1,-325,45,49,H1
"Hampton County, SC",2013-2014,20395,20405,10,0.049,-10,20,45,49,H1
"Hampton County, SC",2014-2015,20422,20049,-373,-1.826,-1,-372,45,49,H1
"Hampton County, SC",2015-2016,20049,19874,-175,-0.873,-20,-155,45,49,H1
"Hampton County, SC",2016-2017,19874,19602,-272,-1.369,-31,-241,45,49,H1
"Horry County, SC",2000-2001,198019,201982,3963,2.001,602,3361,45,51,H1
"Horry County, SC",2001-2002,201982,206566,4584,2.27,687,3897,45,51,H1
"Horry County, SC",2002-2003,206566,211725,5159,2.498,630,4529,45,51,H1
"Horry County, SC",2003-2004,211725,219094,7369,3.48,779,6590,45,51,H1
"Horry County, SC",2004-2005,219094,229899,10805,4.932,728,10077,45,51,H1
"Horry County, SC",2005-2006,229899,242194,12295,5.348,863,11432,45,51,H1
"Horry County, SC",2006-2007,242194,252464,10270,4.24,1211,9059,45,51,H1
"Horry County, SC",2007-2008,252464,260609,8145,3.226,922,7223,45,51,H1
"Horry County, SC",2008-2009,260609,265640,5031,1.93,644,4387,45,51,H1
"Horry County, SC",2009-2010,265640,270561,4921,1.853,442,4479,45,51,H1
"Horry County, SC",2010-2011,270561,275490,4929,1.822,404,4525,45,51,H1
"Horry County, SC",2011-2012,275490,281990,6500,2.359,311,6189,45,51,H1
"Horry County, SC",2012-2013,281990,289527,7537,2.673,170,7367,45,51,H1
"Horry County, SC",2013-2014,289527,298832,9305,3.214,159,9146,45,51,H1
"Horry County, SC",2014-2015,298258,309199,10941,3.668,119,10822,45,51,H1
"Horry County, SC",2015-2016,309199,321440,12241,3.959,-312,12553,45,51,H1
"Horry County, SC",2016-2017,321440,333268,11828,3.68,-241,12069,45,51,H1
"Jasper County, SC",2000-2001,20721,21024,303,1.462,183,120,45,53,H1
"Jasper County, SC",2001-2002,21024,21102,78,0.371,100,-22,45,53,H1
"Jasper County, SC",2002-2003,21102,21236,134,0.635,116,18,45,53,H1
"Jasper County, SC",2003-2004,21236,21456,220,1.036,143,77,45,53,H1
"Jasper County, SC",2004-2005,21456,21845,389,1.813,151,238,45,53,H1
"Jasper County, SC",2005-2006,21845,22406,561,2.568,212,349,45,53,H1
"Jasper County, SC",2006-2007,22406,22971,565,2.522,195,370,45,53,H1
"Jasper County, SC",2007-2008,22971,23620,649,2.825,236,413,45,53,H1
"Jasper County, SC",2008-2009,23620,24234,614,2.599,139,475,45,53,H1
"Jasper County, SC",2009-2010,24234,24940,706,2.913,124,582,45,53,H1
"Jasper County, SC",2010-2011,24940,25418,478,1.917,105,373,45,53,H1
"Jasper County, SC",2011-2012,25418,25973,555,2.183,135,420,45,53,H1
"Jasper County, SC",2012-2013,25973,26710,737,2.838,99,638,45,53,H1
"Jasper County, SC",2013-2014,26710,27170,460,1.722,88,372,45,53,H1
"Jasper County, SC",2014-2015,27019,27824,805,2.979,112,693,45,53,H1
"Jasper County, SC",2015-2016,27824,28071,247,0.888,77,170,45,53,H1
"Jasper County, SC",2016-2017,28071,28458,387,1.379,79,308,45,53,H1
"Kershaw County, SC",2000-2001,52851,53474,623,1.179,263,360,45,55,H1
"Kershaw County, SC",2001-2002,53474,53714,240,0.449,153,87,45,55,H1
"Kershaw County, SC",2002-2003,53714,54614,900,1.676,252,648,45,55,H1
"Kershaw County, SC",2003-2004,54614,55415,801,1.467,143,658,45,55,H1
"Kershaw County, SC",2004-2005,55415,56506,1091,1.969,214,877,45,55,H1
"Kershaw County, SC",2005-2006,56506,58060,1554,2.75,288,1266,45,55,H1
"Kershaw County, SC",2006-2007,58060,59380,1320,2.274,319,1001,45,55,H1
"Kershaw County, SC",2007-2008,59380,60395,1015,1.709,259,756,45,55,H1
"Kershaw County, SC",2008-2009,60395,61143,748,1.239,211,537,45,55,H1
"Kershaw County, SC",2009-2010,61143,61678,535,0.875,150,385,45,55,H1
"Kershaw County, SC",2010-2011,61678,62034,356,0.577,178,178,45,55,H1
"Kershaw County, SC",2011-2012,62034,62232,198,0.319,119,79,45,55,H1
"Kershaw County, SC",2012-2013,62232,62604,372,0.598,38,334,45,55,H1
"Kershaw County, SC",2013-2014,62604,63161,557,0.89,32,525,45,55,H1
"Kershaw County, SC",2014-2015,63147,63603,456,0.722,51,405,45,55,H1
"Kershaw County, SC",2015-2016,63603,64269,666,1.047,83,583,45,55,H1
"Kershaw County, SC",2016-2017,64269,65036,767,1.193,26,741,45,55,H1
"Lancaster County, SC",2000-2001,61571,62250,679,1.103,298,381,45,57,H1
"Lancaster County, SC",2001-2002,62250,63282,1032,1.658,189,843,45,57,H1
"Lancaster County, SC",2002-2003,63282,64210,928,1.466,209,719,45,57,H1
"Lancaster County, SC",2003-2004,64210,65079,869,1.353,163,706,45,57,H1
"Lancaster County, SC",2004-2005,65079,65875,796,1.223,250,546,45,57,H1
"Lancaster County, SC",2005-2006,65875,66992,1117,1.696,297,820,45,57,H1
"Lancaster County, SC",2006-2007,66992,69504,2512,3.75,339,2173,45,57,H1
"Lancaster County, SC",2007-2008,69504,72733,3229,4.646,295,2934,45,57,H1
"Lancaster County, SC",2008-2009,72733,75394,2661,3.659,306,2355,45,57,H1
"Lancaster County, SC",2009-2010,75394,76945,1551,2.057,239,1312,45,57,H1
"Lancaster County, SC",2010-2011,76945,77758,813,1.057,178,635,45,57,H1
"Lancaster County, SC",2011-2012,77758,79193,1435,1.845,121,1314,45,57,H1
"Lancaster County, SC",2012-2013,79193,80520,1327,1.676,110,1217,45,57,H1
"Lancaster County, SC",2013-2014,80520,83160,2640,3.279,130,2510,45,57,H1
"Lancaster County, SC",2014-2015,83120,85842,2722,3.275,168,2554,45,57,H1
"Lancaster County, SC",2015-2016,85842,89855,4013,4.675,147,3866,45,57,H1
"Lancaster County, SC",2016-2017,89855,92550,2695,2.999,171,2524,45,57,H1
"Laurens County, SC",2000-2001,69428,69407,-21,-0.03,73,-94,45,59,H1
"Laurens County, SC",2001-2002,69407,68841,-566,-0.815,50,-616,45,59,H1
"Laurens County, SC",2002-2003,68841,68468,-373,-0.542,95,-468,45,59,H1
"Laurens County, SC",2003-2004,68468,67784,-684,-0.999,85,-769,45,59,H1
"Laurens County, SC",2004-2005,67784,67629,-155,-0.229,42,-197,45,59,H1
"Laurens County, SC",2005-2006,67629,67388,-241,-0.356,130,-371,45,59,H1
"Laurens County, SC",2006-2007,67388,67172,-216,-0.321,159,-375,45,59,H1
"Laurens County, SC",2007-2008,67172,67173,1,0.001,108,-107,45,59,H1
"Laurens County, SC",2008-2009,67173,66897,-276,-0.411,37,-313,45,59,H1
"Laurens County, SC",2009-2010,66897,66533,-364,-0.544,11,-375,45,59,H1
"Laurens County, SC",2010-2011,66533,66419,-114,-0.171,82,-196,45,59,H1
"Laurens County, SC",2011-2012,66419,66258,-161,-0.242,2,-163,45,59,H1
"Laurens County, SC",2012-2013,66258,66207,-51,-0.077,-102,51,45,59,H1
"Laurens County, SC",2013-2014,66207,66533,326,0.492,-55,381,45,59,H1
"Laurens County, SC",2014-2015,66498,66623,125,0.188,-60,185,45,59,H1
"Laurens County, SC",2015-2016,66623,66571,-52,-0.078,-56,4,45,59,H1
"Laurens County, SC",2016-2017,66571,66848,277,0.416,-61,338,45,59,H1
"Lee County, SC",2000-2001,20088,19957,-131,-0.652,55,-186,45,61,H1
"Lee County, SC",2001-2002,19957,19970,13,0.065,51,-38,45,61,H1
"Lee County, SC",2002-2003,19970,20005,35,0.175,45,-10,45,61,H1
"Lee County, SC",2003-2004,20005,20157,152,0.76,22,130,45,61,H1
"Lee County, SC",2004-2005,20157,20079,-78,-0.387,30,-108,45,61,H1
"Lee County, SC",2005-2006,20079,20001,-78,-0.388,24,-102,45,61,H1
"Lee County, SC",2006-2007,20001,19836,-165,-0.825,38,-203,45,61,H1
"Lee County, SC",2007-2008,19836,19697,-139,-0.701,37,-176,45,61,H1
"Lee County, SC",2008-2009,19697,19352,-345,-1.752,7,-352,45,61,H1
"Lee County, SC",2009-2010,19352,19202,-150,-0.775,-11,-139,45,61,H1
"Lee County, SC",2010-2011,19202,18917,-285,-1.484,-85,-200,45,61,H1
"Lee County, SC",2011-2012,18917,18669,-248,-1.311,-30,-218,45,61,H1
"Lee County, SC",2012-2013,18669,18407,-262,-1.403,-26,-236,45,61,H1
"Lee County, SC",2013-2014,18407,18343,-64,-0.348,-72,8,45,61,H1
"Lee County, SC",2014-2015,18379,17896,-483,-2.628,-72,-411,45,61,H1
"Lee County, SC",2015-2016,17896,17607,-289,-1.615,-74,-215,45,61,H1
"Lee County, SC",2016-2017,17607,17350,-257,-1.46,-114,-143,45,61,H1
"Lexington County, SC",2000-2001,216873,220099,3226,1.488,1321,1905,45,63,H1
"Lexington County, SC",2001-2002,220099,222761,2662,1.209,1237,1425,45,63,H1
"Lexington County, SC",2002-2003,222761,226887,4126,1.852,1343,2783,45,63,H1
"Lexington County, SC",2003-2004,226887,230832,3945,1.739,1304,2641,45,63,H1
"Lexington County, SC",2004-2005,230832,235176,4344,1.882,1288,3056,45,63,H1
"Lexington County, SC",2005-2006,235176,241219,6043,2.57,1408,4635,45,63,H1
"Lexington County, SC",2006-2007,241219,246461,5242,2.173,1592,3650,45,63,H1
"Lexington County, SC",2007-2008,246461,252747,6286,2.551,1379,4907,45,63,H1
"Lexington County, SC",2008-2009,252747,258983,6236,2.467,1380,4856,45,63,H1
"Lexington County, SC",2009-2010,258983,263325,4342,1.677,1314,3028,45,63,H1
"Lexington County, SC",2010-2011,263325,266383,3058,1.161,1124,1934,45,63,H1
"Lexington County, SC",2011-2012,266383,270114,3731,1.401,1061,2670,45,63,H1
"Lexington County, SC",2012-2013,270114,273604,3490,1.292,1092,2398,45,63,H1
"Lexington County, SC",2013-2014,273604,277888,4284,1.566,1071,3213,45,63,H1
"Lexington County, SC",2014-2015,277488,281833,4345,1.566,1028,3317,45,63,H1
"Lexington County, SC",2015-2016,281833,286394,4561,1.618,892,3669,45,63,H1
"Lexington County, SC",2016-2017,286394,290642,4248,1.483,833,3415,45,63,H1
"McCormick County, SC",2000-2001,9957,10095,138,1.386,-11,149,45,65,H1
"McCormick County, SC",2001-2002,10095,10110,15,0.149,-35,50,45,65,H1
"McCormick County, SC",2002-2003,10110,10167,57,0.564,-44,101,45,65,H1
"McCormick County, SC",2003-2004,10167,9982,-185,-1.82,-44,-141,45,65,H1
"McCormick County, SC",2004-2005,9982,10049,67,0.671,-56,123,45,65,H1
"McCormick County, SC",2005-2006,10049,10166,117,1.164,-44,161,45,65,H1
"McCormick County, SC",2006-2007,10166,10162,-4,-0.039,-25,21,45,65,H1
"McCormick County, SC",2007-2008,10162,10224,62,0.61,-33,95,45,65,H1
"McCormick County, SC",2008-2009,10224,10235,11,0.108,-73,84,45,65,H1
"McCormick County, SC",2009-2010,10235,10230,-5,-0.049,-75,70,45,65,H1
"McCormick County, SC",2010-2011,10230,10056,-174,-1.701,-53,-121,45,65,H1
"McCormick County, SC",2011-2012,10056,9949,-107,-1.064,-62,-45,45,65,H1
"McCormick County, SC",2012-2013,9949,9932,-17,-0.171,-53,36,45,65,H1
"McCormick County, SC",2013-2014,9932,9846,-86,-0.866,-78,-8,45,65,H1
"McCormick County, SC",2014-2015,9861,9706,-155,-1.572,-77,-78,45,65,H1
"McCormick County, SC",2015-2016,9706,9569,-137,-1.411,-87,-50,45,65,H1
"McCormick County, SC",2016-2017,9569,9545,-24,-0.251,-99,75,45,65,H1
"Marion County, SC",2000-2001,35463,35119,-344,-0.97,139,-483,45,67,H1
"Marion County, SC",2001-2002,35119,34786,-333,-0.948,118,-451,45,67,H1
"Marion County, SC",2002-2003,34786,34690,-96,-0.276,143,-239,45,67,H1
"Marion County, SC",2003-2004,34690,34577,-113,-0.326,115,-228,45,67,H1
"Marion County, SC",2004-2005,34577,34334,-243,-0.703,99,-342,45,67,H1
"Marion County, SC",2005-2006,34334,33994,-340,-0.99,44,-384,45,67,H1
"Marion County, SC",2006-2007,33994,33842,-152,-0.447,132,-284,45,67,H1
"Marion County, SC",2007-2008,33842,33724,-118,-0.349,104,-222,45,67,H1
"Marion County, SC",2008-2009,33724,33277,-447,-1.325,73,-520,45,67,H1
"Marion County, SC",2009-2010,33277,32958,-319,-0.959,31,-350,45,67,H1
"Marion County, SC",2010-2011,32958,32760,-198,-0.601,29,-227,45,67,H1
"Marion County, SC",2011-2012,32760,32391,-369,-1.126,2,-371,45,67,H1
"Marion County, SC",2012-2013,32391,32013,-378,-1.167,-55,-323,45,67,H1
"Marion County, SC",2013-2014,32013,31933,-80,-0.25,-70,-10,45,67,H1
"Marion County, SC",2014-2015,31941,31747,-194,-0.607,-22,-172,45,67,H1
"Marion County, SC",2015-2016,31747,31753,6,0.019,-20,26,45,67,H1
"Marion County, SC",2016-2017,31753,31293,-460,-1.449,-73,-387,45,67,H1
"Marlboro County, SC",2000-2001,28800,28606,-194,-0.674,51,-245,45,69,H1
"Marlboro County, SC",2001-2002,28606,28599,-7,-0.024,50,-57,45,69,H1
"Marlboro County, SC",2002-2003,28599,28485,-114,-0.399,28,-142,45,69,H1
"Marlboro County, SC",2003-2004,28485,28351,-134,-0.47,-10,-124,45,69,H1
"Marlboro County, SC",2004-2005,28351,27918,-433,-1.527,67,-500,45,69,H1
"Marlboro County, SC",2005-2006,27918,29199,1281,4.588,41,1240,45,69,H1
"Marlboro County, SC",2006-2007,29199,29221,22,0.075,67,-45,45,69,H1
"Marlboro County, SC",2007-2008,29221,29079,-142,-0.486,24,-166,45,69,H1
"Marlboro County, SC",2008-2009,29079,29189,110,0.378,-25,135,45,69,H1
"Marlboro County, SC",2009-2010,29189,28907,-282,-0.966,-24,-258,45,69,H1
"Marlboro County, SC",2010-2011,28907,28484,-423,-1.463,-19,-404,45,69,H1
"Marlboro County, SC",2011-2012,28484,28157,-327,-1.148,-12,-315,45,69,H1
"Marlboro County, SC",2012-2013,28157,27999,-158,-0.561,-30,-128,45,69,H1
"Marlboro County, SC",2013-2014,27999,27924,-75,-0.268,-25,-50,45,69,H1
"Marlboro County, SC",2014-2015,27889,27494,-395,-1.416,-17,-378,45,69,H1
"Marlboro County, SC",2015-2016,27494,27036,-458,-1.666,-4,-454,45,69,H1
"Marlboro County, SC",2016-2017,27036,26825,-211,-0.78,-2,-209,45,69,H1
"Newberry County, SC",2000-2001,35958,36053,95,0.264,152,-57,45,71,H1
"Newberry County, SC",2001-2002,36053,36244,191,0.53,16,175,45,71,H1
"Newberry County, SC",2002-2003,36244,36226,-18,-0.05,73,-91,45,71,H1
"Newberry County, SC",2003-2004,36226,36312,86,0.237,63,23,45,71,H1
"Newberry County, SC",2004-2005,36312,36399,87,0.24,109,-22,45,71,H1
"Newberry County, SC",2005-2006,36399,36746,347,0.953,136,211,45,71,H1
"Newberry County, SC",2006-2007,36746,37061,315,0.857,175,140,45,71,H1
"Newberry County, SC",2007-2008,37061,37192,131,0.353,104,27,45,71,H1
"Newberry County, SC",2008-2009,37192,37413,221,0.594,81,140,45,71,H1
"Newberry County, SC",2009-2010,37413,37559,146,0.39,45,101,45,71,H1
"Newberry County, SC",2010-2011,37559,37491,-68,-0.181,-12,-56,45,71,H1
"Newberry County, SC",2011-2012,37491,37563,72,0.192,-37,109,45,71,H1
"Newberry County, SC",2012-2013,37563,37568,5,0.013,76,-71,45,71,H1
"Newberry County, SC",2013-2014,37568,37783,215,0.572,15,200,45,71,H1
"Newberry County, SC",2014-2015,37807,38012,205,0.542,59,146,45,71,H1
"Newberry County, SC",2015-2016,38012,38044,32,0.084,11,21,45,71,H1
"Newberry County, SC",2016-2017,38044,38488,444,1.167,16,428,45,71,H1
"Oconee County, SC",2000-2001,66434,67170,736,1.108,103,633,45,73,H1
"Oconee County, SC",2001-2002,67170,68194,1024,1.524,177,847,45,73,H1
"Oconee County, SC",2002-2003,68194,68900,706,1.035,102,604,45,73,H1
"Oconee County, SC",2003-2004,68900,69615,715,1.038,122,593,45,73,H1
"Oconee County, SC",2004-2005,69615,70581,966,1.388,140,826,45,73,H1
"Oconee County, SC",2005-2006,70581,71490,909,1.288,26,883,45,73,H1
"Oconee County, SC",2006-2007,71490,72407,917,1.283,161,756,45,73,H1
"Oconee County, SC",2007-2008,72407,73089,682,0.942,90,592,45,73,H1
"Oconee County, SC",2008-2009,73089,73829,740,1.012,69,671,45,73,H1
"Oconee County, SC",2009-2010,73829,74364,535,0.725,30,505,45,73,H1
"Oconee County, SC",2010-2011,74364,74226,-138,-0.186,6,-144,45,73,H1
"Oconee County, SC",2011-2012,74226,74583,357,0.481,-3,360,45,73,H1
"Oconee County, SC",2012-2013,74583,74913,330,0.442,-88,418,45,73,H1
"Oconee County, SC",2013-2014,74913,75192,279,0.372,-84,363,45,73,H1
"Oconee County, SC",2014-2015,75232,75713,481,0.639,-124,605,45,73,H1
"Oconee County, SC",2015-2016,75713,76407,694,0.917,-159,853,45,73,H1
"Oconee County, SC",2016-2017,76407,77270,863,1.129,-120,983,45,73,H1
"Orangeburg County, SC",2000-2001,91524,91536,12,0.013,392,-380,45,75,H1
"Orangeburg County, SC",2001-2002,91536,91676,140,0.153,291,-151,45,75,H1
"Orangeburg County, SC",2002-2003,91676,91788,112,0.122,274,-162,45,75,H1
"Orangeburg County, SC",2003-2004,91788,91691,-97,-0.106,255,-352,45,75,H1
"Orangeburg County, SC",2004-2005,91691,92197,506,0.552,368,138,45,75,H1
"Orangeburg County, SC",2005-2006,92197,91761,-436,-0.473,337,-773,45,75,H1
"Orangeburg County, SC",2006-2007,91761,92626,865,0.943,378,487,45,75,H1
"Orangeburg County, SC",2007-2008,92626,92886,260,0.281,348,-88,45,75,H1
"Orangeburg County, SC",2008-2009,92886,92755,-131,-0.141,299,-430,45,75,H1
"Orangeburg County, SC",2009-2010,92755,92312,-443,-0.478,244,-687,45,75,H1
"Orangeburg County, SC",2010-2011,92312,91755,-557,-0.603,142,-699,45,75,H1
"Orangeburg County, SC",2011-2012,91755,91429,-326,-0.355,188,-514,45,75,H1
"Orangeburg County, SC",2012-2013,91429,90726,-703,-0.769,91,-794,45,75,H1
"Orangeburg County, SC",2013-2014,90726,90090,-636,-0.701,12,-648,45,75,H1
"Orangeburg County, SC",2014-2015,89924,89208,-716,-0.796,-43,-673,45,75,H1
"Orangeburg County, SC",2015-2016,89208,88334,-874,-0.98,-135,-739,45,75,H1
"Orangeburg County, SC",2016-2017,88334,87476,-858,-0.971,-149,-709,45,75,H1
"Pickens County, SC",2000-2001,111062,111600,538,0.484,418,120,45,77,H1
"Pickens County, SC",2001-2002,111600,111806,206,0.185,411,-205,45,77,H1
"Pickens County, SC",2002-2003,111806,112704,898,0.803,279,619,45,77,H1
"Pickens County, SC",2003-2004,112704,113554,850,0.754,404,446,45,77,H1
"Pickens County, SC",2004-2005,113554,114344,790,0.696,360,430,45,77,H1
"Pickens County, SC",2005-2006,114344,115570,1226,1.072,441,785,45,77,H1
"Pickens County, SC",2006-2007,115570,116815,1245,1.077,408,837,45,77,H1
"Pickens County, SC",2007-2008,116815,118330,1515,1.297,347,1168,45,77,H1
"Pickens County, SC",2008-2009,118330,119183,853,0.721,318,535,45,77,H1
"Pickens County, SC",2009-2010,119183,119215,32,0.027,253,-221,45,77,H1
"Pickens County, SC",2010-2011,119215,119426,211,0.177,175,36,45,77,H1
"Pickens County, SC",2011-2012,119426,119656,230,0.193,107,123,45,77,H1
"Pickens County, SC",2012-2013,119656,119222,-434,-0.363,50,-484,45,77,H1
"Pickens County, SC",2013-2014,119222,120368,1146,0.961,69,1077,45,77,H1
"Pickens County, SC",2014-2015,120622,121691,1069,0.886,117,952,45,77,H1
"Pickens County, SC",2015-2016,121691,122939,1248,1.026,113,1135,45,77,H1
"Pickens County, SC",2016-2017,122939,123479,540,0.439,99,441,45,77,H1
"Richland County, SC",2000-2001,321981,327446,5465,1.697,1899,3566,45,79,H1
"Richland County, SC",2001-2002,327446,331285,3839,1.172,1916,1923,45,79,H1
"Richland County, SC",2002-2003,331285,336273,4988,1.506,1775,3213,45,79,H1
"Richland County, SC",2003-2004,336273,345750,9477,2.818,2084,7393,45,79,H1
"Richland County, SC",2004-2005,345750,349003,3253,0.941,2123,1130,45,79,H1
"Richland County, SC",2005-2006,349003,357096,8093,2.319,2288,5805,45,79,H1
"Richland County, SC",2006-2007,357096,366111,9015,2.525,2455,6560,45,79,H1
"Richland County, SC",2007-2008,366111,373789,7678,2.097,2206,5472,45,79,H1
"Richland County, SC",2008-2009,373789,380245,6456,1.727,2027,4429,45,79,H1
"Richland County, SC",2009-2010,380245,385800,5555,1.461,2282,3273,45,79,H1
"Richland County, SC",2010-2011,385800,389600,3800,0.985,2207,1593,45,79,H1
"Richland County, SC",2011-2012,389600,393677,4077,1.046,2173,1904,45,79,H1
"Richland County, SC",2012-2013,393677,397893,4216,1.071,1833,2383,45,79,H1
"Richland County, SC",2013-2014,397893,401566,3673,0.923,1904,1769,45,79,H1
"Richland County, SC",2014-2015,401591,407051,5460,1.36,1906,3554,45,79,H1
"Richland County, SC",2015-2016,407051,409104,2053,0.504,1854,199,45,79,H1
"Richland County, SC",2016-2017,409104,411592,2488,0.608,1796,692,45,79,H1
"Saluda County, SC",2000-2001,19191,19191,0,0,50,-50,45,81,H1
"Saluda County, SC",2001-2002,19191,19180,-11,-0.057,59,-70,45,81,H1
"Saluda County, SC",2002-2003,19180,19096,-84,-0.438,26,-110,45,81,H1
"Saluda County, SC",2003-2004,19096,18904,-192,-1.005,5,-197,45,81,H1
"Saluda County, SC",2004-2005,18904,19131,227,1.201,62,165,45,81,H1
"Saluda County, SC",2005-2006,19131,19310,179,0.936,81,98,45,81,H1
"Saluda County, SC",2006-2007,19310,19417,107,0.554,122,-15,45,81,H1
"Saluda County, SC",2007-2008,19417,19503,86,0.443,71,15,45,81,H1
"Saluda County, SC",2008-2009,19503,19677,174,0.892,33,141,45,81,H1
"Saluda County, SC",2009-2010,19677,19909,232,1.179,9,223,45,81,H1
"Saluda County, SC",2010-2011,19909,19867,-42,-0.211,38,-80,45,81,H1
"Saluda County, SC",2011-2012,19867,19963,96,0.483,58,38,45,81,H1
"Saluda County, SC",2012-2013,19963,20100,137,0.686,50,87,45,81,H1
"Saluda County, SC",2013-2014,20100,20026,-74,-0.368,58,-132,45,81,H1
"Saluda County, SC",2014-2015,20027,20053,26,0.13,30,-4,45,81,H1
"Saluda County, SC",2015-2016,20053,20295,242,1.207,44,198,45,81,H1
"Saluda County, SC",2016-2017,20295,20452,157,0.774,42,115,45,81,H1
"Spartanburg County, SC",2000-2001,254443,256469,2026,0.796,790,1236,45,83,H1
"Spartanburg County, SC",2001-2002,256469,258467,1998,0.779,875,1123,45,83,H1
"Spartanburg County, SC",2002-2003,258467,260223,1756,0.679,890,866,45,83,H1
"Spartanburg County, SC",2003-2004,260223,261828,1605,0.617,805,800,45,83,H1
"Spartanburg County, SC",2004-2005,261828,264481,2653,1.013,758,1895,45,83,H1
"Spartanburg County, SC",2005-2006,264481,268898,4417,1.67,1060,3357,45,83,H1
"Spartanburg County, SC",2006-2007,268898,274215,5317,1.977,1344,3973,45,83,H1
"Spartanburg County, SC",2007-2008,274215,279673,5458,1.99,1142,4316,45,83,H1
"Spartanburg County, SC",2008-2009,279673,283335,3662,1.309,938,2724,45,83,H1
"Spartanburg County, SC",2009-2010,283335,284767,1432,0.505,764,668,45,83,H1
"Spartanburg County, SC",2010-2011,284767,286092,1325,0.465,940,385,45,83,H1
"Spartanburg County, SC",2011-2012,286092,288421,2329,0.814,818,1511,45,83,H1
"Spartanburg County, SC",2012-2013,288421,290818,2397,0.831,613,1784,45,83,H1
"Spartanburg County, SC",2013-2014,290818,293542,2724,0.937,744,1980,45,83,H1
"Spartanburg County, SC",2014-2015,293536,297302,3766,1.283,705,3061,45,83,H1
"Spartanburg County, SC",2015-2016,297302,301066,3764,1.266,655,3109,45,83,H1
"Spartanburg County, SC",2016-2017,301066,306854,5788,1.923,636,5152,45,83,H1
"Sumter County, SC",2000-2001,104802,104629,-173,-0.165,862,-1035,45,85,H1
"Sumter County, SC",2001-2002,104629,105380,751,0.718,698,53,45,85,H1
"Sumter County, SC",2002-2003,105380,105112,-268,-0.254,662,-930,45,85,H1
"Sumter County, SC",2003-2004,105112,106099,987,0.939,700,287,45,85,H1
"Sumter County, SC",2004-2005,106099,106082,-17,-0.016,698,-715,45,85,H1
"Sumter County, SC",2005-2006,106082,105953,-129,-0.122,760,-889,45,85,H1
"Sumter County, SC",2006-2007,105953,106014,61,0.058,708,-647,45,85,H1
"Sumter County, SC",2007-2008,106014,106463,449,0.424,644,-195,45,85,H1
"Sumter County, SC",2008-2009,106463,107004,541,0.508,584,-43,45,85,H1
"Sumter County, SC",2009-2010,107004,107581,577,0.539,679,-102,45,85,H1
"Sumter County, SC",2010-2011,107581,107350,-231,-0.215,459,-690,45,85,H1
"Sumter County, SC",2011-2012,107350,108060,710,0.661,588,122,45,85,H1
"Sumter County, SC",2012-2013,108060,108002,-58,-0.054,514,-572,45,85,H1
"Sumter County, SC",2013-2014,108002,107919,-83,-0.077,523,-606,45,85,H1
"Sumter County, SC",2014-2015,107940,107480,-460,-0.426,449,-909,45,85,H1
"Sumter County, SC",2015-2016,107480,107287,-193,-0.18,354,-547,45,85,H1
"Sumter County, SC",2016-2017,107287,106847,-440,-0.41,391,-831,45,85,H1
"Union County, SC",2000-2001,29971,29813,-158,-0.527,16,-174,45,87,H1
"Union County, SC",2001-2002,29813,29699,-114,-0.382,30,-144,45,87,H1
"Union County, SC",2002-2003,29699,29519,-180,-0.606,-27,-153,45,87,H1
"Union County, SC",2003-2004,29519,29279,-240,-0.813,-56,-184,45,87,H1
"Union County, SC",2004-2005,29279,29241,-38,-0.13,-73,35,45,87,H1
"Union County, SC",2005-2006,29241,29248,7,0.024,-6,13,45,87,H1
"Union County, SC",2006-2007,29248,29060,-188,-0.643,-75,-113,45,87,H1
"Union County, SC",2007-2008,29060,29172,112,0.385,-5,117,45,87,H1
"Union County, SC",2008-2009,29172,29100,-72,-0.247,-67,-5,45,87,H1
"Union County, SC",2009-2010,29100,28909,-191,-0.656,-70,-121,45,87,H1
"Union County, SC",2010-2011,28909,28655,-254,-0.879,-57,-197,45,87,H1
"Union County, SC",2011-2012,28655,28222,-433,-1.511,-87,-346,45,87,H1
"Union County, SC",2012-2013,28222,27982,-240,-0.85,-87,-153,45,87,H1
"Union County, SC",2013-2014,27982,27876,-106,-0.379,-70,-36,45,87,H1
"Union County, SC",2014-2015,27947,27777,-170,-0.608,-39,-131,45,87,H1
"Union County, SC",2015-2016,27777,27685,-92,-0.331,-67,-25,45,87,H1
"Union County, SC",2016-2017,27685,27537,-148,-0.535,-58,-90,45,87,H1
"Williamsburg County, SC",2000-2001,37145,36751,-394,-1.061,140,-534,45,89,H1
"Williamsburg County, SC",2001-2002,36751,36333,-418,-1.137,150,-568,45,89,H1
"Williamsburg County, SC",2002-2003,36333,35592,-741,-2.039,17,-758,45,89,H1
"Williamsburg County, SC",2003-2004,35592,35561,-31,-0.087,66,-97,45,89,H1
"Williamsburg County, SC",2004-2005,35561,35193,-368,-1.035,112,-480,45,89,H1
"Williamsburg County, SC",2005-2006,35193,35458,265,0.753,18,247,45,89,H1
"Williamsburg County, SC",2006-2007,35458,35444,-14,-0.039,73,-87,45,89,H1
"Williamsburg County, SC",2007-2008,35444,35090,-354,-0.999,57,-411,45,89,H1
"Williamsburg County, SC",2008-2009,35090,34622,-468,-1.334,27,-495,45,89,H1
"Williamsburg County, SC",2009-2010,34622,34336,-286,-0.826,10,-296,45,89,H1
"Williamsburg County, SC",2010-2011,34336,34113,-223,-0.649,-55,-168,45,89,H1
"Williamsburg County, SC",2011-2012,34113,33592,-521,-1.527,-55,-466,45,89,H1
"Williamsburg County, SC",2012-2013,33592,33066,-526,-1.566,-97,-429,45,89,H1
"Williamsburg County, SC",2013-2014,33066,32695,-371,-1.122,-86,-285,45,89,H1
"Williamsburg County, SC",2014-2015,32761,32535,-226,-0.69,-55,-171,45,89,H1
"Williamsburg County, SC",2015-2016,32535,31847,-688,-2.115,-84,-604,45,89,H1
"Williamsburg County, SC",2016-2017,31847,31133,-714,-2.242,-65,-649,45,89,H1
"York County, SC",2000-2001,165620,169103,3483,2.103,1053,2430,45,91,H1
"York County, SC",2001-2002,169103,173021,3918,2.317,997,2921,45,91,H1
"York County, SC",2002-2003,173021,177138,4117,2.379,950,3167,45,91,H1
"York County, SC",2003-2004,177138,181839,4701,2.654,1060,3641,45,91,H1
"York County, SC",2004-2005,181839,188117,6278,3.453,1041,5237,45,91,H1
"York County, SC",2005-2006,188117,197892,9775,5.196,1272,8503,45,91,H1
"York County, SC",2006-2007,197892,208640,10748,5.431,1421,9327,45,91,H1
"York County, SC",2007-2008,208640,217463,8823,4.229,1456,7367,45,91,H1
"York County, SC",2008-2009,217463,223616,6153,2.829,1291,4862,45,91,H1
"York County, SC",2009-2010,223616,226913,3297,1.474,1121,2176,45,91,H1
"York County, SC",2010-2011,226913,230183,3270,1.441,1055,2215,45,91,H1
"York County, SC",2011-2012,230183,234566,4383,1.904,1088,3295,45,91,H1
"York County, SC",2012-2013,234566,239415,4849,2.067,1079,3770,45,91,H1
"York County, SC",2013-2014,239415,245346,5931,2.477,1135,4796,45,91,H1
"York County, SC",2014-2015,245124,251195,6071,2.477,1059,5012,45,91,H1
"York County, SC",2015-2016,251195,257998,6803,2.708,980,5823,45,91,H1
"York County, SC",2016-2017,257998,266439,8441,3.272,984,7457,45,91,H1
Tennessee,2000-2001,5703719,5750789,47070,0.825,23746,23324,47,0,STATE
Tennessee,2001-2002,5750789,5795918,45129,0.785,21968,23161,47,0,STATE
Tennessee,2002-2003,5795918,5847812,51894,0.895,21352,30542,47,0,STATE
Tennessee,2003-2004,5847812,5910809,62997,1.077,22386,40611,47,0,STATE
Tennessee,2004-2005,5910809,5991057,80248,1.358,23509,56739,47,0,STATE
Tennessee,2005-2006,5991057,6088766,97709,1.631,26552,71157,47,0,STATE
Tennessee,2006-2007,6088766,6175727,86961,1.428,28493,58468,47,0,STATE
Tennessee,2007-2008,6175727,6247411,71684,1.161,28867,42817,47,0,STATE
Tennessee,2008-2009,6247411,6306019,58608,0.938,25862,32746,47,0,STATE
Tennessee,2009-2010,6306019,6356585,50566,0.802,24576,25990,47,0,STATE
Tennessee,2010-2011,6356585,6398408,41823,0.658,18415,23408,47,0,STATE
Tennessee,2011-2012,6398408,6455469,57061,0.892,19677,37384,47,0,STATE
Tennessee,2012-2013,6455469,6496130,40661,0.63,16757,23904,47,0,STATE
Tennessee,2013-2014,6496130,6547779,51649,0.795,17402,34247,47,0,STATE
Tennessee,2014-2015,6547779,6600299,52520,0.802,18787,33733,47,0,STATE
Tennessee,2015-2016,6600299,6649404,49105,0.744,15630,33475,47,0,STATE
Tennessee,2016-2017,6649404,6715984,66580,1.001,15875,50705,47,0,STATE
"Anderson County, TN",2000-2001,71357,71461,104,0.146,-5,109,47,1,H1
"Anderson County, TN",2001-2002,71461,71515,54,0.076,-25,79,47,1,H1
"Anderson County, TN",2002-2003,71515,71608,93,0.13,-8,101,47,1,H1
"Anderson County, TN",2003-2004,71608,71587,-21,-0.029,-75,54,47,1,H1
"Anderson County, TN",2004-2005,71587,72040,453,0.633,84,369,47,1,H1
"Anderson County, TN",2005-2006,72040,73117,1077,1.495,12,1065,47,1,H1
"Anderson County, TN",2006-2007,73117,73580,463,0.633,34,429,47,1,H1
"Anderson County, TN",2007-2008,73580,74397,817,1.11,82,735,47,1,H1
"Anderson County, TN",2008-2009,74397,75031,634,0.852,52,582,47,1,H1
"Anderson County, TN",2009-2010,75031,75146,115,0.153,26,89,47,1,H1
"Anderson County, TN",2010-2011,75146,75212,66,0.088,-72,138,47,1,H1
"Anderson County, TN",2011-2012,75212,75349,137,0.182,-133,270,47,1,H1
"Anderson County, TN",2012-2013,75349,75494,145,0.192,-53,198,47,1,H1
"Anderson County, TN",2013-2014,75494,75528,34,0.045,-42,76,47,1,H1
"Anderson County, TN",2014-2015,75382,75749,367,0.487,-119,486,47,1,H1
"Anderson County, TN",2015-2016,75749,75585,-164,-0.217,-126,-38,47,1,H1
"Anderson County, TN",2016-2017,75585,76257,672,0.889,-98,770,47,1,H1
"Bedford County, TN",2000-2001,37806,38414,608,1.608,207,401,47,3,H1
"Bedford County, TN",2001-2002,38414,38960,546,1.421,222,324,47,3,H1
"Bedford County, TN",2002-2003,38960,39697,737,1.892,171,566,47,3,H1
"Bedford County, TN",2003-2004,39697,40558,861,2.169,259,602,47,3,H1
"Bedford County, TN",2004-2005,40558,41616,1058,2.609,304,754,47,3,H1
"Bedford County, TN",2005-2006,41616,42780,1164,2.797,279,885,47,3,H1
"Bedford County, TN",2006-2007,42780,43678,898,2.099,362,536,47,3,H1
"Bedford County, TN",2007-2008,43678,44395,717,1.642,265,452,47,3,H1
"Bedford County, TN",2008-2009,44395,44845,450,1.014,270,180,47,3,H1
"Bedford County, TN",2009-2010,44845,45112,267,0.595,278,-11,47,3,H1
"Bedford County, TN",2010-2011,45112,45313,201,0.446,180,21,47,3,H1
"Bedford County, TN",2011-2012,45313,45400,87,0.192,173,-86,47,3,H1
"Bedford County, TN",2012-2013,45400,45849,449,0.989,200,249,47,3,H1
"Bedford County, TN",2013-2014,45849,46627,778,1.697,214,564,47,3,H1
"Bedford County, TN",2014-2015,46428,47183,755,1.626,202,553,47,3,H1
"Bedford County, TN",2015-2016,47183,47420,237,0.502,153,84,47,3,H1
"Bedford County, TN",2016-2017,47420,48117,697,1.47,129,568,47,3,H1
"Benton County, TN",2000-2001,16537,16673,136,0.822,-48,184,47,5,H1
"Benton County, TN",2001-2002,16673,16572,-101,-0.606,-65,-36,47,5,H1
"Benton County, TN",2002-2003,16572,16531,-41,-0.247,-68,27,47,5,H1
"Benton County, TN",2003-2004,16531,16517,-14,-0.085,-41,27,47,5,H1
"Benton County, TN",2004-2005,16517,16515,-2,-0.012,-43,41,47,5,H1
"Benton County, TN",2005-2006,16515,16435,-80,-0.484,-77,-3,47,5,H1
"Benton County, TN",2006-2007,16435,16490,55,0.335,-80,135,47,5,H1
"Benton County, TN",2007-2008,16490,16431,-59,-0.358,-85,26,47,5,H1
"Benton County, TN",2008-2009,16431,16424,-7,-0.043,-50,43,47,5,H1
"Benton County, TN",2009-2010,16424,16500,76,0.463,-40,116,47,5,H1
"Benton County, TN",2010-2011,16500,16428,-72,-0.436,-47,-25,47,5,H1
"Benton County, TN",2011-2012,16428,16369,-59,-0.359,-104,45,47,5,H1
"Benton County, TN",2012-2013,16369,16282,-87,-0.531,-100,13,47,5,H1
"Benton County, TN",2013-2014,16282,16145,-137,-0.841,-100,-37,47,5,H1
"Benton County, TN",2014-2015,16115,16129,14,0.087,-87,101,47,5,H1
"Benton County, TN",2015-2016,16129,16059,-70,-0.434,-102,32,47,5,H1
"Benton County, TN",2016-2017,16059,15986,-73,-0.455,-100,27,47,5,H1
"Bledsoe County, TN",2000-2001,12390,12468,78,0.63,18,60,47,7,H1
"Bledsoe County, TN",2001-2002,12468,12446,-22,-0.176,8,-30,47,7,H1
"Bledsoe County, TN",2002-2003,12446,12502,56,0.45,14,42,47,7,H1
"Bledsoe County, TN",2003-2004,12502,12610,108,0.864,13,95,47,7,H1
"Bledsoe County, TN",2004-2005,12610,12685,75,0.595,13,62,47,7,H1
"Bledsoe County, TN",2005-2006,12685,12847,162,1.277,32,130,47,7,H1
"Bledsoe County, TN",2006-2007,12847,13028,181,1.409,31,150,47,7,H1
"Bledsoe County, TN",2007-2008,13028,13070,42,0.322,29,13,47,7,H1
"Bledsoe County, TN",2008-2009,13070,12924,-146,-1.117,2,-148,47,7,H1
"Bledsoe County, TN",2009-2010,12924,12866,-58,-0.449,-10,-48,47,7,H1
"Bledsoe County, TN",2010-2011,12866,12834,-32,-0.249,-2,-30,47,7,H1
"Bledsoe County, TN",2011-2012,12834,12781,-53,-0.413,5,-58,47,7,H1
"Bledsoe County, TN",2012-2013,12781,13786,1005,7.863,-25,1030,47,7,H1
"Bledsoe County, TN",2013-2014,13786,13931,145,1.052,-13,158,47,7,H1
"Bledsoe County, TN",2014-2015,14526,14502,-24,-0.165,-13,-11,47,7,H1
"Bledsoe County, TN",2015-2016,14502,14599,97,0.669,-12,109,47,7,H1
"Bledsoe County, TN",2016-2017,14599,14717,118,0.808,6,112,47,7,H1
"Blount County, TN",2000-2001,106193,107916,1723,1.623,246,1477,47,9,H1
"Blount County, TN",2001-2002,107916,109515,1599,1.482,109,1490,47,9,H1
"Blount County, TN",2002-2003,109515,111156,1641,1.498,81,1560,47,9,H1
"Blount County, TN",2003-2004,111156,113151,1995,1.795,126,1869,47,9,H1
"Blount County, TN",2004-2005,113151,115336,2185,1.931,188,1997,47,9,H1
"Blount County, TN",2005-2006,115336,118228,2892,2.507,156,2736,47,9,H1
"Blount County, TN",2006-2007,118228,119950,1722,1.457,245,1477,47,9,H1
"Blount County, TN",2007-2008,119950,121716,1766,1.472,181,1585,47,9,H1
"Blount County, TN",2008-2009,121716,122689,973,0.799,166,807,47,9,H1
"Blount County, TN",2009-2010,122689,123151,462,0.377,68,394,47,9,H1
"Blount County, TN",2010-2011,123151,123625,474,0.385,-20,494,47,9,H1
"Blount County, TN",2011-2012,123625,124016,391,0.316,37,354,47,9,H1
"Blount County, TN",2012-2013,124016,125045,1029,0.83,47,982,47,9,H1
"Blount County, TN",2013-2014,125045,126339,1294,1.035,88,1206,47,9,H1
"Blount County, TN",2014-2015,126124,127253,1129,0.895,56,1073,47,9,H1
"Blount County, TN",2015-2016,127253,128244,991,0.779,-88,1079,47,9,H1
"Blount County, TN",2016-2017,128244,129929,1685,1.314,-103,1788,47,9,H1
"Bradley County, TN",2000-2001,88206,88934,728,0.825,355,373,47,11,H1
"Bradley County, TN",2001-2002,88934,89711,777,0.874,429,348,47,11,H1
"Bradley County, TN",2002-2003,89711,90399,688,0.767,359,329,47,11,H1
"Bradley County, TN",2003-2004,90399,91814,1415,1.565,393,1022,47,11,H1
"Bradley County, TN",2004-2005,91814,93024,1210,1.318,333,877,47,11,H1
"Bradley County, TN",2005-2006,93024,94638,1614,1.735,350,1264,47,11,H1
"Bradley County, TN",2006-2007,94638,96336,1698,1.794,432,1266,47,11,H1
"Bradley County, TN",2007-2008,96336,97547,1211,1.257,349,862,47,11,H1
"Bradley County, TN",2008-2009,97547,98360,813,0.833,335,478,47,11,H1
"Bradley County, TN",2009-2010,98360,99142,782,0.795,302,480,47,11,H1
"Bradley County, TN",2010-2011,99142,99911,769,0.776,139,630,47,11,H1
"Bradley County, TN",2011-2012,99911,101117,1206,1.207,263,943,47,11,H1
"Bradley County, TN",2012-2013,101117,101873,756,0.748,241,515,47,11,H1
"Bradley County, TN",2013-2014,101873,102975,1102,1.082,227,875,47,11,H1
"Bradley County, TN",2014-2015,103058,104091,1033,1.002,245,788,47,11,H1
"Bradley County, TN",2015-2016,104091,104407,316,0.304,180,136,47,11,H1
"Bradley County, TN",2016-2017,104407,105560,1153,1.104,151,1002,47,11,H1
"Campbell County, TN",2000-2001,39880,39802,-78,-0.196,55,-133,47,13,H1
"Campbell County, TN",2001-2002,39802,39824,22,0.055,-53,75,47,13,H1
"Campbell County, TN",2002-2003,39824,39957,133,0.334,31,102,47,13,H1
"Campbell County, TN",2003-2004,39957,40371,414,1.036,53,361,47,13,H1
"Campbell County, TN",2004-2005,40371,40397,26,0.064,-2,28,47,13,H1
"Campbell County, TN",2005-2006,40397,40475,78,0.193,36,42,47,13,H1
"Campbell County, TN",2006-2007,40475,40480,5,0.012,-56,61,47,13,H1
"Campbell County, TN",2007-2008,40480,40672,192,0.474,5,187,47,13,H1
"Campbell County, TN",2008-2009,40672,40790,118,0.29,-31,149,47,13,H1
"Campbell County, TN",2009-2010,40790,40704,-86,-0.211,-27,-59,47,13,H1
"Campbell County, TN",2010-2011,40704,40559,-145,-0.356,-130,-15,47,13,H1
"Campbell County, TN",2011-2012,40559,40429,-130,-0.321,-47,-83,47,13,H1
"Campbell County, TN",2012-2013,40429,40195,-234,-0.579,-124,-110,47,13,H1
"Campbell County, TN",2013-2014,40195,39918,-277,-0.689,-140,-137,47,13,H1
"Campbell County, TN",2014-2015,39910,39752,-158,-0.396,-127,-31,47,13,H1
"Campbell County, TN",2015-2016,39752,39671,-81,-0.204,-141,60,47,13,H1
"Campbell County, TN",2016-2017,39671,39648,-23,-0.058,-146,123,47,13,H1
"Cannon County, TN",2000-2001,12912,12990,78,0.604,3,75,47,15,H1
"Cannon County, TN",2001-2002,12990,12965,-25,-0.192,17,-42,47,15,H1
"Cannon County, TN",2002-2003,12965,13020,55,0.424,5,50,47,15,H1
"Cannon County, TN",2003-2004,13020,13114,94,0.722,-6,100,47,15,H1
"Cannon County, TN",2004-2005,13114,13153,39,0.297,-18,57,47,15,H1
"Cannon County, TN",2005-2006,13153,13280,127,0.966,17,110,47,15,H1
"Cannon County, TN",2006-2007,13280,13435,155,1.167,38,117,47,15,H1
"Cannon County, TN",2007-2008,13435,13822,387,2.881,42,345,47,15,H1
"Cannon County, TN",2008-2009,13822,13823,1,0.007,10,-9,47,15,H1
"Cannon County, TN",2009-2010,13823,13793,-30,-0.217,-15,-15,47,15,H1
"Cannon County, TN",2010-2011,13793,13742,-51,-0.37,-8,-43,47,15,H1
"Cannon County, TN",2011-2012,13742,13842,100,0.728,-18,118,47,15,H1
"Cannon County, TN",2012-2013,13842,13797,-45,-0.325,3,-48,47,15,H1
"Cannon County, TN",2013-2014,13797,13757,-40,-0.29,25,-65,47,15,H1
"Cannon County, TN",2014-2015,13718,13840,122,0.889,-20,142,47,15,H1
"Cannon County, TN",2015-2016,13840,13907,67,0.484,-19,86,47,15,H1
"Cannon County, TN",2016-2017,13907,14216,309,2.222,23,286,47,15,H1
"Carroll County, TN",2000-2001,29423,29447,24,0.082,-92,116,47,17,H1
"Carroll County, TN",2001-2002,29447,29146,-301,-1.022,-54,-247,47,17,H1
"Carroll County, TN",2002-2003,29146,29145,-1,-0.003,-59,58,47,17,H1
"Carroll County, TN",2003-2004,29145,29104,-41,-0.141,-81,40,47,17,H1
"Carroll County, TN",2004-2005,29104,28707,-397,-1.364,-80,-317,47,17,H1
"Carroll County, TN",2005-2006,28707,28791,84,0.293,-50,134,47,17,H1
"Carroll County, TN",2006-2007,28791,28793,2,0.007,-123,125,47,17,H1
"Carroll County, TN",2007-2008,28793,28645,-148,-0.514,-51,-97,47,17,H1
"Carroll County, TN",2008-2009,28645,28474,-171,-0.597,-63,-108,47,17,H1
"Carroll County, TN",2009-2010,28474,28479,5,0.018,-55,60,47,17,H1
"Carroll County, TN",2010-2011,28479,28587,108,0.379,-81,189,47,17,H1
"Carroll County, TN",2011-2012,28587,28623,36,0.126,-82,118,47,17,H1
"Carroll County, TN",2012-2013,28623,28496,-127,-0.444,-36,-91,47,17,H1
"Carroll County, TN",2013-2014,28496,28370,-126,-0.442,-50,-76,47,17,H1
"Carroll County, TN",2014-2015,28207,27910,-297,-1.053,-82,-215,47,17,H1
"Carroll County, TN",2015-2016,27910,27924,14,0.05,-79,93,47,17,H1
"Carroll County, TN",2016-2017,27924,27860,-64,-0.229,-83,19,47,17,H1
"Carter County, TN",2000-2001,56789,56770,-19,-0.033,-75,56,47,19,H1
"Carter County, TN",2001-2002,56770,56682,-88,-0.155,-49,-39,47,19,H1
"Carter County, TN",2002-2003,56682,57530,848,1.496,-66,914,47,19,H1
"Carter County, TN",2003-2004,57530,57532,2,0.003,-42,44,47,19,H1
"Carter County, TN",2004-2005,57532,57693,161,0.28,-18,179,47,19,H1
"Carter County, TN",2005-2006,57693,57877,184,0.319,-56,240,47,19,H1
"Carter County, TN",2006-2007,57877,57781,-96,-0.166,-101,5,47,19,H1
"Carter County, TN",2007-2008,57781,57895,114,0.197,-19,133,47,19,H1
"Carter County, TN",2008-2009,57895,57639,-256,-0.442,-22,-234,47,19,H1
"Carter County, TN",2009-2010,57639,57384,-255,-0.442,-57,-198,47,19,H1
"Carter County, TN",2010-2011,57384,57511,127,0.221,5,122,47,19,H1
"Carter County, TN",2011-2012,57511,57376,-135,-0.235,-138,3,47,19,H1
"Carter County, TN",2012-2013,57376,57331,-45,-0.078,-187,142,47,19,H1
"Carter County, TN",2013-2014,57331,56886,-445,-0.776,-205,-240,47,19,H1
"Carter County, TN",2014-2015,56358,56486,128,0.227,-181,309,47,19,H1
"Carter County, TN",2015-2016,56486,56458,-28,-0.05,-215,187,47,19,H1
"Carter County, TN",2016-2017,56458,56488,30,0.053,-224,254,47,19,H1
"Cheatham County, TN",2000-2001,35979,36377,398,1.106,219,179,47,21,H1
"Cheatham County, TN",2001-2002,36377,36709,332,0.913,210,122,47,21,H1
"Cheatham County, TN",2002-2003,36709,36897,188,0.512,198,-10,47,21,H1
"Cheatham County, TN",2003-2004,36897,37256,359,0.973,189,170,47,21,H1
"Cheatham County, TN",2004-2005,37256,37668,412,1.106,192,220,47,21,H1
"Cheatham County, TN",2005-2006,37668,38186,518,1.375,196,322,47,21,H1
"Cheatham County, TN",2006-2007,38186,38637,451,1.181,197,254,47,21,H1
"Cheatham County, TN",2007-2008,38637,38947,310,0.802,205,105,47,21,H1
"Cheatham County, TN",2008-2009,38947,39170,223,0.573,200,23,47,21,H1
"Cheatham County, TN",2009-2010,39170,39116,-54,-0.138,137,-191,47,21,H1
"Cheatham County, TN",2010-2011,39116,39009,-107,-0.274,45,-152,47,21,H1
"Cheatham County, TN",2011-2012,39009,39275,266,0.682,97,169,47,21,H1
"Cheatham County, TN",2012-2013,39275,39457,182,0.463,79,103,47,21,H1
"Cheatham County, TN",2013-2014,39457,39764,307,0.778,98,209,47,21,H1
"Cheatham County, TN",2014-2015,39714,39741,27,0.068,96,-69,47,21,H1
"Cheatham County, TN",2015-2016,39741,39728,-13,-0.033,30,-43,47,21,H1
"Cheatham County, TN",2016-2017,39728,40330,602,1.515,80,522,47,21,H1
"Chester County, TN",2000-2001,15549,15856,307,1.974,-5,312,47,23,H1
"Chester County, TN",2001-2002,15856,15900,44,0.277,47,-3,47,23,H1
"Chester County, TN",2002-2003,15900,15672,-228,-1.434,28,-256,47,23,H1
"Chester County, TN",2003-2004,15672,16225,553,3.529,46,507,47,23,H1
"Chester County, TN",2004-2005,16225,16355,130,0.801,30,100,47,23,H1
"Chester County, TN",2005-2006,16355,16491,136,0.832,34,102,47,23,H1
"Chester County, TN",2006-2007,16491,16622,131,0.794,18,113,47,23,H1
"Chester County, TN",2007-2008,16622,16840,218,1.312,52,166,47,23,H1
"Chester County, TN",2008-2009,16840,16864,24,0.143,38,-14,47,23,H1
"Chester County, TN",2009-2010,16864,17174,310,1.838,29,281,47,23,H1
"Chester County, TN",2010-2011,17174,17216,42,0.245,-7,49,47,23,H1
"Chester County, TN",2011-2012,17216,17225,9,0.052,14,-5,47,23,H1
"Chester County, TN",2012-2013,17225,17354,129,0.749,26,103,47,23,H1
"Chester County, TN",2013-2014,17354,17379,25,0.144,32,-7,47,23,H1
"Chester County, TN",2014-2015,17379,17471,92,0.529,36,56,47,23,H1
"Chester County, TN",2015-2016,17471,17102,-369,-2.112,5,-374,47,23,H1
"Chester County, TN",2016-2017,17102,17119,17,0.099,13,4,47,23,H1
"Claiborne County, TN",2000-2001,29930,30095,165,0.551,-6,171,47,25,H1
"Claiborne County, TN",2001-2002,30095,30099,4,0.013,-16,20,47,25,H1
"Claiborne County, TN",2002-2003,30099,30511,412,1.369,20,392,47,25,H1
"Claiborne County, TN",2003-2004,30511,30830,319,1.046,15,304,47,25,H1
"Claiborne County, TN",2004-2005,30830,31206,376,1.22,-19,395,47,25,H1
"Claiborne County, TN",2005-2006,31206,31481,275,0.881,42,233,47,25,H1
"Claiborne County, TN",2006-2007,31481,31729,248,0.788,-20,268,47,25,H1
"Claiborne County, TN",2007-2008,31729,32006,277,0.873,-22,299,47,25,H1
"Claiborne County, TN",2008-2009,32006,32056,50,0.156,-35,85,47,25,H1
"Claiborne County, TN",2009-2010,32056,32230,174,0.543,-40,214,47,25,H1
"Claiborne County, TN",2010-2011,32230,32074,-156,-0.484,-68,-88,47,25,H1
"Claiborne County, TN",2011-2012,32074,31716,-358,-1.116,-122,-236,47,25,H1
"Claiborne County, TN",2012-2013,31716,31593,-123,-0.388,-134,11,47,25,H1
"Claiborne County, TN",2013-2014,31593,31592,-1,-0.003,-116,115,47,25,H1
"Claiborne County, TN",2014-2015,31624,31709,85,0.269,-100,185,47,25,H1
"Claiborne County, TN",2015-2016,31709,31561,-148,-0.467,-180,32,47,25,H1
"Claiborne County, TN",2016-2017,31561,31609,48,0.152,-119,167,47,25,H1
"Clay County, TN",2000-2001,7968,7921,-47,-0.59,-4,-43,47,27,H1
"Clay County, TN",2001-2002,7921,7924,3,0.038,-28,31,47,27,H1
"Clay County, TN",2002-2003,7924,7909,-15,-0.189,-34,19,47,27,H1
"Clay County, TN",2003-2004,7909,7947,38,0.48,-32,70,47,27,H1
"Clay County, TN",2004-2005,7947,7954,7,0.088,-1,8,47,27,H1
"Clay County, TN",2005-2006,7954,7977,23,0.289,13,10,47,27,H1
"Clay County, TN",2006-2007,7977,7901,-76,-0.953,-11,-65,47,27,H1
"Clay County, TN",2007-2008,7901,7862,-39,-0.494,-8,-31,47,27,H1
"Clay County, TN",2008-2009,7862,7830,-32,-0.407,2,-34,47,27,H1
"Clay County, TN",2009-2010,7830,7848,18,0.23,-11,29,47,27,H1
"Clay County, TN",2010-2011,7848,7823,-25,-0.319,-33,8,47,27,H1
"Clay County, TN",2011-2012,7823,7800,-23,-0.294,-43,20,47,27,H1
"Clay County, TN",2012-2013,7800,7775,-25,-0.321,-11,-14,47,27,H1
"Clay County, TN",2013-2014,7775,7765,-10,-0.129,-6,-4,47,27,H1
"Clay County, TN",2014-2015,7740,7771,31,0.401,-26,57,47,27,H1
"Clay County, TN",2015-2016,7771,7688,-83,-1.068,-51,-32,47,27,H1
"Clay County, TN",2016-2017,7688,7703,15,0.195,-36,51,47,27,H1
"Cocke County, TN",2000-2001,33595,33618,23,0.068,-22,45,47,29,H1
"Cocke County, TN",2001-2002,33618,33920,302,0.898,18,284,47,29,H1
"Cocke County, TN",2002-2003,33920,34234,314,0.926,-1,315,47,29,H1
"Cocke County, TN",2003-2004,34234,34393,159,0.464,-24,183,47,29,H1
"Cocke County, TN",2004-2005,34393,34644,251,0.73,-19,270,47,29,H1
"Cocke County, TN",2005-2006,34644,35001,357,1.03,-15,372,47,29,H1
"Cocke County, TN",2006-2007,35001,35272,271,0.774,36,235,47,29,H1
"Cocke County, TN",2007-2008,35272,35666,394,1.117,51,343,47,29,H1
"Cocke County, TN",2008-2009,35666,35811,145,0.407,-7,152,47,29,H1
"Cocke County, TN",2009-2010,35811,35653,-158,-0.441,-51,-107,47,29,H1
"Cocke County, TN",2010-2011,35653,35394,-259,-0.726,-69,-190,47,29,H1
"Cocke County, TN",2011-2012,35394,35488,94,0.266,-63,157,47,29,H1
"Cocke County, TN",2012-2013,35488,35354,-134,-0.378,-82,-52,47,29,H1
"Cocke County, TN",2013-2014,35354,35374,20,0.057,-63,83,47,29,H1
"Cocke County, TN",2014-2015,35285,35162,-123,-0.349,-87,-36,47,29,H1
"Cocke County, TN",2015-2016,35162,35160,-2,-0.006,-130,128,47,29,H1
"Cocke County, TN",2016-2017,35160,35556,396,1.126,-102,498,47,29,H1
"Coffee County, TN",2000-2001,48224,48594,370,0.767,102,268,47,31,H1
"Coffee County, TN",2001-2002,48594,49074,480,0.988,86,394,47,31,H1
"Coffee County, TN",2002-2003,49074,49602,528,1.076,89,439,47,31,H1
"Coffee County, TN",2003-2004,49602,50077,475,0.958,74,401,47,31,H1
"Coffee County, TN",2004-2005,50077,50834,757,1.512,106,651,47,31,H1
"Coffee County, TN",2005-2006,50834,51646,812,1.597,209,603,47,31,H1
"Coffee County, TN",2006-2007,51646,52022,376,0.728,158,218,47,31,H1
"Coffee County, TN",2007-2008,52022,52460,438,0.842,201,237,47,31,H1
"Coffee County, TN",2008-2009,52460,52813,353,0.673,124,229,47,31,H1
"Coffee County, TN",2009-2010,52813,52787,-26,-0.049,62,-88,47,31,H1
"Coffee County, TN",2010-2011,52787,52894,107,0.203,1,106,47,31,H1
"Coffee County, TN",2011-2012,52894,53137,243,0.459,-21,264,47,31,H1
"Coffee County, TN",2012-2013,53137,53316,179,0.337,4,175,47,31,H1
"Coffee County, TN",2013-2014,53316,53623,307,0.576,23,284,47,31,H1
"Coffee County, TN",2014-2015,53638,54277,639,1.191,53,586,47,31,H1
"Coffee County, TN",2015-2016,54277,54428,151,0.278,10,141,47,31,H1
"Coffee County, TN",2016-2017,54428,55034,606,1.113,47,559,47,31,H1
"Crockett County, TN",2000-2001,14545,14546,1,0.007,11,-10,47,33,H1
"Crockett County, TN",2001-2002,14546,14487,-59,-0.406,19,-78,47,33,H1
"Crockett County, TN",2002-2003,14487,14365,-122,-0.842,-12,-110,47,33,H1
"Crockett County, TN",2003-2004,14365,14434,69,0.48,-6,75,47,33,H1
"Crockett County, TN",2004-2005,14434,14437,3,0.021,-4,7,47,33,H1
"Crockett County, TN",2005-2006,14437,14430,-7,-0.048,-6,-1,47,33,H1
"Crockett County, TN",2006-2007,14430,14491,61,0.423,44,17,47,33,H1
"Crockett County, TN",2007-2008,14491,14541,50,0.345,35,15,47,33,H1
"Crockett County, TN",2008-2009,14541,14573,32,0.22,13,19,47,33,H1
"Crockett County, TN",2009-2010,14573,14571,-2,-0.014,26,-28,47,33,H1
"Crockett County, TN",2010-2011,14571,14543,-28,-0.192,0,-28,47,33,H1
"Crockett County, TN",2011-2012,14543,14602,59,0.406,-18,77,47,33,H1
"Crockett County, TN",2012-2013,14602,14613,11,0.075,40,-29,47,33,H1
"Crockett County, TN",2013-2014,14613,14668,55,0.376,22,33,47,33,H1
"Crockett County, TN",2014-2015,14635,14601,-34,-0.232,14,-48,47,33,H1
"Crockett County, TN",2015-2016,14601,14467,-134,-0.918,5,-139,47,33,H1
"Crockett County, TN",2016-2017,14467,14473,6,0.041,-21,27,47,33,H1
"Cumberland County, TN",2000-2001,47027,47849,822,1.748,-35,857,47,35,H1
"Cumberland County, TN",2001-2002,47849,48918,1069,2.234,-61,1130,47,35,H1
"Cumberland County, TN",2002-2003,48918,49607,689,1.408,-63,752,47,35,H1
"Cumberland County, TN",2003-2004,49607,50584,977,1.969,-29,1006,47,35,H1
"Cumberland County, TN",2004-2005,50584,51758,1174,2.321,-40,1214,47,35,H1
"Cumberland County, TN",2005-2006,51758,53363,1605,3.101,-75,1680,47,35,H1
"Cumberland County, TN",2006-2007,53363,54534,1171,2.194,-42,1213,47,35,H1
"Cumberland County, TN",2007-2008,54534,55184,650,1.192,-86,736,47,35,H1
"Cumberland County, TN",2008-2009,55184,55672,488,0.884,-138,626,47,35,H1
"Cumberland County, TN",2009-2010,55672,56206,534,0.959,-112,646,47,35,H1
"Cumberland County, TN",2010-2011,56206,56600,394,0.701,-124,518,47,35,H1
"Cumberland County, TN",2011-2012,56600,57037,437,0.772,-192,629,47,35,H1
"Cumberland County, TN",2012-2013,57037,57492,455,0.798,-199,654,47,35,H1
"Cumberland County, TN",2013-2014,57492,57985,493,0.858,-193,686,47,35,H1
"Cumberland County, TN",2014-2015,57915,58229,314,0.542,-244,558,47,35,H1
"Cumberland County, TN",2015-2016,58229,58532,303,0.52,-250,553,47,35,H1
"Cumberland County, TN",2016-2017,58532,59078,546,0.933,-259,805,47,35,H1
"Davidson County, TN",2000-2001,570439,574119,3680,0.645,3867,-187,47,37,H6
"Davidson County, TN",2001-2002,574119,574215,96,0.017,3736,-3640,47,37,H6
"Davidson County, TN",2002-2003,574215,577231,3016,0.525,3498,-482,47,37,H6
"Davidson County, TN",2003-2004,577231,583013,5782,1.002,3975,1807,47,37,H6
"Davidson County, TN",2004-2005,583013,589787,6774,1.162,4294,2480,47,37,H6
"Davidson County, TN",2005-2006,589787,597597,7810,1.324,4778,3032,47,37,H6
"Davidson County, TN",2006-2007,597597,605031,7434,1.244,4991,2443,47,37,H6
"Davidson County, TN",2007-2008,605031,612649,7618,1.259,5019,2599,47,37,H6
"Davidson County, TN",2008-2009,612649,621008,8359,1.364,4686,3673,47,37,H6
"Davidson County, TN",2009-2010,621008,628045,7037,1.133,5144,1893,47,37,H6
"Davidson County, TN",2010-2011,628045,635663,7618,1.213,4550,3068,47,37,H6
"Davidson County, TN",2011-2012,635663,649142,13479,2.12,4786,8693,47,37,H6
"Davidson County, TN",2012-2013,649142,659042,9900,1.525,4620,5280,47,37,H6
"Davidson County, TN",2013-2014,659042,668347,9305,1.412,4585,4720,47,37,H6
"Davidson County, TN",2014-2015,669094,678889,9795,1.464,4955,4840,47,37,H6
"Davidson County, TN",2015-2016,678889,688901,10012,1.475,4786,5226,47,37,H6
"Davidson County, TN",2016-2017,688901,691243,2342,0.34,4802,-2460,47,37,H6
"Decatur County, TN",2000-2001,11687,11691,4,0.034,-15,19,47,39,H1
"Decatur County, TN",2001-2002,11691,11659,-32,-0.274,-28,-4,47,39,H1
"Decatur County, TN",2002-2003,11659,11600,-59,-0.506,-63,4,47,39,H1
"Decatur County, TN",2003-2004,11600,11655,55,0.474,-31,86,47,39,H1
"Decatur County, TN",2004-2005,11655,11597,-58,-0.498,-69,11,47,39,H1
"Decatur County, TN",2005-2006,11597,11567,-30,-0.259,-32,2,47,39,H1
"Decatur County, TN",2006-2007,11567,11721,154,1.331,-5,159,47,39,H1
"Decatur County, TN",2007-2008,11721,11769,48,0.41,-13,61,47,39,H1
"Decatur County, TN",2008-2009,11769,11779,10,0.085,-47,57,47,39,H1
"Decatur County, TN",2009-2010,11779,11721,-58,-0.492,-53,-5,47,39,H1
"Decatur County, TN",2010-2011,11721,11673,-48,-0.41,-55,7,47,39,H1
"Decatur County, TN",2011-2012,11673,11648,-25,-0.214,-58,33,47,39,H1
"Decatur County, TN",2012-2013,11648,11665,17,0.146,-82,99,47,39,H1
"Decatur County, TN",2013-2014,11665,11666,1,0.009,-71,72,47,39,H1
"Decatur County, TN",2014-2015,11730,11660,-70,-0.597,-44,-26,47,39,H1
"Decatur County, TN",2015-2016,11660,11711,51,0.437,-51,102,47,39,H1
"Decatur County, TN",2016-2017,11711,11751,40,0.342,-53,93,47,39,H1
"DeKalb County, TN",2000-2001,17443,17498,55,0.315,23,32,47,41,H1
"DeKalb County, TN",2001-2002,17498,17678,180,1.029,30,150,47,41,H1
"DeKalb County, TN",2002-2003,17678,17883,205,1.16,47,158,47,41,H1
"DeKalb County, TN",2003-2004,17883,18051,168,0.939,12,156,47,41,H1
"DeKalb County, TN",2004-2005,18051,18150,99,0.548,19,80,47,41,H1
"DeKalb County, TN",2005-2006,18150,18289,139,0.766,43,96,47,41,H1
"DeKalb County, TN",2006-2007,18289,18414,125,0.683,44,81,47,41,H1
"DeKalb County, TN",2007-2008,18414,18693,279,1.515,68,211,47,41,H1
"DeKalb County, TN",2008-2009,18693,18720,27,0.144,33,-6,47,41,H1
"DeKalb County, TN",2009-2010,18720,18727,7,0.037,11,-4,47,41,H1
"DeKalb County, TN",2010-2011,18727,18802,75,0.4,-7,82,47,41,H1
"DeKalb County, TN",2011-2012,18802,18920,118,0.628,-9,127,47,41,H1
"DeKalb County, TN",2012-2013,18920,19123,203,1.073,8,195,47,41,H1
"DeKalb County, TN",2013-2014,19123,19268,145,0.758,17,128,47,41,H1
"DeKalb County, TN",2014-2015,19211,19182,-29,-0.151,9,-38,47,41,H1
"DeKalb County, TN",2015-2016,19182,19442,260,1.355,-28,288,47,41,H1
"DeKalb County, TN",2016-2017,19442,19852,410,2.109,-7,417,47,41,H1
"Dickson County, TN",2000-2001,43362,43987,625,1.441,270,355,47,43,H1
"Dickson County, TN",2001-2002,43987,44586,599,1.362,223,376,47,43,H1
"Dickson County, TN",2002-2003,44586,45241,655,1.469,203,452,47,43,H1
"Dickson County, TN",2003-2004,45241,45727,486,1.074,164,322,47,43,H1
"Dickson County, TN",2004-2005,45727,46361,634,1.386,258,376,47,43,H1
"Dickson County, TN",2005-2006,46361,47229,868,1.872,251,617,47,43,H1
"Dickson County, TN",2006-2007,47229,48287,1058,2.24,243,815,47,43,H1
"Dickson County, TN",2007-2008,48287,48929,642,1.33,221,421,47,43,H1
"Dickson County, TN",2008-2009,48929,49380,451,0.922,247,204,47,43,H1
"Dickson County, TN",2009-2010,49380,49708,328,0.664,187,141,47,43,H1
"Dickson County, TN",2010-2011,49708,49944,236,0.475,102,134,47,43,H1
"Dickson County, TN",2011-2012,49944,50167,223,0.447,65,158,47,43,H1
"Dickson County, TN",2012-2013,50167,50183,16,0.032,151,-135,47,43,H1
"Dickson County, TN",2013-2014,50183,50575,392,0.781,118,274,47,43,H1
"Dickson County, TN",2014-2015,50592,51487,895,1.769,164,731,47,43,H1
"Dickson County, TN",2015-2016,51487,51922,435,0.845,9,426,47,43,H1
"Dickson County, TN",2016-2017,51922,52853,931,1.793,88,843,47,43,H1
"Dyer County, TN",2000-2001,37325,37156,-169,-0.453,73,-242,47,45,H1
"Dyer County, TN",2001-2002,37156,37166,10,0.027,94,-84,47,45,H1
"Dyer County, TN",2002-2003,37166,37332,166,0.447,42,124,47,45,H1
"Dyer County, TN",2003-2004,37332,37520,188,0.504,65,123,47,45,H1
"Dyer County, TN",2004-2005,37520,37882,362,0.965,93,269,47,45,H1
"Dyer County, TN",2005-2006,37882,38043,161,0.425,88,73,47,45,H1
"Dyer County, TN",2006-2007,38043,38077,34,0.089,125,-91,47,45,H1
"Dyer County, TN",2007-2008,38077,38149,72,0.189,118,-46,47,45,H1
"Dyer County, TN",2008-2009,38149,38254,105,0.275,97,8,47,45,H1
"Dyer County, TN",2009-2010,38254,38321,67,0.175,81,-14,47,45,H1
"Dyer County, TN",2010-2011,38321,38139,-182,-0.475,34,-216,47,45,H1
"Dyer County, TN",2011-2012,38139,38223,84,0.22,107,-23,47,45,H1
"Dyer County, TN",2012-2013,38223,38160,-63,-0.165,81,-144,47,45,H1
"Dyer County, TN",2013-2014,38160,37935,-225,-0.59,55,-280,47,45,H1
"Dyer County, TN",2014-2015,37868,37893,25,0.066,44,-19,47,45,H1
"Dyer County, TN",2015-2016,37893,37605,-288,-0.76,34,-322,47,45,H1
"Dyer County, TN",2016-2017,37605,37463,-142,-0.378,4,-146,47,45,H1
"Fayette County, TN",2000-2001,29083,30139,1056,3.631,137,919,47,47,H1
"Fayette County, TN",2001-2002,30139,30936,797,2.644,85,712,47,47,H1
"Fayette County, TN",2002-2003,30936,31929,993,3.21,126,867,47,47,H1
"Fayette County, TN",2003-2004,31929,33005,1076,3.37,53,1023,47,47,H1
"Fayette County, TN",2004-2005,33005,33831,826,2.503,124,702,47,47,H1
"Fayette County, TN",2005-2006,33831,35667,1836,5.427,184,1652,47,47,H1
"Fayette County, TN",2006-2007,35667,36953,1286,3.606,167,1119,47,47,H1
"Fayette County, TN",2007-2008,36953,37851,898,2.43,192,706,47,47,H1
"Fayette County, TN",2008-2009,37851,38386,535,1.413,146,389,47,47,H1
"Fayette County, TN",2009-2010,38386,38404,18,0.047,94,-76,47,47,H1
"Fayette County, TN",2010-2011,38404,38525,121,0.315,123,-2,47,47,H1
"Fayette County, TN",2011-2012,38525,38609,84,0.218,117,-33,47,47,H1
"Fayette County, TN",2012-2013,38609,38772,163,0.422,64,99,47,47,H1
"Fayette County, TN",2013-2014,38772,39011,239,0.616,25,214,47,47,H1
"Fayette County, TN",2014-2015,38999,39165,166,0.426,21,145,47,47,H1
"Fayette County, TN",2015-2016,39165,39575,410,1.047,-31,441,47,47,H1
"Fayette County, TN",2016-2017,39575,40036,461,1.165,-12,473,47,47,H1
"Fentress County, TN",2000-2001,16630,16711,81,0.487,2,79,47,49,H1
"Fentress County, TN",2001-2002,16711,16865,154,0.922,2,152,47,49,H1
"Fentress County, TN",2002-2003,16865,16934,69,0.409,-25,94,47,49,H1
"Fentress County, TN",2003-2004,16934,16959,25,0.148,-7,32,47,49,H1
"Fentress County, TN",2004-2005,16959,17167,208,1.226,-41,249,47,49,H1
"Fentress County, TN",2005-2006,17167,17514,347,2.021,-28,375,47,49,H1
"Fentress County, TN",2006-2007,17514,17599,85,0.485,1,84,47,49,H1
"Fentress County, TN",2007-2008,17599,17851,252,1.432,-23,275,47,49,H1
"Fentress County, TN",2008-2009,17851,17975,124,0.695,-37,161,47,49,H1
"Fentress County, TN",2009-2010,17975,17915,-60,-0.334,-40,-20,47,49,H1
"Fentress County, TN",2010-2011,17915,18009,94,0.525,-11,105,47,49,H1
"Fentress County, TN",2011-2012,18009,17911,-98,-0.544,-41,-57,47,49,H1
"Fentress County, TN",2012-2013,17911,17919,8,0.045,-43,51,47,49,H1
"Fentress County, TN",2013-2014,17919,17855,-64,-0.357,-52,-12,47,49,H1
"Fentress County, TN",2014-2015,17862,17917,55,0.308,-35,90,47,49,H1
"Fentress County, TN",2015-2016,17917,17955,38,0.212,-38,76,47,49,H1
"Fentress County, TN",2016-2017,17955,18136,181,1.008,-62,243,47,49,H1
"Franklin County, TN",2000-2001,39298,39577,279,0.71,12,267,47,51,H1
"Franklin County, TN",2001-2002,39577,39889,312,0.788,39,273,47,51,H1
"Franklin County, TN",2002-2003,39889,40084,195,0.489,78,117,47,51,H1
"Franklin County, TN",2003-2004,40084,40359,275,0.686,17,258,47,51,H1
"Franklin County, TN",2004-2005,40359,40531,172,0.426,-20,192,47,51,H1
"Franklin County, TN",2005-2006,40531,40877,346,0.854,30,316,47,51,H1
"Franklin County, TN",2006-2007,40877,41151,274,0.67,19,255,47,51,H1
"Franklin County, TN",2007-2008,41151,41093,-58,-0.141,3,-61,47,51,H1
"Franklin County, TN",2008-2009,41093,41141,48,0.117,27,21,47,51,H1
"Franklin County, TN",2009-2010,41141,40989,-152,-0.369,9,-161,47,51,H1
"Franklin County, TN",2010-2011,40989,40871,-118,-0.288,-107,-11,47,51,H1
"Franklin County, TN",2011-2012,40871,40785,-86,-0.21,-61,-25,47,51,H1
"Franklin County, TN",2012-2013,40785,41297,512,1.255,-59,571,47,51,H1
"Franklin County, TN",2013-2014,41297,41402,105,0.254,-17,122,47,51,H1
"Franklin County, TN",2014-2015,41378,41449,71,0.172,-34,105,47,51,H1
"Franklin County, TN",2015-2016,41449,41567,118,0.285,-76,194,47,51,H1
"Franklin County, TN",2016-2017,41567,41652,85,0.204,-74,159,47,51,H1
"Gibson County, TN",2000-2001,48125,47973,-152,-0.316,-84,-68,47,53,H1
"Gibson County, TN",2001-2002,47973,47897,-76,-0.158,-56,-20,47,53,H1
"Gibson County, TN",2002-2003,47897,47719,-178,-0.372,-138,-40,47,53,H1
"Gibson County, TN",2003-2004,47719,47834,115,0.241,-86,201,47,53,H1
"Gibson County, TN",2004-2005,47834,47924,90,0.188,-39,129,47,53,H1
"Gibson County, TN",2005-2006,47924,48101,177,0.369,-106,283,47,53,H1
"Gibson County, TN",2006-2007,48101,48474,373,0.775,-31,404,47,53,H1
"Gibson County, TN",2007-2008,48474,49209,735,1.516,-61,796,47,53,H1
"Gibson County, TN",2008-2009,49209,49575,366,0.744,-43,409,47,53,H1
"Gibson County, TN",2009-2010,49575,49726,151,0.305,-20,171,47,53,H1
"Gibson County, TN",2010-2011,49726,49859,133,0.267,-123,256,47,53,H1
"Gibson County, TN",2011-2012,49859,49670,-189,-0.379,-13,-176,47,53,H1
"Gibson County, TN",2012-2013,49670,49434,-236,-0.475,-49,-187,47,53,H1
"Gibson County, TN",2013-2014,49434,49472,38,0.077,-41,79,47,53,H1
"Gibson County, TN",2014-2015,49501,49399,-102,-0.206,-16,-86,47,53,H1
"Gibson County, TN",2015-2016,49399,49103,-296,-0.599,-99,-197,47,53,H1
"Gibson County, TN",2016-2017,49103,49111,8,0.016,-68,76,47,53,H1
"Giles County, TN",2000-2001,29460,29613,153,0.519,23,130,47,55,H1
"Giles County, TN",2001-2002,29613,29479,-134,-0.453,-23,-111,47,55,H1
"Giles County, TN",2002-2003,29479,29320,-159,-0.539,-47,-112,47,55,H1
"Giles County, TN",2003-2004,29320,29382,62,0.211,-32,94,47,55,H1
"Giles County, TN",2004-2005,29382,29454,72,0.245,-50,122,47,55,H1
"Giles County, TN",2005-2006,29454,29515,61,0.207,-11,72,47,55,H1
"Giles County, TN",2006-2007,29515,29494,-21,-0.071,50,-71,47,55,H1
"Giles County, TN",2007-2008,29494,29705,211,0.715,18,193,47,55,H1
"Giles County, TN",2008-2009,29705,29695,-10,-0.034,-6,-4,47,55,H1
"Giles County, TN",2009-2010,29695,29403,-292,-0.983,20,-312,47,55,H1
"Giles County, TN",2010-2011,29403,29332,-71,-0.241,-76,5,47,55,H1
"Giles County, TN",2011-2012,29332,28948,-384,-1.309,-60,-324,47,55,H1
"Giles County, TN",2012-2013,28948,28783,-165,-0.57,-24,-141,47,55,H1
"Giles County, TN",2013-2014,28783,28853,70,0.243,-56,126,47,55,H1
"Giles County, TN",2014-2015,28811,28946,135,0.469,-20,155,47,55,H1
"Giles County, TN",2015-2016,28946,29140,194,0.67,-7,201,47,55,H1
"Giles County, TN",2016-2017,29140,29401,261,0.896,-9,270,47,55,H1
"Grainger County, TN",2000-2001,20653,20715,62,0.3,56,6,47,57,H1
"Grainger County, TN",2001-2002,20715,20932,217,1.048,33,184,47,57,H1
"Grainger County, TN",2002-2003,20932,21248,316,1.51,62,254,47,57,H1
"Grainger County, TN",2003-2004,21248,21502,254,1.195,32,222,47,57,H1
"Grainger County, TN",2004-2005,21502,21871,369,1.716,24,345,47,57,H1
"Grainger County, TN",2005-2006,21871,22175,304,1.39,39,265,47,57,H1
"Grainger County, TN",2006-2007,22175,22309,134,0.604,23,111,47,57,H1
"Grainger County, TN",2007-2008,22309,22380,71,0.318,40,31,47,57,H1
"Grainger County, TN",2008-2009,22380,22513,133,0.594,13,120,47,57,H1
"Grainger County, TN",2009-2010,22513,22702,189,0.84,1,188,47,57,H1
"Grainger County, TN",2010-2011,22702,22722,20,0.088,-33,53,47,57,H1
"Grainger County, TN",2011-2012,22722,22640,-82,-0.361,-9,-73,47,57,H1
"Grainger County, TN",2012-2013,22640,22694,54,0.239,-46,100,47,57,H1
"Grainger County, TN",2013-2014,22694,22864,170,0.749,-35,205,47,57,H1
"Grainger County, TN",2014-2015,22815,22846,31,0.136,-30,61,47,57,H1
"Grainger County, TN",2015-2016,22846,23112,266,1.164,-39,305,47,57,H1
"Grainger County, TN",2016-2017,23112,23144,32,0.138,-52,84,47,57,H1
"Greene County, TN",2000-2001,63081,63622,541,0.858,47,494,47,59,H1
"Greene County, TN",2001-2002,63622,64070,448,0.704,-71,519,47,59,H1
"Greene County, TN",2002-2003,64070,64614,544,0.849,-67,611,47,59,H1
"Greene County, TN",2003-2004,64614,65364,750,1.161,24,726,47,59,H1
"Greene County, TN",2004-2005,65364,66369,1005,1.538,26,979,47,59,H1
"Greene County, TN",2005-2006,66369,67153,784,1.181,-45,829,47,59,H1
"Greene County, TN",2006-2007,67153,67840,687,1.023,-48,735,47,59,H1
"Greene County, TN",2007-2008,67840,68328,488,0.719,-77,565,47,59,H1
"Greene County, TN",2008-2009,68328,68744,416,0.609,-92,508,47,59,H1
"Greene County, TN",2009-2010,68744,68812,68,0.099,-52,120,47,59,H1
"Greene County, TN",2010-2011,68812,68962,150,0.218,-287,437,47,59,H1
"Greene County, TN",2011-2012,68962,68634,-328,-0.476,-207,-121,47,59,H1
"Greene County, TN",2012-2013,68634,68235,-399,-0.581,-252,-147,47,59,H1
"Greene County, TN",2013-2014,68235,68335,100,0.147,-242,342,47,59,H1
"Greene County, TN",2014-2015,68413,68580,167,0.244,-185,352,47,59,H1
"Greene County, TN",2015-2016,68580,68559,-21,-0.031,-238,217,47,59,H1
"Greene County, TN",2016-2017,68559,68808,249,0.363,-247,496,47,59,H1
"Grundy County, TN",2000-2001,14306,14156,-150,-1.049,3,-153,47,61,H1
"Grundy County, TN",2001-2002,14156,14156,0,0,21,-21,47,61,H1
"Grundy County, TN",2002-2003,14156,14098,-58,-0.41,25,-83,47,61,H1
"Grundy County, TN",2003-2004,14098,14146,48,0.34,60,-12,47,61,H1
"Grundy County, TN",2004-2005,14146,14139,-7,-0.049,2,-9,47,61,H1
"Grundy County, TN",2005-2006,14139,14073,-66,-0.467,-7,-59,47,61,H1
"Grundy County, TN",2006-2007,14073,14048,-25,-0.178,31,-56,47,61,H1
"Grundy County, TN",2007-2008,14048,13963,-85,-0.605,-33,-52,47,61,H1
"Grundy County, TN",2008-2009,13963,13777,-186,-1.332,-30,-156,47,61,H1
"Grundy County, TN",2009-2010,13777,13721,-56,-0.406,-14,-42,47,61,H1
"Grundy County, TN",2010-2011,13721,13630,-91,-0.663,-21,-70,47,61,H1
"Grundy County, TN",2011-2012,13630,13630,0,0,-57,57,47,61,H1
"Grundy County, TN",2012-2013,13630,13466,-164,-1.203,-65,-99,47,61,H1
"Grundy County, TN",2013-2014,13466,13425,-41,-0.304,-36,-5,47,61,H1
"Grundy County, TN",2014-2015,13444,13441,-3,-0.022,-16,13,47,61,H1
"Grundy County, TN",2015-2016,13441,13279,-162,-1.205,-36,-126,47,61,H1
"Grundy County, TN",2016-2017,13279,13361,82,0.618,-39,121,47,61,H1
"Hamblen County, TN",2000-2001,58230,58710,480,0.824,278,202,47,63,H1
"Hamblen County, TN",2001-2002,58710,58285,-425,-0.724,167,-592,47,63,H1
"Hamblen County, TN",2002-2003,58285,58618,333,0.571,192,141,47,63,H1
"Hamblen County, TN",2003-2004,58618,59114,496,0.846,139,357,47,63,H1
"Hamblen County, TN",2004-2005,59114,59918,804,1.36,232,572,47,63,H1
"Hamblen County, TN",2005-2006,59918,60629,711,1.187,279,432,47,63,H1
"Hamblen County, TN",2006-2007,60629,61592,963,1.588,285,678,47,63,H1
"Hamblen County, TN",2007-2008,61592,62101,509,0.826,194,315,47,63,H1
"Hamblen County, TN",2008-2009,62101,62330,229,0.369,206,23,47,63,H1
"Hamblen County, TN",2009-2010,62330,62607,277,0.444,164,113,47,63,H1
"Hamblen County, TN",2010-2011,62607,62862,255,0.407,122,133,47,63,H1
"Hamblen County, TN",2011-2012,62862,62733,-129,-0.205,90,-219,47,63,H1
"Hamblen County, TN",2012-2013,62733,63078,345,0.55,117,228,47,63,H1
"Hamblen County, TN",2013-2014,63078,63036,-42,-0.067,104,-146,47,63,H1
"Hamblen County, TN",2014-2015,62994,63402,408,0.648,55,353,47,63,H1
"Hamblen County, TN",2015-2016,63402,63717,315,0.497,1,314,47,63,H1
"Hamblen County, TN",2016-2017,63717,64277,560,0.879,44,516,47,63,H1
"Hamilton County, TN",2000-2001,308547,310254,1707,0.553,835,872,47,65,H1
"Hamilton County, TN",2001-2002,310254,311890,1636,0.527,740,896,47,65,H1
"Hamilton County, TN",2002-2003,311890,313079,1189,0.381,779,410,47,65,H1
"Hamilton County, TN",2003-2004,313079,315396,2317,0.74,770,1547,47,65,H1
"Hamilton County, TN",2004-2005,315396,317901,2505,0.794,708,1797,47,65,H1
"Hamilton County, TN",2005-2006,317901,321350,3449,1.085,922,2527,47,65,H1
"Hamilton County, TN",2006-2007,321350,324784,3434,1.069,1175,2259,47,65,H1
"Hamilton County, TN",2007-2008,324784,328711,3927,1.209,1224,2703,47,65,H1
"Hamilton County, TN",2008-2009,328711,332659,3948,1.201,991,2957,47,65,H1
"Hamilton County, TN",2009-2010,332659,337197,4538,1.364,916,3622,47,65,H1
"Hamilton County, TN",2010-2011,337197,340755,3558,1.055,858,2700,47,65,H1
"Hamilton County, TN",2011-2012,340755,345657,4902,1.439,794,4108,47,65,H1
"Hamilton County, TN",2012-2013,345657,349030,3373,0.976,850,2523,47,65,H1
"Hamilton County, TN",2013-2014,349030,351220,2190,0.627,799,1391,47,65,H1
"Hamilton County, TN",2014-2015,350800,354098,3298,0.94,776,2522,47,65,H1
"Hamilton County, TN",2015-2016,354098,358061,3963,1.119,901,3062,47,65,H1
"Hamilton County, TN",2016-2017,358061,361613,3552,0.992,782,2770,47,65,H1
"Hancock County, TN",2000-2001,6786,6814,28,0.413,-15,43,47,67,H1
"Hancock County, TN",2001-2002,6814,6798,-16,-0.235,-24,8,47,67,H1
"Hancock County, TN",2002-2003,6798,6694,-104,-1.53,-21,-83,47,67,H1
"Hancock County, TN",2003-2004,6694,6739,45,0.672,4,41,47,67,H1
"Hancock County, TN",2004-2005,6739,6805,66,0.979,13,53,47,67,H1
"Hancock County, TN",2005-2006,6805,6730,-75,-1.102,-28,-47,47,67,H1
"Hancock County, TN",2006-2007,6730,6816,86,1.278,30,56,47,67,H1
"Hancock County, TN",2007-2008,6816,6765,-51,-0.748,-36,-15,47,67,H1
"Hancock County, TN",2008-2009,6765,6768,3,0.044,-8,11,47,67,H1
"Hancock County, TN",2009-2010,6768,6817,49,0.724,-7,56,47,67,H1
"Hancock County, TN",2010-2011,6817,6715,-102,-1.496,-40,-62,47,67,H1
"Hancock County, TN",2011-2012,6715,6679,-36,-0.536,-21,-15,47,67,H1
"Hancock County, TN",2012-2013,6679,6662,-17,-0.255,-1,-16,47,67,H1
"Hancock County, TN",2013-2014,6662,6657,-5,-0.075,-12,7,47,67,H1
"Hancock County, TN",2014-2015,6619,6572,-47,-0.71,-31,-16,47,67,H1
"Hancock County, TN",2015-2016,6572,6597,25,0.38,-11,36,47,67,H1
"Hancock County, TN",2016-2017,6597,6600,3,0.045,-18,21,47,67,H1
"Hardeman County, TN",2000-2001,28124,28125,1,0.004,24,-23,47,69,H1
"Hardeman County, TN",2001-2002,28125,28093,-32,-0.114,51,-83,47,69,H1
"Hardeman County, TN",2002-2003,28093,27948,-145,-0.516,57,-202,47,69,H1
"Hardeman County, TN",2003-2004,27948,27816,-132,-0.472,44,-176,47,69,H1
"Hardeman County, TN",2004-2005,27816,27824,8,0.029,21,-13,47,69,H1
"Hardeman County, TN",2005-2006,27824,27816,-8,-0.029,51,-59,47,69,H1
"Hardeman County, TN",2006-2007,27816,27835,19,0.068,59,-40,47,69,H1
"Hardeman County, TN",2007-2008,27835,27837,2,0.007,66,-64,47,69,H1
"Hardeman County, TN",2008-2009,27837,27612,-225,-0.808,23,-248,47,69,H1
"Hardeman County, TN",2009-2010,27612,27167,-445,-1.612,21,-466,47,69,H1
"Hardeman County, TN",2010-2011,27167,26851,-316,-1.163,10,-326,47,69,H1
"Hardeman County, TN",2011-2012,26851,26532,-319,-1.188,-21,-298,47,69,H1
"Hardeman County, TN",2012-2013,26532,26287,-245,-0.923,8,-253,47,69,H1
"Hardeman County, TN",2013-2014,26287,25965,-322,-1.225,-26,-296,47,69,H1
"Hardeman County, TN",2014-2015,25941,25707,-234,-0.902,-7,-227,47,69,H1
"Hardeman County, TN",2015-2016,25707,25476,-231,-0.899,-37,-194,47,69,H1
"Hardeman County, TN",2016-2017,25476,25447,-29,-0.114,-53,24,47,69,H1
"Hardin County, TN",2000-2001,25571,25737,166,0.649,-61,227,47,71,H1
"Hardin County, TN",2001-2002,25737,25758,21,0.082,-47,68,47,71,H1
"Hardin County, TN",2002-2003,25758,25657,-101,-0.392,-68,-33,47,71,H1
"Hardin County, TN",2003-2004,25657,25514,-143,-0.557,-62,-81,47,71,H1
"Hardin County, TN",2004-2005,25514,25710,196,0.768,-70,266,47,71,H1
"Hardin County, TN",2005-2006,25710,25863,153,0.595,-17,170,47,71,H1
"Hardin County, TN",2006-2007,25863,25983,120,0.464,7,113,47,71,H1
"Hardin County, TN",2007-2008,25983,26059,76,0.292,-39,115,47,71,H1
"Hardin County, TN",2008-2009,26059,26045,-14,-0.054,-64,50,47,71,H1
"Hardin County, TN",2009-2010,26045,26052,7,0.027,-52,59,47,71,H1
"Hardin County, TN",2010-2011,26052,25890,-162,-0.622,-50,-112,47,71,H1
"Hardin County, TN",2011-2012,25890,26025,135,0.521,-50,185,47,71,H1
"Hardin County, TN",2012-2013,26025,26006,-19,-0.073,-98,79,47,71,H1
"Hardin County, TN",2013-2014,26006,25870,-136,-0.523,-75,-61,47,71,H1
"Hardin County, TN",2014-2015,25843,25756,-87,-0.337,-81,-6,47,71,H1
"Hardin County, TN",2015-2016,25756,25759,3,0.012,-48,51,47,71,H1
"Hardin County, TN",2016-2017,25759,25846,87,0.338,-40,127,47,71,H1
"Hawkins County, TN",2000-2001,53669,54032,363,0.676,131,232,47,73,H1
"Hawkins County, TN",2001-2002,54032,54302,270,0.5,65,205,47,73,H1
"Hawkins County, TN",2002-2003,54302,54739,437,0.805,86,351,47,73,H1
"Hawkins County, TN",2003-2004,54739,55029,290,0.53,72,218,47,73,H1
"Hawkins County, TN",2004-2005,55029,55539,510,0.927,76,434,47,73,H1
"Hawkins County, TN",2005-2006,55539,56030,491,0.884,61,430,47,73,H1
"Hawkins County, TN",2006-2007,56030,56380,350,0.625,-19,369,47,73,H1
"Hawkins County, TN",2007-2008,56380,56698,318,0.564,45,273,47,73,H1
"Hawkins County, TN",2008-2009,56698,56856,158,0.279,23,135,47,73,H1
"Hawkins County, TN",2009-2010,56856,56883,27,0.047,1,26,47,73,H1
"Hawkins County, TN",2010-2011,56883,56657,-226,-0.397,-88,-138,47,73,H1
"Hawkins County, TN",2011-2012,56657,56601,-56,-0.099,-151,95,47,73,H1
"Hawkins County, TN",2012-2013,56601,56831,230,0.406,-68,298,47,73,H1
"Hawkins County, TN",2013-2014,56831,56735,-96,-0.169,-105,9,47,73,H1
"Hawkins County, TN",2014-2015,56558,56471,-87,-0.154,-187,100,47,73,H1
"Hawkins County, TN",2015-2016,56471,56366,-105,-0.186,-183,78,47,73,H1
"Hawkins County, TN",2016-2017,56366,56459,93,0.165,-178,271,47,73,H1
"Haywood County, TN",2000-2001,19804,19822,18,0.091,58,-40,47,75,H1
"Haywood County, TN",2001-2002,19822,19524,-298,-1.503,60,-358,47,75,H1
"Haywood County, TN",2002-2003,19524,19456,-68,-0.348,61,-129,47,75,H1
"Haywood County, TN",2003-2004,19456,19573,117,0.601,72,45,47,75,H1
"Haywood County, TN",2004-2005,19573,19392,-181,-0.925,53,-234,47,75,H1
"Haywood County, TN",2005-2006,19392,19288,-104,-0.536,32,-136,47,75,H1
"Haywood County, TN",2006-2007,19288,19142,-146,-0.757,86,-232,47,75,H1
"Haywood County, TN",2007-2008,19142,18996,-146,-0.763,32,-178,47,75,H1
"Haywood County, TN",2008-2009,18996,18860,-136,-0.716,14,-150,47,75,H1
"Haywood County, TN",2009-2010,18860,18764,-96,-0.509,31,-127,47,75,H1
"Haywood County, TN",2010-2011,18764,18533,-231,-1.231,31,-262,47,75,H1
"Haywood County, TN",2011-2012,18533,18243,-290,-1.565,16,-306,47,75,H1
"Haywood County, TN",2012-2013,18243,18218,-25,-0.137,33,-58,47,75,H1
"Haywood County, TN",2013-2014,18218,18185,-33,-0.181,19,-52,47,75,H1
"Haywood County, TN",2014-2015,18196,18023,-173,-0.951,22,-195,47,75,H1
"Haywood County, TN",2015-2016,18023,17803,-220,-1.221,-15,-205,47,75,H1
"Haywood County, TN",2016-2017,17803,17573,-230,-1.292,-27,-203,47,75,H1
"Henderson County, TN",2000-2001,25595,25744,149,0.582,49,100,47,77,H1
"Henderson County, TN",2001-2002,25744,25930,186,0.722,44,142,47,77,H1
"Henderson County, TN",2002-2003,25930,26091,161,0.621,42,119,47,77,H1
"Henderson County, TN",2003-2004,26091,26237,146,0.56,18,128,47,77,H1
"Henderson County, TN",2004-2005,26237,26581,344,1.311,37,307,47,77,H1
"Henderson County, TN",2005-2006,26581,27066,485,1.825,80,405,47,77,H1
"Henderson County, TN",2006-2007,27066,27370,304,1.123,85,219,47,77,H1
"Henderson County, TN",2007-2008,27370,27655,285,1.041,90,195,47,77,H1
"Henderson County, TN",2008-2009,27655,27748,93,0.336,66,27,47,77,H1
"Henderson County, TN",2009-2010,27748,27789,41,0.148,34,7,47,77,H1
"Henderson County, TN",2010-2011,27789,28023,234,0.842,58,176,47,77,H1
"Henderson County, TN",2011-2012,28023,28019,-4,-0.014,5,-9,47,77,H1
"Henderson County, TN",2012-2013,28019,27973,-46,-0.164,-9,-37,47,77,H1
"Henderson County, TN",2013-2014,27973,28009,36,0.129,26,10,47,77,H1
"Henderson County, TN",2014-2015,28017,28015,-2,-0.007,22,-24,47,77,H1
"Henderson County, TN",2015-2016,28015,27793,-222,-0.792,-19,-203,47,77,H1
"Henderson County, TN",2016-2017,27793,27751,-42,-0.151,5,-47,47,77,H1
"Henry County, TN",2000-2001,31131,31214,83,0.267,-62,145,47,79,H1
"Henry County, TN",2001-2002,31214,31343,129,0.413,-47,176,47,79,H1
"Henry County, TN",2002-2003,31343,31195,-148,-0.472,-81,-67,47,79,H1
"Henry County, TN",2003-2004,31195,31265,70,0.224,-115,185,47,79,H1
"Henry County, TN",2004-2005,31265,31538,273,0.873,-52,325,47,79,H1
"Henry County, TN",2005-2006,31538,31686,148,0.469,-53,201,47,79,H1
"Henry County, TN",2006-2007,31686,31833,147,0.464,-62,209,47,79,H1
"Henry County, TN",2007-2008,31833,32106,273,0.858,-75,348,47,79,H1
"Henry County, TN",2008-2009,32106,32234,128,0.399,-85,213,47,79,H1
"Henry County, TN",2009-2010,32234,32354,120,0.372,-80,200,47,79,H1
"Henry County, TN",2010-2011,32354,32333,-21,-0.065,-103,82,47,79,H1
"Henry County, TN",2011-2012,32333,32334,1,0.003,-123,124,47,79,H1
"Henry County, TN",2012-2013,32334,32171,-163,-0.504,-152,-11,47,79,H1
"Henry County, TN",2013-2014,32171,32204,33,0.103,-155,188,47,79,H1
"Henry County, TN",2014-2015,32261,32147,-114,-0.353,-110,-4,47,79,H1
"Henry County, TN",2015-2016,32147,32245,98,0.305,-172,270,47,79,H1
"Henry County, TN",2016-2017,32245,32450,205,0.636,-127,332,47,79,H1
"Hickman County, TN",2000-2001,22467,22788,321,1.429,76,245,47,81,H1
"Hickman County, TN",2001-2002,22788,23203,415,1.821,55,360,47,81,H1
"Hickman County, TN",2002-2003,23203,23292,89,0.384,30,59,47,81,H1
"Hickman County, TN",2003-2004,23292,23676,384,1.649,48,336,47,81,H1
"Hickman County, TN",2004-2005,23676,23940,264,1.115,30,234,47,81,H1
"Hickman County, TN",2005-2006,23940,24159,219,0.915,52,167,47,81,H1
"Hickman County, TN",2006-2007,24159,24490,331,1.37,40,291,47,81,H1
"Hickman County, TN",2007-2008,24490,24623,133,0.543,57,76,47,81,H1
"Hickman County, TN",2008-2009,24623,24597,-26,-0.106,23,-49,47,81,H1
"Hickman County, TN",2009-2010,24597,24669,72,0.293,13,59,47,81,H1
"Hickman County, TN",2010-2011,24669,24359,-310,-1.257,-7,-303,47,81,H1
"Hickman County, TN",2011-2012,24359,24152,-207,-0.85,-23,-184,47,81,H1
"Hickman County, TN",2012-2013,24152,24207,55,0.228,41,14,47,81,H1
"Hickman County, TN",2013-2014,24207,24384,177,0.731,20,157,47,81,H1
"Hickman County, TN",2014-2015,24388,24363,-25,-0.103,43,-68,47,81,H1
"Hickman County, TN",2015-2016,24363,24649,286,1.174,4,282,47,81,H1
"Hickman County, TN",2016-2017,24649,24864,215,0.872,18,197,47,81,H1
"Houston County, TN",2000-2001,8016,8051,35,0.437,22,13,47,83,H1
"Houston County, TN",2001-2002,8051,8028,-23,-0.286,-22,-1,47,83,H1
"Houston County, TN",2002-2003,8028,8073,45,0.561,-15,60,47,83,H1
"Houston County, TN",2003-2004,8073,7973,-100,-1.239,-20,-80,47,83,H1
"Houston County, TN",2004-2005,7973,8060,87,1.091,-2,89,47,83,H1
"Houston County, TN",2005-2006,8060,8080,20,0.248,-12,32,47,83,H1
"Houston County, TN",2006-2007,8080,8219,139,1.72,1,138,47,83,H1
"Houston County, TN",2007-2008,8219,8320,101,1.229,0,101,47,83,H1
"Houston County, TN",2008-2009,8320,8375,55,0.661,-9,64,47,83,H1
"Houston County, TN",2009-2010,8375,8450,75,0.896,-10,85,47,83,H1
"Houston County, TN",2010-2011,8450,8346,-104,-1.231,-12,-92,47,83,H1
"Houston County, TN",2011-2012,8346,8423,77,0.923,-43,120,47,83,H1
"Houston County, TN",2012-2013,8423,8295,-128,-1.52,-6,-122,47,83,H1
"Houston County, TN",2013-2014,8295,8267,-28,-0.338,-9,-19,47,83,H1
"Houston County, TN",2014-2015,8258,8149,-109,-1.32,-3,-106,47,83,H1
"Houston County, TN",2015-2016,8149,8118,-31,-0.38,-10,-21,47,83,H1
"Houston County, TN",2016-2017,8118,8213,95,1.17,-11,106,47,83,H1
"Humphreys County, TN",2000-2001,17920,18060,140,0.781,23,117,47,85,H1
"Humphreys County, TN",2001-2002,18060,17976,-84,-0.465,4,-88,47,85,H1
"Humphreys County, TN",2002-2003,17976,17962,-14,-0.078,14,-28,47,85,H1
"Humphreys County, TN",2003-2004,17962,17918,-44,-0.245,-9,-35,47,85,H1
"Humphreys County, TN",2004-2005,17918,18017,99,0.553,1,98,47,85,H1
"Humphreys County, TN",2005-2006,18017,18234,217,1.204,16,201,47,85,H1
"Humphreys County, TN",2006-2007,18234,18405,171,0.938,19,152,47,85,H1
"Humphreys County, TN",2007-2008,18405,18411,6,0.033,-26,32,47,85,H1
"Humphreys County, TN",2008-2009,18411,18477,66,0.358,-28,94,47,85,H1
"Humphreys County, TN",2009-2010,18477,18563,86,0.465,-2,88,47,85,H1
"Humphreys County, TN",2010-2011,18563,18388,-175,-0.943,-16,-159,47,85,H1
"Humphreys County, TN",2011-2012,18388,18280,-108,-0.587,-17,-91,47,85,H1
"Humphreys County, TN",2012-2013,18280,18245,-35,-0.191,-16,-19,47,85,H1
"Humphreys County, TN",2013-2014,18245,18135,-110,-0.603,-9,-101,47,85,H1
"Humphreys County, TN",2014-2015,18128,18135,7,0.039,-31,38,47,85,H1
"Humphreys County, TN",2015-2016,18135,18381,246,1.356,-35,281,47,85,H1
"Humphreys County, TN",2016-2017,18381,18484,103,0.56,-35,138,47,85,H1
"Jackson County, TN",2000-2001,11049,11208,159,1.439,-50,209,47,87,H1
"Jackson County, TN",2001-2002,11208,11259,51,0.455,-42,93,47,87,H1
"Jackson County, TN",2002-2003,11259,11328,69,0.613,-35,104,47,87,H1
"Jackson County, TN",2003-2004,11328,11396,68,0.6,-10,78,47,87,H1
"Jackson County, TN",2004-2005,11396,11385,-11,-0.097,-63,52,47,87,H1
"Jackson County, TN",2005-2006,11385,11317,-68,-0.597,-22,-46,47,87,H1
"Jackson County, TN",2006-2007,11317,11391,74,0.654,-17,91,47,87,H1
"Jackson County, TN",2007-2008,11391,11555,164,1.44,-57,221,47,87,H1
"Jackson County, TN",2008-2009,11555,11539,-16,-0.138,-43,27,47,87,H1
"Jackson County, TN",2009-2010,11539,11607,68,0.589,-45,113,47,87,H1
"Jackson County, TN",2010-2011,11607,11518,-89,-0.767,-39,-50,47,87,H1
"Jackson County, TN",2011-2012,11518,11529,11,0.096,-36,47,47,87,H1
"Jackson County, TN",2012-2013,11529,11551,22,0.191,-44,66,47,87,H1
"Jackson County, TN",2013-2014,11551,11568,17,0.147,-34,51,47,87,H1
"Jackson County, TN",2014-2015,11478,11509,31,0.27,-59,90,47,87,H1
"Jackson County, TN",2015-2016,11509,11602,93,0.808,-48,141,47,87,H1
"Jackson County, TN",2016-2017,11602,11677,75,0.646,-45,120,47,87,H1
"Jefferson County, TN",2000-2001,44566,45111,545,1.223,90,455,47,89,H1
"Jefferson County, TN",2001-2002,45111,45634,523,1.159,90,433,47,89,H1
"Jefferson County, TN",2002-2003,45634,46673,1039,2.277,37,1002,47,89,H1
"Jefferson County, TN",2003-2004,46673,47200,527,1.129,75,452,47,89,H1
"Jefferson County, TN",2004-2005,47200,47785,585,1.239,39,546,47,89,H1
"Jefferson County, TN",2005-2006,47785,49079,1294,2.708,133,1161,47,89,H1
"Jefferson County, TN",2006-2007,49079,50184,1105,2.251,113,992,47,89,H1
"Jefferson County, TN",2007-2008,50184,51014,830,1.654,60,770,47,89,H1
"Jefferson County, TN",2008-2009,51014,51288,274,0.537,62,212,47,89,H1
"Jefferson County, TN",2009-2010,51288,51610,322,0.628,33,289,47,89,H1
"Jefferson County, TN",2010-2011,51610,51938,328,0.636,-45,373,47,89,H1
"Jefferson County, TN",2011-2012,51938,52309,371,0.714,-31,402,47,89,H1
"Jefferson County, TN",2012-2013,52309,52296,-13,-0.025,-55,42,47,89,H1
"Jefferson County, TN",2013-2014,52296,52677,381,0.729,-81,462,47,89,H1
"Jefferson County, TN",2014-2015,52680,53240,560,1.063,-81,641,47,89,H1
"Jefferson County, TN",2015-2016,53240,53157,-83,-0.156,-112,29,47,89,H1
"Jefferson County, TN",2016-2017,53157,53804,647,1.217,-145,792,47,89,H1
"Johnson County, TN",2000-2001,17547,17709,162,0.923,-43,205,47,91,H1
"Johnson County, TN",2001-2002,17709,17780,71,0.401,-71,142,47,91,H1
"Johnson County, TN",2002-2003,17780,17966,186,1.046,-27,213,47,91,H1
"Johnson County, TN",2003-2004,17966,18007,41,0.228,-47,88,47,91,H1
"Johnson County, TN",2004-2005,18007,18153,146,0.811,-27,173,47,91,H1
"Johnson County, TN",2005-2006,18153,18059,-94,-0.518,-50,-44,47,91,H1
"Johnson County, TN",2006-2007,18059,18212,153,0.847,-25,178,47,91,H1
"Johnson County, TN",2007-2008,18212,18220,8,0.044,-43,51,47,91,H1
"Johnson County, TN",2008-2009,18220,18203,-17,-0.093,-34,17,47,91,H1
"Johnson County, TN",2009-2010,18203,18281,78,0.429,-47,125,47,91,H1
"Johnson County, TN",2010-2011,18281,18207,-74,-0.405,-35,-39,47,91,H1
"Johnson County, TN",2011-2012,18207,18119,-88,-0.483,-65,-23,47,91,H1
"Johnson County, TN",2012-2013,18119,17977,-142,-0.784,-88,-54,47,91,H1
"Johnson County, TN",2013-2014,17977,17859,-118,-0.656,-83,-35,47,91,H1
"Johnson County, TN",2014-2015,17917,17830,-87,-0.486,-37,-50,47,91,H1
"Johnson County, TN",2015-2016,17830,17777,-53,-0.297,-82,29,47,91,H1
"Johnson County, TN",2016-2017,17777,17691,-86,-0.484,-73,-13,47,91,H1
"Knox County, TN",2000-2001,382887,385823,2936,0.767,1118,1818,47,93,H1
"Knox County, TN",2001-2002,385823,389443,3620,0.938,1157,2463,47,93,H1
"Knox County, TN",2002-2003,389443,394263,4820,1.238,1285,3535,47,93,H1
"Knox County, TN",2003-2004,394263,398307,4044,1.026,1305,2739,47,93,H1
"Knox County, TN",2004-2005,398307,404234,5927,1.488,1388,4539,47,93,H1
"Knox County, TN",2005-2006,404234,411785,7551,1.868,1744,5807,47,93,H1
"Knox County, TN",2006-2007,411785,419096,7311,1.775,1717,5594,47,93,H1
"Knox County, TN",2007-2008,419096,425276,6180,1.475,1671,4509,47,93,H1
"Knox County, TN",2008-2009,425276,429475,4199,0.987,1642,2557,47,93,H1
"Knox County, TN",2009-2010,429475,433005,3530,0.822,1640,1890,47,93,H1
"Knox County, TN",2010-2011,433005,436523,3518,0.812,1163,2355,47,93,H1
"Knox County, TN",2011-2012,436523,441136,4613,1.057,1225,3388,47,93,H1
"Knox County, TN",2012-2013,441136,444350,3214,0.729,1137,2077,47,93,H1
"Knox County, TN",2013-2014,444350,448644,4294,0.966,1211,3083,47,93,H1
"Knox County, TN",2014-2015,448617,451324,2707,0.603,979,1728,47,93,H1
"Knox County, TN",2015-2016,451324,456114,4790,1.061,1070,3720,47,93,H1
"Knox County, TN",2016-2017,456114,461860,5746,1.26,1036,4710,47,93,H1
"Lake County, TN",2000-2001,7943,8009,66,0.831,-41,107,47,95,H1
"Lake County, TN",2001-2002,8009,8003,-6,-0.075,-41,35,47,95,H1
"Lake County, TN",2002-2003,8003,8044,41,0.512,-11,52,47,95,H1
"Lake County, TN",2003-2004,8044,7885,-159,-1.977,-21,-138,47,95,H1
"Lake County, TN",2004-2005,7885,7847,-38,-0.482,-42,4,47,95,H1
"Lake County, TN",2005-2006,7847,7846,-1,-0.013,-4,3,47,95,H1
"Lake County, TN",2006-2007,7846,7846,0,0,-15,15,47,95,H1
"Lake County, TN",2007-2008,7846,7812,-34,-0.433,-16,-18,47,95,H1
"Lake County, TN",2008-2009,7812,7804,-8,-0.102,-19,11,47,95,H1
"Lake County, TN",2009-2010,7804,7817,13,0.167,-23,36,47,95,H1
"Lake County, TN",2010-2011,7817,7770,-47,-0.601,-35,-12,47,95,H1
"Lake County, TN",2011-2012,7770,7703,-67,-0.862,-14,-53,47,95,H1
"Lake County, TN",2012-2013,7703,7706,3,0.039,-17,20,47,95,H1
"Lake County, TN",2013-2014,7706,7631,-75,-0.973,-32,-43,47,95,H1
"Lake County, TN",2014-2015,7664,7576,-88,-1.148,-38,-50,47,95,H1
"Lake County, TN",2015-2016,7576,7530,-46,-0.607,-25,-21,47,95,H1
"Lake County, TN",2016-2017,7530,7468,-62,-0.823,-31,-31,47,95,H1
"Lauderdale County, TN",2000-2001,27108,27359,251,0.926,116,135,47,97,H1
"Lauderdale County, TN",2001-2002,27359,27417,58,0.212,106,-48,47,97,H1
"Lauderdale County, TN",2002-2003,27417,27439,22,0.08,104,-82,47,97,H1
"Lauderdale County, TN",2003-2004,27439,27318,-121,-0.441,132,-253,47,97,H1
"Lauderdale County, TN",2004-2005,27318,27402,84,0.307,60,24,47,97,H1
"Lauderdale County, TN",2005-2006,27402,27548,146,0.533,129,17,47,97,H1
"Lauderdale County, TN",2006-2007,27548,27703,155,0.563,71,84,47,97,H1
"Lauderdale County, TN",2007-2008,27703,27840,137,0.495,127,10,47,97,H1
"Lauderdale County, TN",2008-2009,27840,27860,20,0.072,87,-67,47,97,H1
"Lauderdale County, TN",2009-2010,27860,27760,-100,-0.359,109,-209,47,97,H1
"Lauderdale County, TN",2010-2011,27760,27703,-57,-0.205,78,-135,47,97,H1
"Lauderdale County, TN",2011-2012,27703,27681,-22,-0.079,25,-47,47,97,H1
"Lauderdale County, TN",2012-2013,27681,27571,-110,-0.397,47,-157,47,97,H1
"Lauderdale County, TN",2013-2014,27571,27382,-189,-0.686,41,-230,47,97,H1
"Lauderdale County, TN",2014-2015,27335,26936,-399,-1.46,8,-407,47,97,H1
"Lauderdale County, TN",2015-2016,26936,25350,-1586,-5.888,7,-1593,47,97,H1
"Lauderdale County, TN",2016-2017,25350,25274,-76,-0.3,18,-94,47,97,H1
"Lawrence County, TN",2000-2001,39940,39994,54,0.135,234,-180,47,99,H1
"Lawrence County, TN",2001-2002,39994,40524,530,1.325,156,374,47,99,H1
"Lawrence County, TN",2002-2003,40524,40547,23,0.057,162,-139,47,99,H1
"Lawrence County, TN",2003-2004,40547,40596,49,0.121,113,-64,47,99,H1
"Lawrence County, TN",2004-2005,40596,40794,198,0.488,55,143,47,99,H1
"Lawrence County, TN",2005-2006,40794,40773,-21,-0.051,46,-67,47,99,H1
"Lawrence County, TN",2006-2007,40773,41072,299,0.733,165,134,47,99,H1
"Lawrence County, TN",2007-2008,41072,41272,200,0.487,130,70,47,99,H1
"Lawrence County, TN",2008-2009,41272,41487,215,0.521,96,119,47,99,H1
"Lawrence County, TN",2009-2010,41487,41990,503,1.212,91,412,47,99,H1
"Lawrence County, TN",2010-2011,41990,42053,63,0.15,82,-19,47,99,H1
"Lawrence County, TN",2011-2012,42053,42129,76,0.181,66,10,47,99,H1
"Lawrence County, TN",2012-2013,42129,41973,-156,-0.37,54,-210,47,99,H1
"Lawrence County, TN",2013-2014,41973,42274,301,0.717,70,231,47,99,H1
"Lawrence County, TN",2014-2015,42323,42564,241,0.569,82,159,47,99,H1
"Lawrence County, TN",2015-2016,42564,42979,415,0.975,42,373,47,99,H1
"Lawrence County, TN",2016-2017,42979,43396,417,0.97,75,342,47,99,H1
"Lewis County, TN",2000-2001,11405,11483,78,0.684,13,65,47,101,H1
"Lewis County, TN",2001-2002,11483,11540,57,0.496,0,57,47,101,H1
"Lewis County, TN",2002-2003,11540,11599,59,0.511,26,33,47,101,H1
"Lewis County, TN",2003-2004,11599,11630,31,0.267,21,10,47,101,H1
"Lewis County, TN",2004-2005,11630,11654,24,0.206,30,-6,47,101,H1
"Lewis County, TN",2005-2006,11654,11817,163,1.399,-5,168,47,101,H1
"Lewis County, TN",2006-2007,11817,11961,144,1.219,7,137,47,101,H1
"Lewis County, TN",2007-2008,11961,11986,25,0.209,16,9,47,101,H1
"Lewis County, TN",2008-2009,11986,12078,92,0.768,34,58,47,101,H1
"Lewis County, TN",2009-2010,12078,12152,74,0.613,20,54,47,101,H1
"Lewis County, TN",2010-2011,12152,12136,-16,-0.132,-28,12,47,101,H1
"Lewis County, TN",2011-2012,12136,11899,-237,-1.953,11,-248,47,101,H1
"Lewis County, TN",2012-2013,11899,11956,57,0.479,14,43,47,101,H1
"Lewis County, TN",2013-2014,11956,11906,-50,-0.418,28,-78,47,101,H1
"Lewis County, TN",2014-2015,11872,11854,-18,-0.152,6,-24,47,101,H1
"Lewis County, TN",2015-2016,11854,11912,58,0.489,-17,75,47,101,H1
"Lewis County, TN",2016-2017,11912,12035,123,1.033,-4,127,47,101,H1
"Lincoln County, TN",2000-2001,31381,31515,134,0.427,5,129,47,103,H1
"Lincoln County, TN",2001-2002,31515,31540,25,0.079,-20,45,47,103,H1
"Lincoln County, TN",2002-2003,31540,31663,123,0.39,53,70,47,103,H1
"Lincoln County, TN",2003-2004,31663,31665,2,0.006,8,-6,47,103,H1
"Lincoln County, TN",2004-2005,31665,32014,349,1.102,57,292,47,103,H1
"Lincoln County, TN",2005-2006,32014,32310,296,0.925,46,250,47,103,H1
"Lincoln County, TN",2006-2007,32310,32563,253,0.783,65,188,47,103,H1
"Lincoln County, TN",2007-2008,32563,32975,412,1.265,43,369,47,103,H1
"Lincoln County, TN",2008-2009,32975,33138,163,0.494,76,87,47,103,H1
"Lincoln County, TN",2009-2010,33138,33414,276,0.833,46,230,47,103,H1
"Lincoln County, TN",2010-2011,33414,33407,-7,-0.021,-19,12,47,103,H1
"Lincoln County, TN",2011-2012,33407,33436,29,0.087,-48,77,47,103,H1
"Lincoln County, TN",2012-2013,33436,33596,160,0.479,-16,176,47,103,H1
"Lincoln County, TN",2013-2014,33596,33637,41,0.122,6,35,47,103,H1
"Lincoln County, TN",2014-2015,33589,33743,154,0.458,-45,199,47,103,H1
"Lincoln County, TN",2015-2016,33743,33528,-215,-0.637,-47,-168,47,103,H1
"Lincoln County, TN",2016-2017,33528,33751,223,0.665,-54,277,47,103,H1
"Loudon County, TN",2000-2001,39228,40093,865,2.205,62,803,47,105,H1
"Loudon County, TN",2001-2002,40093,40993,900,2.245,39,861,47,105,H1
"Loudon County, TN",2002-2003,40993,41813,820,2,8,812,47,105,H1
"Loudon County, TN",2003-2004,41813,42679,866,2.071,23,843,47,105,H1
"Loudon County, TN",2004-2005,42679,43923,1244,2.915,51,1193,47,105,H1
"Loudon County, TN",2005-2006,43923,45207,1284,2.923,-35,1319,47,105,H1
"Loudon County, TN",2006-2007,45207,46294,1087,2.404,87,1.00E+03,47,105,H1
"Loudon County, TN",2007-2008,46294,47342,1048,2.264,22,1026,47,105,H1
"Loudon County, TN",2008-2009,47342,47940,598,1.263,5,593,47,105,H1
"Loudon County, TN",2009-2010,47940,48735,795,1.658,5,790,47,105,H1
"Loudon County, TN",2010-2011,48735,49059,324,0.665,9,315,47,105,H1
"Loudon County, TN",2011-2012,49059,49743,684,1.394,-30,714,47,105,H1
"Loudon County, TN",2012-2013,49743,50438,695,1.397,-25,720,47,105,H1
"Loudon County, TN",2013-2014,50438,50771,333,0.66,31,302,47,105,H1
"Loudon County, TN",2014-2015,50722,51130,408,0.804,-34,442,47,105,H1
"Loudon County, TN",2015-2016,51130,51275,145,0.284,-115,260,47,105,H1
"Loudon County, TN",2016-2017,51275,52152,877,1.71,-67,944,47,105,H1
"McMinn County, TN",2000-2001,49148,49711,563,1.146,147,416,47,107,H1
"McMinn County, TN",2001-2002,49711,49934,223,0.449,55,168,47,107,H1
"McMinn County, TN",2002-2003,49934,50257,323,0.647,55,268,47,107,H1
"McMinn County, TN",2003-2004,50257,50441,184,0.366,16,168,47,107,H1
"McMinn County, TN",2004-2005,50441,50999,558,1.106,53,505,47,107,H1
"McMinn County, TN",2005-2006,50999,51610,611,1.198,64,547,47,107,H1
"McMinn County, TN",2006-2007,51610,51912,302,0.585,-6,308,47,107,H1
"McMinn County, TN",2007-2008,51912,52284,372,0.717,56,316,47,107,H1
"McMinn County, TN",2008-2009,52284,52332,48,0.092,24,24,47,107,H1
"McMinn County, TN",2009-2010,52332,52224,-108,-0.206,0,-108,47,107,H1
"McMinn County, TN",2010-2011,52224,52378,154,0.295,-95,249,47,107,H1
"McMinn County, TN",2011-2012,52378,52452,74,0.141,10,64,47,107,H1
"McMinn County, TN",2012-2013,52452,52363,-89,-0.17,-89,0,47,107,H1
"McMinn County, TN",2013-2014,52363,52626,263,0.502,-46,309,47,107,H1
"McMinn County, TN",2014-2015,52684,52639,-45,-0.085,-52,7,47,107,H1
"McMinn County, TN",2015-2016,52639,52659,20,0.038,-88,108,47,107,H1
"McMinn County, TN",2016-2017,52659,52877,218,0.414,-72,290,47,107,H1
"McNairy County, TN",2000-2001,24681,24571,-110,-0.446,12,-122,47,109,H1
"McNairy County, TN",2001-2002,24571,24579,8,0.033,47,-39,47,109,H1
"McNairy County, TN",2002-2003,24579,24758,179,0.728,12,167,47,109,H1
"McNairy County, TN",2003-2004,24758,24890,132,0.533,-16,148,47,109,H1
"McNairy County, TN",2004-2005,24890,25134,244,0.98,35,209,47,109,H1
"McNairy County, TN",2005-2006,25134,25445,311,1.237,-16,327,47,109,H1
"McNairy County, TN",2006-2007,25445,25541,96,0.377,-24,120,47,109,H1
"McNairy County, TN",2007-2008,25541,25766,225,0.881,-16,241,47,109,H1
"McNairy County, TN",2008-2009,25766,25940,174,0.675,4,170,47,109,H1
"McNairy County, TN",2009-2010,25940,26052,112,0.432,0,112,47,109,H1
"McNairy County, TN",2010-2011,26052,26042,-10,-0.038,-52,42,47,109,H1
"McNairy County, TN",2011-2012,26042,26171,129,0.495,-19,148,47,109,H1
"McNairy County, TN",2012-2013,26171,26160,-11,-0.042,-6,-5,47,109,H1
"McNairy County, TN",2013-2014,26160,26267,107,0.409,-22,129,47,109,H1
"McNairy County, TN",2014-2015,26149,26066,-83,-0.317,-65,-18,47,109,H1
"McNairy County, TN",2015-2016,26066,25810,-256,-0.982,-67,-189,47,109,H1
"McNairy County, TN",2016-2017,25810,26004,194,0.752,-77,271,47,109,H1
"Macon County, TN",2000-2001,20472,20830,358,1.749,70,288,47,111,H1
"Macon County, TN",2001-2002,20830,20781,-49,-0.235,27,-76,47,111,H1
"Macon County, TN",2002-2003,20781,20917,136,0.654,49,87,47,111,H1
"Macon County, TN",2003-2004,20917,21148,231,1.104,32,199,47,111,H1
"Macon County, TN",2004-2005,21148,21254,106,0.501,16,90,47,111,H1
"Macon County, TN",2005-2006,21254,21556,302,1.421,129,173,47,111,H1
"Macon County, TN",2006-2007,21556,21693,137,0.636,88,49,47,111,H1
"Macon County, TN",2007-2008,21693,22017,324,1.494,24,300,47,111,H1
"Macon County, TN",2008-2009,22017,22110,93,0.422,19,74,47,111,H1
"Macon County, TN",2009-2010,22110,22260,150,0.678,63,87,47,111,H1
"Macon County, TN",2010-2011,22260,22477,217,0.975,94,123,47,111,H1
"Macon County, TN",2011-2012,22477,22512,35,0.156,41,-6,47,111,H1
"Macon County, TN",2012-2013,22512,22658,146,0.649,34,112,47,111,H1
"Macon County, TN",2013-2014,22658,23003,345,1.523,56,289,47,111,H1
"Macon County, TN",2014-2015,23012,23177,165,0.717,63,102,47,111,H1
"Macon County, TN",2015-2016,23177,23455,278,1.199,66,212,47,111,H1
"Macon County, TN",2016-2017,23455,24079,624,2.66,68,556,47,111,H1
"Madison County, TN",2000-2001,92048,92985,937,1.018,507,430,47,113,H1
"Madison County, TN",2001-2002,92985,93503,518,0.557,461,57,47,113,H1
"Madison County, TN",2002-2003,93503,93849,346,0.37,412,-66,47,113,H1
"Madison County, TN",2003-2004,93849,94692,843,0.898,500,343,47,113,H1
"Madison County, TN",2004-2005,94692,95400,708,0.748,440,268,47,113,H1
"Madison County, TN",2005-2006,95400,96681,1281,1.343,467,814,47,113,H1
"Madison County, TN",2006-2007,96681,97021,340,0.352,578,-238,47,113,H1
"Madison County, TN",2007-2008,97021,97064,43,0.044,542,-499,47,113,H1
"Madison County, TN",2008-2009,97064,97727,663,0.683,447,216,47,113,H1
"Madison County, TN",2009-2010,97727,98298,571,0.584,509,62,47,113,H1
"Madison County, TN",2010-2011,98298,98044,-254,-0.258,321,-575,47,113,H1
"Madison County, TN",2011-2012,98044,98551,507,0.517,465,42,47,113,H1
"Madison County, TN",2012-2013,98551,98751,200,0.203,342,-142,47,113,H1
"Madison County, TN",2013-2014,98751,98178,-573,-0.58,374,-947,47,113,H1
"Madison County, TN",2014-2015,98089,97610,-479,-0.488,308,-787,47,113,H1
"Madison County, TN",2015-2016,97610,97514,-96,-0.098,237,-333,47,113,H1
"Madison County, TN",2016-2017,97514,97643,129,0.132,226,-97,47,113,H1
"Marion County, TN",2000-2001,27749,27807,58,0.209,79,-21,47,115,H1
"Marion County, TN",2001-2002,27807,27804,-3,-0.011,-5,2,47,115,H1
"Marion County, TN",2002-2003,27804,27955,151,0.543,0,151,47,115,H1
"Marion County, TN",2003-2004,27955,27769,-186,-0.665,86,-272,47,115,H1
"Marion County, TN",2004-2005,27769,27751,-18,-0.065,4,-22,47,115,H1
"Marion County, TN",2005-2006,27751,27992,241,0.868,20,221,47,115,H1
"Marion County, TN",2006-2007,27992,28074,82,0.293,10,72,47,115,H1
"Marion County, TN",2007-2008,28074,28138,64,0.228,21,43,47,115,H1
"Marion County, TN",2008-2009,28138,28143,5,0.018,10,-5,47,115,H1
"Marion County, TN",2009-2010,28143,28236,93,0.33,18,75,47,115,H1
"Marion County, TN",2010-2011,28236,28082,-154,-0.545,-29,-125,47,115,H1
"Marion County, TN",2011-2012,28082,28227,145,0.516,-20,165,47,115,H1
"Marion County, TN",2012-2013,28227,28353,126,0.446,-30,156,47,115,H1
"Marion County, TN",2013-2014,28353,28407,54,0.19,-24,78,47,115,H1
"Marion County, TN",2014-2015,28396,28487,91,0.32,-19,110,47,115,H1
"Marion County, TN",2015-2016,28487,28321,-166,-0.583,-81,-85,47,115,H1
"Marion County, TN",2016-2017,28321,28425,104,0.367,-42,146,47,115,H1
"Marshall County, TN",2000-2001,26863,27130,267,0.994,98,169,47,117,H1
"Marshall County, TN",2001-2002,27130,27305,175,0.645,123,52,47,117,H1
"Marshall County, TN",2002-2003,27305,27474,169,0.619,118,51,47,117,H1
"Marshall County, TN",2003-2004,27474,27841,367,1.336,85,282,47,117,H1
"Marshall County, TN",2004-2005,27841,28181,340,1.221,73,267,47,117,H1
"Marshall County, TN",2005-2006,28181,28821,640,2.271,124,516,47,117,H1
"Marshall County, TN",2006-2007,28821,29494,673,2.335,118,555,47,117,H1
"Marshall County, TN",2007-2008,29494,30108,614,2.082,132,482,47,117,H1
"Marshall County, TN",2008-2009,30108,30403,295,0.98,120,175,47,117,H1
"Marshall County, TN",2009-2010,30403,30682,279,0.918,103,176,47,117,H1
"Marshall County, TN",2010-2011,30682,30900,218,0.711,41,177,47,117,H1
"Marshall County, TN",2011-2012,30900,30934,34,0.11,76,-42,47,117,H1
"Marshall County, TN",2012-2013,30934,31098,164,0.53,62,102,47,117,H1
"Marshall County, TN",2013-2014,31098,31269,171,0.55,37,134,47,117,H1
"Marshall County, TN",2014-2015,31301,31552,251,0.802,64,187,47,117,H1
"Marshall County, TN",2015-2016,31552,31973,421,1.334,45,376,47,117,H1
"Marshall County, TN",2016-2017,31973,32931,958,2.996,53,905,47,117,H1
"Maury County, TN",2000-2001,69651,69789,138,0.198,300,-162,47,119,H1
"Maury County, TN",2001-2002,69789,70574,785,1.125,326,459,47,119,H1
"Maury County, TN",2002-2003,70574,71768,1194,1.692,301,893,47,119,H1
"Maury County, TN",2003-2004,71768,72885,1117,1.556,308,809,47,119,H1
"Maury County, TN",2004-2005,72885,73962,1077,1.478,282,795,47,119,H1
"Maury County, TN",2005-2006,73962,75795,1833,2.478,349,1484,47,119,H1
"Maury County, TN",2006-2007,75795,77857,2062,2.72,443,1619,47,119,H1
"Maury County, TN",2007-2008,77857,79666,1809,2.323,475,1334,47,119,H1
"Maury County, TN",2008-2009,79666,80685,1019,1.279,411,608,47,119,H1
"Maury County, TN",2009-2010,80685,81191,506,0.627,338,168,47,119,H1
"Maury County, TN",2010-2011,81191,81395,204,0.251,397,-193,47,119,H1
"Maury County, TN",2011-2012,81395,81944,549,0.674,313,236,47,119,H1
"Maury County, TN",2012-2013,81944,83600,1656,2.021,227,1429,47,119,H1
"Maury County, TN",2013-2014,83600,85515,1915,2.291,217,1698,47,119,H1
"Maury County, TN",2014-2015,85598,87757,2159,2.522,241,1918,47,119,H1
"Maury County, TN",2015-2016,87757,89588,1831,2.086,264,1567,47,119,H1
"Maury County, TN",2016-2017,89588,92163,2575,2.874,242,2333,47,119,H1
"Meigs County, TN",2000-2001,11091,11162,71,0.64,42,29,47,121,H1
"Meigs County, TN",2001-2002,11162,11155,-7,-0.063,36,-43,47,121,H1
"Meigs County, TN",2002-2003,11155,11120,-35,-0.314,5,-40,47,121,H1
"Meigs County, TN",2003-2004,11120,11218,98,0.881,29,69,47,121,H1
"Meigs County, TN",2004-2005,11218,11241,23,0.205,-18,41,47,121,H1
"Meigs County, TN",2005-2006,11241,11346,105,0.934,-12,117,47,121,H1
"Meigs County, TN",2006-2007,11346,11436,90,0.793,17,73,47,121,H1
"Meigs County, TN",2007-2008,11436,11606,170,1.487,15,155,47,121,H1
"Meigs County, TN",2008-2009,11606,11753,147,1.267,8,139,47,121,H1
"Meigs County, TN",2009-2010,11753,11778,25,0.213,-11,36,47,121,H1
"Meigs County, TN",2010-2011,11778,11664,-114,-0.968,-59,-55,47,121,H1
"Meigs County, TN",2011-2012,11664,11678,14,0.12,-44,58,47,121,H1
"Meigs County, TN",2012-2013,11678,11650,-28,-0.24,-20,-8,47,121,H1
"Meigs County, TN",2013-2014,11650,11701,51,0.438,-27,78,47,121,H1
"Meigs County, TN",2014-2015,11724,11830,106,0.904,-21,127,47,121,H1
"Meigs County, TN",2015-2016,11830,11948,118,0.997,-40,158,47,121,H1
"Meigs County, TN",2016-2017,11948,12068,120,1.004,-22,142,47,121,H1
"Monroe County, TN",2000-2001,39130,39371,241,0.616,97,144,47,123,H1
"Monroe County, TN",2001-2002,39371,39889,518,1.316,119,399,47,123,H1
"Monroe County, TN",2002-2003,39889,40438,549,1.376,126,423,47,123,H1
"Monroe County, TN",2003-2004,40438,41291,853,2.109,210,643,47,123,H1
"Monroe County, TN",2004-2005,41291,42163,872,2.112,89,783,47,123,H1
"Monroe County, TN",2005-2006,42163,42955,792,1.878,72,720,47,123,H1
"Monroe County, TN",2006-2007,42955,43735,780,1.816,128,652,47,123,H1
"Monroe County, TN",2007-2008,43735,44437,702,1.605,99,603,47,123,H1
"Monroe County, TN",2008-2009,44437,44341,-96,-0.216,88,-184,47,123,H1
"Monroe County, TN",2009-2010,44341,44605,264,0.595,58,206,47,123,H1
"Monroe County, TN",2010-2011,44605,44895,290,0.65,-24,314,47,123,H1
"Monroe County, TN",2011-2012,44895,45108,213,0.474,-18,231,47,123,H1
"Monroe County, TN",2012-2013,45108,45169,61,0.135,-9,70,47,123,H1
"Monroe County, TN",2013-2014,45169,45233,64,0.142,-38,102,47,123,H1
"Monroe County, TN",2014-2015,45386,45771,385,0.848,27,358,47,123,H1
"Monroe County, TN",2015-2016,45771,45967,196,0.428,-64,260,47,123,H1
"Monroe County, TN",2016-2017,45967,46240,273,0.594,-65,338,47,123,H1
"Montgomery County, TN",2000-2001,135536,136801,1265,0.933,1625,-360,47,125,H1
"Montgomery County, TN",2001-2002,136801,138098,1297,0.948,1477,-180,47,125,H1
"Montgomery County, TN",2002-2003,138098,139322,1224,0.886,1474,-250,47,125,H1
"Montgomery County, TN",2003-2004,139322,143761,4439,3.186,1250,3189,47,125,H1
"Montgomery County, TN",2004-2005,143761,151122,7361,5.12,1888,5473,47,125,H1
"Montgomery County, TN",2005-2006,151122,153054,1932,1.278,1828,104,47,125,H1
"Montgomery County, TN",2006-2007,153054,160642,7588,4.958,1644,5944,47,125,H1
"Montgomery County, TN",2007-2008,160642,162144,1502,0.935,2185,-683,47,125,H1
"Montgomery County, TN",2008-2009,162144,168866,6722,4.146,1734,4988,47,125,H1
"Montgomery County, TN",2009-2010,168866,173255,4389,2.599,2124,2265,47,125,H1
"Montgomery County, TN",2010-2011,173255,176769,3514,2.028,1966,1548,47,125,H1
"Montgomery County, TN",2011-2012,176769,185360,8591,4.86,2407,6184,47,125,H1
"Montgomery County, TN",2012-2013,185360,184729,-631,-0.34,2356,-2987,47,125,H1
"Montgomery County, TN",2013-2014,184729,189961,5232,2.832,2309,2923,47,125,H1
"Montgomery County, TN",2014-2015,189795,193479,3684,1.941,2268,1416,47,125,H1
"Montgomery County, TN",2015-2016,193479,194795,1316,0.68,2222,-906,47,125,H1
"Montgomery County, TN",2016-2017,194795,200182,5387,2.765,2200,3187,47,125,H1
"Moore County, TN",2000-2001,5728,5778,50,0.873,1,49,47,127,H6
"Moore County, TN",2001-2002,5778,5928,150,2.596,17,133,47,127,H6
"Moore County, TN",2002-2003,5928,5900,-28,-0.472,0,-28,47,127,H6
"Moore County, TN",2003-2004,5900,5998,98,1.661,9,89,47,127,H6
"Moore County, TN",2004-2005,5998,6088,90,1.501,-8,98,47,127,H6
"Moore County, TN",2005-2006,6088,6123,35,0.575,15,20,47,127,H6
"Moore County, TN",2006-2007,6123,6210,87,1.421,-10,97,47,127,H6
"Moore County, TN",2007-2008,6210,6299,89,1.433,13,76,47,127,H6
"Moore County, TN",2008-2009,6299,6334,35,0.556,0,35,47,127,H6
"Moore County, TN",2009-2010,6334,6350,16,0.253,-9,25,47,127,H6
"Moore County, TN",2010-2011,6350,6412,62,0.976,-19,81,47,127,H6
"Moore County, TN",2011-2012,6412,6348,-64,-0.998,-20,-44,47,127,H6
"Moore County, TN",2012-2013,6348,6313,-35,-0.551,-11,-24,47,127,H6
"Moore County, TN",2013-2014,6313,6319,6,0.095,1,5,47,127,H6
"Moore County, TN",2014-2015,6336,6322,-14,-0.221,11,-25,47,127,H6
"Moore County, TN",2015-2016,6322,6293,-29,-0.459,-5,-24,47,127,H6
"Moore County, TN",2016-2017,6293,6384,91,1.446,3,88,47,127,H6
"Morgan County, TN",2000-2001,19801,20161,360,1.818,62,298,47,129,H1
"Morgan County, TN",2001-2002,20161,20352,191,0.947,20,171,47,129,H1
"Morgan County, TN",2002-2003,20352,20634,282,1.386,33,249,47,129,H1
"Morgan County, TN",2003-2004,20634,20759,125,0.606,27,98,47,129,H1
"Morgan County, TN",2004-2005,20759,20959,200,0.963,1,199,47,129,H1
"Morgan County, TN",2005-2006,20959,21156,197,0.94,55,142,47,129,H1
"Morgan County, TN",2006-2007,21156,21601,445,2.103,20,425,47,129,H1
"Morgan County, TN",2007-2008,21601,21734,133,0.616,13,120,47,129,H1
"Morgan County, TN",2008-2009,21734,21832,98,0.451,20,78,47,129,H1
"Morgan County, TN",2009-2010,21832,21995,163,0.747,5,158,47,129,H1
"Morgan County, TN",2010-2011,21995,22056,61,0.277,-31,92,47,129,H1
"Morgan County, TN",2011-2012,22056,21945,-111,-0.503,-38,-73,47,129,H1
"Morgan County, TN",2012-2013,21945,21672,-273,-1.244,-33,-240,47,129,H1
"Morgan County, TN",2013-2014,21672,21660,-12,-0.055,-47,35,47,129,H1
"Morgan County, TN",2014-2015,21757,21498,-259,-1.19,-12,-247,47,129,H1
"Morgan County, TN",2015-2016,21498,21724,226,1.051,-31,257,47,129,H1
"Morgan County, TN",2016-2017,21724,21636,-88,-0.405,-16,-72,47,129,H1
"Obion County, TN",2000-2001,32507,32370,-137,-0.421,37,-174,47,131,H1
"Obion County, TN",2001-2002,32370,32354,-16,-0.049,48,-64,47,131,H1
"Obion County, TN",2002-2003,32354,32353,-1,-0.003,18,-19,47,131,H1
"Obion County, TN",2003-2004,32353,32346,-7,-0.022,-2,-5,47,131,H1
"Obion County, TN",2004-2005,32346,32179,-167,-0.516,16,-183,47,131,H1
"Obion County, TN",2005-2006,32179,31990,-189,-0.587,-60,-129,47,131,H1
"Obion County, TN",2006-2007,31990,31972,-18,-0.056,1,-19,47,131,H1
"Obion County, TN",2007-2008,31972,31971,-1,-0.003,17,-18,47,131,H1
"Obion County, TN",2008-2009,31971,31791,-180,-0.563,-27,-153,47,131,H1
"Obion County, TN",2009-2010,31791,31814,23,0.072,-7,30,47,131,H1
"Obion County, TN",2010-2011,31814,31685,-129,-0.405,-26,-103,47,131,H1
"Obion County, TN",2011-2012,31685,31351,-334,-1.054,-52,-282,47,131,H1
"Obion County, TN",2012-2013,31351,31100,-251,-0.801,-22,-229,47,131,H1
"Obion County, TN",2013-2014,31100,30941,-159,-0.511,-41,-118,47,131,H1
"Obion County, TN",2014-2015,30884,30639,-245,-0.793,-69,-176,47,131,H1
"Obion County, TN",2015-2016,30639,30526,-113,-0.369,1,-114,47,131,H1
"Obion County, TN",2016-2017,30526,30385,-141,-0.462,-7,-134,47,131,H1
"Overton County, TN",2000-2001,20192,20299,107,0.53,25,82,47,133,H1
"Overton County, TN",2001-2002,20299,20427,128,0.631,-44,172,47,133,H1
"Overton County, TN",2002-2003,20427,20386,-41,-0.201,-72,31,47,133,H1
"Overton County, TN",2003-2004,20386,20791,405,1.987,13,392,47,133,H1
"Overton County, TN",2004-2005,20791,20983,192,0.923,-10,202,47,133,H1
"Overton County, TN",2005-2006,20983,21371,388,1.849,25,363,47,133,H1
"Overton County, TN",2006-2007,21371,21683,312,1.46,26,286,47,133,H1
"Overton County, TN",2007-2008,21683,21756,73,0.337,-4,77,47,133,H1
"Overton County, TN",2008-2009,21756,21988,232,1.066,-35,267,47,133,H1
"Overton County, TN",2009-2010,21988,22088,100,0.455,-43,143,47,133,H1
"Overton County, TN",2010-2011,22088,22177,89,0.403,-12,101,47,133,H1
"Overton County, TN",2011-2012,22177,22211,34,0.153,-14,48,47,133,H1
"Overton County, TN",2012-2013,22211,22039,-172,-0.774,-75,-97,47,133,H1
"Overton County, TN",2013-2014,22039,22028,-11,-0.05,-76,65,47,133,H1
"Overton County, TN",2014-2015,21981,22129,148,0.673,-63,211,47,133,H1
"Overton County, TN",2015-2016,22129,21978,-151,-0.682,-66,-85,47,133,H1
"Overton County, TN",2016-2017,21978,22012,34,0.155,-84,118,47,133,H1
"Perry County, TN",2000-2001,7613,7478,-135,-1.773,0,-135,47,135,H1
"Perry County, TN",2001-2002,7478,7530,52,0.695,-12,64,47,135,H1
"Perry County, TN",2002-2003,7530,7617,87,1.155,8,79,47,135,H1
"Perry County, TN",2003-2004,7617,7595,-22,-0.289,-10,-12,47,135,H1
"Perry County, TN",2004-2005,7595,7594,-1,-0.013,-18,17,47,135,H1
"Perry County, TN",2005-2006,7594,7620,26,0.342,-13,39,47,135,H1
"Perry County, TN",2006-2007,7620,7692,72,0.945,-18,90,47,135,H1
"Perry County, TN",2007-2008,7692,7794,102,1.326,25,77,47,135,H1
"Perry County, TN",2008-2009,7794,7851,57,0.731,-4,61,47,135,H1
"Perry County, TN",2009-2010,7851,7919,68,0.866,-11,79,47,135,H1
"Perry County, TN",2010-2011,7919,7834,-85,-1.073,-7,-78,47,135,H1
"Perry County, TN",2011-2012,7834,7830,-4,-0.051,-3,-1,47,135,H1
"Perry County, TN",2012-2013,7830,7851,21,0.268,3,18,47,135,H1
"Perry County, TN",2013-2014,7851,7822,-29,-0.369,-6,-23,47,135,H1
"Perry County, TN",2014-2015,7843,7929,86,1.097,8,78,47,135,H1
"Perry County, TN",2015-2016,7929,7892,-37,-0.467,-9,-28,47,135,H1
"Perry County, TN",2016-2017,7892,7975,83,1.052,-10,93,47,135,H1
"Pickett County, TN",2000-2001,4933,4999,66,1.338,-29,95,47,137,H1
"Pickett County, TN",2001-2002,4999,5097,98,1.96,-11,109,47,137,H1
"Pickett County, TN",2002-2003,5097,5031,-66,-1.295,-21,-45,47,137,H1
"Pickett County, TN",2003-2004,5031,4984,-47,-0.934,-2,-45,47,137,H1
"Pickett County, TN",2004-2005,4984,4997,13,0.261,-1,14,47,137,H1
"Pickett County, TN",2005-2006,4997,5023,26,0.52,0,26,47,137,H1
"Pickett County, TN",2006-2007,5023,5053,30,0.597,-7,37,47,137,H1
"Pickett County, TN",2007-2008,5053,5122,69,1.366,-15,84,47,137,H1
"Pickett County, TN",2008-2009,5122,5101,-21,-0.41,-19,-2,47,137,H1
"Pickett County, TN",2009-2010,5101,5069,-32,-0.627,-26,-6,47,137,H1
"Pickett County, TN",2010-2011,5069,5140,71,1.401,-24,95,47,137,H1
"Pickett County, TN",2011-2012,5140,5088,-52,-1.012,-32,-20,47,137,H1
"Pickett County, TN",2012-2013,5088,5083,-5,-0.098,-23,18,47,137,H1
"Pickett County, TN",2013-2014,5083,5124,41,0.807,-16,57,47,137,H1
"Pickett County, TN",2014-2015,5084,5146,62,1.22,-15,77,47,137,H1
"Pickett County, TN",2015-2016,5146,5085,-61,-1.185,-11,-50,47,137,H1
"Pickett County, TN",2016-2017,5085,5073,-12,-0.236,-14,2,47,137,H1
"Polk County, TN",2000-2001,16132,16361,229,1.42,23,206,47,139,H1
"Polk County, TN",2001-2002,16361,16268,-93,-0.568,1,-94,47,139,H1
"Polk County, TN",2002-2003,16268,16355,87,0.535,-12,99,47,139,H1
"Polk County, TN",2003-2004,16355,16285,-70,-0.428,14,-84,47,139,H1
"Polk County, TN",2004-2005,16285,16386,101,0.62,-39,140,47,139,H1
"Polk County, TN",2005-2006,16386,16539,153,0.934,-47,200,47,139,H1
"Polk County, TN",2006-2007,16539,16599,60,0.363,-22,82,47,139,H1
"Polk County, TN",2007-2008,16599,16759,160,0.964,12,148,47,139,H1
"Polk County, TN",2008-2009,16759,16730,-29,-0.173,0,-29,47,139,H1
"Polk County, TN",2009-2010,16730,16823,93,0.556,-39,132,47,139,H1
"Polk County, TN",2010-2011,16823,16746,-77,-0.458,-68,-9,47,139,H1
"Polk County, TN",2011-2012,16746,16613,-133,-0.794,-78,-55,47,139,H1
"Polk County, TN",2012-2013,16613,16664,51,0.307,-71,122,47,139,H1
"Polk County, TN",2013-2014,16664,16730,66,0.396,-51,117,47,139,H1
"Polk County, TN",2014-2015,16711,16773,62,0.371,-28,90,47,139,H1
"Polk County, TN",2015-2016,16773,16770,-3,-0.018,-59,56,47,139,H1
"Polk County, TN",2016-2017,16770,16757,-13,-0.078,-50,37,47,139,H1
"Putnam County, TN",2000-2001,62487,63130,643,1.029,216,427,47,141,H1
"Putnam County, TN",2001-2002,63130,64013,883,1.399,193,690,47,141,H1
"Putnam County, TN",2002-2003,64013,64810,797,1.245,218,579,47,141,H1
"Putnam County, TN",2003-2004,64810,65851,1041,1.606,250,791,47,141,H1
"Putnam County, TN",2004-2005,65851,66871,1020,1.549,259,761,47,141,H1
"Putnam County, TN",2005-2006,66871,68493,1622,2.426,287,1335,47,141,H1
"Putnam County, TN",2006-2007,68493,69468,975,1.424,288,687,47,141,H1
"Putnam County, TN",2007-2008,69468,70746,1278,1.84,309,969,47,141,H1
"Putnam County, TN",2008-2009,70746,71579,833,1.177,245,588,47,141,H1
"Putnam County, TN",2009-2010,71579,72542,963,1.345,244,719,47,141,H1
"Putnam County, TN",2010-2011,72542,72852,310,0.427,259,51,47,141,H1
"Putnam County, TN",2011-2012,72852,73071,219,0.301,99,120,47,141,H1
"Putnam County, TN",2012-2013,73071,73553,482,0.66,174,308,47,141,H1
"Putnam County, TN",2013-2014,73553,74165,612,0.832,169,443,47,141,H1
"Putnam County, TN",2014-2015,74467,74553,86,0.115,152,-66,47,141,H1
"Putnam County, TN",2015-2016,74553,76123,1570,2.106,55,1515,47,141,H1
"Putnam County, TN",2016-2017,76123,77674,1551,2.037,135,1416,47,141,H1
"Rhea County, TN",2000-2001,28428,28601,173,0.609,118,55,47,143,H1
"Rhea County, TN",2001-2002,28601,28884,283,0.989,61,222,47,143,H1
"Rhea County, TN",2002-2003,28884,29257,373,1.291,103,270,47,143,H1
"Rhea County, TN",2003-2004,29257,29469,212,0.725,63,149,47,143,H1
"Rhea County, TN",2004-2005,29469,29919,450,1.527,142,308,47,143,H1
"Rhea County, TN",2005-2006,29919,30440,521,1.741,36,485,47,143,H1
"Rhea County, TN",2006-2007,30440,30769,329,1.081,84,245,47,143,H1
"Rhea County, TN",2007-2008,30769,31308,539,1.752,40,499,47,143,H1
"Rhea County, TN",2008-2009,31308,31717,409,1.306,56,353,47,143,H1
"Rhea County, TN",2009-2010,31717,31877,160,0.504,79,81,47,143,H1
"Rhea County, TN",2010-2011,31877,32018,141,0.442,29,112,47,143,H1
"Rhea County, TN",2011-2012,32018,32307,289,0.903,37,252,47,143,H1
"Rhea County, TN",2012-2013,32307,32515,208,0.644,21,187,47,143,H1
"Rhea County, TN",2013-2014,32515,32641,126,0.388,5,121,47,143,H1
"Rhea County, TN",2014-2015,32652,32526,-126,-0.386,20,-146,47,143,H1
"Rhea County, TN",2015-2016,32526,32392,-134,-0.412,-13,-121,47,143,H1
"Rhea County, TN",2016-2017,32392,32691,299,0.923,1,298,47,143,H1
"Roane County, TN",2000-2001,51957,52166,209,0.402,12,197,47,145,H1
"Roane County, TN",2001-2002,52166,52325,159,0.305,-50,209,47,145,H1
"Roane County, TN",2002-2003,52325,52780,455,0.87,-56,511,47,145,H1
"Roane County, TN",2003-2004,52780,53115,335,0.635,-116,451,47,145,H1
"Roane County, TN",2004-2005,53115,53175,60,0.113,-184,244,47,145,H1
"Roane County, TN",2005-2006,53175,53821,646,1.215,-9,655,47,145,H1
"Roane County, TN",2006-2007,53821,54129,308,0.572,-118,426,47,145,H1
"Roane County, TN",2007-2008,54129,54374,245,0.453,-42,287,47,145,H1
"Roane County, TN",2008-2009,54374,54367,-7,-0.013,-88,81,47,145,H1
"Roane County, TN",2009-2010,54367,54129,-238,-0.438,-128,-110,47,145,H1
"Roane County, TN",2010-2011,54129,53792,-337,-0.623,-186,-151,47,145,H1
"Roane County, TN",2011-2012,53792,53426,-366,-0.68,-182,-184,47,145,H1
"Roane County, TN",2012-2013,53426,52971,-455,-0.852,-176,-279,47,145,H1
"Roane County, TN",2013-2014,52971,52748,-223,-0.421,-208,-15,47,145,H1
"Roane County, TN",2014-2015,52756,52753,-3,-0.006,-220,217,47,145,H1
"Roane County, TN",2015-2016,52753,52913,160,0.303,-244,404,47,145,H1
"Roane County, TN",2016-2017,52913,53036,123,0.232,-232,355,47,145,H1
"Robertson County, TN",2000-2001,54795,55861,1066,1.945,338,728,47,147,H1
"Robertson County, TN",2001-2002,55861,56795,934,1.672,420,514,47,147,H1
"Robertson County, TN",2002-2003,56795,57682,887,1.562,366,521,47,147,H1
"Robertson County, TN",2003-2004,57682,58618,936,1.623,391,545,47,147,H1
"Robertson County, TN",2004-2005,58618,59720,1102,1.88,422,680,47,147,H1
"Robertson County, TN",2005-2006,59720,61551,1831,3.066,494,1337,47,147,H1
"Robertson County, TN",2006-2007,61551,63143,1592,2.586,500,1092,47,147,H1
"Robertson County, TN",2007-2008,63143,64780,1637,2.593,518,1119,47,147,H1
"Robertson County, TN",2008-2009,64780,65791,1011,1.561,490,521,47,147,H1
"Robertson County, TN",2009-2010,65791,66364,573,0.871,463,110,47,147,H1
"Robertson County, TN",2010-2011,66364,66668,304,0.458,283,21,47,147,H1
"Robertson County, TN",2011-2012,66668,66719,51,0.076,324,-273,47,147,H1
"Robertson County, TN",2012-2013,66719,67288,569,0.853,316,253,47,147,H1
"Robertson County, TN",2013-2014,67288,68079,791,1.176,335,456,47,147,H1
"Robertson County, TN",2014-2015,67983,68570,587,0.863,283,304,47,147,H1
"Robertson County, TN",2015-2016,68570,69177,607,0.885,221,386,47,147,H1
"Robertson County, TN",2016-2017,69177,70177,1.00E+03,1.446,226,774,47,147,H1
"Rutherford County, TN",2000-2001,183600,189901,6301,3.432,1756,4545,47,149,H1
"Rutherford County, TN",2001-2002,189901,196518,6617,3.484,1801,4816,47,149,H1
"Rutherford County, TN",2002-2003,196518,203483,6965,3.544,1880,5085,47,149,H1
"Rutherford County, TN",2003-2004,203483,211714,8231,4.045,1941,6290,47,149,H1
"Rutherford County, TN",2004-2005,211714,221318,9604,4.536,2212,7392,47,149,H1
"Rutherford County, TN",2005-2006,221318,233247,11929,5.39,2235,9694,47,149,H1
"Rutherford County, TN",2006-2007,233247,243953,10706,4.59,2520,8186,47,149,H1
"Rutherford County, TN",2007-2008,243953,252565,8612,3.53,2639,5973,47,149,H1
"Rutherford County, TN",2008-2009,252565,259078,6513,2.579,2616,3897,47,149,H1
"Rutherford County, TN",2009-2010,259078,263774,4696,1.813,2318,2378,47,149,H1
"Rutherford County, TN",2010-2011,263774,269046,5272,1.999,2105,3167,47,149,H1
"Rutherford County, TN",2011-2012,269046,274208,5162,1.919,2030,3132,47,149,H1
"Rutherford County, TN",2012-2013,274208,281373,7165,2.613,1947,5218,47,149,H1
"Rutherford County, TN",2013-2014,281373,288906,7533,2.677,2021,5512,47,149,H1
"Rutherford County, TN",2014-2015,289147,298612,9465,3.273,2231,7234,47,149,H1
"Rutherford County, TN",2015-2016,298612,307683,9071,3.038,2261,6810,47,149,H1
"Rutherford County, TN",2016-2017,307683,317157,9474,3.079,2251,7223,47,149,H1
"Scott County, TN",2000-2001,21170,21481,311,1.469,111,200,47,151,H1
"Scott County, TN",2001-2002,21481,21593,112,0.521,155,-43,47,151,H1
"Scott County, TN",2002-2003,21593,21567,-26,-0.12,96,-122,47,151,H1
"Scott County, TN",2003-2004,21567,21688,121,0.561,91,30,47,151,H1
"Scott County, TN",2004-2005,21688,21865,177,0.816,101,76,47,151,H1
"Scott County, TN",2005-2006,21865,22034,169,0.773,127,42,47,151,H1
"Scott County, TN",2006-2007,22034,22179,145,0.658,100,45,47,151,H1
"Scott County, TN",2007-2008,22179,22214,35,0.158,85,-50,47,151,H1
"Scott County, TN",2008-2009,22214,22195,-19,-0.086,52,-71,47,151,H1
"Scott County, TN",2009-2010,22195,22241,46,0.207,60,-14,47,151,H1
"Scott County, TN",2010-2011,22241,22116,-125,-0.562,-37,-88,47,151,H1
"Scott County, TN",2011-2012,22116,22166,50,0.226,18,32,47,151,H1
"Scott County, TN",2012-2013,22166,22009,-157,-0.708,3,-160,47,151,H1
"Scott County, TN",2013-2014,22009,21987,-22,-0.1,-3,-19,47,151,H1
"Scott County, TN",2014-2015,21994,21950,-44,-0.2,23,-67,47,151,H1
"Scott County, TN",2015-2016,21950,21892,-58,-0.264,42,-100,47,151,H1
"Scott County, TN",2016-2017,21892,21989,97,0.443,0,97,47,151,H1
"Sequatchie County, TN",2000-2001,11318,11470,152,1.343,-1,153,47,153,H1
"Sequatchie County, TN",2001-2002,11470,11740,270,2.354,60,210,47,153,H1
"Sequatchie County, TN",2002-2003,11740,12062,322,2.743,64,258,47,153,H1
"Sequatchie County, TN",2003-2004,12062,12422,360,2.985,69,291,47,153,H1
"Sequatchie County, TN",2004-2005,12422,12819,397,3.196,12,385,47,153,H1
"Sequatchie County, TN",2005-2006,12819,13282,463,3.612,51,412,47,153,H1
"Sequatchie County, TN",2006-2007,13282,13650,368,2.771,85,283,47,153,H1
"Sequatchie County, TN",2007-2008,13650,13904,254,1.861,39,215,47,153,H1
"Sequatchie County, TN",2008-2009,13904,14137,233,1.676,29,204,47,153,H1
"Sequatchie County, TN",2009-2010,14137,14131,-6,-0.042,27,-33,47,153,H1
"Sequatchie County, TN",2010-2011,14131,14277,146,1.033,6,140,47,153,H1
"Sequatchie County, TN",2011-2012,14277,14417,140,0.981,17,123,47,153,H1
"Sequatchie County, TN",2012-2013,14417,14624,207,1.436,-57,264,47,153,H1
"Sequatchie County, TN",2013-2014,14624,14704,80,0.547,-51,131,47,153,H1
"Sequatchie County, TN",2014-2015,14778,14811,33,0.223,-5,38,47,153,H1
"Sequatchie County, TN",2015-2016,14811,14740,-71,-0.479,-17,-54,47,153,H1
"Sequatchie County, TN",2016-2017,14740,14736,-4,-0.027,-13,9,47,153,H1
"Sevier County, TN",2000-2001,71776,73563,1787,2.49,299,1488,47,155,H1
"Sevier County, TN",2001-2002,73563,75035,1472,2.001,211,1261,47,155,H1
"Sevier County, TN",2002-2003,75035,76616,1581,2.107,301,1280,47,155,H1
"Sevier County, TN",2003-2004,76616,78610,1994,2.603,181,1813,47,155,H1
"Sevier County, TN",2004-2005,78610,81275,2665,3.39,309,2356,47,155,H1
"Sevier County, TN",2005-2006,81275,84098,2823,3.473,373,2450,47,155,H1
"Sevier County, TN",2006-2007,84098,86284,2186,2.599,384,1802,47,155,H1
"Sevier County, TN",2007-2008,86284,87983,1699,1.969,419,1280,47,155,H1
"Sevier County, TN",2008-2009,87983,89096,1113,1.265,294,819,47,155,H1
"Sevier County, TN",2009-2010,89096,90135,1039,1.166,226,813,47,155,H1
"Sevier County, TN",2010-2011,90135,91336,1201,1.332,158,1043,47,155,H1
"Sevier County, TN",2011-2012,91336,92532,1196,1.309,157,1039,47,155,H1
"Sevier County, TN",2012-2013,92532,93693,1161,1.255,93,1068,47,155,H1
"Sevier County, TN",2013-2014,93693,95110,1417,1.512,122,1295,47,155,H1
"Sevier County, TN",2014-2015,94889,95946,1057,1.114,96,961,47,155,H1
"Sevier County, TN",2015-2016,95946,96609,663,0.691,110,553,47,155,H1
"Sevier County, TN",2016-2017,96609,97638,1029,1.065,58,971,47,155,H1
"Shelby County, TN",2000-2001,898211,899345,1134,0.126,6512,-5378,47,157,H1
"Shelby County, TN",2001-2002,899345,902634,3289,0.366,6414,-3125,47,157,H1
"Shelby County, TN",2002-2003,902634,906733,4099,0.454,6358,-2259,47,157,H1
"Shelby County, TN",2003-2004,906733,909643,2910,0.321,6641,-3731,47,157,H1
"Shelby County, TN",2004-2005,909643,913201,3558,0.391,6510,-2952,47,157,H1
"Shelby County, TN",2005-2006,913201,920106,6905,0.756,7331,-426,47,157,H1
"Shelby County, TN",2006-2007,920106,921119,1013,0.11,7757,-6744,47,157,H1
"Shelby County, TN",2007-2008,921119,920685,-434,-0.047,7642,-8076,47,157,H1
"Shelby County, TN",2008-2009,920685,922541,1856,0.202,7148,-5292,47,157,H1
"Shelby County, TN",2009-2010,922541,928786,6245,0.677,7003,-758,47,157,H1
"Shelby County, TN",2010-2011,928786,933756,4970,0.535,6192,-1222,47,157,H1
"Shelby County, TN",2011-2012,933756,939942,6186,0.662,6649,-463,47,157,H1
"Shelby County, TN",2012-2013,939942,939365,-577,-0.061,5936,-6513,47,157,H1
"Shelby County, TN",2013-2014,939365,938803,-562,-0.06,5715,-6277,47,157,H1
"Shelby County, TN",2014-2015,938405,938069,-336,-0.036,5787,-6123,47,157,H1
"Shelby County, TN",2015-2016,938069,937130,-939,-0.1,5205,-6144,47,157,H1
"Shelby County, TN",2016-2017,937130,936961,-169,-0.018,4996,-5165,47,157,H1
"Smith County, TN",2000-2001,17784,17962,178,1.001,42,136,47,159,H1
"Smith County, TN",2001-2002,17962,18104,142,0.791,32,110,47,159,H1
"Smith County, TN",2002-2003,18104,18236,132,0.729,6,126,47,159,H1
"Smith County, TN",2003-2004,18236,18302,66,0.362,21,45,47,159,H1
"Smith County, TN",2004-2005,18302,18521,219,1.197,-6,225,47,159,H1
"Smith County, TN",2005-2006,18521,18726,205,1.107,18,187,47,159,H1
"Smith County, TN",2006-2007,18726,18905,179,0.956,42,137,47,159,H1
"Smith County, TN",2007-2008,18905,19179,274,1.449,18,256,47,159,H1
"Smith County, TN",2008-2009,19179,19219,40,0.209,38,2,47,159,H1
"Smith County, TN",2009-2010,19219,19125,-94,-0.489,38,-132,47,159,H1
"Smith County, TN",2010-2011,19125,19146,21,0.11,-9,30,47,159,H1
"Smith County, TN",2011-2012,19146,19120,-26,-0.136,-6,-20,47,159,H1
"Smith County, TN",2012-2013,19120,19061,-59,-0.309,15,-74,47,159,H1
"Smith County, TN",2013-2014,19061,19009,-52,-0.273,6,-58,47,159,H1
"Smith County, TN",2014-2015,19040,19295,255,1.339,47,208,47,159,H1
"Smith County, TN",2015-2016,19295,19466,171,0.886,57,114,47,159,H1
"Smith County, TN",2016-2017,19466,19636,170,0.873,24,146,47,159,H1
"Stewart County, TN",2000-2001,12444,12548,104,0.836,21,83,47,161,H1
"Stewart County, TN",2001-2002,12548,12662,114,0.909,-2,116,47,161,H1
"Stewart County, TN",2002-2003,12662,12678,16,0.126,12,4,47,161,H1
"Stewart County, TN",2003-2004,12678,12644,-34,-0.268,0,-34,47,161,H1
"Stewart County, TN",2004-2005,12644,12843,199,1.574,0,199,47,161,H1
"Stewart County, TN",2005-2006,12843,12866,23,0.179,-20,43,47,161,H1
"Stewart County, TN",2006-2007,12866,12997,131,1.018,-38,169,47,161,H1
"Stewart County, TN",2007-2008,12997,13199,202,1.554,8,194,47,161,H1
"Stewart County, TN",2008-2009,13199,13253,54,0.409,-1,55,47,161,H1
"Stewart County, TN",2009-2010,13253,13351,98,0.739,-18,116,47,161,H1
"Stewart County, TN",2010-2011,13351,13244,-107,-0.801,-14,-93,47,161,H1
"Stewart County, TN",2011-2012,13244,13336,92,0.695,-24,116,47,161,H1
"Stewart County, TN",2012-2013,13336,13345,9,0.067,-32,41,47,161,H1
"Stewart County, TN",2013-2014,13345,13279,-66,-0.495,-29,-37,47,161,H1
"Stewart County, TN",2014-2015,13268,13259,-9,-0.068,-42,33,47,161,H1
"Stewart County, TN",2015-2016,13259,13174,-85,-0.641,-10,-75,47,161,H1
"Stewart County, TN",2016-2017,13174,13355,181,1.374,-29,210,47,161,H1
"Sullivan County, TN",2000-2001,152995,152718,-277,-0.181,17,-294,47,163,H1
"Sullivan County, TN",2001-2002,152718,153160,442,0.289,-117,559,47,163,H1
"Sullivan County, TN",2002-2003,153160,153280,120,0.078,-250,370,47,163,H1
"Sullivan County, TN",2003-2004,153280,152808,-472,-0.308,-271,-201,47,163,H1
"Sullivan County, TN",2004-2005,152808,153463,655,0.429,-168,823,47,163,H1
"Sullivan County, TN",2005-2006,153463,154227,764,0.498,-157,921,47,163,H1
"Sullivan County, TN",2006-2007,154227,155367,1140,0.739,-114,1254,47,163,H1
"Sullivan County, TN",2007-2008,155367,156028,661,0.425,-45,706,47,163,H1
"Sullivan County, TN",2008-2009,156028,156661,633,0.406,-158,791,47,163,H1
"Sullivan County, TN",2009-2010,156661,156856,195,0.124,-234,429,47,163,H1
"Sullivan County, TN",2010-2011,156856,156978,122,0.078,-403,525,47,163,H1
"Sullivan County, TN",2011-2012,156978,156673,-305,-0.194,-445,140,47,163,H1
"Sullivan County, TN",2012-2013,156673,156694,21,0.013,-308,329,47,163,H1
"Sullivan County, TN",2013-2014,156694,157047,353,0.225,-182,535,47,163,H1
"Sullivan County, TN",2014-2015,156803,156791,-12,-0.008,-273,261,47,163,H1
"Sullivan County, TN",2015-2016,156791,156335,-456,-0.291,-499,43,47,163,H1
"Sullivan County, TN",2016-2017,156335,157158,823,0.526,-402,1225,47,163,H1
"Sumner County, TN",2000-2001,131207,133681,2474,1.886,773,1701,47,165,H1
"Sumner County, TN",2001-2002,133681,136097,2416,1.807,695,1721,47,165,H1
"Sumner County, TN",2002-2003,136097,138153,2056,1.511,643,1413,47,165,H1
"Sumner County, TN",2003-2004,138153,141103,2950,2.135,739,2211,47,165,H1
"Sumner County, TN",2004-2005,141103,144124,3021,2.141,727,2294,47,165,H1
"Sumner County, TN",2005-2006,144124,148941,4817,3.342,806,4011,47,165,H1
"Sumner County, TN",2006-2007,148941,152949,4008,2.691,861,3147,47,165,H1
"Sumner County, TN",2007-2008,152949,155999,3050,1.994,939,2111,47,165,H1
"Sumner County, TN",2008-2009,155999,158819,2820,1.808,880,1940,47,165,H1
"Sumner County, TN",2009-2010,158819,161276,2457,1.547,732,1725,47,165,H1
"Sumner County, TN",2010-2011,161276,163929,2653,1.645,545,2108,47,165,H1
"Sumner County, TN",2011-2012,163929,166156,2227,1.359,683,1544,47,165,H1
"Sumner County, TN",2012-2013,166156,169114,2958,1.78,511,2447,47,165,H1
"Sumner County, TN",2013-2014,169114,172706,3592,2.124,481,3111,47,165,H1
"Sumner County, TN",2014-2015,172870,175989,3119,1.804,640,2479,47,165,H1
"Sumner County, TN",2015-2016,175989,179108,3119,1.772,532,2587,47,165,H1
"Sumner County, TN",2016-2017,179108,183545,4437,2.477,524,3913,47,165,H1
"Tipton County, TN",2000-2001,51577,52696,1119,2.17,269,850,47,167,H1
"Tipton County, TN",2001-2002,52696,53382,686,1.302,253,433,47,167,H1
"Tipton County, TN",2002-2003,53382,54037,655,1.227,196,459,47,167,H1
"Tipton County, TN",2003-2004,54037,54581,544,1.007,266,278,47,167,H1
"Tipton County, TN",2004-2005,54581,56022,1441,2.64,255,1186,47,167,H1
"Tipton County, TN",2005-2006,56022,57466,1444,2.578,225,1219,47,167,H1
"Tipton County, TN",2006-2007,57466,58866,1400,2.436,334,1066,47,167,H1
"Tipton County, TN",2007-2008,58866,60128,1262,2.144,320,942,47,167,H1
"Tipton County, TN",2008-2009,60128,60866,738,1.227,290,448,47,167,H1
"Tipton County, TN",2009-2010,60866,61121,255,0.419,224,31,47,167,H1
"Tipton County, TN",2010-2011,61121,61279,158,0.259,218,-60,47,167,H1
"Tipton County, TN",2011-2012,61279,61576,297,0.485,276,21,47,167,H1
"Tipton County, TN",2012-2013,61576,61564,-12,-0.019,171,-183,47,167,H1
"Tipton County, TN",2013-2014,61564,61623,59,0.096,167,-108,47,167,H1
"Tipton County, TN",2014-2015,61812,61870,58,0.094,170,-112,47,167,H1
"Tipton County, TN",2015-2016,61870,61176,-694,-1.122,77,-771,47,167,H1
"Tipton County, TN",2016-2017,61176,61366,190,0.311,110,80,47,167,H1
"Trousdale County, TN",2000-2001,7395,7350,-45,-0.609,4,-49,47,169,H6
"Trousdale County, TN",2001-2002,7350,7334,-16,-0.218,2,-18,47,169,H6
"Trousdale County, TN",2002-2003,7334,7295,-39,-0.532,-12,-27,47,169,H6
"Trousdale County, TN",2003-2004,7295,7315,20,0.274,2,18,47,169,H6
"Trousdale County, TN",2004-2005,7315,7443,128,1.75,-3,131,47,169,H6
"Trousdale County, TN",2005-2006,7443,7531,88,1.182,-4,92,47,169,H6
"Trousdale County, TN",2006-2007,7531,7694,163,2.164,5,158,47,169,H6
"Trousdale County, TN",2007-2008,7694,7777,83,1.079,9,74,47,169,H6
"Trousdale County, TN",2008-2009,7777,7881,104,1.337,3,101,47,169,H6
"Trousdale County, TN",2009-2010,7881,7874,-7,-0.089,4,-11,47,169,H6
"Trousdale County, TN",2010-2011,7874,7820,-54,-0.686,-4,-50,47,169,H6
"Trousdale County, TN",2011-2012,7820,7791,-29,-0.371,1,-30,47,169,H6
"Trousdale County, TN",2012-2013,7791,7806,15,0.193,-4,19,47,169,H6
"Trousdale County, TN",2013-2014,7806,8002,196,2.511,11,185,47,169,H6
"Trousdale County, TN",2014-2015,8002,8042,40,0.5,16,24,47,169,H6
"Trousdale County, TN",2015-2016,8042,9950,1908,23.725,6,1902,47,169,H6
"Trousdale County, TN",2016-2017,9950,10083,133,1.337,23,110,47,169,H6
"Unicoi County, TN",2000-2001,17686,17642,-44,-0.249,-63,19,47,171,H1
"Unicoi County, TN",2001-2002,17642,17765,123,0.697,-65,188,47,171,H1
"Unicoi County, TN",2002-2003,17765,17918,153,0.861,-81,234,47,171,H1
"Unicoi County, TN",2003-2004,17918,17936,18,0.1,-86,104,47,171,H1
"Unicoi County, TN",2004-2005,17936,17937,1,0.006,-45,46,47,171,H1
"Unicoi County, TN",2005-2006,17937,18143,206,1.148,-84,290,47,171,H1
"Unicoi County, TN",2006-2007,18143,18205,62,0.342,-92,154,47,171,H1
"Unicoi County, TN",2007-2008,18205,18291,86,0.472,-62,148,47,171,H1
"Unicoi County, TN",2008-2009,18291,18367,76,0.416,-75,151,47,171,H1
"Unicoi County, TN",2009-2010,18367,18290,-77,-0.419,-82,5,47,171,H1
"Unicoi County, TN",2010-2011,18290,18294,4,0.022,-90,94,47,171,H1
"Unicoi County, TN",2011-2012,18294,18251,-43,-0.235,-76,33,47,171,H1
"Unicoi County, TN",2012-2013,18251,18077,-174,-0.953,-99,-75,47,171,H1
"Unicoi County, TN",2013-2014,18077,17963,-114,-0.631,-100,-14,47,171,H1
"Unicoi County, TN",2014-2015,17928,17860,-68,-0.379,-99,31,47,171,H1
"Unicoi County, TN",2015-2016,17860,17665,-195,-1.092,-114,-81,47,171,H1
"Unicoi County, TN",2016-2017,17665,17759,94,0.532,-111,205,47,171,H1
"Union County, TN",2000-2001,17891,18322,431,2.409,61,370,47,173,H1
"Union County, TN",2001-2002,18322,18453,131,0.715,82,49,47,173,H1
"Union County, TN",2002-2003,18453,18652,199,1.078,88,111,47,173,H1
"Union County, TN",2003-2004,18652,18653,1,0.005,76,-75,47,173,H1
"Union County, TN",2004-2005,18653,18734,81,0.434,83,-2,47,173,H1
"Union County, TN",2005-2006,18734,18896,162,0.865,91,71,47,173,H1
"Union County, TN",2006-2007,18896,19041,145,0.767,81,64,47,173,H1
"Union County, TN",2007-2008,19041,19208,167,0.877,88,79,47,173,H1
"Union County, TN",2008-2009,19208,19225,17,0.089,59,-42,47,173,H1
"Union County, TN",2009-2010,19225,19120,-105,-0.546,26,-131,47,173,H1
"Union County, TN",2010-2011,19120,19237,117,0.612,17,100,47,173,H1
"Union County, TN",2011-2012,19237,19133,-104,-0.541,24,-128,47,173,H1
"Union County, TN",2012-2013,19133,19092,-41,-0.214,43,-84,47,173,H1
"Union County, TN",2013-2014,19092,19113,21,0.11,47,-26,47,173,H1
"Union County, TN",2014-2015,18984,19119,135,0.711,-28,163,47,173,H1
"Union County, TN",2015-2016,19119,19232,113,0.591,-9,122,47,173,H1
"Union County, TN",2016-2017,19232,19442,210,1.092,18,192,47,173,H1
"Van Buren County, TN",2000-2001,5507,5475,-32,-0.581,-6,-26,47,175,H1
"Van Buren County, TN",2001-2002,5475,5505,30,0.548,14,16,47,175,H1
"Van Buren County, TN",2002-2003,5505,5415,-90,-1.635,-4,-86,47,175,H1
"Van Buren County, TN",2003-2004,5415,5412,-3,-0.055,7,-10,47,175,H1
"Van Buren County, TN",2004-2005,5412,5413,1,0.018,-12,13,47,175,H1
"Van Buren County, TN",2005-2006,5413,5406,-7,-0.129,1,-8,47,175,H1
"Van Buren County, TN",2006-2007,5406,5480,74,1.369,1,73,47,175,H1
"Van Buren County, TN",2007-2008,5480,5541,61,1.113,16,45,47,175,H1
"Van Buren County, TN",2008-2009,5541,5540,-1,-0.018,1,-2,47,175,H1
"Van Buren County, TN",2009-2010,5540,5552,12,0.217,-8,20,47,175,H1
"Van Buren County, TN",2010-2011,5552,5526,-26,-0.468,0,-26,47,175,H1
"Van Buren County, TN",2011-2012,5526,5620,94,1.701,-9,103,47,175,H1
"Van Buren County, TN",2012-2013,5620,5561,-59,-1.05,-3,-56,47,175,H1
"Van Buren County, TN",2013-2014,5561,5633,72,1.295,16,56,47,175,H1
"Van Buren County, TN",2014-2015,5611,5677,66,1.176,15,51,47,175,H1
"Van Buren County, TN",2015-2016,5677,5716,39,0.687,2,37,47,175,H1
"Van Buren County, TN",2016-2017,5716,5742,26,0.455,15,11,47,175,H1
"Warren County, TN",2000-2001,38371,38566,195,0.508,161,34,47,177,H1
"Warren County, TN",2001-2002,38566,38500,-66,-0.171,206,-272,47,177,H1
"Warren County, TN",2002-2003,38500,38828,328,0.852,154,174,47,177,H1
"Warren County, TN",2003-2004,38828,38864,36,0.093,58,-22,47,177,H1
"Warren County, TN",2004-2005,38864,38987,123,0.316,93,30,47,177,H1
"Warren County, TN",2005-2006,38987,39190,203,0.521,92,111,47,177,H1
"Warren County, TN",2006-2007,39190,39365,175,0.447,109,66,47,177,H1
"Warren County, TN",2007-2008,39365,39534,169,0.429,72,97,47,177,H1
"Warren County, TN",2008-2009,39534,39709,175,0.443,88,87,47,177,H1
"Warren County, TN",2009-2010,39709,39859,150,0.378,73,77,47,177,H1
"Warren County, TN",2010-2011,39859,39885,26,0.065,-17,43,47,177,H1
"Warren County, TN",2011-2012,39885,39755,-130,-0.326,2,-132,47,177,H1
"Warren County, TN",2012-2013,39755,39866,111,0.279,37,74,47,177,H1
"Warren County, TN",2013-2014,39866,39969,103,0.258,22,81,47,177,H1
"Warren County, TN",2014-2015,40038,40435,397,0.992,65,332,47,177,H1
"Warren County, TN",2015-2016,40435,40400,-35,-0.087,-30,-5,47,177,H1
"Warren County, TN",2016-2017,40400,40651,251,0.621,-19,270,47,177,H1
"Washington County, TN",2000-2001,107469,107775,306,0.285,155,151,47,179,H1
"Washington County, TN",2001-2002,107775,109526,1751,1.625,119,1632,47,179,H1
"Washington County, TN",2002-2003,109526,110592,1066,0.973,171,895,47,179,H1
"Washington County, TN",2003-2004,110592,111849,1257,1.137,159,1098,47,179,H1
"Washington County, TN",2004-2005,111849,113552,1703,1.523,139,1564,47,179,H1
"Washington County, TN",2005-2006,113552,115923,2371,2.088,149,2222,47,179,H1
"Washington County, TN",2006-2007,115923,117833,1910,1.648,149,1761,47,179,H1
"Washington County, TN",2007-2008,117833,120056,2223,1.887,205,2018,47,179,H1
"Washington County, TN",2008-2009,120056,121692,1636,1.363,200,1436,47,179,H1
"Washington County, TN",2009-2010,121692,123302,1610,1.323,129,1481,47,179,H1
"Washington County, TN",2010-2011,123302,123989,687,0.557,29,658,47,179,H1
"Washington County, TN",2011-2012,123989,124897,908,0.732,30,878,47,179,H1
"Washington County, TN",2012-2013,124897,125561,664,0.532,149,515,47,179,H1
"Washington County, TN",2013-2014,125561,126242,681,0.542,202,479,47,179,H1
"Washington County, TN",2014-2015,125862,126302,440,0.35,66,374,47,179,H1
"Washington County, TN",2015-2016,126302,127220,918,0.727,-7,925,47,179,H1
"Washington County, TN",2016-2017,127220,127806,586,0.461,9,577,47,179,H1
"Wayne County, TN",2000-2001,16819,17075,256,1.522,-2,258,47,181,H1
"Wayne County, TN",2001-2002,17075,17078,3,0.018,-15,18,47,181,H1
"Wayne County, TN",2002-2003,17078,17036,-42,-0.246,-18,-24,47,181,H1
"Wayne County, TN",2003-2004,17036,17010,-26,-0.153,-9,-17,47,181,H1
"Wayne County, TN",2004-2005,17010,17006,-4,-0.024,-23,19,47,181,H1
"Wayne County, TN",2005-2006,17006,17033,27,0.159,-2,29,47,181,H1
"Wayne County, TN",2006-2007,17033,16991,-42,-0.247,-27,-15,47,181,H1
"Wayne County, TN",2007-2008,16991,17004,13,0.077,-30,43,47,181,H1
"Wayne County, TN",2008-2009,17004,17048,44,0.259,-13,57,47,181,H1
"Wayne County, TN",2009-2010,17048,16985,-63,-0.37,-17,-46,47,181,H1
"Wayne County, TN",2010-2011,16985,17001,16,0.094,-55,71,47,181,H1
"Wayne County, TN",2011-2012,17001,16990,-11,-0.065,1,-12,47,181,H1
"Wayne County, TN",2012-2013,16990,16946,-44,-0.259,-34,-10,47,181,H1
"Wayne County, TN",2013-2014,16946,16913,-33,-0.195,-19,-14,47,181,H1
"Wayne County, TN",2014-2015,16842,16748,-94,-0.558,-58,-36,47,181,H1
"Wayne County, TN",2015-2016,16748,16665,-83,-0.496,-60,-23,47,181,H1
"Wayne County, TN",2016-2017,16665,16583,-82,-0.492,-69,-13,47,181,H1
"Weakley County, TN",2000-2001,34927,34491,-436,-1.248,47,-483,47,183,H1
"Weakley County, TN",2001-2002,34491,34443,-48,-0.139,0,-48,47,183,H1
"Weakley County, TN",2002-2003,34443,34300,-143,-0.415,-33,-110,47,183,H1
"Weakley County, TN",2003-2004,34300,34307,7,0.02,8,-1,47,183,H1
"Weakley County, TN",2004-2005,34307,34407,100,0.291,-27,127,47,183,H1
"Weakley County, TN",2005-2006,34407,34289,-118,-0.343,-35,-83,47,183,H1
"Weakley County, TN",2006-2007,34289,34256,-33,-0.096,-36,3,47,183,H1
"Weakley County, TN",2007-2008,34256,34484,228,0.666,-16,244,47,183,H1
"Weakley County, TN",2008-2009,34484,34732,248,0.719,-10,258,47,183,H1
"Weakley County, TN",2009-2010,34732,35026,294,0.846,52,242,47,183,H1
"Weakley County, TN",2010-2011,35026,34962,-64,-0.183,-30,-34,47,183,H1
"Weakley County, TN",2011-2012,34962,34712,-250,-0.715,-10,-240,47,183,H1
"Weakley County, TN",2012-2013,34712,34424,-288,-0.83,-23,-265,47,183,H1
"Weakley County, TN",2013-2014,34424,34373,-51,-0.148,-2,-49,47,183,H1
"Weakley County, TN",2014-2015,34142,33960,-182,-0.533,15,-197,47,183,H1
"Weakley County, TN",2015-2016,33960,33568,-392,-1.154,-38,-354,47,183,H1
"Weakley County, TN",2016-2017,33568,33337,-231,-0.688,-14,-217,47,183,H1
"White County, TN",2000-2001,23160,23468,308,1.33,23,285,47,185,H1
"White County, TN",2001-2002,23468,23650,182,0.776,-15,197,47,185,H1
"White County, TN",2002-2003,23650,23754,104,0.44,-33,137,47,185,H1
"White County, TN",2003-2004,23754,24069,315,1.326,-11,326,47,185,H1
"White County, TN",2004-2005,24069,24489,420,1.745,6,414,47,185,H1
"White County, TN",2005-2006,24489,24866,377,1.539,50,327,47,185,H1
"White County, TN",2006-2007,24866,25250,384,1.544,32,352,47,185,H1
"White County, TN",2007-2008,25250,25548,298,1.18,8,290,47,185,H1
"White County, TN",2008-2009,25548,25789,241,0.943,10,231,47,185,H1
"White County, TN",2009-2010,25789,25816,27,0.105,-13,40,47,185,H1
"White County, TN",2010-2011,25816,26020,204,0.79,-55,259,47,185,H1
"White County, TN",2011-2012,26020,26060,40,0.154,-64,104,47,185,H1
"White County, TN",2012-2013,26060,26231,171,0.656,-53,224,47,185,H1
"White County, TN",2013-2014,26231,26301,70,0.267,-26,96,47,185,H1
"White County, TN",2014-2015,26350,26521,171,0.649,-21,192,47,185,H1
"White County, TN",2015-2016,26521,26451,-70,-0.264,-79,9,47,185,H1
"White County, TN",2016-2017,26451,26753,302,1.142,-56,358,47,185,H1
"Williamson County, TN",2000-2001,128134,132536,4402,3.435,1001,3401,47,187,H1
"Williamson County, TN",2001-2002,132536,136953,4417,3.333,996,3421,47,187,H1
"Williamson County, TN",2002-2003,136953,141876,4923,3.595,1077,3846,47,187,H1
"Williamson County, TN",2003-2004,141876,147439,5563,3.921,1216,4347,47,187,H1
"Williamson County, TN",2004-2005,147439,154099,6660,4.517,1110,5550,47,187,H1
"Williamson County, TN",2005-2006,154099,161902,7803,5.064,1304,6499,47,187,H1
"Williamson County, TN",2006-2007,161902,169534,7632,4.714,1311,6321,47,187,H1
"Williamson County, TN",2007-2008,169534,175498,5964,3.518,1281,4683,47,187,H1
"Williamson County, TN",2008-2009,175498,180332,4834,2.754,1341,3493,47,187,H1
"Williamson County, TN",2009-2010,180332,184068,3736,2.072,1142,2594,47,187,H1
"Williamson County, TN",2010-2011,184068,188299,4231,2.299,974,3257,47,187,H1
"Williamson County, TN",2011-2012,188299,193037,4738,2.516,1022,3716,47,187,H1
"Williamson County, TN",2012-2013,193037,198975,5938,3.076,968,4970,47,187,H1
"Williamson County, TN",2013-2014,198975,205226,6251,3.142,1002,5249,47,187,H1
"Williamson County, TN",2014-2015,205334,211672,6338,3.087,1143,5195,47,187,H1
"Williamson County, TN",2015-2016,211672,218888,7216,3.409,1110,6106,47,187,H1
"Williamson County, TN",2016-2017,218888,226257,7369,3.367,1135,6234,47,187,H1
"Wilson County, TN",2000-2001,89220,91020,1800,2.017,586,1214,47,189,H1
"Wilson County, TN",2001-2002,91020,93033,2013,2.212,514,1499,47,189,H1
"Wilson County, TN",2002-2003,93033,94924,1891,2.033,496,1395,47,189,H1
"Wilson County, TN",2003-2004,94924,97139,2215,2.333,513,1702,47,189,H1
"Wilson County, TN",2004-2005,97139,99960,2821,2.904,572,2249,47,189,H1
"Wilson County, TN",2005-2006,99960,103697,3737,3.738,547,3190,47,189,H1
"Wilson County, TN",2006-2007,103697,106757,3060,2.951,643,2417,47,189,H1
"Wilson County, TN",2007-2008,106757,110474,3717,3.482,630,3087,47,189,H1
"Wilson County, TN",2008-2009,110474,112350,1876,1.698,649,1227,47,189,H1
"Wilson County, TN",2009-2010,112350,114650,2300,2.047,428,1872,47,189,H1
"Wilson County, TN",2010-2011,114650,116791,2141,1.867,424,1717,47,189,H1
"Wilson County, TN",2011-2012,116791,119088,2297,1.967,427,1870,47,189,H1
"Wilson County, TN",2012-2013,119088,122016,2928,2.459,444,2484,47,189,H1
"Wilson County, TN",2013-2014,122016,125376,3360,2.754,422,2938,47,189,H1
"Wilson County, TN",2014-2015,125418,128911,3493,2.785,440,3053,47,189,H1
"Wilson County, TN",2015-2016,128911,132433,3522,2.732,533,2989,47,189,H1
"Wilson County, TN",2016-2017,132433,136442,4009,3.027,463,3546,47,189,H1
Texas,2000-2001,20944499,21319622,375123,1.791,212160,162963,48,0,STATE
Texas,2001-2002,21319622,21690325,370703,1.739,212584,158119,48,0,STATE
Texas,2002-2003,21690325,22030931,340606,1.57,223374,117232,48,0,STATE
Texas,2003-2004,22030931,22394023,363092,1.648,225553,137539,48,0,STATE
Texas,2004-2005,22394023,22778123,384100,1.715,228820,155280,48,0,STATE
Texas,2005-2006,22778123,23359580,581457,2.553,235889,345568,48,0,STATE
Texas,2006-2007,23359580,23831983,472403,2.022,244059,228344,48,0,STATE
Texas,2007-2008,23831983,24309039,477056,2.002,245582,231474,48,0,STATE
Texas,2008-2009,24309039,24801761,492722,2.027,245537,247185,48,0,STATE
Texas,2009-2010,24801761,25244363,442602,1.785,246636,195966,48,0,STATE
Texas,2010-2011,25244363,25654464,410101,1.625,213690,196411,48,0,STATE
Texas,2011-2012,25654464,26089741,435277,1.697,209059,226218,48,0,STATE
Texas,2012-2013,26089741,26500674,410933,1.575,205812,205121,48,0,STATE
Texas,2013-2014,26500674,26979078,478404,1.805,211389,267015,48,0,STATE
Texas,2014-2015,26979078,27469114,490036,1.816,215609,274427,48,0,STATE
Texas,2015-2016,27469114,27904862,435748,1.586,212021,223727,48,0,STATE
Texas,2016-2017,27904862,28304596,399734,1.432,209690,190044,48,0,STATE
"Anderson County, TX",2000-2001,55062,54263,-799,-1.451,53,-852,48,1,H1
"Anderson County, TX",2001-2002,54263,54740,477,0.879,109,368,48,1,H1
"Anderson County, TX",2002-2003,54740,56068,1328,2.426,48,1280,48,1,H1
"Anderson County, TX",2003-2004,56068,56245,177,0.316,47,130,48,1,H1
"Anderson County, TX",2004-2005,56245,56873,628,1.117,99,529,48,1,H1
"Anderson County, TX",2005-2006,56873,57386,513,0.902,58,455,48,1,H1
"Anderson County, TX",2006-2007,57386,57870,484,0.843,84,400,48,1,H1
"Anderson County, TX",2007-2008,57870,57963,93,0.161,48,45,48,1,H1
"Anderson County, TX",2008-2009,57963,58410,447,0.771,20,427,48,1,H1
"Anderson County, TX",2009-2010,58410,58478,68,0.116,20,48,48,1,H1
"Anderson County, TX",2010-2011,58478,58353,-125,-0.214,-46,-79,48,1,H1
"Anderson County, TX",2011-2012,58353,58026,-327,-0.56,-54,-273,48,1,H1
"Anderson County, TX",2012-2013,58026,57934,-92,-0.159,-24,-68,48,1,H1
"Anderson County, TX",2013-2014,57934,57627,-307,-0.53,-72,-235,48,1,H1
"Anderson County, TX",2014-2015,57742,57580,-162,-0.281,-42,-120,48,1,H1
"Anderson County, TX",2015-2016,57580,57558,-22,-0.038,-32,10,48,1,H1
"Anderson County, TX",2016-2017,57558,57741,183,0.318,-43,226,48,1,H1
"Andrews County, TX",2000-2001,12949,12856,-93,-0.718,112,-205,48,3,H1
"Andrews County, TX",2001-2002,12856,13022,166,1.291,88,78,48,3,H1
"Andrews County, TX",2002-2003,13022,12976,-46,-0.353,100,-146,48,3,H1
"Andrews County, TX",2003-2004,12976,13006,30,0.231,82,-52,48,3,H1
"Andrews County, TX",2004-2005,13006,13016,10,0.077,103,-93,48,3,H1
"Andrews County, TX",2005-2006,13016,13195,179,1.375,73,106,48,3,H1
"Andrews County, TX",2006-2007,13195,13513,318,2.41,145,173,48,3,H1
"Andrews County, TX",2007-2008,13513,14099,586,4.337,117,469,48,3,H1
"Andrews County, TX",2008-2009,14099,14601,502,3.561,143,359,48,3,H1
"Andrews County, TX",2009-2010,14601,14835,234,1.603,149,85,48,3,H1
"Andrews County, TX",2010-2011,14835,15393,558,3.761,135,423,48,3,H1
"Andrews County, TX",2011-2012,15393,16119,726,4.716,154,572,48,3,H1
"Andrews County, TX",2012-2013,16119,16808,689,4.274,222,467,48,3,H1
"Andrews County, TX",2013-2014,16808,17477,669,3.98,249,420,48,3,H1
"Andrews County, TX",2014-2015,17457,18105,648,3.712,254,394,48,3,H1
"Andrews County, TX",2015-2016,18105,17837,-268,-1.48,207,-475,48,3,H1
"Andrews County, TX",2016-2017,17837,17722,-115,-0.645,209,-324,48,3,H1
"Angelina County, TX",2000-2001,80270,80273,3,0.004,417,-414,48,5,H1
"Angelina County, TX",2001-2002,80273,80803,530,0.66,536,-6,48,5,H1
"Angelina County, TX",2002-2003,80803,81510,707,0.875,503,204,48,5,H1
"Angelina County, TX",2003-2004,81510,82070,560,0.687,551,9,48,5,H1
"Angelina County, TX",2004-2005,82070,82553,483,0.589,502,-19,48,5,H1
"Angelina County, TX",2005-2006,82553,83810,1257,1.523,593,664,48,5,H1
"Angelina County, TX",2006-2007,83810,84518,708,0.845,552,156,48,5,H1
"Angelina County, TX",2007-2008,84518,84961,443,0.524,529,-86,48,5,H1
"Angelina County, TX",2008-2009,84961,86029,1068,1.257,518,550,48,5,H1
"Angelina County, TX",2009-2010,86029,86920,891,1.036,563,328,48,5,H1
"Angelina County, TX",2010-2011,86920,87299,379,0.436,390,-11,48,5,H1
"Angelina County, TX",2011-2012,87299,87585,286,0.328,426,-140,48,5,H1
"Angelina County, TX",2012-2013,87585,87613,28,0.032,301,-273,48,5,H1
"Angelina County, TX",2013-2014,87613,87750,137,0.156,324,-187,48,5,H1
"Angelina County, TX",2014-2015,87875,88255,380,0.432,354,26,48,5,H1
"Angelina County, TX",2015-2016,88255,87830,-425,-0.482,329,-754,48,5,H1
"Angelina County, TX",2016-2017,87830,87805,-25,-0.028,254,-279,48,5,H1
"Aransas County, TX",2000-2001,22452,22287,-165,-0.735,-31,-134,48,7,H1
"Aransas County, TX",2001-2002,22287,22616,329,1.476,-1,330,48,7,H1
"Aransas County, TX",2002-2003,22616,22843,227,1.004,-1,228,48,7,H1
"Aransas County, TX",2003-2004,22843,23067,224,0.981,-18,242,48,7,H1
"Aransas County, TX",2004-2005,23067,23561,494,2.142,-19,513,48,7,H1
"Aransas County, TX",2005-2006,23561,23395,-166,-0.705,13,-179,48,7,H1
"Aransas County, TX",2006-2007,23395,23172,-223,-0.953,-53,-170,48,7,H1
"Aransas County, TX",2007-2008,23172,23225,53,0.229,-66,119,48,7,H1
"Aransas County, TX",2008-2009,23225,23291,66,0.284,-17,83,48,7,H1
"Aransas County, TX",2009-2010,23291,23204,-87,-0.374,-23,-64,48,7,H1
"Aransas County, TX",2010-2011,23204,23335,131,0.565,-87,218,48,7,H1
"Aransas County, TX",2011-2012,23335,23707,372,1.594,-95,467,48,7,H1
"Aransas County, TX",2012-2013,23707,24229,522,2.202,-68,590,48,7,H1
"Aransas County, TX",2013-2014,24229,24972,743,3.067,-75,818,48,7,H1
"Aransas County, TX",2014-2015,24933,25350,417,1.672,-68,485,48,7,H1
"Aransas County, TX",2015-2016,25350,25275,-75,-0.296,-38,-37,48,7,H1
"Aransas County, TX",2016-2017,25275,25572,297,1.175,-91,388,48,7,H1
"Archer County, TX",2000-2001,8966,8849,-117,-1.305,1,-118,48,9,H1
"Archer County, TX",2001-2002,8849,8942,93,1.051,24,69,48,9,H1
"Archer County, TX",2002-2003,8942,9013,71,0.794,30,41,48,9,H1
"Archer County, TX",2003-2004,9013,9078,65,0.721,52,13,48,9,H1
"Archer County, TX",2004-2005,9078,9068,-10,-0.11,27,-37,48,9,H1
"Archer County, TX",2005-2006,9068,9063,-5,-0.055,-3,-2,48,9,H1
"Archer County, TX",2006-2007,9063,9026,-37,-0.408,24,-61,48,9,H1
"Archer County, TX",2007-2008,9026,9104,78,0.864,23,55,48,9,H1
"Archer County, TX",2008-2009,9104,9023,-81,-0.89,43,-124,48,9,H1
"Archer County, TX",2009-2010,9023,9103,80,0.887,27,53,48,9,H1
"Archer County, TX",2010-2011,9103,8830,-273,-2.999,0,-273,48,9,H1
"Archer County, TX",2011-2012,8830,8772,-58,-0.657,-5,-53,48,9,H1
"Archer County, TX",2012-2013,8772,8750,-22,-0.251,-7,-15,48,9,H1
"Archer County, TX",2013-2014,8750,8811,61,0.697,9,52,48,9,H1
"Archer County, TX",2014-2015,8808,8715,-93,-1.056,19,-112,48,9,H1
"Archer County, TX",2015-2016,8715,8774,59,0.677,-17,76,48,9,H1
"Archer County, TX",2016-2017,8774,8809,35,0.399,8,27,48,9,H1
"Armstrong County, TX",2000-2001,2166,2128,-38,-1.754,-6,-32,48,11,H1
"Armstrong County, TX",2001-2002,2128,2036,-92,-4.323,-1,-91,48,11,H1
"Armstrong County, TX",2002-2003,2036,2001,-35,-1.719,-9,-26,48,11,H1
"Armstrong County, TX",2003-2004,2001,2023,22,1.099,-5,27,48,11,H1
"Armstrong County, TX",2004-2005,2023,2037,14,0.692,0,14,48,11,H1
"Armstrong County, TX",2005-2006,2037,1989,-48,-2.356,-4,-44,48,11,H1
"Armstrong County, TX",2006-2007,1989,1936,-53,-2.665,-5,-48,48,11,H1
"Armstrong County, TX",2007-2008,1936,1936,0,0,16,-16,48,11,H1
"Armstrong County, TX",2008-2009,1936,1911,-25,-1.291,14,-39,48,11,H1
"Armstrong County, TX",2009-2010,1911,1902,-9,-0.471,14,-23,48,11,H1
"Armstrong County, TX",2010-2011,1902,1934,32,1.682,-9,41,48,11,H1
"Armstrong County, TX",2011-2012,1934,1948,14,0.724,-7,21,48,11,H1
"Armstrong County, TX",2012-2013,1948,1957,9,0.462,-4,13,48,11,H1
"Armstrong County, TX",2013-2014,1957,1955,-2,-0.102,8,-10,48,11,H1
"Armstrong County, TX",2014-2015,1948,1947,-1,-0.051,5,-6,48,11,H1
"Armstrong County, TX",2015-2016,1947,1856,-91,-4.674,-12,-79,48,11,H1
"Armstrong County, TX",2016-2017,1856,1879,23,1.239,-3,26,48,11,H1
"Atascosa County, TX",2000-2001,38805,39828,1023,2.636,371,652,48,13,H1
"Atascosa County, TX",2001-2002,39828,40767,939,2.358,321,618,48,13,H1
"Atascosa County, TX",2002-2003,40767,41306,539,1.322,341,198,48,13,H1
"Atascosa County, TX",2003-2004,41306,42109,803,1.944,358,445,48,13,H1
"Atascosa County, TX",2004-2005,42109,42495,386,0.917,351,35,48,13,H1
"Atascosa County, TX",2005-2006,42495,43059,564,1.327,340,224,48,13,H1
"Atascosa County, TX",2006-2007,43059,43611,552,1.282,397,155,48,13,H1
"Atascosa County, TX",2007-2008,43611,43947,336,0.77,318,18,48,13,H1
"Atascosa County, TX",2008-2009,43947,44623,676,1.538,323,353,48,13,H1
"Atascosa County, TX",2009-2010,44623,44955,332,0.744,302,30,48,13,H1
"Atascosa County, TX",2010-2011,44955,45463,508,1.13,285,223,48,13,H1
"Atascosa County, TX",2011-2012,45463,46436,973,2.14,225,748,48,13,H1
"Atascosa County, TX",2012-2013,46436,47085,649,1.398,298,351,48,13,H1
"Atascosa County, TX",2013-2014,47085,47774,689,1.463,246,443,48,13,H1
"Atascosa County, TX",2014-2015,47812,48435,623,1.303,273,350,48,13,H1
"Atascosa County, TX",2015-2016,48435,48666,231,0.477,276,-45,48,13,H1
"Atascosa County, TX",2016-2017,48666,48981,315,0.647,272,43,48,13,H1
"Austin County, TX",2000-2001,23836,24341,505,2.119,32,473,48,15,H1
"Austin County, TX",2001-2002,24341,24818,477,1.96,72,405,48,15,H1
"Austin County, TX",2002-2003,24818,25388,570,2.297,73,497,48,15,H1
"Austin County, TX",2003-2004,25388,25976,588,2.316,46,542,48,15,H1
"Austin County, TX",2004-2005,25976,26331,355,1.367,37,318,48,15,H1
"Austin County, TX",2005-2006,26331,26828,497,1.888,80,417,48,15,H1
"Austin County, TX",2006-2007,26828,27454,626,2.333,99,527,48,15,H1
"Austin County, TX",2007-2008,27454,27935,481,1.752,110,371,48,15,H1
"Austin County, TX",2008-2009,27935,28254,319,1.142,114,205,48,15,H1
"Austin County, TX",2009-2010,28254,28423,169,0.598,71,98,48,15,H1
"Austin County, TX",2010-2011,28423,28652,229,0.806,99,130,48,15,H1
"Austin County, TX",2011-2012,28652,28622,-30,-0.105,86,-116,48,15,H1
"Austin County, TX",2012-2013,28622,28811,189,0.66,85,104,48,15,H1
"Austin County, TX",2013-2014,28811,29114,303,1.052,85,218,48,15,H1
"Austin County, TX",2014-2015,28994,29563,569,1.962,69,500,48,15,H1
"Austin County, TX",2015-2016,29563,29637,74,0.25,78,-4,48,15,H1
"Austin County, TX",2016-2017,29637,29786,149,0.503,74,75,48,15,H1
"Bailey County, TX",2000-2001,6596,6636,40,0.606,81,-41,48,17,H1
"Bailey County, TX",2001-2002,6636,6637,1,0.015,61,-60,48,17,H1
"Bailey County, TX",2002-2003,6637,6791,154,2.32,31,123,48,17,H1
"Bailey County, TX",2003-2004,6791,6945,154,2.268,76,78,48,17,H1
"Bailey County, TX",2004-2005,6945,7024,79,1.138,68,11,48,17,H1
"Bailey County, TX",2005-2006,7024,7001,-23,-0.327,46,-69,48,17,H1
"Bailey County, TX",2006-2007,7001,6927,-74,-1.057,45,-119,48,17,H1
"Bailey County, TX",2007-2008,6927,6979,52,0.751,98,-46,48,17,H1
"Bailey County, TX",2008-2009,6979,7050,71,1.017,86,-15,48,17,H1
"Bailey County, TX",2009-2010,7050,7156,106,1.504,94,12,48,17,H1
"Bailey County, TX",2010-2011,7156,7175,19,0.266,70,-51,48,17,H1
"Bailey County, TX",2011-2012,7175,7101,-74,-1.031,73,-147,48,17,H1
"Bailey County, TX",2012-2013,7101,7080,-21,-0.296,47,-68,48,17,H1
"Bailey County, TX",2013-2014,7080,6910,-170,-2.401,80,-250,48,17,H1
"Bailey County, TX",2014-2015,6960,7210,250,3.592,70,180,48,17,H1
"Bailey County, TX",2015-2016,7210,7180,-30,-0.416,83,-113,48,17,H1
"Bailey County, TX",2016-2017,7180,7077,-103,-1.435,87,-190,48,17,H1
"Bandera County, TX",2000-2001,17755,18125,370,2.084,33,337,48,19,H1
"Bandera County, TX",2001-2002,18125,18652,527,2.908,21,506,48,19,H1
"Bandera County, TX",2002-2003,18652,19044,392,2.102,46,346,48,19,H1
"Bandera County, TX",2003-2004,19044,19226,182,0.956,57,125,48,19,H1
"Bandera County, TX",2004-2005,19226,19428,202,1.051,4,198,48,19,H1
"Bandera County, TX",2005-2006,19428,19775,347,1.786,-19,366,48,19,H1
"Bandera County, TX",2006-2007,19775,20254,479,2.422,6,473,48,19,H1
"Bandera County, TX",2007-2008,20254,20407,153,0.755,-15,168,48,19,H1
"Bandera County, TX",2008-2009,20407,20365,-42,-0.206,16,-58,48,19,H1
"Bandera County, TX",2009-2010,20365,20551,186,0.913,-33,219,48,19,H1
"Bandera County, TX",2010-2011,20551,20554,3,0.015,-31,34,48,19,H1
"Bandera County, TX",2011-2012,20554,20608,54,0.263,0,54,48,19,H1
"Bandera County, TX",2012-2013,20608,20607,-1,-0.005,-45,44,48,19,H1
"Bandera County, TX",2013-2014,20607,20892,285,1.383,-35,320,48,19,H1
"Bandera County, TX",2014-2015,20916,21269,353,1.688,-26,379,48,19,H1
"Bandera County, TX",2015-2016,21269,21710,441,2.073,-50,491,48,19,H1
"Bandera County, TX",2016-2017,21710,22351,641,2.953,-33,674,48,19,H1
"Bastrop County, TX",2000-2001,58234,61106,2872,4.932,433,2439,48,21,H1
"Bastrop County, TX",2001-2002,61106,63508,2402,3.931,497,1905,48,21,H1
"Bastrop County, TX",2002-2003,63508,65825,2317,3.648,431,1886,48,21,H1
"Bastrop County, TX",2003-2004,65825,67122,1297,1.97,334,963,48,21,H1
"Bastrop County, TX",2004-2005,67122,68233,1111,1.655,452,659,48,21,H1
"Bastrop County, TX",2005-2006,68233,69720,1487,2.179,429,1058,48,21,H1
"Bastrop County, TX",2006-2007,69720,71348,1628,2.335,463,1165,48,21,H1
"Bastrop County, TX",2007-2008,71348,72389,1041,1.459,481,560,48,21,H1
"Bastrop County, TX",2008-2009,72389,73587,1198,1.655,399,799,48,21,H1
"Bastrop County, TX",2009-2010,73587,74336,749,1.018,241,508,48,21,H1
"Bastrop County, TX",2010-2011,74336,75151,815,1.096,313,502,48,21,H1
"Bastrop County, TX",2011-2012,75151,74886,-265,-0.353,225,-490,48,21,H1
"Bastrop County, TX",2012-2013,74886,76099,1213,1.62,336,877,48,21,H1
"Bastrop County, TX",2013-2014,76099,78069,1970,2.589,273,1697,48,21,H1
"Bastrop County, TX",2014-2015,78148,80527,2379,3.044,413,1966,48,21,H1
"Bastrop County, TX",2015-2016,80527,82754,2227,2.766,420,1807,48,21,H1
"Bastrop County, TX",2016-2017,82754,84761,2007,2.425,437,1570,48,21,H1
"Baylor County, TX",2000-2001,4135,3930,-205,-4.958,-29,-176,48,23,H1
"Baylor County, TX",2001-2002,3930,3897,-33,-0.84,-35,2,48,23,H1
"Baylor County, TX",2002-2003,3897,3941,44,1.129,-17,61,48,23,H1
"Baylor County, TX",2003-2004,3941,3955,14,0.355,-15,29,48,23,H1
"Baylor County, TX",2004-2005,3955,3877,-78,-1.972,-15,-63,48,23,H1
"Baylor County, TX",2005-2006,3877,3870,-7,-0.181,-6,-1,48,23,H1
"Baylor County, TX",2006-2007,3870,3905,35,0.904,-4,39,48,23,H1
"Baylor County, TX",2007-2008,3905,3747,-158,-4.046,0,-158,48,23,H1
"Baylor County, TX",2008-2009,3747,3726,-21,-0.56,-1,-20,48,23,H1
"Baylor County, TX",2009-2010,3726,3717,-9,-0.242,-9,0,48,23,H1
"Baylor County, TX",2010-2011,3717,3711,-6,-0.161,-20,14,48,23,H1
"Baylor County, TX",2011-2012,3711,3615,-96,-2.587,-31,-65,48,23,H1
"Baylor County, TX",2012-2013,3615,3605,-10,-0.277,-14,4,48,23,H1
"Baylor County, TX",2013-2014,3605,3592,-13,-0.361,-3,-10,48,23,H1
"Baylor County, TX",2014-2015,3586,3618,32,0.892,-13,45,48,23,H1
"Baylor County, TX",2015-2016,3618,3638,20,0.553,-17,37,48,23,H1
"Baylor County, TX",2016-2017,3638,3581,-57,-1.567,-10,-47,48,23,H1
"Bee County, TX",2000-2001,32200,31695,-505,-1.568,198,-703,48,25,H1
"Bee County, TX",2001-2002,31695,31804,109,0.344,132,-23,48,25,H1
"Bee County, TX",2002-2003,31804,32620,816,2.566,168,648,48,25,H1
"Bee County, TX",2003-2004,32620,32352,-268,-0.822,120,-388,48,25,H1
"Bee County, TX",2004-2005,32352,32101,-251,-0.776,156,-407,48,25,H1
"Bee County, TX",2005-2006,32101,31977,-124,-0.386,176,-300,48,25,H1
"Bee County, TX",2006-2007,31977,31936,-41,-0.128,201,-242,48,25,H1
"Bee County, TX",2007-2008,31936,31814,-122,-0.382,152,-274,48,25,H1
"Bee County, TX",2008-2009,31814,31864,50,0.157,140,-90,48,25,H1
"Bee County, TX",2009-2010,31864,31901,37,0.116,141,-104,48,25,H1
"Bee County, TX",2010-2011,31901,32321,420,1.317,89,331,48,25,H1
"Bee County, TX",2011-2012,32321,32451,130,0.402,140,-10,48,25,H1
"Bee County, TX",2012-2013,32451,32773,322,0.992,165,157,48,25,H1
"Bee County, TX",2013-2014,32773,32863,90,0.275,165,-75,48,25,H1
"Bee County, TX",2014-2015,32911,32874,-37,-0.112,197,-234,48,25,H1
"Bee County, TX",2015-2016,32874,32835,-39,-0.119,160,-199,48,25,H1
"Bee County, TX",2016-2017,32835,32563,-272,-0.828,168,-440,48,25,H1
"Bell County, TX",2000-2001,239890,244299,4409,1.838,3930,479,48,27,H1
"Bell County, TX",2001-2002,244299,249671,5372,2.199,3838,1534,48,27,H1
"Bell County, TX",2002-2003,249671,252922,3251,1.302,3966,-715,48,27,H1
"Bell County, TX",2003-2004,252922,258138,5216,2.062,3771,1445,48,27,H1
"Bell County, TX",2004-2005,258138,266017,7879,3.052,3559,4320,48,27,H1
"Bell County, TX",2005-2006,266017,273771,7754,2.915,4223,3531,48,27,H1
"Bell County, TX",2006-2007,273771,287752,13981,5.107,4248,9733,48,27,H1
"Bell County, TX",2007-2008,287752,297873,10121,3.517,4231,5890,48,27,H1
"Bell County, TX",2008-2009,297873,301050,3177,1.067,3849,-672,48,27,H1
"Bell County, TX",2009-2010,301050,312874,11824,3.928,4497,7327,48,27,H1
"Bell County, TX",2010-2011,312874,316164,3290,1.052,4785,-1495,48,27,H1
"Bell County, TX",2011-2012,316164,323147,6983,2.209,4028,2955,48,27,H1
"Bell County, TX",2012-2013,323147,326632,3485,1.078,4406,-921,48,27,H1
"Bell County, TX",2013-2014,326632,329140,2508,0.768,4228,-1720,48,27,H1
"Bell County, TX",2014-2015,329394,334941,5547,1.684,4294,1253,48,27,H1
"Bell County, TX",2015-2016,334941,341203,6262,1.87,4018,2244,48,27,H1
"Bell County, TX",2016-2017,341203,347833,6630,1.943,4131,2499,48,27,H1
"Bexar County, TX",2000-2001,1398834,1419020,20186,1.443,13887,6299,48,29,H1
"Bexar County, TX",2001-2002,1419020,1446755,27735,1.955,13869,13866,48,29,H1
"Bexar County, TX",2002-2003,1446755,1469623,22868,1.581,14524,8344,48,29,H1
"Bexar County, TX",2003-2004,1469623,1500919,31296,2.13,14927,16369,48,29,H1
"Bexar County, TX",2004-2005,1500919,1529270,28351,1.889,14985,13366,48,29,H1
"Bexar County, TX",2005-2006,1529270,1573935,44665,2.921,15642,29023,48,29,H1
"Bexar County, TX",2006-2007,1573935,1615210,41275,2.622,16241,25034,48,29,H1
"Bexar County, TX",2007-2008,1615210,1651709,36499,2.26,16696,19803,48,29,H1
"Bexar County, TX",2008-2009,1651709,1685628,33919,2.054,16689,17230,48,29,H1
"Bexar County, TX",2009-2010,1685628,1723035,37407,2.219,16810,20597,48,29,H1
"Bexar County, TX",2010-2011,1723035,1755526,32491,1.886,14852,17639,48,29,H1
"Bexar County, TX",2011-2012,1755526,1788858,33332,1.899,14505,18827,48,29,H1
"Bexar County, TX",2012-2013,1788858,1822154,33296,1.861,14024,19272,48,29,H1
"Bexar County, TX",2013-2014,1822154,1855866,33712,1.85,14412,19300,48,29,H1
"Bexar County, TX",2014-2015,1860274,1897753,37479,2.015,15038,22441,48,29,H1
"Bexar County, TX",2015-2016,1897753,1927747,29994,1.581,14622,15372,48,29,H1
"Bexar County, TX",2016-2017,1927747,1958578,30831,1.599,14729,16102,48,29,H1
"Blanco County, TX",2000-2001,8495,8776,281,3.308,-5,286,48,31,H1
"Blanco County, TX",2001-2002,8776,8950,174,1.983,23,151,48,31,H1
"Blanco County, TX",2002-2003,8950,9096,146,1.631,13,133,48,31,H1
"Blanco County, TX",2003-2004,9096,9337,241,2.65,-36,277,48,31,H1
"Blanco County, TX",2004-2005,9337,9554,217,2.324,53,164,48,31,H1
"Blanco County, TX",2005-2006,9554,9686,132,1.382,10,122,48,31,H1
"Blanco County, TX",2006-2007,9686,9835,149,1.538,23,126,48,31,H1
"Blanco County, TX",2007-2008,9835,10061,226,2.298,11,215,48,31,H1
"Blanco County, TX",2008-2009,10061,10315,254,2.525,21,233,48,31,H1
"Blanco County, TX",2009-2010,10315,10509,194,1.881,19,175,48,31,H1
"Blanco County, TX",2010-2011,10509,10554,45,0.428,-24,69,48,31,H1
"Blanco County, TX",2011-2012,10554,10616,62,0.587,-9,71,48,31,H1
"Blanco County, TX",2012-2013,10616,10634,18,0.17,-21,39,48,31,H1
"Blanco County, TX",2013-2014,10634,10812,178,1.674,-18,196,48,31,H1
"Blanco County, TX",2014-2015,10798,11004,206,1.908,-47,253,48,31,H1
"Blanco County, TX",2015-2016,11004,11341,337,3.063,-15,352,48,31,H1
"Blanco County, TX",2016-2017,11341,11626,285,2.513,-15,300,48,31,H1
"Borden County, TX",2000-2001,715,677,-38,-5.315,1,-39,48,33,H1
"Borden County, TX",2001-2002,677,685,8,1.182,-3,11,48,33,H1
"Borden County, TX",2002-2003,685,666,-19,-2.774,0,-19,48,33,H1
"Borden County, TX",2003-2004,666,671,5,0.751,-1,6,48,33,H1
"Borden County, TX",2004-2005,671,638,-33,-4.918,1,-34,48,33,H1
"Borden County, TX",2005-2006,638,634,-4,-0.627,2,-6,48,33,H1
"Borden County, TX",2006-2007,634,597,-37,-5.836,-5,-32,48,33,H1
"Borden County, TX",2007-2008,597,612,15,2.513,-1,16,48,33,H1
"Borden County, TX",2008-2009,612,618,6,0.98,1,5,48,33,H1
"Borden County, TX",2009-2010,618,643,25,4.045,2,23,48,33,H1
"Borden County, TX",2010-2011,643,628,-15,-2.333,-1,-14,48,33,H1
"Borden County, TX",2011-2012,628,613,-15,-2.389,-3,-12,48,33,H1
"Borden County, TX",2012-2013,613,639,26,4.241,7,19,48,33,H1
"Borden County, TX",2013-2014,639,652,13,2.034,4,9,48,33,H1
"Borden County, TX",2014-2015,654,648,-6,-0.917,7,-13,48,33,H1
"Borden County, TX",2015-2016,648,660,12,1.852,5,7,48,33,H1
"Borden County, TX",2016-2017,660,673,13,1.97,5,8,48,33,H1
"Bosque County, TX",2000-2001,17218,17338,120,0.697,-66,186,48,35,H1
"Bosque County, TX",2001-2002,17338,17474,136,0.784,-24,160,48,35,H1
"Bosque County, TX",2002-2003,17474,17647,173,0.99,-75,248,48,35,H1
"Bosque County, TX",2003-2004,17647,17871,224,1.269,-43,267,48,35,H1
"Bosque County, TX",2004-2005,17871,17990,119,0.666,-20,139,48,35,H1
"Bosque County, TX",2005-2006,17990,18046,56,0.311,-33,89,48,35,H1
"Bosque County, TX",2006-2007,18046,18077,31,0.172,-44,75,48,35,H1
"Bosque County, TX",2007-2008,18077,17939,-138,-0.763,-34,-104,48,35,H1
"Bosque County, TX",2008-2009,17939,18004,65,0.362,-17,82,48,35,H1
"Bosque County, TX",2009-2010,18004,18258,254,1.411,-14,268,48,35,H1
"Bosque County, TX",2010-2011,18258,18247,-11,-0.06,-77,66,48,35,H1
"Bosque County, TX",2011-2012,18247,18111,-136,-0.745,-61,-75,48,35,H1
"Bosque County, TX",2012-2013,18111,17862,-249,-1.375,-42,-207,48,35,H1
"Bosque County, TX",2013-2014,17862,17780,-82,-0.459,-32,-50,48,35,H1
"Bosque County, TX",2014-2015,17734,17891,157,0.885,-25,182,48,35,H1
"Bosque County, TX",2015-2016,17891,18010,119,0.665,-54,173,48,35,H1
"Bosque County, TX",2016-2017,18010,18326,316,1.755,-39,355,48,35,H1
"Bowie County, TX",2000-2001,89156,88942,-214,-0.24,155,-369,48,37,H1
"Bowie County, TX",2001-2002,88942,88813,-129,-0.145,141,-270,48,37,H1
"Bowie County, TX",2002-2003,88813,88839,26,0.029,123,-97,48,37,H1
"Bowie County, TX",2003-2004,88839,89055,216,0.243,127,89,48,37,H1
"Bowie County, TX",2004-2005,89055,89239,184,0.207,142,42,48,37,H1
"Bowie County, TX",2005-2006,89239,90235,996,1.116,332,664,48,37,H1
"Bowie County, TX",2006-2007,90235,90456,221,0.245,382,-161,48,37,H1
"Bowie County, TX",2007-2008,90456,91349,893,0.987,268,625,48,37,H1
"Bowie County, TX",2008-2009,91349,92231,882,0.966,247,635,48,37,H1
"Bowie County, TX",2009-2010,92231,92656,425,0.461,195,230,48,37,H1
"Bowie County, TX",2010-2011,92656,92879,223,0.241,238,-15,48,37,H1
"Bowie County, TX",2011-2012,92879,93088,209,0.225,301,-92,48,37,H1
"Bowie County, TX",2012-2013,93088,93442,354,0.38,204,150,48,37,H1
"Bowie County, TX",2013-2014,93442,93275,-167,-0.179,277,-444,48,37,H1
"Bowie County, TX",2014-2015,93298,93389,91,0.098,230,-139,48,37,H1
"Bowie County, TX",2015-2016,93389,93881,492,0.527,264,228,48,37,H1
"Bowie County, TX",2016-2017,93881,94012,131,0.14,263,-132,48,37,H1
"Brazoria County, TX",2000-2001,243116,248280,5164,2.124,2512,2652,48,39,H1
"Brazoria County, TX",2001-2002,248280,255246,6966,2.806,2389,4577,48,39,H1
"Brazoria County, TX",2002-2003,255246,261269,6023,2.36,2641,3382,48,39,H1
"Brazoria County, TX",2003-2004,261269,268051,6782,2.596,2605,4177,48,39,H1
"Brazoria County, TX",2004-2005,268051,274336,6285,2.345,2515,3770,48,39,H1
"Brazoria County, TX",2005-2006,274336,284248,9912,3.613,2764,7148,48,39,H1
"Brazoria County, TX",2006-2007,284248,293296,9048,3.183,2893,6155,48,39,H1
"Brazoria County, TX",2007-2008,293296,301336,8040,2.741,2989,5051,48,39,H1
"Brazoria County, TX",2008-2009,301336,309236,7900,2.622,2972,4928,48,39,H1
"Brazoria County, TX",2009-2010,309236,314452,5216,1.687,2715,2501,48,39,H1
"Brazoria County, TX",2010-2011,314452,319444,4992,1.588,2733,2259,48,39,H1
"Brazoria County, TX",2011-2012,319444,324697,5253,1.644,2546,2707,48,39,H1
"Brazoria County, TX",2012-2013,324697,330670,5973,1.84,2404,3569,48,39,H1
"Brazoria County, TX",2013-2014,330670,338124,7454,2.254,2484,4970,48,39,H1
"Brazoria County, TX",2014-2015,338176,346312,8136,2.406,2635,5501,48,39,H1
"Brazoria County, TX",2015-2016,346312,353828,7516,2.17,2502,5014,48,39,H1
"Brazoria County, TX",2016-2017,353828,362457,8629,2.439,2523,6106,48,39,H1
"Brazos County, TX",2000-2001,153145,155533,2388,1.559,1454,934,48,41,H1
"Brazos County, TX",2001-2002,155533,159297,3764,2.42,1495,2269,48,41,H1
"Brazos County, TX",2002-2003,159297,163279,3982,2.5,1522,2460,48,41,H1
"Brazos County, TX",2003-2004,163279,166150,2871,1.758,1522,1349,48,41,H1
"Brazos County, TX",2004-2005,166150,169824,3674,2.211,1653,2021,48,41,H1
"Brazos County, TX",2005-2006,169824,175433,5609,3.303,1637,3972,48,41,H1
"Brazos County, TX",2006-2007,175433,179472,4039,2.302,1811,2228,48,41,H1
"Brazos County, TX",2007-2008,179472,185098,5626,3.135,1962,3664,48,41,H1
"Brazos County, TX",2008-2009,185098,191434,6336,3.423,1793,4543,48,41,H1
"Brazos County, TX",2009-2010,191434,195680,4246,2.218,1839,2407,48,41,H1
"Brazos County, TX",2010-2011,195680,197649,1969,1.006,1788,181,48,41,H1
"Brazos County, TX",2011-2012,197649,200567,2918,1.476,1720,1198,48,41,H1
"Brazos County, TX",2012-2013,200567,204621,4054,2.021,1694,2360,48,41,H1
"Brazos County, TX",2013-2014,204621,209152,4531,2.214,1661,2870,48,41,H1
"Brazos County, TX",2014-2015,209201,215037,5836,2.79,1748,4088,48,41,H1
"Brazos County, TX",2015-2016,215037,219561,4524,2.104,1855,2669,48,41,H1
"Brazos County, TX",2016-2017,219561,222830,3269,1.489,1871,1398,48,41,H1
"Brewster County, TX",2000-2001,8903,8836,-67,-0.753,35,-102,48,43,H1
"Brewster County, TX",2001-2002,8836,8945,109,1.234,31,78,48,43,H1
"Brewster County, TX",2002-2003,8945,9030,85,0.95,61,24,48,43,H1
"Brewster County, TX",2003-2004,9030,9002,-28,-0.31,50,-78,48,43,H1
"Brewster County, TX",2004-2005,9002,8830,-172,-1.911,50,-222,48,43,H1
"Brewster County, TX",2005-2006,8830,8790,-40,-0.453,41,-81,48,43,H1
"Brewster County, TX",2006-2007,8790,8843,53,0.603,48,5,48,43,H1
"Brewster County, TX",2007-2008,8843,8868,25,0.283,64,-39,48,43,H1
"Brewster County, TX",2008-2009,8868,9054,186,2.097,51,135,48,43,H1
"Brewster County, TX",2009-2010,9054,9275,221,2.441,60,161,48,43,H1
"Brewster County, TX",2010-2011,9275,9359,84,0.906,48,36,48,43,H1
"Brewster County, TX",2011-2012,9359,9254,-105,-1.122,31,-136,48,43,H1
"Brewster County, TX",2012-2013,9254,9289,35,0.378,63,-28,48,43,H1
"Brewster County, TX",2013-2014,9289,9173,-116,-1.249,64,-180,48,43,H1
"Brewster County, TX",2014-2015,9148,9145,-3,-0.033,54,-57,48,43,H1
"Brewster County, TX",2015-2016,9145,9193,48,0.525,13,35,48,43,H1
"Brewster County, TX",2016-2017,9193,9337,144,1.566,23,121,48,43,H1
"Briscoe County, TX",2000-2001,1796,1764,-32,-1.782,14,-46,48,45,H1
"Briscoe County, TX",2001-2002,1764,1746,-18,-1.02,-5,-13,48,45,H1
"Briscoe County, TX",2002-2003,1746,1763,17,0.974,5,12,48,45,H1
"Briscoe County, TX",2003-2004,1763,1768,5,0.284,-2,7,48,45,H1
"Briscoe County, TX",2004-2005,1768,1726,-42,-2.376,-8,-34,48,45,H1
"Briscoe County, TX",2005-2006,1726,1704,-22,-1.275,4,-26,48,45,H1
"Briscoe County, TX",2006-2007,1704,1647,-57,-3.345,4,-61,48,45,H1
"Briscoe County, TX",2007-2008,1647,1651,4,0.243,-4,8,48,45,H1
"Briscoe County, TX",2008-2009,1651,1634,-17,-1.03,-4,-13,48,45,H1
"Briscoe County, TX",2009-2010,1634,1626,-8,-0.49,2,-10,48,45,H1
"Briscoe County, TX",2010-2011,1626,1643,17,1.046,-2,19,48,45,H1
"Briscoe County, TX",2011-2012,1643,1560,-83,-5.052,-1,-82,48,45,H1
"Briscoe County, TX",2012-2013,1560,1544,-16,-1.026,-4,-12,48,45,H1
"Briscoe County, TX",2013-2014,1544,1536,-8,-0.518,1,-9,48,45,H1
"Briscoe County, TX",2014-2015,1535,1505,-30,-1.954,2,-32,48,45,H1
"Briscoe County, TX",2015-2016,1505,1486,-19,-1.262,-8,-11,48,45,H1
"Briscoe County, TX",2016-2017,1486,1528,42,2.826,3,39,48,45,H1
"Brooks County, TX",2000-2001,7944,7669,-275,-3.462,51,-326,48,47,H1
"Brooks County, TX",2001-2002,7669,7668,-1,-0.013,53,-54,48,47,H1
"Brooks County, TX",2002-2003,7668,7627,-41,-0.535,63,-104,48,47,H1
"Brooks County, TX",2003-2004,7627,7593,-34,-0.446,78,-112,48,47,H1
"Brooks County, TX",2004-2005,7593,7562,-31,-0.408,68,-99,48,47,H1
"Brooks County, TX",2005-2006,7562,7490,-72,-0.952,71,-143,48,47,H1
"Brooks County, TX",2006-2007,7490,7413,-77,-1.028,72,-149,48,47,H1
"Brooks County, TX",2007-2008,7413,7345,-68,-0.917,57,-125,48,47,H1
"Brooks County, TX",2008-2009,7345,7297,-48,-0.654,84,-132,48,47,H1
"Brooks County, TX",2009-2010,7297,7210,-87,-1.192,76,-163,48,47,H1
"Brooks County, TX",2010-2011,7210,7213,3,0.042,60,-57,48,47,H1
"Brooks County, TX",2011-2012,7213,7168,-45,-0.624,52,-97,48,47,H1
"Brooks County, TX",2012-2013,7168,7215,47,0.656,24,23,48,47,H1
"Brooks County, TX",2013-2014,7215,7194,-21,-0.291,38,-59,48,47,H1
"Brooks County, TX",2014-2015,7242,7230,-12,-0.166,58,-70,48,47,H1
"Brooks County, TX",2015-2016,7230,7263,33,0.456,47,-14,48,47,H1
"Brooks County, TX",2016-2017,7263,7235,-28,-0.386,39,-67,48,47,H1
"Brown County, TX",2000-2001,37689,37599,-90,-0.239,23,-113,48,49,H1
"Brown County, TX",2001-2002,37599,37766,167,0.444,18,149,48,49,H1
"Brown County, TX",2002-2003,37766,37654,-112,-0.297,-35,-77,48,49,H1
"Brown County, TX",2003-2004,37654,37940,286,0.76,78,208,48,49,H1
"Brown County, TX",2004-2005,37940,38172,232,0.611,-12,244,48,49,H1
"Brown County, TX",2005-2006,38172,38492,320,0.838,34,286,48,49,H1
"Brown County, TX",2006-2007,38492,38221,-271,-0.704,52,-323,48,49,H1
"Brown County, TX",2007-2008,38221,38135,-86,-0.225,-29,-57,48,49,H1
"Brown County, TX",2008-2009,38135,38001,-134,-0.351,12,-146,48,49,H1
"Brown County, TX",2009-2010,38001,38097,96,0.253,0,96,48,49,H1
"Brown County, TX",2010-2011,38097,38001,-96,-0.252,-41,-55,48,49,H1
"Brown County, TX",2011-2012,38001,37857,-144,-0.379,-40,-104,48,49,H1
"Brown County, TX",2012-2013,37857,37908,51,0.135,-38,89,48,49,H1
"Brown County, TX",2013-2014,37908,37653,-255,-0.673,-26,-229,48,49,H1
"Brown County, TX",2014-2015,37625,37896,271,0.72,-14,285,48,49,H1
"Brown County, TX",2015-2016,37896,38065,169,0.446,-64,233,48,49,H1
"Brown County, TX",2016-2017,38065,38053,-12,-0.032,-49,37,48,49,H1
"Burleson County, TX",2000-2001,16553,16650,97,0.586,59,38,48,51,H1
"Burleson County, TX",2001-2002,16650,16666,16,0.096,62,-46,48,51,H1
"Burleson County, TX",2002-2003,16666,16881,215,1.29,42,173,48,51,H1
"Burleson County, TX",2003-2004,16881,16964,83,0.492,78,5,48,51,H1
"Burleson County, TX",2004-2005,16964,17167,203,1.197,80,123,48,51,H1
"Burleson County, TX",2005-2006,17167,1.70E+04,-167,-0.973,52,-219,48,51,H1
"Burleson County, TX",2006-2007,1.70E+04,16982,-18,-0.106,73,-91,48,51,H1
"Burleson County, TX",2007-2008,16982,17025,43,0.253,53,-10,48,51,H1
"Burleson County, TX",2008-2009,17025,17076,51,0.3,72,-21,48,51,H1
"Burleson County, TX",2009-2010,17076,17210,134,0.785,44,90,48,51,H1
"Burleson County, TX",2010-2011,17210,17236,26,0.151,-9,35,48,51,H1
"Burleson County, TX",2011-2012,17236,17316,80,0.464,-1,81,48,51,H1
"Burleson County, TX",2012-2013,17316,17163,-153,-0.884,0,-153,48,51,H1
"Burleson County, TX",2013-2014,17163,17253,90,0.524,5,85,48,51,H1
"Burleson County, TX",2014-2015,17270,17460,190,1.1,-10,200,48,51,H1
"Burleson County, TX",2015-2016,17460,17811,351,2.01,0,351,48,51,H1
"Burleson County, TX",2016-2017,17811,18011,200,1.123,2,198,48,51,H1
"Burnet County, TX",2000-2001,34505,35741,1236,3.582,97,1139,48,53,H1
"Burnet County, TX",2001-2002,35741,36850,1109,3.103,99,1010,48,53,H1
"Burnet County, TX",2002-2003,36850,37776,926,2.513,50,876,48,53,H1
"Burnet County, TX",2003-2004,37776,38966,1190,3.15,84,1106,48,53,H1
"Burnet County, TX",2004-2005,38966,39798,832,2.135,92,740,48,53,H1
"Burnet County, TX",2005-2006,39798,41109,1311,3.294,115,1196,48,53,H1
"Burnet County, TX",2006-2007,41109,42026,917,2.231,92,825,48,53,H1
"Burnet County, TX",2007-2008,42026,42477,451,1.073,123,328,48,53,H1
"Burnet County, TX",2008-2009,42477,42611,134,0.315,61,73,48,53,H1
"Burnet County, TX",2009-2010,42611,42789,178,0.418,-47,225,48,53,H1
"Burnet County, TX",2010-2011,42789,43366,577,1.348,24,553,48,53,H1
"Burnet County, TX",2011-2012,43366,44078,712,1.642,47,665,48,53,H1
"Burnet County, TX",2012-2013,44078,44380,302,0.685,53,249,48,53,H1
"Burnet County, TX",2013-2014,44380,44943,563,1.269,46,517,48,53,H1
"Burnet County, TX",2014-2015,44441,45463,1022,2.3,43,979,48,53,H1
"Burnet County, TX",2015-2016,45463,45914,451,0.992,60,391,48,53,H1
"Burnet County, TX",2016-2017,45914,46804,890,1.938,58,832,48,53,H1
"Caldwell County, TX",2000-2001,32378,33654,1276,3.941,235,1041,48,55,H1
"Caldwell County, TX",2001-2002,33654,34715,1061,3.153,206,855,48,55,H1
"Caldwell County, TX",2002-2003,34715,35330,615,1.772,277,338,48,55,H1
"Caldwell County, TX",2003-2004,35330,36200,870,2.462,240,630,48,55,H1
"Caldwell County, TX",2004-2005,36200,36388,188,0.519,293,-105,48,55,H1
"Caldwell County, TX",2005-2006,36388,36533,145,0.398,248,-103,48,55,H1
"Caldwell County, TX",2006-2007,36533,36906,373,1.021,197,176,48,55,H1
"Caldwell County, TX",2007-2008,36906,37671,765,2.073,289,476,48,55,H1
"Caldwell County, TX",2008-2009,37671,37829,158,0.419,262,-104,48,55,H1
"Caldwell County, TX",2009-2010,37829,38116,287,0.759,214,73,48,55,H1
"Caldwell County, TX",2010-2011,38116,38467,351,0.921,204,147,48,55,H1
"Caldwell County, TX",2011-2012,38467,38711,244,0.634,155,89,48,55,H1
"Caldwell County, TX",2012-2013,38711,39248,537,1.387,198,339,48,55,H1
"Caldwell County, TX",2013-2014,39248,39810,562,1.432,181,381,48,55,H1
"Caldwell County, TX",2014-2015,39797,40522,725,1.822,191,534,48,55,H1
"Caldwell County, TX",2015-2016,40522,41108,586,1.446,246,340,48,55,H1
"Caldwell County, TX",2016-2017,41108,42338,1230,2.992,249,981,48,55,H1
"Calhoun County, TX",2000-2001,20676,20762,86,0.416,155,-69,48,57,H1
"Calhoun County, TX",2001-2002,20762,20550,-212,-1.021,153,-365,48,57,H1
"Calhoun County, TX",2002-2003,20550,20575,25,0.122,161,-136,48,57,H1
"Calhoun County, TX",2003-2004,20575,20692,117,0.569,137,-20,48,57,H1
"Calhoun County, TX",2004-2005,20692,20715,23,0.111,65,-42,48,57,H1
"Calhoun County, TX",2005-2006,20715,20839,124,0.599,93,31,48,57,H1
"Calhoun County, TX",2006-2007,20839,20888,49,0.235,115,-66,48,57,H1
"Calhoun County, TX",2007-2008,20888,21127,239,1.144,120,119,48,57,H1
"Calhoun County, TX",2008-2009,21127,21388,261,1.235,131,130,48,57,H1
"Calhoun County, TX",2009-2010,21388,21336,-52,-0.243,125,-177,48,57,H1
"Calhoun County, TX",2010-2011,21336,21359,23,0.108,82,-59,48,57,H1
"Calhoun County, TX",2011-2012,21359,21567,208,0.974,67,141,48,57,H1
"Calhoun County, TX",2012-2013,21567,21785,218,1.011,109,109,48,57,H1
"Calhoun County, TX",2013-2014,21785,21797,12,0.055,75,-63,48,57,H1
"Calhoun County, TX",2014-2015,21791,21895,104,0.477,95,9,48,57,H1
"Calhoun County, TX",2015-2016,21895,21942,47,0.215,116,-69,48,57,H1
"Calhoun County, TX",2016-2017,21942,21744,-198,-0.902,89,-287,48,57,H1
"Callahan County, TX",2000-2001,12885,12703,-182,-1.412,-14,-168,48,59,H1
"Callahan County, TX",2001-2002,12703,12799,96,0.756,-6,102,48,59,H1
"Callahan County, TX",2002-2003,12799,12913,114,0.891,-26,140,48,59,H1
"Callahan County, TX",2003-2004,12913,13156,243,1.882,-7,250,48,59,H1
"Callahan County, TX",2004-2005,13156,13281,125,0.95,-3,128,48,59,H1
"Callahan County, TX",2005-2006,13281,13309,28,0.211,18,10,48,59,H1
"Callahan County, TX",2006-2007,13309,13418,109,0.819,-6,115,48,59,H1
"Callahan County, TX",2007-2008,13418,13474,56,0.417,-10,66,48,59,H1
"Callahan County, TX",2008-2009,13474,13548,74,0.549,23,51,48,59,H1
"Callahan County, TX",2009-2010,13548,13516,-32,-0.236,21,-53,48,59,H1
"Callahan County, TX",2010-2011,13516,13534,18,0.133,-38,56,48,59,H1
"Callahan County, TX",2011-2012,13534,13515,-19,-0.14,-20,1,48,59,H1
"Callahan County, TX",2012-2013,13515,13518,3,0.022,-39,42,48,59,H1
"Callahan County, TX",2013-2014,13518,13513,-5,-0.037,-37,32,48,59,H1
"Callahan County, TX",2014-2015,13520,13557,37,0.274,-45,82,48,59,H1
"Callahan County, TX",2015-2016,13557,13777,220,1.623,-41,261,48,59,H1
"Callahan County, TX",2016-2017,13777,13946,169,1.227,-24,193,48,59,H1
"Cameron County, TX",2000-2001,336123,342368,6245,1.858,6487,-242,48,61,H1
"Cameron County, TX",2001-2002,342368,350194,7826,2.286,6318,1508,48,61,H1
"Cameron County, TX",2002-2003,350194,358492,8298,2.37,6688,1610,48,61,H1
"Cameron County, TX",2003-2004,358492,366299,7807,2.178,6605,1202,48,61,H1
"Cameron County, TX",2004-2005,366299,373429,7130,1.946,6724,406,48,61,H1
"Cameron County, TX",2005-2006,373429,380169,6740,1.805,6563,177,48,61,H1
"Cameron County, TX",2006-2007,380169,386306,6137,1.614,6454,-317,48,61,H1
"Cameron County, TX",2007-2008,386306,3.93E+05,6694,1.733,6493,201,48,61,H1
"Cameron County, TX",2008-2009,3.93E+05,400303,7303,1.858,6646,657,48,61,H1
"Cameron County, TX",2009-2010,400303,407672,7369,1.841,6128,1241,48,61,H1
"Cameron County, TX",2010-2011,407672,413188,5516,1.353,5492,24,48,61,H1
"Cameron County, TX",2011-2012,413188,416048,2860,0.692,4993,-2133,48,61,H1
"Cameron County, TX",2012-2013,416048,418217,2169,0.521,4878,-2709,48,61,H1
"Cameron County, TX",2013-2014,418217,420392,2175,0.52,4772,-2597,48,61,H1
"Cameron County, TX",2014-2015,420400,422156,1756,0.418,4847,-3091,48,61,H1
"Cameron County, TX",2015-2016,422156,421766,-390,-0.092,4402,-4792,48,61,H1
"Cameron County, TX",2016-2017,421766,423725,1959,0.464,4308,-2349,48,61,H1
"Camp County, TX",2000-2001,11568,11399,-169,-1.461,12,-181,48,63,H1
"Camp County, TX",2001-2002,11399,11549,150,1.316,47,103,48,63,H1
"Camp County, TX",2002-2003,11549,11582,33,0.286,60,-27,48,63,H1
"Camp County, TX",2003-2004,11582,11715,133,1.148,48,85,48,63,H1
"Camp County, TX",2004-2005,11715,11990,275,2.347,77,198,48,63,H1
"Camp County, TX",2005-2006,11990,12068,78,0.651,64,14,48,63,H1
"Camp County, TX",2006-2007,12068,12253,185,1.533,70,115,48,63,H1
"Camp County, TX",2007-2008,12253,12331,78,0.637,79,-1,48,63,H1
"Camp County, TX",2008-2009,12331,12364,33,0.268,89,-56,48,63,H1
"Camp County, TX",2009-2010,12364,12404,40,0.324,91,-51,48,63,H1
"Camp County, TX",2010-2011,12404,12408,4,0.032,38,-34,48,63,H1
"Camp County, TX",2011-2012,12408,12460,52,0.419,2,50,48,63,H1
"Camp County, TX",2012-2013,12460,12422,-38,-0.305,80,-118,48,63,H1
"Camp County, TX",2013-2014,12422,12621,199,1.602,76,123,48,63,H1
"Camp County, TX",2014-2015,12617,12682,65,0.515,104,-39,48,63,H1
"Camp County, TX",2015-2016,12682,12775,93,0.733,47,46,48,63,H1
"Camp County, TX",2016-2017,12775,12855,80,0.626,44,36,48,63,H1
"Carson County, TX",2000-2001,6492,6385,-107,-1.648,25,-132,48,65,H1
"Carson County, TX",2001-2002,6385,6508,123,1.926,3,120,48,65,H1
"Carson County, TX",2002-2003,6508,6391,-117,-1.798,10,-127,48,65,H1
"Carson County, TX",2003-2004,6391,6381,-10,-0.156,19,-29,48,65,H1
"Carson County, TX",2004-2005,6381,6449,68,1.066,10,58,48,65,H1
"Carson County, TX",2005-2006,6449,6413,-36,-0.558,2,-38,48,65,H1
"Carson County, TX",2006-2007,6413,6361,-52,-0.811,-7,-45,48,65,H1
"Carson County, TX",2007-2008,6361,6260,-101,-1.588,14,-115,48,65,H1
"Carson County, TX",2008-2009,6260,6220,-40,-0.639,10,-50,48,65,H1
"Carson County, TX",2009-2010,6220,6164,-56,-0.9,4,-60,48,65,H1
"Carson County, TX",2010-2011,6164,6270,106,1.72,-3,109,48,65,H1
"Carson County, TX",2011-2012,6270,6109,-161,-2.568,-23,-138,48,65,H1
"Carson County, TX",2012-2013,6109,5986,-123,-2.013,10,-133,48,65,H1
"Carson County, TX",2013-2014,5986,6013,27,0.451,-7,34,48,65,H1
"Carson County, TX",2014-2015,6007,5969,-38,-0.633,-5,-33,48,65,H1
"Carson County, TX",2015-2016,5969,6107,138,2.312,13,125,48,65,H1
"Carson County, TX",2016-2017,6107,6032,-75,-1.228,8,-83,48,65,H1
"Cass County, TX",2000-2001,30412,30134,-278,-0.914,-60,-218,48,67,H1
"Cass County, TX",2001-2002,30134,30120,-14,-0.046,-52,38,48,67,H1
"Cass County, TX",2002-2003,30120,30065,-55,-0.183,-7,-48,48,67,H1
"Cass County, TX",2003-2004,30065,30053,-12,-0.04,-44,32,48,67,H1
"Cass County, TX",2004-2005,30053,30088,35,0.116,-102,137,48,67,H1
"Cass County, TX",2005-2006,30088,30095,7,0.023,-18,25,48,67,H1
"Cass County, TX",2006-2007,30095,30176,81,0.269,11,70,48,67,H1
"Cass County, TX",2007-2008,30176,30217,41,0.136,-62,103,48,67,H1
"Cass County, TX",2008-2009,30217,30297,80,0.265,-54,134,48,67,H1
"Cass County, TX",2009-2010,30297,30432,135,0.446,-50,185,48,67,H1
"Cass County, TX",2010-2011,30432,30503,71,0.233,-45,116,48,67,H1
"Cass County, TX",2011-2012,30503,30187,-316,-1.036,-46,-270,48,67,H1
"Cass County, TX",2012-2013,30187,30369,182,0.603,-54,236,48,67,H1
"Cass County, TX",2013-2014,30369,30261,-108,-0.356,-57,-51,48,67,H1
"Cass County, TX",2014-2015,30274,30313,39,0.129,-39,78,48,67,H1
"Cass County, TX",2015-2016,30313,30080,-233,-0.769,-65,-168,48,67,H1
"Cass County, TX",2016-2017,30080,30012,-68,-0.226,-84,16,48,67,H1
"Castro County, TX",2000-2001,8229,8155,-74,-0.899,76,-150,48,69,H1
"Castro County, TX",2001-2002,8155,8083,-72,-0.883,49,-121,48,69,H1
"Castro County, TX",2002-2003,8083,8037,-46,-0.569,51,-97,48,69,H1
"Castro County, TX",2003-2004,8037,7947,-90,-1.12,81,-171,48,69,H1
"Castro County, TX",2004-2005,7947,7908,-39,-0.491,78,-117,48,69,H1
"Castro County, TX",2005-2006,7908,7780,-128,-1.619,70,-198,48,69,H1
"Castro County, TX",2006-2007,7780,7737,-43,-0.553,65,-108,48,69,H1
"Castro County, TX",2007-2008,7737,7758,21,0.271,84,-63,48,69,H1
"Castro County, TX",2008-2009,7758,7856,98,1.263,69,29,48,69,H1
"Castro County, TX",2009-2010,7856,8111,255,3.246,77,178,48,69,H1
"Castro County, TX",2010-2011,8111,8048,-63,-0.777,83,-146,48,69,H1
"Castro County, TX",2011-2012,8048,8179,131,1.628,90,41,48,69,H1
"Castro County, TX",2012-2013,8179,8012,-167,-2.042,71,-238,48,69,H1
"Castro County, TX",2013-2014,8012,7781,-231,-2.883,79,-310,48,69,H1
"Castro County, TX",2014-2015,7805,7656,-149,-1.909,65,-214,48,69,H1
"Castro County, TX",2015-2016,7656,7823,167,2.181,65,102,48,69,H1
"Castro County, TX",2016-2017,7823,7843,20,0.256,82,-62,48,69,H1
"Chambers County, TX",2000-2001,26188,26811,623,2.379,99,524,48,71,H1
"Chambers County, TX",2001-2002,26811,27490,679,2.533,119,560,48,71,H1
"Chambers County, TX",2002-2003,27490,28021,531,1.932,164,367,48,71,H1
"Chambers County, TX",2003-2004,28021,28749,728,2.598,137,591,48,71,H1
"Chambers County, TX",2004-2005,28749,29388,639,2.223,153,486,48,71,H1
"Chambers County, TX",2005-2006,29388,29980,592,2.014,216,376,48,71,H1
"Chambers County, TX",2006-2007,29980,30714,734,2.448,262,472,48,71,H1
"Chambers County, TX",2007-2008,30714,31619,905,2.947,198,707,48,71,H1
"Chambers County, TX",2008-2009,31619,34230,2611,8.258,192,2419,48,71,H1
"Chambers County, TX",2009-2010,34230,35406,1176,3.436,209,967,48,71,H1
"Chambers County, TX",2010-2011,35406,35597,191,0.539,233,-42,48,71,H1
"Chambers County, TX",2011-2012,35597,36388,791,2.222,183,608,48,71,H1
"Chambers County, TX",2012-2013,36388,37215,827,2.273,214,613,48,71,H1
"Chambers County, TX",2013-2014,37215,38145,930,2.499,244,686,48,71,H1
"Chambers County, TX",2014-2015,38132,38863,731,1.917,262,469,48,71,H1
"Chambers County, TX",2015-2016,38863,40283,1420,3.654,285,1135,48,71,H1
"Chambers County, TX",2016-2017,40283,41441,1158,2.875,279,879,48,71,H1
"Cherokee County, TX",2000-2001,46790,47007,217,0.464,157,60,48,73,H1
"Cherokee County, TX",2001-2002,47007,47136,129,0.274,201,-72,48,73,H1
"Cherokee County, TX",2002-2003,47136,47832,696,1.477,214,482,48,73,H1
"Cherokee County, TX",2003-2004,47832,48315,483,1.01,203,280,48,73,H1
"Cherokee County, TX",2004-2005,48315,48751,436,0.902,260,176,48,73,H1
"Cherokee County, TX",2005-2006,48751,49162,411,0.843,296,115,48,73,H1
"Cherokee County, TX",2006-2007,49162,49669,507,1.031,283,224,48,73,H1
"Cherokee County, TX",2007-2008,49669,49976,307,0.618,264,43,48,73,H1
"Cherokee County, TX",2008-2009,49976,50447,471,0.942,236,235,48,73,H1
"Cherokee County, TX",2009-2010,50447,50872,425,0.842,281,144,48,73,H1
"Cherokee County, TX",2010-2011,50872,50965,93,0.183,238,-145,48,73,H1
"Cherokee County, TX",2011-2012,50965,51152,187,0.367,229,-42,48,73,H1
"Cherokee County, TX",2012-2013,51152,50965,-187,-0.366,239,-426,48,73,H1
"Cherokee County, TX",2013-2014,50965,50902,-63,-0.124,238,-301,48,73,H1
"Cherokee County, TX",2014-2015,51052,51542,490,0.96,270,220,48,73,H1
"Cherokee County, TX",2015-2016,51542,51896,354,0.687,228,126,48,73,H1
"Cherokee County, TX",2016-2017,51896,52240,344,0.663,254,90,48,73,H1
"Childress County, TX",2000-2001,7676,7531,-145,-1.889,-13,-132,48,75,H1
"Childress County, TX",2001-2002,7531,7428,-103,-1.368,-1,-102,48,75,H1
"Childress County, TX",2002-2003,7428,7411,-17,-0.229,-3,-14,48,75,H1
"Childress County, TX",2003-2004,7411,7366,-45,-0.607,23,-68,48,75,H1
"Childress County, TX",2004-2005,7366,7205,-161,-2.186,-6,-155,48,75,H1
"Childress County, TX",2005-2006,7205,7214,9,0.125,3,6,48,75,H1
"Childress County, TX",2006-2007,7214,7148,-66,-0.915,35,-101,48,75,H1
"Childress County, TX",2007-2008,7148,7123,-25,-0.35,10,-35,48,75,H1
"Childress County, TX",2008-2009,7123,7030,-93,-1.306,11,-104,48,75,H1
"Childress County, TX",2009-2010,7030,7064,34,0.484,-3,37,48,75,H1
"Childress County, TX",2010-2011,7064,7019,-45,-0.637,37,-82,48,75,H1
"Childress County, TX",2011-2012,7019,7096,77,1.097,-3,80,48,75,H1
"Childress County, TX",2012-2013,7096,7063,-33,-0.465,0,-33,48,75,H1
"Childress County, TX",2013-2014,7063,7089,26,0.368,7,19,48,75,H1
"Childress County, TX",2014-2015,7065,7088,23,0.326,1,22,48,75,H1
"Childress County, TX",2015-2016,7088,7095,7,0.099,17,-10,48,75,H1
"Childress County, TX",2016-2017,7095,7067,-28,-0.395,7,-35,48,75,H1
"Clay County, TX",2000-2001,11064,11131,67,0.606,-17,84,48,77,H1
"Clay County, TX",2001-2002,11131,11292,161,1.446,-12,173,48,77,H1
"Clay County, TX",2002-2003,11292,11270,-22,-0.195,-11,-11,48,77,H1
"Clay County, TX",2003-2004,11270,11278,8,0.071,6,2,48,77,H1
"Clay County, TX",2004-2005,11278,11317,39,0.346,-6,45,48,77,H1
"Clay County, TX",2005-2006,11317,11157,-160,-1.414,-17,-143,48,77,H1
"Clay County, TX",2006-2007,11157,11051,-106,-0.95,-8,-98,48,77,H1
"Clay County, TX",2007-2008,11051,10843,-208,-1.882,12,-220,48,77,H1
"Clay County, TX",2008-2009,10843,10832,-11,-0.101,-3,-8,48,77,H1
"Clay County, TX",2009-2010,10832,10734,-98,-0.905,-10,-88,48,77,H1
"Clay County, TX",2010-2011,10734,10682,-52,-0.484,-10,-42,48,77,H1
"Clay County, TX",2011-2012,10682,10512,-170,-1.591,-45,-125,48,77,H1
"Clay County, TX",2012-2013,10512,10436,-76,-0.723,-27,-49,48,77,H1
"Clay County, TX",2013-2014,10436,10370,-66,-0.632,-20,-46,48,77,H1
"Clay County, TX",2014-2015,10381,10360,-21,-0.202,-18,-3,48,77,H1
"Clay County, TX",2015-2016,10360,10242,-118,-1.139,-25,-93,48,77,H1
"Clay County, TX",2016-2017,10242,10421,179,1.748,-36,215,48,77,H1
"Cochran County, TX",2000-2001,3707,3674,-33,-0.89,6,-39,48,79,H1
"Cochran County, TX",2001-2002,3674,3521,-153,-4.164,14,-167,48,79,H1
"Cochran County, TX",2002-2003,3521,3490,-31,-0.88,23,-54,48,79,H1
"Cochran County, TX",2003-2004,3490,3373,-117,-3.352,22,-139,48,79,H1
"Cochran County, TX",2004-2005,3373,3338,-35,-1.038,16,-51,48,79,H1
"Cochran County, TX",2005-2006,3338,3257,-81,-2.427,16,-97,48,79,H1
"Cochran County, TX",2006-2007,3257,3194,-63,-1.934,37,-100,48,79,H1
"Cochran County, TX",2007-2008,3194,3100,-94,-2.943,37,-131,48,79,H1
"Cochran County, TX",2008-2009,3100,3086,-14,-0.452,42,-56,48,79,H1
"Cochran County, TX",2009-2010,3086,3139,53,1.717,36,17,48,79,H1
"Cochran County, TX",2010-2011,3139,3071,-68,-2.166,25,-93,48,79,H1
"Cochran County, TX",2011-2012,3071,3017,-54,-1.758,13,-67,48,79,H1
"Cochran County, TX",2012-2013,3017,2995,-22,-0.729,34,-56,48,79,H1
"Cochran County, TX",2013-2014,2995,2935,-60,-2.003,40,-100,48,79,H1
"Cochran County, TX",2014-2015,2923,2953,30,1.026,32,-2,48,79,H1
"Cochran County, TX",2015-2016,2953,2911,-42,-1.422,19,-61,48,79,H1
"Cochran County, TX",2016-2017,2911,2851,-60,-2.061,28,-88,48,79,H1
"Coke County, TX",2000-2001,3844,3810,-34,-0.884,-17,-17,48,81,H1
"Coke County, TX",2001-2002,3810,3732,-78,-2.047,-35,-43,48,81,H1
"Coke County, TX",2002-2003,3732,3678,-54,-1.447,-29,-25,48,81,H1
"Coke County, TX",2003-2004,3678,3559,-119,-3.235,-37,-82,48,81,H1
"Coke County, TX",2004-2005,3559,3540,-19,-0.534,-10,-9,48,81,H1
"Coke County, TX",2005-2006,3540,3492,-48,-1.356,-19,-29,48,81,H1
"Coke County, TX",2006-2007,3492,3375,-117,-3.351,-39,-78,48,81,H1
"Coke County, TX",2007-2008,3375,3348,-27,-0.8,-27,0,48,81,H1
"Coke County, TX",2008-2009,3348,3310,-38,-1.135,-18,-20,48,81,H1
"Coke County, TX",2009-2010,3310,3323,13,0.393,-21,34,48,81,H1
"Coke County, TX",2010-2011,3323,3285,-38,-1.144,-28,-10,48,81,H1
"Coke County, TX",2011-2012,3285,3224,-61,-1.857,-26,-35,48,81,H1
"Coke County, TX",2012-2013,3224,3215,-9,-0.279,-19,10,48,81,H1
"Coke County, TX",2013-2014,3215,3254,39,1.213,-16,55,48,81,H1
"Coke County, TX",2014-2015,3242,3238,-4,-0.123,-22,18,48,81,H1
"Coke County, TX",2015-2016,3238,3263,25,0.772,-7,32,48,81,H1
"Coke County, TX",2016-2017,3263,3306,43,1.318,-6,49,48,81,H1
"Coleman County, TX",2000-2001,9180,9103,-77,-0.839,-47,-30,48,83,H1
"Coleman County, TX",2001-2002,9103,8937,-166,-1.824,-59,-107,48,83,H1
"Coleman County, TX",2002-2003,8937,8827,-110,-1.231,-60,-50,48,83,H1
"Coleman County, TX",2003-2004,8827,8817,-10,-0.113,-40,30,48,83,H1
"Coleman County, TX",2004-2005,8817,8739,-78,-0.885,-38,-40,48,83,H1
"Coleman County, TX",2005-2006,8739,8853,114,1.304,-60,174,48,83,H1
"Coleman County, TX",2006-2007,8853,8774,-79,-0.892,-60,-19,48,83,H1
"Coleman County, TX",2007-2008,8774,8899,125,1.425,-44,169,48,83,H1
"Coleman County, TX",2008-2009,8899,8867,-32,-0.36,-37,5,48,83,H1
"Coleman County, TX",2009-2010,8867,8888,21,0.237,-46,67,48,83,H1
"Coleman County, TX",2010-2011,8888,8749,-139,-1.564,-12,-127,48,83,H1
"Coleman County, TX",2011-2012,8749,8675,-74,-0.846,-46,-28,48,83,H1
"Coleman County, TX",2012-2013,8675,8536,-139,-1.602,-13,-126,48,83,H1
"Coleman County, TX",2013-2014,8536,8430,-106,-1.242,-17,-89,48,83,H1
"Coleman County, TX",2014-2015,8413,8338,-75,-0.891,-30,-45,48,83,H1
"Coleman County, TX",2015-2016,8338,8421,83,0.995,-31,114,48,83,H1
"Coleman County, TX",2016-2017,8421,8430,9,0.107,-42,51,48,83,H1
"Collin County, TX",2000-2001,499118,534642,35524,7.117,7241,28283,48,85,H1
"Collin County, TX",2001-2002,534642,563565,28923,5.41,7435,21488,48,85,H1
"Collin County, TX",2002-2003,563565,589394,25829,4.583,7700,18129,48,85,H1
"Collin County, TX",2003-2004,589394,617802,28408,4.82,8146,20262,48,85,H1
"Collin County, TX",2004-2005,617802,647187,29385,4.756,8070,21315,48,85,H1
"Collin County, TX",2005-2006,647187,683935,36748,5.678,8376,28372,48,85,H1
"Collin County, TX",2006-2007,683935,714330,30395,4.444,8364,22031,48,85,H1
"Collin County, TX",2007-2008,714330,741264,26934,3.771,8612,18322,48,85,H1
"Collin County, TX",2008-2009,741264,765791,24527,3.309,8927,15600,48,85,H1
"Collin County, TX",2009-2010,765791,788568,22777,2.974,8018,14759,48,85,H1
"Collin County, TX",2010-2011,788568,814738,26170,3.319,7281,18889,48,85,H1
"Collin County, TX",2011-2012,814738,837476,22738,2.791,7035,15703,48,85,H1
"Collin County, TX",2012-2013,837476,858711,21235,2.536,6848,14387,48,85,H1
"Collin County, TX",2013-2014,858711,885241,26530,3.09,6732,19798,48,85,H1
"Collin County, TX",2014-2015,886052,914127,28075,3.169,6877,21198,48,85,H1
"Collin County, TX",2015-2016,914127,942453,28326,3.099,6928,21398,48,85,H1
"Collin County, TX",2016-2017,942453,969603,27150,2.881,6629,20521,48,85,H1
"Collingsworth County, TX",2000-2001,3193,3086,-107,-3.351,-15,-92,48,87,H1
"Collingsworth County, TX",2001-2002,3086,3093,7,0.227,-13,20,48,87,H1
"Collingsworth County, TX",2002-2003,3093,3026,-67,-2.166,-16,-51,48,87,H1
"Collingsworth County, TX",2003-2004,3026,3028,2,0.066,-12,14,48,87,H1
"Collingsworth County, TX",2004-2005,3028,2980,-48,-1.585,0,-48,48,87,H1
"Collingsworth County, TX",2005-2006,2980,2952,-28,-0.94,4,-32,48,87,H1
"Collingsworth County, TX",2006-2007,2952,2973,21,0.711,10,11,48,87,H1
"Collingsworth County, TX",2007-2008,2973,3017,44,1.48,27,17,48,87,H1
"Collingsworth County, TX",2008-2009,3017,3042,25,0.829,26,-1,48,87,H1
"Collingsworth County, TX",2009-2010,3042,3052,10,0.329,22,-12,48,87,H1
"Collingsworth County, TX",2010-2011,3052,3090,38,1.245,3,35,48,87,H1
"Collingsworth County, TX",2011-2012,3090,3020,-70,-2.265,15,-85,48,87,H1
"Collingsworth County, TX",2012-2013,3020,3087,67,2.219,6,61,48,87,H1
"Collingsworth County, TX",2013-2014,3087,3017,-70,-2.268,17,-87,48,87,H1
"Collingsworth County, TX",2014-2015,3024,3044,20,0.661,14,6,48,87,H1
"Collingsworth County, TX",2015-2016,3044,3028,-16,-0.526,7,-23,48,87,H1
"Collingsworth County, TX",2016-2017,3028,2987,-41,-1.354,2,-43,48,87,H1
"Colorado County, TX",2000-2001,20326,20125,-201,-0.989,-20,-181,48,89,H1
"Colorado County, TX",2001-2002,20125,20328,203,1.009,-1,204,48,89,H1
"Colorado County, TX",2002-2003,20328,20507,179,0.881,39,140,48,89,H1
"Colorado County, TX",2003-2004,20507,20450,-57,-0.278,-8,-49,48,89,H1
"Colorado County, TX",2004-2005,20450,20493,43,0.21,19,24,48,89,H1
"Colorado County, TX",2005-2006,20493,20608,115,0.561,40,75,48,89,H1
"Colorado County, TX",2006-2007,20608,20648,40,0.194,60,-20,48,89,H1
"Colorado County, TX",2007-2008,20648,20818,170,0.823,47,123,48,89,H1
"Colorado County, TX",2008-2009,20818,20784,-34,-0.163,74,-108,48,89,H1
"Colorado County, TX",2009-2010,20784,20877,93,0.447,60,33,48,89,H1
"Colorado County, TX",2010-2011,20877,20799,-78,-0.374,8,-86,48,89,H1
"Colorado County, TX",2011-2012,20799,20685,-114,-0.548,-50,-64,48,89,H1
"Colorado County, TX",2012-2013,20685,20776,91,0.44,-16,107,48,89,H1
"Colorado County, TX",2013-2014,20776,20719,-57,-0.274,-16,-41,48,89,H1
"Colorado County, TX",2014-2015,20675,20870,195,0.943,-4,199,48,89,H1
"Colorado County, TX",2015-2016,20870,21027,157,0.752,18,139,48,89,H1
"Colorado County, TX",2016-2017,21027,21232,205,0.975,-3,208,48,89,H1
"Comal County, TX",2000-2001,78583,80630,2047,2.605,423,1624,48,91,H1
"Comal County, TX",2001-2002,80630,82797,2167,2.688,364,1803,48,91,H1
"Comal County, TX",2002-2003,82797,84837,2040,2.464,395,1645,48,91,H1
"Comal County, TX",2003-2004,84837,88119,3282,3.869,498,2784,48,91,H1
"Comal County, TX",2004-2005,88119,91018,2899,3.29,373,2526,48,91,H1
"Comal County, TX",2005-2006,91018,95637,4619,5.075,431,4188,48,91,H1
"Comal County, TX",2006-2007,95637,99540,3903,4.081,517,3386,48,91,H1
"Comal County, TX",2007-2008,99540,103272,3732,3.749,615,3117,48,91,H1
"Comal County, TX",2008-2009,103272,106350,3078,2.98,731,2347,48,91,H1
"Comal County, TX",2009-2010,106350,109284,2934,2.759,421,2513,48,91,H1
"Comal County, TX",2010-2011,109284,112076,2792,2.555,271,2521,48,91,H1
"Comal County, TX",2011-2012,112076,115097,3021,2.695,260,2761,48,91,H1
"Comal County, TX",2012-2013,115097,118891,3794,3.296,310,3484,48,91,H1
"Comal County, TX",2013-2014,118891,123694,4803,4.04,447,4356,48,91,H1
"Comal County, TX",2014-2015,123439,129048,5609,4.544,521,5088,48,91,H1
"Comal County, TX",2015-2016,129048,134142,5094,3.947,430,4664,48,91,H1
"Comal County, TX",2016-2017,134142,141009,6867,5.119,507,6360,48,91,H1
"Comanche County, TX",2000-2001,13998,13710,-288,-2.057,-72,-216,48,93,H1
"Comanche County, TX",2001-2002,13710,13582,-128,-0.934,-37,-91,48,93,H1
"Comanche County, TX",2002-2003,13582,13526,-56,-0.412,-38,-18,48,93,H1
"Comanche County, TX",2003-2004,13526,13646,120,0.887,4,116,48,93,H1
"Comanche County, TX",2004-2005,13646,13746,100,0.733,23,77,48,93,H1
"Comanche County, TX",2005-2006,13746,13814,68,0.495,9,59,48,93,H1
"Comanche County, TX",2006-2007,13814,13775,-39,-0.282,-6,-33,48,93,H1
"Comanche County, TX",2007-2008,13775,13834,59,0.428,-11,70,48,93,H1
"Comanche County, TX",2008-2009,13834,13912,78,0.564,27,51,48,93,H1
"Comanche County, TX",2009-2010,13912,13986,74,0.532,19,55,48,93,H1
"Comanche County, TX",2010-2011,13986,13903,-83,-0.593,23,-106,48,93,H1
"Comanche County, TX",2011-2012,13903,13746,-157,-1.129,20,-177,48,93,H1
"Comanche County, TX",2012-2013,13746,13591,-155,-1.128,-25,-130,48,93,H1
"Comanche County, TX",2013-2014,13591,13550,-41,-0.302,-17,-24,48,93,H1
"Comanche County, TX",2014-2015,13502,13430,-72,-0.533,-20,-52,48,93,H1
"Comanche County, TX",2015-2016,13430,13521,91,0.678,3,88,48,93,H1
"Comanche County, TX",2016-2017,13521,13573,52,0.385,-8,60,48,93,H1
"Concho County, TX",2000-2001,3963,3921,-42,-1.06,-14,-28,48,95,H1
"Concho County, TX",2001-2002,3921,3959,38,0.969,-23,61,48,95,H1
"Concho County, TX",2002-2003,3959,3991,32,0.808,2,30,48,95,H1
"Concho County, TX",2003-2004,3991,4018,27,0.677,-2,29,48,95,H1
"Concho County, TX",2004-2005,4018,4039,21,0.523,4,17,48,95,H1
"Concho County, TX",2005-2006,4039,3957,-82,-2.03,-6,-76,48,95,H1
"Concho County, TX",2006-2007,3957,4018,61,1.542,16,45,48,95,H1
"Concho County, TX",2007-2008,4018,4108,90,2.24,7,83,48,95,H1
"Concho County, TX",2008-2009,4108,4076,-32,-0.779,10,-42,48,95,H1
"Concho County, TX",2009-2010,4076,4096,20,0.491,9,11,48,95,H1
"Concho County, TX",2010-2011,4096,4137,41,1.001,-2,43,48,95,H1
"Concho County, TX",2011-2012,4137,4065,-72,-1.74,2,-74,48,95,H1
"Concho County, TX",2012-2013,4065,4106,41,1.009,-5,46,48,95,H1
"Concho County, TX",2013-2014,4106,4050,-56,-1.364,-10,-46,48,95,H1
"Concho County, TX",2014-2015,4045,4081,36,0.89,-12,48,48,95,H1
"Concho County, TX",2015-2016,4081,4273,192,4.705,2,190,48,95,H1
"Concho County, TX",2016-2017,4273,2717,-1556,-36.415,2,-1558,48,95,H1
"Cooke County, TX",2000-2001,36433,36844,411,1.128,137,274,48,97,H1
"Cooke County, TX",2001-2002,36844,37390,546,1.482,120,426,48,97,H1
"Cooke County, TX",2002-2003,37390,37598,208,0.556,153,55,48,97,H1
"Cooke County, TX",2003-2004,37598,37815,217,0.577,122,95,48,97,H1
"Cooke County, TX",2004-2005,37815,38143,328,0.867,202,126,48,97,H1
"Cooke County, TX",2005-2006,38143,38241,98,0.257,216,-118,48,97,H1
"Cooke County, TX",2006-2007,38241,38252,11,0.029,208,-197,48,97,H1
"Cooke County, TX",2007-2008,38252,38223,-29,-0.076,167,-196,48,97,H1
"Cooke County, TX",2008-2009,38223,38413,190,0.497,164,26,48,97,H1
"Cooke County, TX",2009-2010,38413,38445,32,0.083,180,-148,48,97,H1
"Cooke County, TX",2010-2011,38445,38375,-70,-0.182,97,-167,48,97,H1
"Cooke County, TX",2011-2012,38375,38733,358,0.933,108,250,48,97,H1
"Cooke County, TX",2012-2013,38733,38475,-258,-0.666,151,-409,48,97,H1
"Cooke County, TX",2013-2014,38475,38761,286,0.743,128,158,48,97,H1
"Cooke County, TX",2014-2015,38828,39229,401,1.033,133,268,48,97,H1
"Cooke County, TX",2015-2016,39229,39244,15,0.038,165,-150,48,97,H1
"Cooke County, TX",2016-2017,39244,39895,651,1.659,162,489,48,97,H1
"Coryell County, TX",2000-2001,75199,74083,-1116,-1.484,696,-1812,48,99,H1
"Coryell County, TX",2001-2002,74083,73135,-948,-1.28,637,-1585,48,99,H1
"Coryell County, TX",2002-2003,73135,71364,-1771,-2.422,582,-2353,48,99,H1
"Coryell County, TX",2003-2004,71364,71943,579,0.811,520,59,48,99,H1
"Coryell County, TX",2004-2005,71943,72610,667,0.927,469,198,48,99,H1
"Coryell County, TX",2005-2006,72610,72217,-393,-0.541,675,-1068,48,99,H1
"Coryell County, TX",2006-2007,72217,73324,1107,1.533,598,509,48,99,H1
"Coryell County, TX",2007-2008,73324,74552,1228,1.675,553,675,48,99,H1
"Coryell County, TX",2008-2009,74552,74673,121,0.162,515,-394,48,99,H1
"Coryell County, TX",2009-2010,74673,75588,915,1.225,568,347,48,99,H1
"Coryell County, TX",2010-2011,75588,76624,1036,1.371,654,382,48,99,H1
"Coryell County, TX",2011-2012,76624,77136,512,0.668,541,-29,48,99,H1
"Coryell County, TX",2012-2013,77136,76471,-665,-0.862,648,-1313,48,99,H1
"Coryell County, TX",2013-2014,76471,75562,-909,-1.189,564,-1473,48,99,H1
"Coryell County, TX",2014-2015,75507,75503,-4,-0.005,628,-632,48,99,H1
"Coryell County, TX",2015-2016,75503,74943,-560,-0.742,502,-1062,48,99,H1
"Coryell County, TX",2016-2017,74943,74913,-30,-0.04,519,-549,48,99,H1
"Cottle County, TX",2000-2001,1883,1774,-109,-5.789,-13,-96,48,101,H1
"Cottle County, TX",2001-2002,1774,1726,-48,-2.706,-4,-44,48,101,H1
"Cottle County, TX",2002-2003,1726,1699,-27,-1.564,8,-35,48,101,H1
"Cottle County, TX",2003-2004,1699,1679,-20,-1.177,5,-25,48,101,H1
"Cottle County, TX",2004-2005,1679,1653,-26,-1.549,7,-33,48,101,H1
"Cottle County, TX",2005-2006,1653,1577,-76,-4.598,-9,-67,48,101,H1
"Cottle County, TX",2006-2007,1577,1513,-64,-4.058,-25,-39,48,101,H1
"Cottle County, TX",2007-2008,1513,1527,14,0.925,-10,24,48,101,H1
"Cottle County, TX",2008-2009,1527,1509,-18,-1.179,15,-33,48,101,H1
"Cottle County, TX",2009-2010,1509,1500,-9,-0.596,18,-27,48,101,H1
"Cottle County, TX",2010-2011,1500,1503,3,0.2,-6,9,48,101,H1
"Cottle County, TX",2011-2012,1503,1479,-24,-1.597,-2,-22,48,101,H1
"Cottle County, TX",2012-2013,1479,1442,-37,-2.502,-20,-17,48,101,H1
"Cottle County, TX",2013-2014,1442,1415,-27,-1.872,-6,-21,48,101,H1
"Cottle County, TX",2014-2015,1427,1426,-1,-0.07,0,-1,48,101,H1
"Cottle County, TX",2015-2016,1426,1404,-22,-1.543,-12,-10,48,101,H1
"Cottle County, TX",2016-2017,1404,1387,-17,-1.211,-4,-13,48,101,H1
"Crane County, TX",2000-2001,3951,3893,-58,-1.468,10,-68,48,103,H1
"Crane County, TX",2001-2002,3893,3891,-2,-0.051,19,-21,48,103,H1
"Crane County, TX",2002-2003,3891,3847,-44,-1.131,11,-55,48,103,H1
"Crane County, TX",2003-2004,3847,3865,18,0.468,12,6,48,103,H1
"Crane County, TX",2004-2005,3865,3840,-25,-0.647,9,-34,48,103,H1
"Crane County, TX",2005-2006,3840,3855,15,0.391,14,1,48,103,H1
"Crane County, TX",2006-2007,3855,3976,121,3.139,24,97,48,103,H1
"Crane County, TX",2007-2008,3976,4157,181,4.552,46,135,48,103,H1
"Crane County, TX",2008-2009,4157,4333,176,4.234,54,122,48,103,H1
"Crane County, TX",2009-2010,4333,4376,43,0.992,53,-10,48,103,H1
"Crane County, TX",2010-2011,4376,4363,-13,-0.297,18,-31,48,103,H1
"Crane County, TX",2011-2012,4363,4567,204,4.676,39,165,48,103,H1
"Crane County, TX",2012-2013,4567,4755,188,4.116,40,148,48,103,H1
"Crane County, TX",2013-2014,4755,4950,195,4.101,63,132,48,103,H1
"Crane County, TX",2014-2015,4927,5048,121,2.456,66,55,48,103,H1
"Crane County, TX",2015-2016,5048,4807,-241,-4.774,61,-302,48,103,H1
"Crane County, TX",2016-2017,4807,4740,-67,-1.394,57,-124,48,103,H1
"Crockett County, TX",2000-2001,4012,3844,-168,-4.187,5,-173,48,105,H1
"Crockett County, TX",2001-2002,3844,3841,-3,-0.078,16,-19,48,105,H1
"Crockett County, TX",2002-2003,3841,3862,21,0.547,24,-3,48,105,H1
"Crockett County, TX",2003-2004,3862,3857,-5,-0.129,22,-27,48,105,H1
"Crockett County, TX",2004-2005,3857,3851,-6,-0.156,23,-29,48,105,H1
"Crockett County, TX",2005-2006,3851,3739,-112,-2.908,17,-129,48,105,H1
"Crockett County, TX",2006-2007,3739,3759,20,0.535,41,-21,48,105,H1
"Crockett County, TX",2007-2008,3759,3783,24,0.638,42,-18,48,105,H1
"Crockett County, TX",2008-2009,3783,3740,-43,-1.137,50,-93,48,105,H1
"Crockett County, TX",2009-2010,3740,3706,-34,-0.909,39,-73,48,105,H1
"Crockett County, TX",2010-2011,3706,3673,-33,-0.89,10,-43,48,105,H1
"Crockett County, TX",2011-2012,3673,3716,43,1.171,23,20,48,105,H1
"Crockett County, TX",2012-2013,3716,3772,56,1.507,31,25,48,105,H1
"Crockett County, TX",2013-2014,3772,3812,40,1.06,35,5,48,105,H1
"Crockett County, TX",2014-2015,3781,3710,-71,-1.878,25,-96,48,105,H1
"Crockett County, TX",2015-2016,3710,3653,-57,-1.536,24,-81,48,105,H1
"Crockett County, TX",2016-2017,3653,3564,-89,-2.436,17,-106,48,105,H1
"Crosby County, TX",2000-2001,7053,6955,-98,-1.389,49,-147,48,107,H1
"Crosby County, TX",2001-2002,6955,6852,-103,-1.481,16,-119,48,107,H1
"Crosby County, TX",2002-2003,6852,6718,-134,-1.956,40,-174,48,107,H1
"Crosby County, TX",2003-2004,6718,6625,-93,-1.384,55,-148,48,107,H1
"Crosby County, TX",2004-2005,6625,6521,-104,-1.57,1,-105,48,107,H1
"Crosby County, TX",2005-2006,6521,6466,-55,-0.843,41,-96,48,107,H1
"Crosby County, TX",2006-2007,6466,6262,-204,-3.155,16,-220,48,107,H1
"Crosby County, TX",2007-2008,6262,6192,-70,-1.118,59,-129,48,107,H1
"Crosby County, TX",2008-2009,6192,6057,-135,-2.18,53,-188,48,107,H1
"Crosby County, TX",2009-2010,6057,6048,-9,-0.149,54,-63,48,107,H1
"Crosby County, TX",2010-2011,6048,6088,40,0.661,19,21,48,107,H1
"Crosby County, TX",2011-2012,6088,6099,11,0.181,5,6,48,107,H1
"Crosby County, TX",2012-2013,6099,5992,-107,-1.754,18,-125,48,107,H1
"Crosby County, TX",2013-2014,5992,5899,-93,-1.552,14,-107,48,107,H1
"Crosby County, TX",2014-2015,5888,5977,89,1.512,-3,92,48,107,H1
"Crosby County, TX",2015-2016,5977,5917,-60,-1.004,19,-79,48,107,H1
"Crosby County, TX",2016-2017,5917,5899,-18,-0.304,23,-41,48,107,H1
"Culberson County, TX",2000-2001,2948,2865,-83,-2.815,18,-101,48,109,H1
"Culberson County, TX",2001-2002,2865,2829,-36,-1.257,31,-67,48,109,H1
"Culberson County, TX",2002-2003,2829,2778,-51,-1.803,33,-84,48,109,H1
"Culberson County, TX",2003-2004,2778,2695,-83,-2.988,4,-87,48,109,H1
"Culberson County, TX",2004-2005,2695,2648,-47,-1.744,2,-49,48,109,H1
"Culberson County, TX",2005-2006,2648,2587,-61,-2.304,20,-81,48,109,H1
"Culberson County, TX",2006-2007,2587,2536,-51,-1.971,20,-71,48,109,H1
"Culberson County, TX",2007-2008,2536,2490,-46,-1.814,24,-70,48,109,H1
"Culberson County, TX",2008-2009,2490,2384,-106,-4.257,26,-132,48,109,H1
"Culberson County, TX",2009-2010,2384,2397,13,0.545,23,-10,48,109,H1
"Culberson County, TX",2010-2011,2397,2373,-24,-1.001,13,-37,48,109,H1
"Culberson County, TX",2011-2012,2373,2303,-70,-2.95,17,-87,48,109,H1
"Culberson County, TX",2012-2013,2303,2288,-15,-0.651,13,-28,48,109,H1
"Culberson County, TX",2013-2014,2288,2266,-22,-0.962,16,-38,48,109,H1
"Culberson County, TX",2014-2015,2266,2236,-30,-1.324,19,-49,48,109,H1
"Culberson County, TX",2015-2016,2236,2219,-17,-0.76,11,-28,48,109,H1
"Culberson County, TX",2016-2017,2219,2231,12,0.541,14,-2,48,109,H1
"Dallam County, TX",2000-2001,6224,6210,-14,-0.225,48,-62,48,111,H1
"Dallam County, TX",2001-2002,6210,6159,-51,-0.821,38,-89,48,111,H1
"Dallam County, TX",2002-2003,6159,6148,-11,-0.179,65,-76,48,111,H1
"Dallam County, TX",2003-2004,6148,6208,60,0.976,39,21,48,111,H1
"Dallam County, TX",2004-2005,6208,6238,30,0.483,50,-20,48,111,H1
"Dallam County, TX",2005-2006,6238,6205,-33,-0.529,87,-120,48,111,H1
"Dallam County, TX",2006-2007,6205,6336,131,2.111,66,65,48,111,H1
"Dallam County, TX",2007-2008,6336,6506,170,2.683,70,100,48,111,H1
"Dallam County, TX",2008-2009,6506,6571,65,0.999,72,-7,48,111,H1
"Dallam County, TX",2009-2010,6571,6761,190,2.891,83,107,48,111,H1
"Dallam County, TX",2010-2011,6761,6846,85,1.257,95,-10,48,111,H1
"Dallam County, TX",2011-2012,6846,6996,150,2.191,76,74,48,111,H1
"Dallam County, TX",2012-2013,6996,7047,51,0.729,119,-68,48,111,H1
"Dallam County, TX",2013-2014,7047,7135,88,1.249,119,-31,48,111,H1
"Dallam County, TX",2014-2015,7108,7121,13,0.183,115,-102,48,111,H1
"Dallam County, TX",2015-2016,7121,7256,135,1.896,122,13,48,111,H1
"Dallam County, TX",2016-2017,7256,7208,-48,-0.662,133,-181,48,111,H1
"Dallas County, TX",2000-2001,2220848,2249418,28570,1.286,28649,-79,48,113,H1
"Dallas County, TX",2001-2002,2249418,2250326,908,0.04,28753,-27845,48,113,H1
"Dallas County, TX",2002-2003,2250326,2246432,-3894,-0.173,28913,-32807,48,113,H1
"Dallas County, TX",2003-2004,2246432,2244020,-2412,-0.107,28487,-30899,48,113,H1
"Dallas County, TX",2004-2005,2244020,2250830,6810,0.303,28633,-21823,48,113,H1
"Dallas County, TX",2005-2006,2250830,2275434,24604,1.093,29324,-4720,48,113,H1
"Dallas County, TX",2006-2007,2275434,2291891,16457,0.723,29993,-13536,48,113,H1
"Dallas County, TX",2007-2008,2291891,2314018,22127,0.965,29055,-6928,48,113,H1
"Dallas County, TX",2008-2009,2314018,2346378,32360,1.398,27824,4536,48,113,H1
"Dallas County, TX",2009-2010,2346378,2373360,26982,1.15,31041,-4059,48,113,H1
"Dallas County, TX",2010-2011,2373360,2409942,36582,1.541,24768,11814,48,113,H1
"Dallas County, TX",2011-2012,2409942,2456693,46751,1.94,24317,22434,48,113,H1
"Dallas County, TX",2012-2013,2456693,2486083,29390,1.196,23637,5753,48,113,H1
"Dallas County, TX",2013-2014,2486083,2518638,32555,1.309,23276,9279,48,113,H1
"Dallas County, TX",2014-2015,2519625,2553385,33760,1.34,23860,9900,48,113,H1
"Dallas County, TX",2015-2016,2553385,2587462,34077,1.335,24113,9964,48,113,H1
"Dallas County, TX",2016-2017,2587462,2618148,30686,1.186,24010,6676,48,113,H1
"Dawson County, TX",2000-2001,14935,14863,-72,-0.482,68,-140,48,115,H1
"Dawson County, TX",2001-2002,14863,14429,-434,-2.92,44,-478,48,115,H1
"Dawson County, TX",2002-2003,14429,14354,-75,-0.52,40,-115,48,115,H1
"Dawson County, TX",2003-2004,14354,14062,-292,-2.034,46,-338,48,115,H1
"Dawson County, TX",2004-2005,14062,14092,30,0.213,45,-15,48,115,H1
"Dawson County, TX",2005-2006,14092,13987,-105,-0.745,73,-178,48,115,H1
"Dawson County, TX",2006-2007,13987,13865,-122,-0.872,100,-222,48,115,H1
"Dawson County, TX",2007-2008,13865,13804,-61,-0.44,57,-118,48,115,H1
"Dawson County, TX",2008-2009,13804,13741,-63,-0.456,77,-140,48,115,H1
"Dawson County, TX",2009-2010,13741,13850,109,0.793,85,24,48,115,H1
"Dawson County, TX",2010-2011,13850,13805,-45,-0.325,57,-102,48,115,H1
"Dawson County, TX",2011-2012,13805,13663,-142,-1.029,66,-208,48,115,H1
"Dawson County, TX",2012-2013,13663,13273,-390,-2.854,52,-442,48,115,H1
"Dawson County, TX",2013-2014,13273,13372,99,0.746,62,37,48,115,H1
"Dawson County, TX",2014-2015,13505,13520,15,0.111,66,-51,48,115,H1
"Dawson County, TX",2015-2016,13520,13042,-478,-3.536,82,-560,48,115,H1
"Dawson County, TX",2016-2017,13042,12813,-229,-1.756,64,-293,48,115,H1
"Deaf Smith County, TX",2000-2001,18515,18391,-124,-0.67,204,-328,48,117,H1
"Deaf Smith County, TX",2001-2002,18391,18439,48,0.261,215,-167,48,117,H1
"Deaf Smith County, TX",2002-2003,18439,18454,15,0.081,200,-185,48,117,H1
"Deaf Smith County, TX",2003-2004,18454,18671,217,1.176,191,26,48,117,H1
"Deaf Smith County, TX",2004-2005,18671,18737,66,0.353,203,-137,48,117,H1
"Deaf Smith County, TX",2005-2006,18737,18770,33,0.176,237,-204,48,117,H1
"Deaf Smith County, TX",2006-2007,18770,18916,146,0.778,229,-83,48,117,H1
"Deaf Smith County, TX",2007-2008,18916,19054,138,0.73,231,-93,48,117,H1
"Deaf Smith County, TX",2008-2009,19054,19084,30,0.157,226,-196,48,117,H1
"Deaf Smith County, TX",2009-2010,19084,19440,356,1.865,253,103,48,117,H1
"Deaf Smith County, TX",2010-2011,19440,19476,36,0.185,209,-173,48,117,H1
"Deaf Smith County, TX",2011-2012,19476,19358,-118,-0.606,193,-311,48,117,H1
"Deaf Smith County, TX",2012-2013,19358,19187,-171,-0.883,203,-374,48,117,H1
"Deaf Smith County, TX",2013-2014,19187,19195,8,0.042,174,-166,48,117,H1
"Deaf Smith County, TX",2014-2015,19201,18952,-249,-1.297,166,-415,48,117,H1
"Deaf Smith County, TX",2015-2016,18952,18850,-102,-0.538,203,-305,48,117,H1
"Deaf Smith County, TX",2016-2017,18850,18836,-14,-0.074,178,-192,48,117,H1
"Delta County, TX",2000-2001,5323,5295,-28,-0.526,-19,-9,48,119,H1
"Delta County, TX",2001-2002,5295,5366,71,1.341,0,71,48,119,H1
"Delta County, TX",2002-2003,5366,5310,-56,-1.044,-11,-45,48,119,H1
"Delta County, TX",2003-2004,5310,5409,99,1.864,-19,118,48,119,H1
"Delta County, TX",2004-2005,5409,5314,-95,-1.756,11,-106,48,119,H1
"Delta County, TX",2005-2006,5314,5355,41,0.772,-8,49,48,119,H1
"Delta County, TX",2006-2007,5355,5199,-156,-2.913,-2,-154,48,119,H1
"Delta County, TX",2007-2008,5199,5252,53,1.019,-8,61,48,119,H1
"Delta County, TX",2008-2009,5252,5180,-72,-1.371,-1,-71,48,119,H1
"Delta County, TX",2009-2010,5180,5241,61,1.178,-2,63,48,119,H1
"Delta County, TX",2010-2011,5241,5204,-37,-0.706,-23,-14,48,119,H1
"Delta County, TX",2011-2012,5204,5307,103,1.979,-18,121,48,119,H1
"Delta County, TX",2012-2013,5307,5205,-102,-1.922,-9,-93,48,119,H1
"Delta County, TX",2013-2014,5205,5238,33,0.634,-5,38,48,119,H1
"Delta County, TX",2014-2015,5218,5217,-1,-0.019,9,-10,48,119,H1
"Delta County, TX",2015-2016,5217,5146,-71,-1.361,-6,-65,48,119,H1
"Delta County, TX",2016-2017,5146,5298,152,2.954,8,144,48,119,H1
"Denton County, TX",2000-2001,438791,463688,24897,5.674,5897,1.90E+04,48,121,H1
"Denton County, TX",2001-2002,463688,487617,23929,5.161,6222,17707,48,121,H1
"Denton County, TX",2002-2003,487617,509732,22115,4.535,6533,15582,48,121,H1
"Denton County, TX",2003-2004,509732,529811,20079,3.939,6862,13217,48,121,H1
"Denton County, TX",2004-2005,529811,553669,23858,4.503,6952,16906,48,121,H1
"Denton County, TX",2005-2006,553669,584561,30892,5.58,7155,23737,48,121,H1
"Denton County, TX",2006-2007,584561,609001,24440,4.181,7117,17323,48,121,H1
"Denton County, TX",2007-2008,609001,630104,21103,3.465,7365,13738,48,121,H1
"Denton County, TX",2008-2009,630104,649702,19598,3.11,7756,11842,48,121,H1
"Denton County, TX",2009-2010,649702,666938,17236,2.653,7314,9922,48,121,H1
"Denton County, TX",2010-2011,666938,685718,18780,2.816,6459,12321,48,121,H1
"Denton County, TX",2011-2012,685718,707962,22244,3.244,6205,16039,48,121,H1
"Denton County, TX",2012-2013,707962,729152,21190,2.993,6413,14777,48,121,H1
"Denton County, TX",2013-2014,729152,753363,24211,3.32,6352,17859,48,121,H1
"Denton County, TX",2014-2015,754792,780612,25820,3.421,6564,19256,48,121,H1
"Denton County, TX",2015-2016,780612,808299,27687,3.547,6627,21060,48,121,H1
"Denton County, TX",2016-2017,808299,836210,27911,3.453,6478,21433,48,121,H1
"DeWitt County, TX",2000-2001,19943,20066,123,0.617,2,121,48,123,H1
"DeWitt County, TX",2001-2002,20066,20015,-51,-0.254,-53,2,48,123,H1
"DeWitt County, TX",2002-2003,20015,20034,19,0.095,-24,43,48,123,H1
"DeWitt County, TX",2003-2004,20034,20176,142,0.709,-16,158,48,123,H1
"DeWitt County, TX",2004-2005,20176,20342,166,0.823,-9,175,48,123,H1
"DeWitt County, TX",2005-2006,20342,20108,-234,-1.15,-18,-216,48,123,H1
"DeWitt County, TX",2006-2007,20108,19961,-147,-0.731,-21,-126,48,123,H1
"DeWitt County, TX",2007-2008,19961,19902,-59,-0.296,6,-65,48,123,H1
"DeWitt County, TX",2008-2009,19902,20048,146,0.734,-1,147,48,123,H1
"DeWitt County, TX",2009-2010,20048,20049,1,0.005,3,-2,48,123,H1
"DeWitt County, TX",2010-2011,20049,20296,247,1.232,-34,281,48,123,H1
"DeWitt County, TX",2011-2012,20296,20456,160,0.788,24,136,48,123,H1
"DeWitt County, TX",2012-2013,20456,20501,45,0.22,30,15,48,123,H1
"DeWitt County, TX",2013-2014,20501,20684,183,0.893,47,136,48,123,H1
"DeWitt County, TX",2014-2015,20668,20797,129,0.624,50,79,48,123,H1
"DeWitt County, TX",2015-2016,20797,20618,-179,-0.861,-16,-163,48,123,H1
"DeWitt County, TX",2016-2017,20618,20226,-392,-1.901,33,-425,48,123,H1
"Dickens County, TX",2000-2001,2724,2653,-71,-2.606,-37,-34,48,125,H1
"Dickens County, TX",2001-2002,2653,2679,26,0.98,-3,29,48,125,H1
"Dickens County, TX",2002-2003,2679,2670,-9,-0.336,-22,13,48,125,H1
"Dickens County, TX",2003-2004,2670,2641,-29,-1.086,-7,-22,48,125,H1
"Dickens County, TX",2004-2005,2641,2563,-78,-2.953,-2,-76,48,125,H1
"Dickens County, TX",2005-2006,2563,2466,-97,-3.785,-9,-88,48,125,H1
"Dickens County, TX",2006-2007,2466,2461,-5,-0.203,-11,6,48,125,H1
"Dickens County, TX",2007-2008,2461,2400,-61,-2.479,6,-67,48,125,H1
"Dickens County, TX",2008-2009,2400,2423,23,0.958,11,12,48,125,H1
"Dickens County, TX",2009-2010,2423,2454,31,1.279,-4,35,48,125,H1
"Dickens County, TX",2010-2011,2454,2408,-46,-1.874,-2,-44,48,125,H1
"Dickens County, TX",2011-2012,2408,2325,-83,-3.447,-13,-70,48,125,H1
"Dickens County, TX",2012-2013,2325,2288,-37,-1.591,-7,-30,48,125,H1
"Dickens County, TX",2013-2014,2288,2218,-70,-3.059,1,-71,48,125,H1
"Dickens County, TX",2014-2015,2205,2206,1,0.045,10,-9,48,125,H1
"Dickens County, TX",2015-2016,2206,2201,-5,-0.227,3,-8,48,125,H1
"Dickens County, TX",2016-2017,2201,2209,8,0.363,5,3,48,125,H1
"Dimmit County, TX",2000-2001,10160,10030,-130,-1.28,89,-219,48,127,H1
"Dimmit County, TX",2001-2002,10030,10042,12,0.12,57,-45,48,127,H1
"Dimmit County, TX",2002-2003,10042,10075,33,0.329,81,-48,48,127,H1
"Dimmit County, TX",2003-2004,10075,9964,-111,-1.102,107,-218,48,127,H1
"Dimmit County, TX",2004-2005,9964,10031,67,0.672,117,-50,48,127,H1
"Dimmit County, TX",2005-2006,10031,9972,-59,-0.588,108,-167,48,127,H1
"Dimmit County, TX",2006-2007,9972,9845,-127,-1.274,86,-213,48,127,H1
"Dimmit County, TX",2007-2008,9845,9833,-12,-0.122,88,-100,48,127,H1
"Dimmit County, TX",2008-2009,9833,9848,15,0.153,110,-95,48,127,H1
"Dimmit County, TX",2009-2010,9848,10033,185,1.879,106,79,48,127,H1
"Dimmit County, TX",2010-2011,10033,10114,81,0.807,68,13,48,127,H1
"Dimmit County, TX",2011-2012,10114,10510,396,3.915,96,300,48,127,H1
"Dimmit County, TX",2012-2013,10510,10939,429,4.082,115,314,48,127,H1
"Dimmit County, TX",2013-2014,10939,11089,150,1.371,133,17,48,127,H1
"Dimmit County, TX",2014-2015,10995,10980,-15,-0.136,134,-149,48,127,H1
"Dimmit County, TX",2015-2016,10980,10784,-196,-1.785,70,-266,48,127,H1
"Dimmit County, TX",2016-2017,10784,10418,-366,-3.394,69,-435,48,127,H1
"Donley County, TX",2000-2001,3813,3829,16,0.42,-31,47,48,129,H1
"Donley County, TX",2001-2002,3829,3825,-4,-0.104,-10,6,48,129,H1
"Donley County, TX",2002-2003,3825,3898,73,1.908,-1,74,48,129,H1
"Donley County, TX",2003-2004,3898,3915,17,0.436,-16,33,48,129,H1
"Donley County, TX",2004-2005,3915,3833,-82,-2.095,-11,-71,48,129,H1
"Donley County, TX",2005-2006,3833,3779,-54,-1.409,-13,-41,48,129,H1
"Donley County, TX",2006-2007,3779,3806,27,0.714,-8,35,48,129,H1
"Donley County, TX",2007-2008,3806,3688,-118,-3.1,-9,-109,48,129,H1
"Donley County, TX",2008-2009,3688,3670,-18,-0.488,-3,-15,48,129,H1
"Donley County, TX",2009-2010,3670,3724,54,1.471,5,49,48,129,H1
"Donley County, TX",2010-2011,3724,3679,-45,-1.208,-19,-26,48,129,H1
"Donley County, TX",2011-2012,3679,3652,-27,-0.734,-20,-7,48,129,H1
"Donley County, TX",2012-2013,3652,3580,-72,-1.972,-12,-60,48,129,H1
"Donley County, TX",2013-2014,3580,3543,-37,-1.034,-7,-30,48,129,H1
"Donley County, TX",2014-2015,3522,3499,-23,-0.653,-17,-6,48,129,H1
"Donley County, TX",2015-2016,3499,3392,-107,-3.058,-11,-96,48,129,H1
"Donley County, TX",2016-2017,3392,3311,-81,-2.388,-13,-68,48,129,H1
"Duval County, TX",2000-2001,13007,12830,-177,-1.361,58,-235,48,131,H1
"Duval County, TX",2001-2002,12830,12707,-123,-0.959,53,-176,48,131,H1
"Duval County, TX",2002-2003,12707,12570,-137,-1.078,70,-207,48,131,H1
"Duval County, TX",2003-2004,12570,12539,-31,-0.247,75,-106,48,131,H1
"Duval County, TX",2004-2005,12539,12426,-113,-0.901,104,-217,48,131,H1
"Duval County, TX",2005-2006,12426,12298,-128,-1.03,66,-194,48,131,H1
"Duval County, TX",2006-2007,12298,12097,-201,-1.634,70,-271,48,131,H1
"Duval County, TX",2007-2008,12097,11945,-152,-1.257,81,-233,48,131,H1
"Duval County, TX",2008-2009,11945,11917,-28,-0.234,93,-121,48,131,H1
"Duval County, TX",2009-2010,11917,11721,-196,-1.645,89,-285,48,131,H1
"Duval County, TX",2010-2011,11721,11791,70,0.597,64,6,48,131,H1
"Duval County, TX",2011-2012,11791,11573,-218,-1.849,68,-286,48,131,H1
"Duval County, TX",2012-2013,11573,11600,27,0.233,25,2,48,131,H1
"Duval County, TX",2013-2014,11600,11533,-67,-0.578,21,-88,48,131,H1
"Duval County, TX",2014-2015,11519,11388,-131,-1.137,19,-150,48,131,H1
"Duval County, TX",2015-2016,11388,11449,61,0.536,34,27,48,131,H1
"Duval County, TX",2016-2017,11449,11273,-176,-1.537,31,-207,48,131,H1
"Eastland County, TX",2000-2001,18296,18061,-235,-1.284,-115,-120,48,133,H1
"Eastland County, TX",2001-2002,18061,18252,191,1.058,-65,256,48,133,H1
"Eastland County, TX",2002-2003,18252,18333,81,0.444,-11,92,48,133,H1
"Eastland County, TX",2003-2004,18333,18442,109,0.595,-73,182,48,133,H1
"Eastland County, TX",2004-2005,18442,18533,91,0.493,-55,146,48,133,H1
"Eastland County, TX",2005-2006,18533,18545,12,0.065,-19,31,48,133,H1
"Eastland County, TX",2006-2007,18545,18636,91,0.491,-26,117,48,133,H1
"Eastland County, TX",2007-2008,18636,18520,-116,-0.622,20,-136,48,133,H1
"Eastland County, TX",2008-2009,18520,18497,-23,-0.124,-3,-20,48,133,H1
"Eastland County, TX",2009-2010,18497,18600,103,0.557,7,96,48,133,H1
"Eastland County, TX",2010-2011,18600,18582,-18,-0.097,-46,28,48,133,H1
"Eastland County, TX",2011-2012,18582,18403,-179,-0.963,-43,-136,48,133,H1
"Eastland County, TX",2012-2013,18403,18253,-150,-0.815,-49,-101,48,133,H1
"Eastland County, TX",2013-2014,18253,18176,-77,-0.422,-66,-11,48,133,H1
"Eastland County, TX",2014-2015,18230,18171,-59,-0.324,-34,-25,48,133,H1
"Eastland County, TX",2015-2016,18171,18303,132,0.726,-41,173,48,133,H1
"Eastland County, TX",2016-2017,18303,18411,108,0.59,-38,146,48,133,H1
"Ector County, TX",2000-2001,120694,120802,108,0.089,1211,-1103,48,135,H1
"Ector County, TX",2001-2002,120802,122199,1397,1.156,1195,202,48,135,H1
"Ector County, TX",2002-2003,122199,122739,540,0.442,1235,-695,48,135,H1
"Ector County, TX",2003-2004,122739,124163,1424,1.16,1245,179,48,135,H1
"Ector County, TX",2004-2005,124163,125378,1215,0.979,1199,16,48,135,H1
"Ector County, TX",2005-2006,125378,127476,2098,1.673,1211,887,48,135,H1
"Ector County, TX",2006-2007,127476,130459,2983,2.34,1482,1501,48,135,H1
"Ector County, TX",2007-2008,130459,133064,2605,1.997,1449,1156,48,135,H1
"Ector County, TX",2008-2009,133064,136930,3866,2.905,1410,2456,48,135,H1
"Ector County, TX",2009-2010,136930,137098,168,0.123,1589,-1421,48,135,H1
"Ector County, TX",2010-2011,137098,139690,2592,1.891,1173,1419,48,135,H1
"Ector County, TX",2011-2012,139690,144444,4754,3.403,1481,3273,48,135,H1
"Ector County, TX",2012-2013,144444,149522,5078,3.516,1739,3339,48,135,H1
"Ector County, TX",2013-2014,149522,153904,4382,2.931,1734,2648,48,135,H1
"Ector County, TX",2014-2015,154399,159436,5037,3.262,1874,3163,48,135,H1
"Ector County, TX",2015-2016,159436,157580,-1856,-1.164,1684,-3540,48,135,H1
"Ector County, TX",2016-2017,157580,157087,-493,-0.313,1577,-2070,48,135,H1
"Edwards County, TX",2000-2001,2143,2070,-73,-3.406,1,-74,48,137,H1
"Edwards County, TX",2001-2002,2070,2056,-14,-0.676,9,-23,48,137,H1
"Edwards County, TX",2002-2003,2056,2042,-14,-0.681,3,-17,48,137,H1
"Edwards County, TX",2003-2004,2042,2027,-15,-0.735,1,-16,48,137,H1
"Edwards County, TX",2004-2005,2027,2011,-16,-0.789,14,-30,48,137,H1
"Edwards County, TX",2005-2006,2011,1995,-16,-0.796,9,-25,48,137,H1
"Edwards County, TX",2006-2007,1995,2062,67,3.358,-4,71,48,137,H1
"Edwards County, TX",2007-2008,2062,2084,22,1.067,16,6,48,137,H1
"Edwards County, TX",2008-2009,2084,2012,-72,-3.455,32,-104,48,137,H1
"Edwards County, TX",2009-2010,2012,1993,-19,-0.944,25,-44,48,137,H1
"Edwards County, TX",2010-2011,1993,1967,-26,-1.305,9,-35,48,137,H1
"Edwards County, TX",2011-2012,1967,1968,1,0.051,5,-4,48,137,H1
"Edwards County, TX",2012-2013,1968,1879,-89,-4.522,4,-93,48,137,H1
"Edwards County, TX",2013-2014,1879,1879,0,0,6,-6,48,137,H1
"Edwards County, TX",2014-2015,1879,1894,15,0.798,13,2,48,137,H1
"Edwards County, TX",2015-2016,1894,1918,24,1.267,1,23,48,137,H1
"Edwards County, TX",2016-2017,1918,1953,35,1.825,11,24,48,137,H1
"Ellis County, TX",2000-2001,112330,115286,2956,2.632,883,2073,48,139,H1
"Ellis County, TX",2001-2002,115286,118737,3451,2.993,959,2492,48,139,H1
"Ellis County, TX",2002-2003,118737,122620,3883,3.27,1134,2749,48,139,H1
"Ellis County, TX",2003-2004,122620,125733,3113,2.539,991,2122,48,139,H1
"Ellis County, TX",2004-2005,125733,129955,4222,3.358,1098,3124,48,139,H1
"Ellis County, TX",2005-2006,129955,135276,5321,4.094,1211,4110,48,139,H1
"Ellis County, TX",2006-2007,135276,139988,4712,3.483,1274,3438,48,139,H1
"Ellis County, TX",2007-2008,139988,144394,4406,3.147,1420,2986,48,139,H1
"Ellis County, TX",2008-2009,144394,147392,2998,2.076,1455,1543,48,139,H1
"Ellis County, TX",2009-2010,147392,150431,3039,2.062,1194,1845,48,139,H1
"Ellis County, TX",2010-2011,150431,152462,2031,1.35,1016,1015,48,139,H1
"Ellis County, TX",2011-2012,152462,153826,1364,0.895,775,589,48,139,H1
"Ellis County, TX",2012-2013,153826,156198,2372,1.542,861,1511,48,139,H1
"Ellis County, TX",2013-2014,156198,159317,3119,1.997,826,2293,48,139,H1
"Ellis County, TX",2014-2015,159365,163632,4267,2.678,965,3302,48,139,H1
"Ellis County, TX",2015-2016,163632,168381,4749,2.902,946,3803,48,139,H1
"Ellis County, TX",2016-2017,168381,173620,5239,3.111,982,4257,48,139,H1
"El Paso County, TX",2000-2001,681729,689163,7434,1.09,10126,-2692,48,141,H1
"El Paso County, TX",2001-2002,689163,696446,7283,1.057,9825,-2542,48,141,H1
"El Paso County, TX",2002-2003,696446,705200,8754,1.257,9959,-1205,48,141,H1
"El Paso County, TX",2003-2004,705200,717652,12452,1.766,10261,2191,48,141,H1
"El Paso County, TX",2004-2005,717652,728095,10443,1.455,10185,258,48,141,H1
"El Paso County, TX",2005-2006,728095,744795,16700,2.294,9825,6875,48,141,H1
"El Paso County, TX",2006-2007,744795,755578,10783,1.448,9956,827,48,141,H1
"El Paso County, TX",2007-2008,755578,769930,14352,1.899,10120,4232,48,141,H1
"El Paso County, TX",2008-2009,769930,786759,16829,2.186,10420,6409,48,141,H1
"El Paso County, TX",2009-2010,786759,803627,16868,2.144,9975,6893,48,141,H1
"El Paso County, TX",2010-2011,803627,819726,16099,2.003,9046,7053,48,141,H1
"El Paso County, TX",2011-2012,819726,831144,11418,1.393,9113,2305,48,141,H1
"El Paso County, TX",2012-2013,831144,831324,180,0.022,8879,-8699,48,141,H1
"El Paso County, TX",2013-2014,831324,833487,2163,0.26,8569,-6406,48,141,H1
"El Paso County, TX",2014-2015,835545,835593,48,0.006,8497,-8449,48,141,H1
"El Paso County, TX",2015-2016,835593,837147,1554,0.186,7977,-6423,48,141,H1
"El Paso County, TX",2016-2017,837147,840410,3263,0.39,7840,-4577,48,141,H1
"Erath County, TX",2000-2001,33057,33045,-12,-0.036,130,-142,48,143,H1
"Erath County, TX",2001-2002,33045,33619,574,1.737,110,464,48,143,H1
"Erath County, TX",2002-2003,33619,34131,512,1.523,138,374,48,143,H1
"Erath County, TX",2003-2004,34131,34887,756,2.215,106,650,48,143,H1
"Erath County, TX",2004-2005,34887,35336,449,1.287,95,354,48,143,H1
"Erath County, TX",2005-2006,35336,36355,1019,2.884,186,833,48,143,H1
"Erath County, TX",2006-2007,36355,36678,323,0.888,196,127,48,143,H1
"Erath County, TX",2007-2008,36678,37137,459,1.251,225,234,48,143,H1
"Erath County, TX",2008-2009,37137,37594,457,1.231,230,227,48,143,H1
"Erath County, TX",2009-2010,37594,37878,284,0.755,254,30,48,143,H1
"Erath County, TX",2010-2011,37878,38972,1094,2.888,135,959,48,143,H1
"Erath County, TX",2011-2012,38972,39456,484,1.242,182,302,48,143,H1
"Erath County, TX",2012-2013,39456,40003,547,1.386,243,304,48,143,H1
"Erath County, TX",2013-2014,40003,40147,144,0.36,169,-25,48,143,H1
"Erath County, TX",2014-2015,40617,41122,505,1.243,164,341,48,143,H1
"Erath County, TX",2015-2016,41122,41443,321,0.781,123,198,48,143,H1
"Erath County, TX",2016-2017,41443,41969,526,1.269,127,399,48,143,H1
"Falls County, TX",2000-2001,18522,18280,-242,-1.307,-47,-195,48,145,H1
"Falls County, TX",2001-2002,18280,18090,-190,-1.039,-31,-159,48,145,H1
"Falls County, TX",2002-2003,18090,18086,-4,-0.022,-19,15,48,145,H1
"Falls County, TX",2003-2004,18086,18066,-20,-0.111,-25,5,48,145,H1
"Falls County, TX",2004-2005,18066,17990,-76,-0.421,2,-78,48,145,H1
"Falls County, TX",2005-2006,17990,17945,-45,-0.25,-20,-25,48,145,H1
"Falls County, TX",2006-2007,17945,17712,-233,-1.298,-51,-182,48,145,H1
"Falls County, TX",2007-2008,17712,17698,-14,-0.079,1,-15,48,145,H1
"Falls County, TX",2008-2009,17698,17762,64,0.362,45,19,48,145,H1
"Falls County, TX",2009-2010,17762,17876,114,0.642,46,68,48,145,H1
"Falls County, TX",2010-2011,17876,17862,-14,-0.078,-2,-12,48,145,H1
"Falls County, TX",2011-2012,17862,17600,-262,-1.467,-2,-260,48,145,H1
"Falls County, TX",2012-2013,17600,17292,-308,-1.75,59,-367,48,145,H1
"Falls County, TX",2013-2014,17292,16989,-303,-1.752,39,-342,48,145,H1
"Falls County, TX",2014-2015,17176,17142,-34,-0.198,30,-64,48,145,H1
"Falls County, TX",2015-2016,17142,17331,189,1.103,54,135,48,145,H1
"Falls County, TX",2016-2017,17331,17437,106,0.612,68,38,48,145,H1
"Fannin County, TX",2000-2001,31334,31400,66,0.211,-56,122,48,147,H1
"Fannin County, TX",2001-2002,31400,31808,408,1.299,-74,482,48,147,H1
"Fannin County, TX",2002-2003,31808,32380,572,1.798,-62,634,48,147,H1
"Fannin County, TX",2003-2004,32380,32692,312,0.964,-48,360,48,147,H1
"Fannin County, TX",2004-2005,32692,33221,529,1.618,-10,539,48,147,H1
"Fannin County, TX",2005-2006,33221,33540,319,0.96,-12,331,48,147,H1
"Fannin County, TX",2006-2007,33540,33644,104,0.31,-70,174,48,147,H1
"Fannin County, TX",2007-2008,33644,33870,226,0.672,-37,263,48,147,H1
"Fannin County, TX",2008-2009,33870,33865,-5,-0.015,22,-27,48,147,H1
"Fannin County, TX",2009-2010,33865,33902,37,0.109,9,28,48,147,H1
"Fannin County, TX",2010-2011,33902,33911,9,0.027,-45,54,48,147,H1
"Fannin County, TX",2011-2012,33911,33667,-244,-0.72,-113,-131,48,147,H1
"Fannin County, TX",2012-2013,33667,33644,-23,-0.068,-40,17,48,147,H1
"Fannin County, TX",2013-2014,33644,33752,108,0.321,-84,192,48,147,H1
"Fannin County, TX",2014-2015,33776,33693,-83,-0.246,-95,12,48,147,H1
"Fannin County, TX",2015-2016,33693,33855,162,0.481,-66,228,48,147,H1
"Fannin County, TX",2016-2017,33855,34446,591,1.746,-77,668,48,147,H1
"Fayette County, TX",2000-2001,21864,22397,533,2.438,-24,557,48,149,H1
"Fayette County, TX",2001-2002,22397,22668,271,1.21,-86,357,48,149,H1
"Fayette County, TX",2002-2003,22668,22910,242,1.068,-69,311,48,149,H1
"Fayette County, TX",2003-2004,22910,23107,197,0.86,-82,279,48,149,H1
"Fayette County, TX",2004-2005,23107,23342,235,1.017,-91,326,48,149,H1
"Fayette County, TX",2005-2006,23342,23631,289,1.238,-68,357,48,149,H1
"Fayette County, TX",2006-2007,23631,23898,267,1.13,-41,308,48,149,H1
"Fayette County, TX",2007-2008,23898,24347,449,1.879,-49,498,48,149,H1
"Fayette County, TX",2008-2009,24347,24470,123,0.505,-26,149,48,149,H1
"Fayette County, TX",2009-2010,24470,24538,68,0.278,-54,122,48,149,H1
"Fayette County, TX",2010-2011,24538,24751,213,0.868,-45,258,48,149,H1
"Fayette County, TX",2011-2012,24751,24720,-31,-0.125,-56,25,48,149,H1
"Fayette County, TX",2012-2013,24720,24785,65,0.263,-90,155,48,149,H1
"Fayette County, TX",2013-2014,24785,24833,48,0.194,-76,124,48,149,H1
"Fayette County, TX",2014-2015,24870,25110,240,0.965,-31,271,48,149,H1
"Fayette County, TX",2015-2016,25110,25070,-40,-0.159,-38,-2,48,149,H1
"Fayette County, TX",2016-2017,25070,25272,202,0.806,-26,228,48,149,H1
"Fisher County, TX",2000-2001,4340,4257,-83,-1.912,-25,-58,48,151,H1
"Fisher County, TX",2001-2002,4257,4242,-15,-0.352,-19,4,48,151,H1
"Fisher County, TX",2002-2003,4242,4191,-51,-1.202,-35,-16,48,151,H1
"Fisher County, TX",2003-2004,4191,4118,-73,-1.742,-33,-40,48,151,H1
"Fisher County, TX",2004-2005,4118,4135,17,0.413,-8,25,48,151,H1
"Fisher County, TX",2005-2006,4135,4098,-37,-0.895,-16,-21,48,151,H1
"Fisher County, TX",2006-2007,4098,4080,-18,-0.439,-30,12,48,151,H1
"Fisher County, TX",2007-2008,4080,4065,-15,-0.368,-9,-6,48,151,H1
"Fisher County, TX",2008-2009,4065,4014,-51,-1.255,-5,-46,48,151,H1
"Fisher County, TX",2009-2010,4014,3953,-61,-1.52,5,-66,48,151,H1
"Fisher County, TX",2010-2011,3953,3953,0,0,-7,7,48,151,H1
"Fisher County, TX",2011-2012,3953,3833,-120,-3.036,-28,-92,48,151,H1
"Fisher County, TX",2012-2013,3833,3838,5,0.13,-11,16,48,151,H1
"Fisher County, TX",2013-2014,3838,3831,-7,-0.182,-22,15,48,151,H1
"Fisher County, TX",2014-2015,3828,3827,-1,-0.026,-23,22,48,151,H1
"Fisher County, TX",2015-2016,3827,3881,54,1.411,13,41,48,151,H1
"Fisher County, TX",2016-2017,3881,3880,-1,-0.026,-4,3,48,151,H1
"Floyd County, TX",2000-2001,7734,7452,-282,-3.646,9,-291,48,153,H1
"Floyd County, TX",2001-2002,7452,7289,-163,-2.187,20,-183,48,153,H1
"Floyd County, TX",2002-2003,7289,7364,75,1.029,58,17,48,153,H1
"Floyd County, TX",2003-2004,7364,7130,-234,-3.178,25,-259,48,153,H1
"Floyd County, TX",2004-2005,7130,6983,-147,-2.062,36,-183,48,153,H1
"Floyd County, TX",2005-2006,6983,6855,-128,-1.833,35,-163,48,153,H1
"Floyd County, TX",2006-2007,6855,6683,-172,-2.509,20,-192,48,153,H1
"Floyd County, TX",2007-2008,6683,6528,-155,-2.319,55,-210,48,153,H1
"Floyd County, TX",2008-2009,6528,6508,-20,-0.306,34,-54,48,153,H1
"Floyd County, TX",2009-2010,6508,6403,-105,-1.613,45,-150,48,153,H1
"Floyd County, TX",2010-2011,6403,6376,-27,-0.422,25,-52,48,153,H1
"Floyd County, TX",2011-2012,6376,6349,-27,-0.423,10,-37,48,153,H1
"Floyd County, TX",2012-2013,6349,6239,-110,-1.733,45,-155,48,153,H1
"Floyd County, TX",2013-2014,6239,5949,-290,-4.648,26,-316,48,153,H1
"Floyd County, TX",2014-2015,5972,5901,-71,-1.189,13,-84,48,153,H1
"Floyd County, TX",2015-2016,5901,5876,-25,-0.424,30,-55,48,153,H1
"Floyd County, TX",2016-2017,5876,5855,-21,-0.357,20,-41,48,153,H1
"Foard County, TX",2000-2001,1594,1606,12,0.753,-7,19,48,155,H1
"Foard County, TX",2001-2002,1606,1536,-70,-4.359,4,-74,48,155,H1
"Foard County, TX",2002-2003,1536,1513,-23,-1.497,-1,-22,48,155,H1
"Foard County, TX",2003-2004,1513,1492,-21,-1.388,-14,-7,48,155,H1
"Foard County, TX",2004-2005,1492,1439,-53,-3.552,1,-54,48,155,H1
"Foard County, TX",2005-2006,1439,1432,-7,-0.486,-3,-4,48,155,H1
"Foard County, TX",2006-2007,1432,1383,-49,-3.422,-11,-38,48,155,H1
"Foard County, TX",2007-2008,1383,1334,-49,-3.543,-4,-45,48,155,H1
"Foard County, TX",2008-2009,1334,1321,-13,-0.975,2,-15,48,155,H1
"Foard County, TX",2009-2010,1321,1335,14,1.06,6,8,48,155,H1
"Foard County, TX",2010-2011,1335,1351,16,1.199,-3,19,48,155,H1
"Foard County, TX",2011-2012,1351,1305,-46,-3.405,0,-46,48,155,H1
"Foard County, TX",2012-2013,1305,1270,-35,-2.682,-6,-29,48,155,H1
"Foard County, TX",2013-2014,1270,1275,5,0.394,0,5,48,155,H1
"Foard County, TX",2014-2015,1268,1220,-48,-3.785,-1,-47,48,155,H1
"Foard County, TX",2015-2016,1220,1211,-9,-0.738,-3,-6,48,155,H1
"Foard County, TX",2016-2017,1211,1222,11,0.908,-1,12,48,155,H1
"Fort Bend County, TX",2000-2001,358738,375708,16970,4.73,3825,13145,48,157,H1
"Fort Bend County, TX",2001-2002,375708,397943,22235,5.918,3769,18466,48,157,H1
"Fort Bend County, TX",2002-2003,397943,418747,20804,5.228,4302,16502,48,157,H1
"Fort Bend County, TX",2003-2004,418747,441139,22392,5.347,4331,18061,48,157,H1
"Fort Bend County, TX",2004-2005,441139,462953,21814,4.945,4661,17153,48,157,H1
"Fort Bend County, TX",2005-2006,462953,490916,27963,6.04,4960,23003,48,157,H1
"Fort Bend County, TX",2006-2007,490916,516564,25648,5.225,5323,20325,48,157,H1
"Fort Bend County, TX",2007-2008,516564,542957,26393,5.109,5483,20910,48,157,H1
"Fort Bend County, TX",2008-2009,542957,569130,26173,4.82,5783,20390,48,157,H1
"Fort Bend County, TX",2009-2010,569130,590619,21489,3.776,5012,16477,48,157,H1
"Fort Bend County, TX",2010-2011,590619,607501,16882,2.858,5394,11488,48,157,H1
"Fort Bend County, TX",2011-2012,607501,626704,19203,3.161,5539,13664,48,157,H1
"Fort Bend County, TX",2012-2013,626704,654561,27857,4.445,5694,22163,48,157,H1
"Fort Bend County, TX",2013-2014,654561,685345,30784,4.703,5766,25018,48,157,H1
"Fort Bend County, TX",2014-2015,686650,716087,29437,4.287,6107,23330,48,157,H1
"Fort Bend County, TX",2015-2016,716087,741958,25871,3.613,6799,19072,48,157,H1
"Fort Bend County, TX",2016-2017,741958,764828,22870,3.082,6717,16153,48,157,H1
"Franklin County, TX",2000-2001,9459,9521,62,0.655,12,50,48,159,H1
"Franklin County, TX",2001-2002,9521,9536,15,0.158,-8,23,48,159,H1
"Franklin County, TX",2002-2003,9536,9597,61,0.64,-6,67,48,159,H1
"Franklin County, TX",2003-2004,9597,9731,134,1.396,-5,139,48,159,H1
"Franklin County, TX",2004-2005,9731,10745,1014,10.42,38,976,48,159,H1
"Franklin County, TX",2005-2006,10745,10755,10,0.093,17,-7,48,159,H1
"Franklin County, TX",2006-2007,10755,10799,44,0.409,24,20,48,159,H1
"Franklin County, TX",2007-2008,10799,10604,-195,-1.806,21,-216,48,159,H1
"Franklin County, TX",2008-2009,10604,10601,-3,-0.028,20,-23,48,159,H1
"Franklin County, TX",2009-2010,10601,10606,5,0.047,20,-15,48,159,H1
"Franklin County, TX",2010-2011,10606,10544,-62,-0.585,7,-69,48,159,H1
"Franklin County, TX",2011-2012,10544,10636,92,0.873,-8,100,48,159,H1
"Franklin County, TX",2012-2013,10636,10612,-24,-0.226,6,-30,48,159,H1
"Franklin County, TX",2013-2014,10612,10600,-12,-0.113,-11,-1,48,159,H1
"Franklin County, TX",2014-2015,10593,10651,58,0.548,-10,68,48,159,H1
"Franklin County, TX",2015-2016,10651,10659,8,0.075,-3,11,48,159,H1
"Franklin County, TX",2016-2017,10659,10767,108,1.013,-13,121,48,159,H1
"Freestone County, TX",2000-2001,17902,18127,225,1.257,-5,230,48,161,H1
"Freestone County, TX",2001-2002,18127,18395,268,1.478,-3,271,48,161,H1
"Freestone County, TX",2002-2003,18395,18483,88,0.478,-32,120,48,161,H1
"Freestone County, TX",2003-2004,18483,18684,201,1.087,-9,210,48,161,H1
"Freestone County, TX",2004-2005,18684,18843,159,0.851,-2,161,48,161,H1
"Freestone County, TX",2005-2006,18843,19123,280,1.486,50,230,48,161,H1
"Freestone County, TX",2006-2007,19123,19162,39,0.204,40,-1,48,161,H1
"Freestone County, TX",2007-2008,19162,19446,284,1.482,59,225,48,161,H1
"Freestone County, TX",2008-2009,19446,19743,297,1.527,55,242,48,161,H1
"Freestone County, TX",2009-2010,19743,19810,67,0.339,43,24,48,161,H1
"Freestone County, TX",2010-2011,19810,19622,-188,-0.949,29,-217,48,161,H1
"Freestone County, TX",2011-2012,19622,19481,-141,-0.719,-18,-123,48,161,H1
"Freestone County, TX",2012-2013,19481,19629,148,0.76,23,125,48,161,H1
"Freestone County, TX",2013-2014,19629,19762,133,0.678,29,104,48,161,H1
"Freestone County, TX",2014-2015,19647,19691,44,0.224,26,18,48,161,H1
"Freestone County, TX",2015-2016,19691,19647,-44,-0.223,35,-79,48,161,H1
"Freestone County, TX",2016-2017,19647,19625,-22,-0.112,11,-33,48,161,H1
"Frio County, TX",2000-2001,16203,16315,112,0.691,152,-40,48,163,H1
"Frio County, TX",2001-2002,16315,16467,152,0.932,161,-9,48,163,H1
"Frio County, TX",2002-2003,16467,16477,10,0.061,117,-107,48,163,H1
"Frio County, TX",2003-2004,16477,16532,55,0.334,117,-62,48,163,H1
"Frio County, TX",2004-2005,16532,16618,86,0.52,129,-43,48,163,H1
"Frio County, TX",2005-2006,16618,16720,102,0.614,122,-20,48,163,H1
"Frio County, TX",2006-2007,16720,16776,56,0.335,131,-75,48,163,H1
"Frio County, TX",2007-2008,16776,16939,163,0.972,153,10,48,163,H1
"Frio County, TX",2008-2009,16939,17120,181,1.069,153,28,48,163,H1
"Frio County, TX",2009-2010,17120,17243,123,0.718,123,0,48,163,H1
"Frio County, TX",2010-2011,17243,17458,215,1.247,154,61,48,163,H1
"Frio County, TX",2011-2012,17458,17829,371,2.125,95,276,48,163,H1
"Frio County, TX",2012-2013,17829,18172,343,1.924,134,209,48,163,H1
"Frio County, TX",2013-2014,18172,18531,359,1.976,141,218,48,163,H1
"Frio County, TX",2014-2015,18577,18793,216,1.163,155,61,48,163,H1
"Frio County, TX",2015-2016,18793,19385,592,3.15,105,487,48,163,H1
"Frio County, TX",2016-2017,19385,19600,215,1.109,110,105,48,163,H1
"Gaines County, TX",2000-2001,14473,14451,-22,-0.152,195,-217,48,165,H1
"Gaines County, TX",2001-2002,14451,14453,2,0.014,151,-149,48,165,H1
"Gaines County, TX",2002-2003,14453,14747,294,2.034,179,115,48,165,H1
"Gaines County, TX",2003-2004,14747,14978,231,1.566,196,35,48,165,H1
"Gaines County, TX",2004-2005,14978,15331,353,2.357,182,171,48,165,H1
"Gaines County, TX",2005-2006,15331,15707,376,2.453,201,175,48,165,H1
"Gaines County, TX",2006-2007,15707,16187,480,3.056,204,276,48,165,H1
"Gaines County, TX",2007-2008,16187,16641,454,2.805,261,193,48,165,H1
"Gaines County, TX",2008-2009,16641,17163,522,3.137,244,278,48,165,H1
"Gaines County, TX",2009-2010,17163,17572,409,2.383,241,168,48,165,H1
"Gaines County, TX",2010-2011,17572,18064,492,2.8,241,251,48,165,H1
"Gaines County, TX",2011-2012,18064,18452,388,2.148,257,131,48,165,H1
"Gaines County, TX",2012-2013,18452,18965,513,2.78,272,241,48,165,H1
"Gaines County, TX",2013-2014,18965,19425,460,2.426,257,203,48,165,H1
"Gaines County, TX",2014-2015,19279,20051,772,4.004,280,492,48,165,H1
"Gaines County, TX",2015-2016,20051,20481,430,2.145,349,81,48,165,H1
"Gaines County, TX",2016-2017,20481,20638,157,0.767,333,-176,48,165,H1
"Galveston County, TX",2000-2001,250675,254521,3846,1.534,1631,2215,48,167,H1
"Galveston County, TX",2001-2002,254521,260096,5575,2.19,1507,4068,48,167,H1
"Galveston County, TX",2002-2003,260096,265269,5173,1.989,1692,3481,48,167,H1
"Galveston County, TX",2003-2004,265269,269760,4491,1.693,1703,2788,48,167,H1
"Galveston County, TX",2004-2005,269760,274806,5046,1.871,1579,3467,48,167,H1
"Galveston County, TX",2005-2006,274806,279182,4376,1.592,1623,2753,48,167,H1
"Galveston County, TX",2006-2007,279182,283770,4588,1.643,1875,2713,48,167,H1
"Galveston County, TX",2007-2008,283770,288643,4873,1.717,1879,2994,48,167,H1
"Galveston County, TX",2008-2009,288643,287428,-1215,-0.421,1878,-3093,48,167,H1
"Galveston County, TX",2009-2010,287428,292574,5146,1.79,1624,3522,48,167,H1
"Galveston County, TX",2010-2011,292574,295673,3099,1.059,1673,1426,48,167,H1
"Galveston County, TX",2011-2012,295673,301469,5796,1.96,1707,4089,48,167,H1
"Galveston County, TX",2012-2013,301469,307465,5996,1.989,1477,4519,48,167,H1
"Galveston County, TX",2013-2014,307465,314198,6733,2.19,1459,5274,48,167,H1
"Galveston County, TX",2014-2015,314283,322225,7942,2.527,1517,6425,48,167,H1
"Galveston County, TX",2015-2016,322225,329306,7081,2.198,1559,5522,48,167,H1
"Galveston County, TX",2016-2017,329306,335036,5730,1.74,1412,4318,48,167,H1
"Garza County, TX",2000-2001,4904,5275,371,7.565,12,359,48,169,H1
"Garza County, TX",2001-2002,5275,5385,110,2.085,13,97,48,169,H1
"Garza County, TX",2002-2003,5385,5531,146,2.711,15,131,48,169,H1
"Garza County, TX",2003-2004,5531,5800,269,4.863,6,263,48,169,H1
"Garza County, TX",2004-2005,5800,5742,-58,-1,14,-72,48,169,H1
"Garza County, TX",2005-2006,5742,5996,254,4.424,17,237,48,169,H1
"Garza County, TX",2006-2007,5996,6049,53,0.884,49,4,48,169,H1
"Garza County, TX",2007-2008,6049,6158,109,1.802,22,87,48,169,H1
"Garza County, TX",2008-2009,6158,6368,210,3.41,15,195,48,169,H1
"Garza County, TX",2009-2010,6368,6460,92,1.445,31,61,48,169,H1
"Garza County, TX",2010-2011,6460,6576,116,1.796,9,107,48,169,H1
"Garza County, TX",2011-2012,6576,6450,-126,-1.916,13,-139,48,169,H1
"Garza County, TX",2012-2013,6450,6405,-45,-0.698,6,-51,48,169,H1
"Garza County, TX",2013-2014,6405,6435,30,0.468,5,25,48,169,H1
"Garza County, TX",2014-2015,6445,6415,-30,-0.465,26,-56,48,169,H1
"Garza County, TX",2015-2016,6415,6444,29,0.452,41,-12,48,169,H1
"Garza County, TX",2016-2017,6444,6528,84,1.304,48,36,48,169,H1
"Gillespie County, TX",2000-2001,20902,21104,202,0.966,-62,264,48,171,H1
"Gillespie County, TX",2001-2002,21104,21585,481,2.279,-70,551,48,171,H1
"Gillespie County, TX",2002-2003,21585,22128,543,2.516,-68,611,48,171,H1
"Gillespie County, TX",2003-2004,22128,22454,326,1.473,-21,347,48,171,H1
"Gillespie County, TX",2004-2005,22454,22858,404,1.799,-78,482,48,171,H1
"Gillespie County, TX",2005-2006,22858,23487,629,2.752,-46,675,48,171,H1
"Gillespie County, TX",2006-2007,23487,23787,300,1.277,-24,324,48,171,H1
"Gillespie County, TX",2007-2008,23787,24206,419,1.761,-16,435,48,171,H1
"Gillespie County, TX",2008-2009,24206,24608,402,1.661,-38,440,48,171,H1
"Gillespie County, TX",2009-2010,24608,24870,262,1.065,-65,327,48,171,H1
"Gillespie County, TX",2010-2011,24870,25022,152,0.611,-102,254,48,171,H1
"Gillespie County, TX",2011-2012,25022,25150,128,0.512,-103,231,48,171,H1
"Gillespie County, TX",2012-2013,25150,25334,184,0.732,-94,278,48,171,H1
"Gillespie County, TX",2013-2014,25334,25520,186,0.734,-99,285,48,171,H1
"Gillespie County, TX",2014-2015,25509,25963,454,1.78,-95,549,48,171,H1
"Gillespie County, TX",2015-2016,25963,26305,342,1.317,-69,411,48,171,H1
"Gillespie County, TX",2016-2017,26305,26646,341,1.296,-104,445,48,171,H1
"Glasscock County, TX",2000-2001,1407,1351,-56,-3.98,17,-73,48,173,H1
"Glasscock County, TX",2001-2002,1351,1339,-12,-0.888,8,-20,48,173,H1
"Glasscock County, TX",2002-2003,1339,1332,-7,-0.523,10,-17,48,173,H1
"Glasscock County, TX",2003-2004,1332,1290,-42,-3.153,4,-46,48,173,H1
"Glasscock County, TX",2004-2005,1290,1273,-17,-1.318,2,-19,48,173,H1
"Glasscock County, TX",2005-2006,1273,1202,-71,-5.577,3,-74,48,173,H1
"Glasscock County, TX",2006-2007,1202,1164,-38,-3.161,7,-45,48,173,H1
"Glasscock County, TX",2007-2008,1164,1218,54,4.639,10,44,48,173,H1
"Glasscock County, TX",2008-2009,1218,1224,6,0.493,13,-7,48,173,H1
"Glasscock County, TX",2009-2010,1224,1228,4,0.327,13,-9,48,173,H1
"Glasscock County, TX",2010-2011,1228,1231,3,0.244,3,0,48,173,H1
"Glasscock County, TX",2011-2012,1231,1256,25,2.031,15,10,48,173,H1
"Glasscock County, TX",2012-2013,1256,1245,-11,-0.876,2,-13,48,173,H1
"Glasscock County, TX",2013-2014,1245,1291,46,3.695,6,40,48,173,H1
"Glasscock County, TX",2014-2015,1291,1315,24,1.859,5,19,48,173,H1
"Glasscock County, TX",2015-2016,1315,1350,35,2.662,11,24,48,173,H1
"Glasscock County, TX",2016-2017,1350,1348,-2,-0.148,8,-10,48,173,H1
"Goliad County, TX",2000-2001,7007,7020,13,0.186,22,-9,48,175,H1
"Goliad County, TX",2001-2002,7020,7051,31,0.442,7,24,48,175,H1
"Goliad County, TX",2002-2003,7051,7135,84,1.191,1,83,48,175,H1
"Goliad County, TX",2003-2004,7135,7071,-64,-0.897,0,-64,48,175,H1
"Goliad County, TX",2004-2005,7071,7070,-1,-0.014,-10,9,48,175,H1
"Goliad County, TX",2005-2006,7070,7121,51,0.721,-3,54,48,175,H1
"Goliad County, TX",2006-2007,7121,7142,21,0.295,-1,22,48,175,H1
"Goliad County, TX",2007-2008,7142,7164,22,0.308,31,-9,48,175,H1
"Goliad County, TX",2008-2009,7164,7157,-7,-0.098,26,-33,48,175,H1
"Goliad County, TX",2009-2010,7157,7221,64,0.894,-5,69,48,175,H1
"Goliad County, TX",2010-2011,7221,7206,-15,-0.208,0,-15,48,175,H1
"Goliad County, TX",2011-2012,7206,7338,132,1.832,-22,154,48,175,H1
"Goliad County, TX",2012-2013,7338,7469,131,1.785,12,119,48,175,H1
"Goliad County, TX",2013-2014,7469,7549,80,1.071,10,70,48,175,H1
"Goliad County, TX",2014-2015,7507,7531,24,0.32,2,22,48,175,H1
"Goliad County, TX",2015-2016,7531,7521,-10,-0.133,6,-16,48,175,H1
"Goliad County, TX",2016-2017,7521,7562,41,0.545,0,41,48,175,H1
"Gonzales County, TX",2000-2001,18642,18714,72,0.386,77,-5,48,177,H1
"Gonzales County, TX",2001-2002,18714,18882,168,0.898,56,112,48,177,H1
"Gonzales County, TX",2002-2003,18882,19181,299,1.584,195,104,48,177,H1
"Gonzales County, TX",2003-2004,19181,19370,189,0.985,139,50,48,177,H1
"Gonzales County, TX",2004-2005,19370,19656,286,1.477,152,134,48,177,H1
"Gonzales County, TX",2005-2006,19656,19633,-23,-0.117,187,-210,48,177,H1
"Gonzales County, TX",2006-2007,19633,19512,-121,-0.616,136,-257,48,177,H1
"Gonzales County, TX",2007-2008,19512,19538,26,0.133,156,-130,48,177,H1
"Gonzales County, TX",2008-2009,19538,19628,90,0.461,196,-106,48,177,H1
"Gonzales County, TX",2009-2010,19628,19821,193,0.983,180,13,48,177,H1
"Gonzales County, TX",2010-2011,19821,19795,-26,-0.131,67,-93,48,177,H1
"Gonzales County, TX",2011-2012,19795,19971,176,0.889,111,65,48,177,H1
"Gonzales County, TX",2012-2013,19971,20219,248,1.242,103,145,48,177,H1
"Gonzales County, TX",2013-2014,20219,20462,243,1.202,83,160,48,177,H1
"Gonzales County, TX",2014-2015,20413,20573,160,0.784,93,67,48,177,H1
"Gonzales County, TX",2015-2016,20573,20863,290,1.41,122,168,48,177,H1
"Gonzales County, TX",2016-2017,20863,20893,30,0.144,120,-90,48,177,H1
"Gray County, TX",2000-2001,22578,22171,-407,-1.803,-55,-352,48,179,H1
"Gray County, TX",2001-2002,22171,21940,-231,-1.042,-6,-225,48,179,H1
"Gray County, TX",2002-2003,21940,21762,-178,-0.811,-13,-165,48,179,H1
"Gray County, TX",2003-2004,21762,21551,-211,-0.97,25,-236,48,179,H1
"Gray County, TX",2004-2005,21551,21776,225,1.044,26,199,48,179,H1
"Gray County, TX",2005-2006,21776,22100,324,1.488,46,278,48,179,H1
"Gray County, TX",2006-2007,22100,22438,338,1.529,36,302,48,179,H1
"Gray County, TX",2007-2008,22438,22772,334,1.489,97,237,48,179,H1
"Gray County, TX",2008-2009,22772,22719,-53,-0.233,117,-170,48,179,H1
"Gray County, TX",2009-2010,22719,22466,-253,-1.114,116,-369,48,179,H1
"Gray County, TX",2010-2011,22466,22584,118,0.525,59,59,48,179,H1
"Gray County, TX",2011-2012,22584,22833,249,1.103,79,170,48,179,H1
"Gray County, TX",2012-2013,22833,22929,96,0.42,104,-8,48,179,H1
"Gray County, TX",2013-2014,22929,23044,115,0.502,116,-1,48,179,H1
"Gray County, TX",2014-2015,23419,23210,-209,-0.892,99,-308,48,179,H1
"Gray County, TX",2015-2016,23210,22738,-472,-2.034,79,-551,48,179,H1
"Gray County, TX",2016-2017,22738,22404,-334,-1.469,65,-399,48,179,H1
"Grayson County, TX",2000-2001,110939,112330,1391,1.254,192,1199,48,181,H1
"Grayson County, TX",2001-2002,112330,113239,909,0.809,373,536,48,181,H1
"Grayson County, TX",2002-2003,113239,114421,1182,1.044,354,828,48,181,H1
"Grayson County, TX",2003-2004,114421,114998,577,0.504,395,182,48,181,H1
"Grayson County, TX",2004-2005,114998,115666,668,0.581,350,318,48,181,H1
"Grayson County, TX",2005-2006,115666,117174,1508,1.304,361,1147,48,181,H1
"Grayson County, TX",2006-2007,117174,118331,1157,0.987,270,887,48,181,H1
"Grayson County, TX",2007-2008,118331,118834,503,0.425,308,195,48,181,H1
"Grayson County, TX",2008-2009,118834,120069,1235,1.039,428,807,48,181,H1
"Grayson County, TX",2009-2010,120069,121086,1017,0.847,352,665,48,181,H1
"Grayson County, TX",2010-2011,121086,121283,197,0.163,199,-2,48,181,H1
"Grayson County, TX",2011-2012,121283,121631,348,0.287,89,259,48,181,H1
"Grayson County, TX",2012-2013,121631,122343,712,0.585,192,520,48,181,H1
"Grayson County, TX",2013-2014,122343,123534,1191,0.973,207,984,48,181,H1
"Grayson County, TX",2014-2015,123419,125467,2048,1.659,249,1799,48,181,H1
"Grayson County, TX",2015-2016,125467,128206,2739,2.183,170,2569,48,181,H1
"Grayson County, TX",2016-2017,128206,131140,2934,2.289,257,2677,48,181,H1
"Gregg County, TX",2000-2001,111255,111791,536,0.482,512,24,48,183,H1
"Gregg County, TX",2001-2002,111791,112767,976,0.873,653,323,48,183,H1
"Gregg County, TX",2002-2003,112767,113775,1008,0.894,725,283,48,183,H1
"Gregg County, TX",2003-2004,113775,114541,766,0.673,713,53,48,183,H1
"Gregg County, TX",2004-2005,114541,115402,861,0.752,630,231,48,183,H1
"Gregg County, TX",2005-2006,115402,117118,1716,1.487,745,971,48,183,H1
"Gregg County, TX",2006-2007,117118,118260,1142,0.975,888,254,48,183,H1
"Gregg County, TX",2007-2008,118260,119157,897,0.758,786,111,48,183,H1
"Gregg County, TX",2008-2009,119157,121238,2081,1.746,688,1393,48,183,H1
"Gregg County, TX",2009-2010,121238,121958,720,0.594,760,-40,48,183,H1
"Gregg County, TX",2010-2011,121958,122430,472,0.387,611,-139,48,183,H1
"Gregg County, TX",2011-2012,122430,122896,466,0.381,758,-292,48,183,H1
"Gregg County, TX",2012-2013,122896,123194,298,0.242,628,-330,48,183,H1
"Gregg County, TX",2013-2014,123194,123204,10,0.008,631,-621,48,183,H1
"Gregg County, TX",2014-2015,123159,124108,949,0.771,627,322,48,183,H1
"Gregg County, TX",2015-2016,124108,123594,-514,-0.414,540,-1054,48,183,H1
"Gregg County, TX",2016-2017,123594,123367,-227,-0.184,504,-731,48,183,H1
"Grimes County, TX",2000-2001,23601,24219,618,2.619,77,541,48,185,H1
"Grimes County, TX",2001-2002,24219,24736,517,2.135,63,454,48,185,H1
"Grimes County, TX",2002-2003,24736,25016,280,1.132,90,190,48,185,H1
"Grimes County, TX",2003-2004,25016,25209,193,0.772,88,105,48,185,H1
"Grimes County, TX",2004-2005,25209,25350,141,0.559,103,38,48,185,H1
"Grimes County, TX",2005-2006,25350,25639,289,1.14,121,168,48,185,H1
"Grimes County, TX",2006-2007,25639,26046,407,1.587,182,225,48,185,H1
"Grimes County, TX",2007-2008,26046,26273,227,0.872,124,103,48,185,H1
"Grimes County, TX",2008-2009,26273,26422,149,0.567,111,38,48,185,H1
"Grimes County, TX",2009-2010,26422,26593,171,0.647,72,99,48,185,H1
"Grimes County, TX",2010-2011,26593,26691,98,0.369,1,97,48,185,H1
"Grimes County, TX",2011-2012,26691,26724,33,0.124,43,-10,48,185,H1
"Grimes County, TX",2012-2013,26724,26881,157,0.587,72,85,48,185,H1
"Grimes County, TX",2013-2014,26881,27172,291,1.083,71,220,48,185,H1
"Grimes County, TX",2014-2015,27069,27512,443,1.637,122,321,48,185,H1
"Grimes County, TX",2015-2016,27512,27574,62,0.225,98,-36,48,185,H1
"Grimes County, TX",2016-2017,27574,28082,508,1.842,91,417,48,185,H1
"Guadalupe County, TX",2000-2001,89841,92626,2785,3.1,619,2166,48,187,H1
"Guadalupe County, TX",2001-2002,92626,95246,2620,2.829,517,2103,48,187,H1
"Guadalupe County, TX",2002-2003,95246,98137,2891,3.035,487,2404,48,187,H1
"Guadalupe County, TX",2003-2004,98137,101495,3358,3.422,590,2768,48,187,H1
"Guadalupe County, TX",2004-2005,101495,105585,4090,4.03,691,3399,48,187,H1
"Guadalupe County, TX",2005-2006,105585,111878,6293,5.96,751,5542,48,187,H1
"Guadalupe County, TX",2006-2007,111878,117667,5789,5.174,769,5020,48,187,H1
"Guadalupe County, TX",2007-2008,117667,123398,5731,4.871,840,4891,48,187,H1
"Guadalupe County, TX",2008-2009,123398,128265,4867,3.944,882,3985,48,187,H1
"Guadalupe County, TX",2009-2010,128265,132552,4287,3.342,741,3546,48,187,H1
"Guadalupe County, TX",2010-2011,132552,135837,3285,2.478,773,2512,48,187,H1
"Guadalupe County, TX",2011-2012,135837,139714,3877,2.854,828,3049,48,187,H1
"Guadalupe County, TX",2012-2013,139714,143191,3477,2.489,788,2689,48,187,H1
"Guadalupe County, TX",2013-2014,143191,147250,4059,2.835,838,3221,48,187,H1
"Guadalupe County, TX",2014-2015,147272,151249,3977,2.7,826,3151,48,187,H1
"Guadalupe County, TX",2015-2016,151249,154596,3347,2.213,799,2548,48,187,H1
"Guadalupe County, TX",2016-2017,154596,159659,5063,3.275,804,4259,48,187,H1
"Hale County, TX",2000-2001,36581,35876,-705,-1.927,333,-1038,48,189,H1
"Hale County, TX",2001-2002,35876,35598,-278,-0.775,317,-595,48,189,H1
"Hale County, TX",2002-2003,35598,35553,-45,-0.126,355,-400,48,189,H1
"Hale County, TX",2003-2004,35553,36259,706,1.986,376,330,48,189,H1
"Hale County, TX",2004-2005,36259,36066,-193,-0.532,285,-478,48,189,H1
"Hale County, TX",2005-2006,36066,36162,96,0.266,279,-183,48,189,H1
"Hale County, TX",2006-2007,36162,36080,-82,-0.227,381,-463,48,189,H1
"Hale County, TX",2007-2008,36080,35662,-418,-1.159,325,-743,48,189,H1
"Hale County, TX",2008-2009,35662,35926,264,0.74,339,-75,48,189,H1
"Hale County, TX",2009-2010,35926,36355,429,1.194,386,43,48,189,H1
"Hale County, TX",2010-2011,36355,36423,68,0.187,241,-173,48,189,H1
"Hale County, TX",2011-2012,36423,36316,-107,-0.294,282,-389,48,189,H1
"Hale County, TX",2012-2013,36316,35809,-507,-1.396,231,-738,48,189,H1
"Hale County, TX",2013-2014,35809,34720,-1089,-3.041,210,-1299,48,189,H1
"Hale County, TX",2014-2015,34602,34360,-242,-0.699,173,-415,48,189,H1
"Hale County, TX",2015-2016,34360,34209,-151,-0.439,148,-299,48,189,H1
"Hale County, TX",2016-2017,34209,34134,-75,-0.219,162,-237,48,189,H1
"Hall County, TX",2000-2001,3749,3750,1,0.027,-7,8,48,191,H1
"Hall County, TX",2001-2002,3750,3709,-41,-1.093,0,-41,48,191,H1
"Hall County, TX",2002-2003,3709,3699,-10,-0.27,-4,-6,48,191,H1
"Hall County, TX",2003-2004,3699,3665,-34,-0.919,-12,-22,48,191,H1
"Hall County, TX",2004-2005,3665,3613,-52,-1.419,-14,-38,48,191,H1
"Hall County, TX",2005-2006,3613,3582,-31,-0.858,-4,-27,48,191,H1
"Hall County, TX",2006-2007,3582,3440,-142,-3.964,-17,-125,48,191,H1
"Hall County, TX",2007-2008,3440,3398,-42,-1.221,4,-46,48,191,H1
"Hall County, TX",2008-2009,3398,3343,-55,-1.619,12,-67,48,191,H1
"Hall County, TX",2009-2010,3343,3356,13,0.389,-1,14,48,191,H1
"Hall County, TX",2010-2011,3356,3322,-34,-1.013,-1,-33,48,191,H1
"Hall County, TX",2011-2012,3322,3298,-24,-0.722,-24,0,48,191,H1
"Hall County, TX",2012-2013,3298,3226,-72,-2.183,-14,-58,48,191,H1
"Hall County, TX",2013-2014,3226,3147,-79,-2.449,2,-81,48,191,H1
"Hall County, TX",2014-2015,3105,3138,33,1.063,-3,36,48,191,H1
"Hall County, TX",2015-2016,3138,3112,-26,-0.829,-14,-12,48,191,H1
"Hall County, TX",2016-2017,3112,3071,-41,-1.317,-7,-34,48,191,H1
"Hamilton County, TX",2000-2001,8239,8169,-70,-0.85,-54,-16,48,193,H1
"Hamilton County, TX",2001-2002,8169,8069,-100,-1.224,-43,-57,48,193,H1
"Hamilton County, TX",2002-2003,8069,8225,156,1.933,-25,181,48,193,H1
"Hamilton County, TX",2003-2004,8225,8181,-44,-0.535,-59,15,48,193,H1
"Hamilton County, TX",2004-2005,8181,8263,82,1.002,-65,147,48,193,H1
"Hamilton County, TX",2005-2006,8263,8389,126,1.525,-33,159,48,193,H1
"Hamilton County, TX",2006-2007,8389,8452,63,0.751,-41,104,48,193,H1
"Hamilton County, TX",2007-2008,8452,8497,45,0.532,-33,78,48,193,H1
"Hamilton County, TX",2008-2009,8497,8527,30,0.353,-29,59,48,193,H1
"Hamilton County, TX",2009-2010,8527,8485,-42,-0.493,-30,-12,48,193,H1
"Hamilton County, TX",2010-2011,8485,8412,-73,-0.86,-46,-27,48,193,H1
"Hamilton County, TX",2011-2012,8412,8290,-122,-1.45,-33,-89,48,193,H1
"Hamilton County, TX",2012-2013,8290,8262,-28,-0.338,-29,1,48,193,H1
"Hamilton County, TX",2013-2014,8262,8199,-63,-0.763,-30,-33,48,193,H1
"Hamilton County, TX",2014-2015,8190,8159,-31,-0.379,-27,-4,48,193,H1
"Hamilton County, TX",2015-2016,8159,8231,72,0.882,-50,122,48,193,H1
"Hamilton County, TX",2016-2017,8231,8422,191,2.32,-29,220,48,193,H1
"Hansford County, TX",2000-2001,5347,5299,-48,-0.898,21,-69,48,195,H1
"Hansford County, TX",2001-2002,5299,5242,-57,-1.076,17,-74,48,195,H1
"Hansford County, TX",2002-2003,5242,5216,-26,-0.496,28,-54,48,195,H1
"Hansford County, TX",2003-2004,5216,5209,-7,-0.134,49,-56,48,195,H1
"Hansford County, TX",2004-2005,5209,5258,49,0.941,51,-2,48,195,H1
"Hansford County, TX",2005-2006,5258,5293,35,0.666,58,-23,48,195,H1
"Hansford County, TX",2006-2007,5293,5365,72,1.36,32,40,48,195,H1
"Hansford County, TX",2007-2008,5365,5512,147,2.74,56,91,48,195,H1
"Hansford County, TX",2008-2009,5512,5556,44,0.798,85,-41,48,195,H1
"Hansford County, TX",2009-2010,5556,5605,49,0.882,82,-33,48,195,H1
"Hansford County, TX",2010-2011,5605,5571,-34,-0.607,29,-63,48,195,H1
"Hansford County, TX",2011-2012,5571,5502,-69,-1.239,24,-93,48,195,H1
"Hansford County, TX",2012-2013,5502,5515,13,0.236,38,-25,48,195,H1
"Hansford County, TX",2013-2014,5515,5509,-6,-0.109,46,-52,48,195,H1
"Hansford County, TX",2014-2015,5537,5610,73,1.318,46,27,48,195,H1
"Hansford County, TX",2015-2016,5610,5532,-78,-1.39,21,-99,48,195,H1
"Hansford County, TX",2016-2017,5532,5447,-85,-1.537,36,-121,48,195,H1
"Hardeman County, TX",2000-2001,4718,4609,-109,-2.31,-16,-93,48,197,H1
"Hardeman County, TX",2001-2002,4609,4547,-62,-1.345,-24,-38,48,197,H1
"Hardeman County, TX",2002-2003,4547,4534,-13,-0.286,-11,-2,48,197,H1
"Hardeman County, TX",2003-2004,4534,4474,-60,-1.323,-9,-51,48,197,H1
"Hardeman County, TX",2004-2005,4474,4417,-57,-1.274,17,-74,48,197,H1
"Hardeman County, TX",2005-2006,4417,4409,-8,-0.181,7,-15,48,197,H1
"Hardeman County, TX",2006-2007,4409,4296,-113,-2.563,5,-118,48,197,H1
"Hardeman County, TX",2007-2008,4296,4187,-109,-2.537,34,-143,48,197,H1
"Hardeman County, TX",2008-2009,4187,4086,-101,-2.412,17,-118,48,197,H1
"Hardeman County, TX",2009-2010,4086,4153,67,1.64,5,62,48,197,H1
"Hardeman County, TX",2010-2011,4153,4117,-36,-0.867,11,-47,48,197,H1
"Hardeman County, TX",2011-2012,4117,4048,-69,-1.676,-21,-48,48,197,H1
"Hardeman County, TX",2012-2013,4048,4006,-42,-1.038,16,-58,48,197,H1
"Hardeman County, TX",2013-2014,4006,3928,-78,-1.947,2,-80,48,197,H1
"Hardeman County, TX",2014-2015,3934,3840,-94,-2.389,-1,-93,48,197,H1
"Hardeman County, TX",2015-2016,3840,3991,151,3.932,22,129,48,197,H1
"Hardeman County, TX",2016-2017,3991,3994,3,0.075,8,-5,48,197,H1
"Hardin County, TX",2000-2001,48162,48463,301,0.625,156,145,48,199,H1
"Hardin County, TX",2001-2002,48463,49045,582,1.201,206,376,48,199,H1
"Hardin County, TX",2002-2003,49045,49472,427,0.871,138,289,48,199,H1
"Hardin County, TX",2003-2004,49472,50220,748,1.512,206,542,48,199,H1
"Hardin County, TX",2004-2005,50220,51141,921,1.834,176,745,48,199,H1
"Hardin County, TX",2005-2006,51141,51470,329,0.643,123,206,48,199,H1
"Hardin County, TX",2006-2007,51470,52446,976,1.896,184,792,48,199,H1
"Hardin County, TX",2007-2008,52446,53206,760,1.449,222,538,48,199,H1
"Hardin County, TX",2008-2009,53206,54228,1022,1.921,195,827,48,199,H1
"Hardin County, TX",2009-2010,54228,54821,593,1.094,163,430,48,199,H1
"Hardin County, TX",2010-2011,54821,55062,241,0.44,148,93,48,199,H1
"Hardin County, TX",2011-2012,55062,55149,87,0.158,141,-54,48,199,H1
"Hardin County, TX",2012-2013,55149,55421,272,0.493,155,117,48,199,H1
"Hardin County, TX",2013-2014,55421,55621,200,0.361,171,29,48,199,H1
"Hardin County, TX",2014-2015,55540,55865,325,0.585,195,130,48,199,H1
"Hardin County, TX",2015-2016,55865,56261,396,0.709,118,278,48,199,H1
"Hardin County, TX",2016-2017,56261,57139,878,1.561,119,759,48,199,H1
"Harris County, TX",2000-2001,3414239,3471291,57052,1.671,42706,14346,48,201,H1
"Harris County, TX",2001-2002,3471291,3536682,65391,1.884,43241,22150,48,201,H1
"Harris County, TX",2002-2003,3536682,3586133,49451,1.398,45625,3826,48,201,H1
"Harris County, TX",2003-2004,3586133,3630185,44052,1.228,46661,-2609,48,201,H1
"Harris County, TX",2004-2005,3630185,3681829,51644,1.423,47234,4410,48,201,H1
"Harris County, TX",2005-2006,3681829,3807435,125606,3.412,48220,77386,48,201,H1
"Harris County, TX",2006-2007,3807435,3863344,55909,1.468,49557,6352,48,201,H1
"Harris County, TX",2007-2008,3863344,3938580,75236,1.947,48805,26431,48,201,H1
"Harris County, TX",2008-2009,3938580,4034866,96286,2.445,47627,48659,48,201,H1
"Harris County, TX",2009-2010,4034866,4108909,74043,1.835,50462,23581,48,201,H1
"Harris County, TX",2010-2011,4108909,4181948,73039,1.778,44991,28048,48,201,H1
"Harris County, TX",2011-2012,4181948,4263060,81112,1.94,43655,37457,48,201,H1
"Harris County, TX",2012-2013,4263060,4352752,89692,2.104,43651,46041,48,201,H1
"Harris County, TX",2013-2014,4352752,4441370,88618,2.036,43820,44798,48,201,H1
"Harris County, TX",2014-2015,4447577,4538028,90451,2.034,45058,45393,48,201,H1
"Harris County, TX",2015-2016,4538028,4617041,79013,1.741,47166,31847,48,201,H1
"Harris County, TX",2016-2017,4617041,4652980,35939,0.778,46122,-10183,48,201,H1
"Harrison County, TX",2000-2001,62040,62256,216,0.348,122,94,48,203,H1
"Harrison County, TX",2001-2002,62256,62062,-194,-0.312,193,-387,48,203,H1
"Harrison County, TX",2002-2003,62062,62018,-44,-0.071,242,-286,48,203,H1
"Harrison County, TX",2003-2004,62018,62583,565,0.911,257,308,48,203,H1
"Harrison County, TX",2004-2005,62583,62811,228,0.364,178,50,48,203,H1
"Harrison County, TX",2005-2006,62811,63699,888,1.414,281,607,48,203,H1
"Harrison County, TX",2006-2007,63699,63661,-38,-0.06,282,-320,48,203,H1
"Harrison County, TX",2007-2008,63661,64107,446,0.701,290,156,48,203,H1
"Harrison County, TX",2008-2009,64107,65185,1078,1.682,331,747,48,203,H1
"Harrison County, TX",2009-2010,65185,65711,526,0.807,310,216,48,203,H1
"Harrison County, TX",2010-2011,65711,67338,1627,2.476,255,1372,48,203,H1
"Harrison County, TX",2011-2012,67338,67284,-54,-0.08,312,-366,48,203,H1
"Harrison County, TX",2012-2013,67284,67185,-99,-0.147,154,-253,48,203,H1
"Harrison County, TX",2013-2014,67185,67336,151,0.225,190,-39,48,203,H1
"Harrison County, TX",2014-2015,66471,66746,275,0.414,224,51,48,203,H1
"Harrison County, TX",2015-2016,66746,66730,-16,-0.024,149,-165,48,203,H1
"Harrison County, TX",2016-2017,66730,66661,-69,-0.103,155,-224,48,203,H1
"Hartley County, TX",2000-2001,5561,5601,40,0.719,37,3,48,205,H1
"Hartley County, TX",2001-2002,5601,5364,-237,-4.231,33,-270,48,205,H1
"Hartley County, TX",2002-2003,5364,5789,425,7.923,63,362,48,205,H1
"Hartley County, TX",2003-2004,5789,5800,11,0.19,28,-17,48,205,H1
"Hartley County, TX",2004-2005,5800,5794,-6,-0.103,20,-26,48,205,H1
"Hartley County, TX",2005-2006,5794,5911,117,2.019,20,97,48,205,H1
"Hartley County, TX",2006-2007,5911,6047,136,2.301,16,120,48,205,H1
"Hartley County, TX",2007-2008,6047,5820,-227,-3.754,14,-241,48,205,H1
"Hartley County, TX",2008-2009,5820,5970,150,2.577,39,111,48,205,H1
"Hartley County, TX",2009-2010,5970,6060,90,1.508,62,28,48,205,H1
"Hartley County, TX",2010-2011,6060,6084,24,0.396,21,3,48,205,H1
"Hartley County, TX",2011-2012,6084,6153,69,1.134,20,49,48,205,H1
"Hartley County, TX",2012-2013,6153,6070,-83,-1.349,39,-122,48,205,H1
"Hartley County, TX",2013-2014,6070,6089,19,0.313,33,-14,48,205,H1
"Hartley County, TX",2014-2015,6119,6193,74,1.209,44,30,48,205,H1
"Hartley County, TX",2015-2016,6193,5706,-487,-7.864,6,-493,48,205,H1
"Hartley County, TX",2016-2017,5706,5691,-15,-0.263,21,-36,48,205,H1
"Haskell County, TX",2000-2001,6062,6034,-28,-0.462,-39,11,48,207,H1
"Haskell County, TX",2001-2002,6034,5915,-119,-1.972,-19,-100,48,207,H1
"Haskell County, TX",2002-2003,5915,5883,-32,-0.541,-38,6,48,207,H1
"Haskell County, TX",2003-2004,5883,5851,-32,-0.544,-37,5,48,207,H1
"Haskell County, TX",2004-2005,5851,5904,53,0.906,-19,72,48,207,H1
"Haskell County, TX",2005-2006,5904,5817,-87,-1.474,-13,-74,48,207,H1
"Haskell County, TX",2006-2007,5817,5802,-15,-0.258,-27,12,48,207,H1
"Haskell County, TX",2007-2008,5802,5839,37,0.638,-23,60,48,207,H1
"Haskell County, TX",2008-2009,5839,5862,23,0.394,-16,39,48,207,H1
"Haskell County, TX",2009-2010,5862,5875,13,0.222,-8,21,48,207,H1
"Haskell County, TX",2010-2011,5875,5966,91,1.549,-40,131,48,207,H1
"Haskell County, TX",2011-2012,5966,5880,-86,-1.442,-43,-43,48,207,H1
"Haskell County, TX",2012-2013,5880,5884,4,0.068,-36,40,48,207,H1
"Haskell County, TX",2013-2014,5884,5769,-115,-1.954,-14,-101,48,207,H1
"Haskell County, TX",2014-2015,5767,5737,-30,-0.52,-16,-14,48,207,H1
"Haskell County, TX",2015-2016,5737,5765,28,0.488,-16,44,48,207,H1
"Haskell County, TX",2016-2017,5765,5746,-19,-0.33,-17,-2,48,207,H1
"Hays County, TX",2000-2001,99267,104739,5472,5.512,958,4514,48,209,H1
"Hays County, TX",2001-2002,104739,111397,6658,6.357,1024,5634,48,209,H1
"Hays County, TX",2002-2003,111397,115665,4268,3.831,1104,3164,48,209,H1
"Hays County, TX",2003-2004,115665,119395,3730,3.225,1074,2656,48,209,H1
"Hays County, TX",2004-2005,119395,125302,5907,4.947,1109,4798,48,209,H1
"Hays County, TX",2005-2006,125302,132111,6809,5.434,1108,5701,48,209,H1
"Hays County, TX",2006-2007,132111,140480,8369,6.335,1278,7091,48,209,H1
"Hays County, TX",2007-2008,140480,147674,7194,5.121,1476,5718,48,209,H1
"Hays County, TX",2008-2009,147674,153619,5945,4.026,1526,4419,48,209,H1
"Hays County, TX",2009-2010,153619,158307,4688,3.052,1433,3255,48,209,H1
"Hays County, TX",2010-2011,158307,163380,5073,3.205,1265,3808,48,209,H1
"Hays County, TX",2011-2012,163380,168855,5475,3.351,1249,4226,48,209,H1
"Hays County, TX",2012-2013,168855,176483,7628,4.517,1262,6366,48,209,H1
"Hays County, TX",2013-2014,176483,185025,8542,4.84,1322,7220,48,209,H1
"Hays County, TX",2014-2015,185096,194739,9643,5.21,1410,8233,48,209,H1
"Hays County, TX",2015-2016,194739,204345,9606,4.933,1405,8201,48,209,H1
"Hays County, TX",2016-2017,204345,214485,10140,4.962,1571,8569,48,209,H1
"Hemphill County, TX",2000-2001,3335,3327,-8,-0.24,14,-22,48,211,H1
"Hemphill County, TX",2001-2002,3327,3357,30,0.902,5,25,48,211,H1
"Hemphill County, TX",2002-2003,3357,3362,5,0.149,20,-15,48,211,H1
"Hemphill County, TX",2003-2004,3362,3410,48,1.428,18,30,48,211,H1
"Hemphill County, TX",2004-2005,3410,3480,70,2.053,22,48,48,211,H1
"Hemphill County, TX",2005-2006,3480,3523,43,1.236,18,25,48,211,H1
"Hemphill County, TX",2006-2007,3523,3538,15,0.426,31,-16,48,211,H1
"Hemphill County, TX",2007-2008,3538,3680,142,4.014,44,98,48,211,H1
"Hemphill County, TX",2008-2009,3680,3802,122,3.315,44,78,48,211,H1
"Hemphill County, TX",2009-2010,3802,3798,-4,-0.105,36,-40,48,211,H1
"Hemphill County, TX",2010-2011,3798,3962,164,4.318,38,126,48,211,H1
"Hemphill County, TX",2011-2012,3962,4082,120,3.029,31,89,48,211,H1
"Hemphill County, TX",2012-2013,4082,4139,57,1.396,35,22,48,211,H1
"Hemphill County, TX",2013-2014,4139,4180,41,0.991,47,-6,48,211,H1
"Hemphill County, TX",2014-2015,4163,4264,101,2.426,43,58,48,211,H1
"Hemphill County, TX",2015-2016,4264,4126,-138,-3.236,21,-159,48,211,H1
"Hemphill County, TX",2016-2017,4126,4024,-102,-2.472,32,-134,48,211,H1
"Henderson County, TX",2000-2001,73332,73762,430,0.586,-18,448,48,213,H1
"Henderson County, TX",2001-2002,73762,74712,950,1.288,90,860,48,213,H1
"Henderson County, TX",2002-2003,74712,76349,1637,2.191,76,1561,48,213,H1
"Henderson County, TX",2003-2004,76349,77807,1458,1.91,18,1440,48,213,H1
"Henderson County, TX",2004-2005,77807,78001,194,0.249,99,95,48,213,H1
"Henderson County, TX",2005-2006,78001,78404,403,0.517,126,277,48,213,H1
"Henderson County, TX",2006-2007,78404,78178,-226,-0.288,136,-362,48,213,H1
"Henderson County, TX",2007-2008,78178,78033,-145,-0.185,84,-229,48,213,H1
"Henderson County, TX",2008-2009,78033,78231,198,0.254,30,168,48,213,H1
"Henderson County, TX",2009-2010,78231,78648,417,0.533,55,362,48,213,H1
"Henderson County, TX",2010-2011,78648,78684,36,0.046,5,31,48,213,H1
"Henderson County, TX",2011-2012,78684,78942,258,0.328,-17,275,48,213,H1
"Henderson County, TX",2012-2013,78942,78618,-324,-0.41,-158,-166,48,213,H1
"Henderson County, TX",2013-2014,78618,79290,672,0.855,-121,793,48,213,H1
"Henderson County, TX",2014-2015,79259,79545,286,0.361,-108,394,48,213,H1
"Henderson County, TX",2015-2016,79545,80034,489,0.615,-184,673,48,213,H1
"Henderson County, TX",2016-2017,80034,81064,1030,1.287,-169,1199,48,213,H1
"Hidalgo County, TX",2000-2001,573216,590067,16851,2.94,12427,4424,48,215,H1
"Hidalgo County, TX",2001-2002,590067,610520,20453,3.466,12129,8324,48,215,H1
"Hidalgo County, TX",2002-2003,610520,632475,21955,3.596,13064,8891,48,215,H1
"Hidalgo County, TX",2003-2004,632475,653779,21304,3.368,13280,8024,48,215,H1
"Hidalgo County, TX",2004-2005,653779,674982,21203,3.243,13460,7743,48,215,H1
"Hidalgo County, TX",2005-2006,674982,695352,20370,3.018,13926,6444,48,215,H1
"Hidalgo County, TX",2006-2007,695352,715264,19912,2.864,13713,6199,48,215,H1
"Hidalgo County, TX",2007-2008,715264,736694,21430,2.996,13946,7484,48,215,H1
"Hidalgo County, TX",2008-2009,736694,757468,20774,2.82,14268,6506,48,215,H1
"Hidalgo County, TX",2009-2010,757468,779194,21726,2.868,13487,8239,48,215,H1
"Hidalgo County, TX",2010-2011,779194,795303,16109,2.067,12803,3306,48,215,H1
"Hidalgo County, TX",2011-2012,795303,807725,12422,1.562,12442,-20,48,215,H1
"Hidalgo County, TX",2012-2013,807725,818942,11217,1.389,12209,-992,48,215,H1
"Hidalgo County, TX",2013-2014,818942,831073,12131,1.481,12060,71,48,215,H1
"Hidalgo County, TX",2014-2015,831561,842304,10743,1.292,12072,-1329,48,215,H1
"Hidalgo County, TX",2015-2016,842304,850187,7883,0.936,11205,-3322,48,215,H1
"Hidalgo County, TX",2016-2017,850187,860661,10474,1.232,11099,-625,48,215,H1
"Hill County, TX",2000-2001,32539,32766,227,0.698,158,69,48,217,H1
"Hill County, TX",2001-2002,32766,33120,354,1.08,12,342,48,217,H1
"Hill County, TX",2002-2003,33120,33755,635,1.917,77,558,48,217,H1
"Hill County, TX",2003-2004,33755,34064,309,0.915,6,303,48,217,H1
"Hill County, TX",2004-2005,34064,34203,139,0.408,54,85,48,217,H1
"Hill County, TX",2005-2006,34203,34484,281,0.822,63,218,48,217,H1
"Hill County, TX",2006-2007,34484,34650,166,0.481,14,152,48,217,H1
"Hill County, TX",2007-2008,34650,34997,347,1.001,109,238,48,217,H1
"Hill County, TX",2008-2009,34997,35005,8,0.023,94,-86,48,217,H1
"Hill County, TX",2009-2010,35005,35128,123,0.351,67,56,48,217,H1
"Hill County, TX",2010-2011,35128,35191,63,0.179,44,19,48,217,H1
"Hill County, TX",2011-2012,35191,35109,-82,-0.233,18,-100,48,217,H1
"Hill County, TX",2012-2013,35109,34858,-251,-0.715,17,-268,48,217,H1
"Hill County, TX",2013-2014,34858,34848,-10,-0.029,20,-30,48,217,H1
"Hill County, TX",2014-2015,34731,34855,124,0.357,14,110,48,217,H1
"Hill County, TX",2015-2016,34855,35171,316,0.907,-27,343,48,217,H1
"Hill County, TX",2016-2017,35171,35852,681,1.936,-5,686,48,217,H1
"Hockley County, TX",2000-2001,22670,22662,-8,-0.035,162,-170,48,219,H1
"Hockley County, TX",2001-2002,22662,22745,83,0.366,133,-50,48,219,H1
"Hockley County, TX",2002-2003,22745,22955,210,0.923,115,95,48,219,H1
"Hockley County, TX",2003-2004,22955,22919,-36,-0.157,162,-198,48,219,H1
"Hockley County, TX",2004-2005,22919,23094,175,0.764,152,23,48,219,H1
"Hockley County, TX",2005-2006,23094,22912,-182,-0.788,130,-312,48,219,H1
"Hockley County, TX",2006-2007,22912,22844,-68,-0.297,161,-229,48,219,H1
"Hockley County, TX",2007-2008,22844,22958,114,0.499,210,-96,48,219,H1
"Hockley County, TX",2008-2009,22958,23086,128,0.558,169,-41,48,219,H1
"Hockley County, TX",2009-2010,23086,22839,-247,-1.07,166,-413,48,219,H1
"Hockley County, TX",2010-2011,22839,22965,126,0.552,106,20,48,219,H1
"Hockley County, TX",2011-2012,22965,23122,157,0.684,158,-1,48,219,H1
"Hockley County, TX",2012-2013,23122,23520,398,1.721,160,238,48,219,H1
"Hockley County, TX",2013-2014,23520,23577,57,0.242,160,-103,48,219,H1
"Hockley County, TX",2014-2015,23599,23433,-166,-0.703,113,-279,48,219,H1
"Hockley County, TX",2015-2016,23433,23103,-330,-1.408,119,-449,48,219,H1
"Hockley County, TX",2016-2017,23103,23088,-15,-0.065,87,-102,48,219,H1
"Hood County, TX",2000-2001,41323,42425,1102,2.667,-42,1144,48,221,H1
"Hood County, TX",2001-2002,42425,43344,919,2.166,-19,938,48,221,H1
"Hood County, TX",2002-2003,43344,44448,1104,2.547,32,1072,48,221,H1
"Hood County, TX",2003-2004,44448,45411,963,2.167,46,917,48,221,H1
"Hood County, TX",2004-2005,45411,46470,1059,2.332,-15,1074,48,221,H1
"Hood County, TX",2005-2006,46470,47952,1482,3.189,72,1410,48,221,H1
"Hood County, TX",2006-2007,47952,48870,918,1.914,43,875,48,221,H1
"Hood County, TX",2007-2008,48870,50112,1242,2.541,30,1212,48,221,H1
"Hood County, TX",2008-2009,50112,50841,729,1.455,72,657,48,221,H1
"Hood County, TX",2009-2010,50841,51291,450,0.885,-10,460,48,221,H1
"Hood County, TX",2010-2011,51291,51491,200,0.39,-3,203,48,221,H1
"Hood County, TX",2011-2012,51491,52136,645,1.253,-98,743,48,221,H1
"Hood County, TX",2012-2013,52136,52897,761,1.46,5,756,48,221,H1
"Hood County, TX",2013-2014,52897,53921,1024,1.936,-1,1025,48,221,H1
"Hood County, TX",2014-2015,53904,55423,1519,2.818,31,1488,48,221,H1
"Hood County, TX",2015-2016,55423,56758,1335,2.409,-56,1391,48,221,H1
"Hood County, TX",2016-2017,56758,58273,1515,2.669,1,1514,48,221,H1
"Hopkins County, TX",2000-2001,31999,32203,204,0.638,122,82,48,223,H1
"Hopkins County, TX",2001-2002,32203,32335,132,0.41,79,53,48,223,H1
"Hopkins County, TX",2002-2003,32335,32625,290,0.897,74,216,48,223,H1
"Hopkins County, TX",2003-2004,32625,33061,436,1.336,43,393,48,223,H1
"Hopkins County, TX",2004-2005,33061,33330,269,0.814,93,176,48,223,H1
"Hopkins County, TX",2005-2006,33330,33746,416,1.248,173,243,48,223,H1
"Hopkins County, TX",2006-2007,33746,34331,585,1.734,187,398,48,223,H1
"Hopkins County, TX",2007-2008,34331,34472,141,0.411,140,1,48,223,H1
"Hopkins County, TX",2008-2009,34472,34919,447,1.297,140,307,48,223,H1
"Hopkins County, TX",2009-2010,34919,35215,296,0.848,94,202,48,223,H1
"Hopkins County, TX",2010-2011,35215,35333,118,0.335,130,-12,48,223,H1
"Hopkins County, TX",2011-2012,35333,35420,87,0.246,101,-14,48,223,H1
"Hopkins County, TX",2012-2013,35420,35499,79,0.223,88,-9,48,223,H1
"Hopkins County, TX",2013-2014,35499,35921,422,1.189,94,328,48,223,H1
"Hopkins County, TX",2014-2015,35857,36223,366,1.021,77,289,48,223,H1
"Hopkins County, TX",2015-2016,36223,36203,-20,-0.055,105,-125,48,223,H1
"Hopkins County, TX",2016-2017,36203,36496,293,0.809,102,191,48,223,H1
"Houston County, TX",2000-2001,23135,23122,-13,-0.056,-74,61,48,225,H1
"Houston County, TX",2001-2002,23122,23257,135,0.584,-83,218,48,225,H1
"Houston County, TX",2002-2003,23257,23336,79,0.34,-51,130,48,225,H1
"Houston County, TX",2003-2004,23336,23578,242,1.037,-46,288,48,225,H1
"Houston County, TX",2004-2005,23578,23500,-78,-0.331,-53,-25,48,225,H1
"Houston County, TX",2005-2006,23500,23551,51,0.217,-27,78,48,225,H1
"Houston County, TX",2006-2007,23551,23641,90,0.382,15,75,48,225,H1
"Houston County, TX",2007-2008,23641,23635,-6,-0.025,-21,15,48,225,H1
"Houston County, TX",2008-2009,23635,23660,25,0.106,-41,66,48,225,H1
"Houston County, TX",2009-2010,23660,23693,33,0.139,-47,80,48,225,H1
"Houston County, TX",2010-2011,23693,23368,-325,-1.372,-51,-274,48,225,H1
"Houston County, TX",2011-2012,23368,23149,-219,-0.937,-50,-169,48,225,H1
"Houston County, TX",2012-2013,23149,22806,-343,-1.482,-62,-281,48,225,H1
"Houston County, TX",2013-2014,22806,22741,-65,-0.285,-51,-14,48,225,H1
"Houston County, TX",2014-2015,22731,22785,54,0.238,-39,93,48,225,H1
"Houston County, TX",2015-2016,22785,22888,103,0.452,-36,139,48,225,H1
"Houston County, TX",2016-2017,22888,23021,133,0.581,-59,192,48,225,H1
"Howard County, TX",2000-2001,33489,33279,-210,-0.627,56,-266,48,227,H1
"Howard County, TX",2001-2002,33279,33479,200,0.601,52,148,48,227,H1
"Howard County, TX",2002-2003,33479,33396,-83,-0.248,127,-210,48,227,H1
"Howard County, TX",2003-2004,33396,33403,7,0.021,68,-61,48,227,H1
"Howard County, TX",2004-2005,33403,33277,-126,-0.377,62,-188,48,227,H1
"Howard County, TX",2005-2006,33277,33328,51,0.153,95,-44,48,227,H1
"Howard County, TX",2006-2007,33328,33817,489,1.467,121,368,48,227,H1
"Howard County, TX",2007-2008,33817,34393,576,1.703,140,436,48,227,H1
"Howard County, TX",2008-2009,34393,34882,489,1.422,148,341,48,227,H1
"Howard County, TX",2009-2010,34882,35027,145,0.416,155,-10,48,227,H1
"Howard County, TX",2010-2011,35027,35018,-9,-0.026,18,-27,48,227,H1
"Howard County, TX",2011-2012,35018,35536,518,1.479,62,456,48,227,H1
"Howard County, TX",2012-2013,35536,36277,741,2.085,87,654,48,227,H1
"Howard County, TX",2013-2014,36277,36651,374,1.031,128,246,48,227,H1
"Howard County, TX",2014-2015,36551,37206,655,1.792,125,530,48,227,H1
"Howard County, TX",2015-2016,37206,36618,-588,-1.58,116,-704,48,227,H1
"Howard County, TX",2016-2017,36618,36040,-578,-1.578,115,-693,48,227,H1
"Hudspeth County, TX",2000-2001,3357,3405,48,1.43,23,25,48,229,H1
"Hudspeth County, TX",2001-2002,3405,3398,-7,-0.206,35,-42,48,229,H1
"Hudspeth County, TX",2002-2003,3398,3345,-53,-1.56,46,-99,48,229,H1
"Hudspeth County, TX",2003-2004,3345,3345,0,0,40,-40,48,229,H1
"Hudspeth County, TX",2004-2005,3345,3416,71,2.123,17,54,48,229,H1
"Hudspeth County, TX",2005-2006,3416,3459,43,1.259,22,21,48,229,H1
"Hudspeth County, TX",2006-2007,3459,3462,3,0.087,26,-23,48,229,H1
"Hudspeth County, TX",2007-2008,3462,3374,-88,-2.542,38,-126,48,229,H1
"Hudspeth County, TX",2008-2009,3374,3423,49,1.452,42,7,48,229,H1
"Hudspeth County, TX",2009-2010,3423,3462,39,1.139,38,1,48,229,H1
"Hudspeth County, TX",2010-2011,3462,3408,-54,-1.56,36,-90,48,229,H1
"Hudspeth County, TX",2011-2012,3408,3333,-75,-2.201,31,-106,48,229,H1
"Hudspeth County, TX",2012-2013,3333,3306,-27,-0.81,25,-52,48,229,H1
"Hudspeth County, TX",2013-2014,3306,3211,-95,-2.874,31,-126,48,229,H1
"Hudspeth County, TX",2014-2015,3211,3379,168,5.232,26,142,48,229,H1
"Hudspeth County, TX",2015-2016,3379,4073,694,20.539,20,674,48,229,H1
"Hudspeth County, TX",2016-2017,4073,4408,335,8.225,44,291,48,229,H1
"Hunt County, TX",2000-2001,76932,78431,1499,1.948,385,1114,48,231,H1
"Hunt County, TX",2001-2002,78431,80234,1803,2.299,320,1483,48,231,H1
"Hunt County, TX",2002-2003,80234,80958,724,0.902,383,341,48,231,H1
"Hunt County, TX",2003-2004,80958,82092,1134,1.401,326,808,48,231,H1
"Hunt County, TX",2004-2005,82092,82822,730,0.889,385,345,48,231,H1
"Hunt County, TX",2005-2006,82822,83770,948,1.145,339,609,48,231,H1
"Hunt County, TX",2006-2007,83770,84351,581,0.694,390,191,48,231,H1
"Hunt County, TX",2007-2008,84351,84447,96,0.114,369,-273,48,231,H1
"Hunt County, TX",2008-2009,84447,85261,814,0.964,323,491,48,231,H1
"Hunt County, TX",2009-2010,85261,86313,1052,1.234,260,792,48,231,H1
"Hunt County, TX",2010-2011,86313,86732,419,0.485,270,149,48,231,H1
"Hunt County, TX",2011-2012,86732,87211,479,0.552,237,242,48,231,H1
"Hunt County, TX",2012-2013,87211,87532,321,0.368,243,78,48,231,H1
"Hunt County, TX",2013-2014,87532,88493,961,1.098,166,795,48,231,H1
"Hunt County, TX",2014-2015,88822,89844,1022,1.151,200,822,48,231,H1
"Hunt County, TX",2015-2016,89844,91939,2095,2.332,189,1906,48,231,H1
"Hunt County, TX",2016-2017,91939,93872,1933,2.102,210,1723,48,231,H1
"Hutchinson County, TX",2000-2001,23778,23247,-531,-2.233,33,-564,48,233,H1
"Hutchinson County, TX",2001-2002,23247,23116,-131,-0.564,79,-210,48,233,H1
"Hutchinson County, TX",2002-2003,23116,22773,-343,-1.484,75,-418,48,233,H1
"Hutchinson County, TX",2003-2004,22773,22478,-295,-1.295,77,-372,48,233,H1
"Hutchinson County, TX",2004-2005,22478,22209,-269,-1.197,43,-312,48,233,H1
"Hutchinson County, TX",2005-2006,22209,22176,-33,-0.149,40,-73,48,233,H1
"Hutchinson County, TX",2006-2007,22176,22138,-38,-0.171,64,-102,48,233,H1
"Hutchinson County, TX",2007-2008,22138,21851,-287,-1.296,57,-344,48,233,H1
"Hutchinson County, TX",2008-2009,21851,22184,333,1.524,70,263,48,233,H1
"Hutchinson County, TX",2009-2010,22184,22212,28,0.126,130,-102,48,233,H1
"Hutchinson County, TX",2010-2011,22212,21972,-240,-1.08,49,-289,48,233,H1
"Hutchinson County, TX",2011-2012,21972,21948,-24,-0.109,89,-113,48,233,H1
"Hutchinson County, TX",2012-2013,21948,21832,-116,-0.529,67,-183,48,233,H1
"Hutchinson County, TX",2013-2014,21832,21773,-59,-0.27,99,-158,48,233,H1
"Hutchinson County, TX",2014-2015,21815,21734,-81,-0.371,104,-185,48,233,H1
"Hutchinson County, TX",2015-2016,21734,21570,-164,-0.755,65,-229,48,233,H1
"Hutchinson County, TX",2016-2017,21570,21375,-195,-0.904,66,-261,48,233,H1
"Irion County, TX",2000-2001,1758,1673,-85,-4.835,-7,-78,48,235,H1
"Irion County, TX",2001-2002,1673,1697,24,1.435,5,19,48,235,H1
"Irion County, TX",2002-2003,1697,1672,-25,-1.473,1,-26,48,235,H1
"Irion County, TX",2003-2004,1672,1629,-43,-2.572,1,-44,48,235,H1
"Irion County, TX",2004-2005,1629,1613,-16,-0.982,-8,-8,48,235,H1
"Irion County, TX",2005-2006,1613,1649,36,2.232,3,33,48,235,H1
"Irion County, TX",2006-2007,1649,1609,-40,-2.426,-5,-35,48,235,H1
"Irion County, TX",2007-2008,1609,1571,-38,-2.362,3,-41,48,235,H1
"Irion County, TX",2008-2009,1571,1587,16,1.018,8,8,48,235,H1
"Irion County, TX",2009-2010,1587,1610,23,1.449,7,16,48,235,H1
"Irion County, TX",2010-2011,1610,1606,-4,-0.248,-10,6,48,235,H1
"Irion County, TX",2011-2012,1606,1576,-30,-1.868,12,-42,48,235,H1
"Irion County, TX",2012-2013,1576,1609,33,2.094,6,27,48,235,H1
"Irion County, TX",2013-2014,1609,1574,-35,-2.175,9,-44,48,235,H1
"Irion County, TX",2014-2015,1568,1554,-14,-0.893,11,-25,48,235,H1
"Irion County, TX",2015-2016,1554,1570,16,1.03,9,7,48,235,H1
"Irion County, TX",2016-2017,1570,1516,-54,-3.439,6,-60,48,235,H1
"Jack County, TX",2000-2001,8752,8710,-42,-0.48,5,-47,48,237,H1
"Jack County, TX",2001-2002,8710,8916,206,2.365,10,196,48,237,H1
"Jack County, TX",2002-2003,8916,8965,49,0.55,-5,54,48,237,H1
"Jack County, TX",2003-2004,8965,9028,63,0.703,18,45,48,237,H1
"Jack County, TX",2004-2005,9028,9092,64,0.709,-10,74,48,237,H1
"Jack County, TX",2005-2006,9092,9177,85,0.935,-7,92,48,237,H1
"Jack County, TX",2006-2007,9177,9068,-109,-1.188,-11,-98,48,237,H1
"Jack County, TX",2007-2008,9068,9030,-38,-0.419,12,-50,48,237,H1
"Jack County, TX",2008-2009,9030,9057,27,0.299,-2,29,48,237,H1
"Jack County, TX",2009-2010,9057,9018,-39,-0.431,-2,-37,48,237,H1
"Jack County, TX",2010-2011,9018,9048,30,0.333,19,11,48,237,H1
"Jack County, TX",2011-2012,9048,9005,-43,-0.475,18,-61,48,237,H1
"Jack County, TX",2012-2013,9005,8911,-94,-1.044,8,-102,48,237,H1
"Jack County, TX",2013-2014,8911,8855,-56,-0.628,17,-73,48,237,H1
"Jack County, TX",2014-2015,8880,8878,-2,-0.023,26,-28,48,237,H1
"Jack County, TX",2015-2016,8878,8766,-112,-1.262,7,-119,48,237,H1
"Jack County, TX",2016-2017,8766,8832,66,0.753,22,44,48,237,H1
"Jackson County, TX",2000-2001,14397,14187,-210,-1.459,27,-237,48,239,H1
"Jackson County, TX",2001-2002,14187,14172,-15,-0.106,55,-70,48,239,H1
"Jackson County, TX",2002-2003,14172,14070,-102,-0.72,61,-163,48,239,H1
"Jackson County, TX",2003-2004,14070,14039,-31,-0.22,44,-75,48,239,H1
"Jackson County, TX",2004-2005,14039,14037,-2,-0.014,56,-58,48,239,H1
"Jackson County, TX",2005-2006,14037,13954,-83,-0.591,39,-122,48,239,H1
"Jackson County, TX",2006-2007,13954,13857,-97,-0.695,50,-147,48,239,H1
"Jackson County, TX",2007-2008,13857,13957,100,0.722,65,35,48,239,H1
"Jackson County, TX",2008-2009,13957,14089,132,0.946,70,62,48,239,H1
"Jackson County, TX",2009-2010,14089,14070,-19,-0.135,68,-87,48,239,H1
"Jackson County, TX",2010-2011,14070,14015,-55,-0.391,43,-98,48,239,H1
"Jackson County, TX",2011-2012,14015,14249,234,1.67,46,188,48,239,H1
"Jackson County, TX",2012-2013,14249,14607,358,2.512,26,332,48,239,H1
"Jackson County, TX",2013-2014,14607,14739,132,0.904,81,51,48,239,H1
"Jackson County, TX",2014-2015,14729,14816,87,0.591,78,9,48,239,H1
"Jackson County, TX",2015-2016,14816,14851,35,0.236,69,-34,48,239,H1
"Jackson County, TX",2016-2017,14851,14805,-46,-0.31,76,-122,48,239,H1
"Jasper County, TX",2000-2001,35552,35722,170,0.478,128,42,48,241,H1
"Jasper County, TX",2001-2002,35722,35692,-30,-0.084,74,-104,48,241,H1
"Jasper County, TX",2002-2003,35692,35580,-112,-0.314,56,-168,48,241,H1
"Jasper County, TX",2003-2004,35580,35493,-87,-0.245,66,-153,48,241,H1
"Jasper County, TX",2004-2005,35493,35558,65,0.183,108,-43,48,241,H1
"Jasper County, TX",2005-2006,35558,34861,-697,-1.96,54,-751,48,241,H1
"Jasper County, TX",2006-2007,34861,35069,208,0.597,121,87,48,241,H1
"Jasper County, TX",2007-2008,35069,35170,101,0.288,75,26,48,241,H1
"Jasper County, TX",2008-2009,35170,35331,161,0.458,52,109,48,241,H1
"Jasper County, TX",2009-2010,35331,35816,485,1.373,61,424,48,241,H1
"Jasper County, TX",2010-2011,35816,36247,431,1.203,58,373,48,241,H1
"Jasper County, TX",2011-2012,36247,35856,-391,-1.079,104,-495,48,241,H1
"Jasper County, TX",2012-2013,35856,35659,-197,-0.549,24,-221,48,241,H1
"Jasper County, TX",2013-2014,35659,35552,-107,-0.3,34,-141,48,241,H1
"Jasper County, TX",2014-2015,35583,35506,-77,-0.216,64,-141,48,241,H1
"Jasper County, TX",2015-2016,35506,35401,-105,-0.296,31,-136,48,241,H1
"Jasper County, TX",2016-2017,35401,35561,160,0.452,35,125,48,241,H1
"Jeff Davis County, TX",2000-2001,2233,2234,1,0.045,-11,12,48,243,H1
"Jeff Davis County, TX",2001-2002,2234,2201,-33,-1.477,-1,-32,48,243,H1
"Jeff Davis County, TX",2002-2003,2201,2235,34,1.545,-7,41,48,243,H1
"Jeff Davis County, TX",2003-2004,2235,2242,7,0.313,3,4,48,243,H1
"Jeff Davis County, TX",2004-2005,2242,2249,7,0.312,-1,8,48,243,H1
"Jeff Davis County, TX",2005-2006,2249,2264,15,0.667,-2,17,48,243,H1
"Jeff Davis County, TX",2006-2007,2264,2277,13,0.574,4,9,48,243,H1
"Jeff Davis County, TX",2007-2008,2277,2316,39,1.713,5,34,48,243,H1
"Jeff Davis County, TX",2008-2009,2316,2326,10,0.432,13,-3,48,243,H1
"Jeff Davis County, TX",2009-2010,2326,2351,25,1.075,6,19,48,243,H1
"Jeff Davis County, TX",2010-2011,2351,2308,-43,-1.829,-9,-34,48,243,H1
"Jeff Davis County, TX",2011-2012,2308,2312,4,0.173,8,-4,48,243,H1
"Jeff Davis County, TX",2012-2013,2312,2236,-76,-3.287,-10,-66,48,243,H1
"Jeff Davis County, TX",2013-2014,2236,2204,-32,-1.431,-15,-17,48,243,H1
"Jeff Davis County, TX",2014-2015,2185,2156,-29,-1.327,-9,-20,48,243,H1
"Jeff Davis County, TX",2015-2016,2156,2245,89,4.128,1,88,48,243,H1
"Jeff Davis County, TX",2016-2017,2245,2280,35,1.559,-3,38,48,243,H1
"Jefferson County, TX",2000-2001,251667,250137,-1530,-0.608,801,-2331,48,245,H1
"Jefferson County, TX",2001-2002,250137,250146,9,0.004,801,-792,48,245,H1
"Jefferson County, TX",2002-2003,250146,250183,37,0.015,913,-876,48,245,H1
"Jefferson County, TX",2003-2004,250183,250638,455,0.182,817,-362,48,245,H1
"Jefferson County, TX",2004-2005,250638,250849,211,0.084,923,-712,48,245,H1
"Jefferson County, TX",2005-2006,250849,245962,-4887,-1.948,636,-5523,48,245,H1
"Jefferson County, TX",2006-2007,245962,247629,1667,0.678,1193,474,48,245,H1
"Jefferson County, TX",2007-2008,247629,249430,1801,0.727,934,867,48,245,H1
"Jefferson County, TX",2008-2009,249430,251332,1902,0.763,862,1040,48,245,H1
"Jefferson County, TX",2009-2010,251332,252495,1163,0.463,1148,15,48,245,H1
"Jefferson County, TX",2010-2011,252495,253384,889,0.352,1092,-203,48,245,H1
"Jefferson County, TX",2011-2012,253384,251404,-1980,-0.781,1081,-3061,48,245,H1
"Jefferson County, TX",2012-2013,251404,252814,1410,0.561,1071,339,48,245,H1
"Jefferson County, TX",2013-2014,252814,252235,-579,-0.229,970,-1549,48,245,H1
"Jefferson County, TX",2014-2015,252439,254308,1869,0.74,1024,845,48,245,H1
"Jefferson County, TX",2015-2016,254308,255954,1646,0.647,1174,472,48,245,H1
"Jefferson County, TX",2016-2017,255954,256299,345,0.135,1122,-777,48,245,H1
"Jim Hogg County, TX",2000-2001,5275,5194,-81,-1.536,13,-94,48,247,H1
"Jim Hogg County, TX",2001-2002,5194,5220,26,0.501,31,-5,48,247,H1
"Jim Hogg County, TX",2002-2003,5220,5148,-72,-1.379,35,-107,48,247,H1
"Jim Hogg County, TX",2003-2004,5148,5173,25,0.486,34,-9,48,247,H1
"Jim Hogg County, TX",2004-2005,5173,5194,21,0.406,33,-12,48,247,H1
"Jim Hogg County, TX",2005-2006,5194,5160,-34,-0.655,55,-89,48,247,H1
"Jim Hogg County, TX",2006-2007,5160,5131,-29,-0.562,45,-74,48,247,H1
"Jim Hogg County, TX",2007-2008,5131,5198,67,1.306,60,7,48,247,H1
"Jim Hogg County, TX",2008-2009,5198,5260,62,1.193,55,7,48,247,H1
"Jim Hogg County, TX",2009-2010,5260,5292,32,0.608,52,-20,48,247,H1
"Jim Hogg County, TX",2010-2011,5292,5282,-10,-0.189,38,-48,48,247,H1
"Jim Hogg County, TX",2011-2012,5282,5265,-17,-0.322,51,-68,48,247,H1
"Jim Hogg County, TX",2012-2013,5265,5236,-29,-0.551,33,-62,48,247,H1
"Jim Hogg County, TX",2013-2014,5236,5255,19,0.363,38,-19,48,247,H1
"Jim Hogg County, TX",2014-2015,5245,5200,-45,-0.858,44,-89,48,247,H1
"Jim Hogg County, TX",2015-2016,5200,5244,44,0.846,36,8,48,247,H1
"Jim Hogg County, TX",2016-2017,5244,5202,-42,-0.801,39,-81,48,247,H1
"Jim Wells County, TX",2000-2001,39361,39701,340,0.864,344,-4,48,249,H1
"Jim Wells County, TX",2001-2002,39701,39821,120,0.302,236,-116,48,249,H1
"Jim Wells County, TX",2002-2003,39821,40008,187,0.47,256,-69,48,249,H1
"Jim Wells County, TX",2003-2004,40008,40309,301,0.752,271,30,48,249,H1
"Jim Wells County, TX",2004-2005,40309,40449,140,0.347,318,-178,48,249,H1
"Jim Wells County, TX",2005-2006,40449,40393,-56,-0.138,356,-412,48,249,H1
"Jim Wells County, TX",2006-2007,40393,40654,261,0.646,390,-129,48,249,H1
"Jim Wells County, TX",2007-2008,40654,40554,-100,-0.246,381,-481,48,249,H1
"Jim Wells County, TX",2008-2009,40554,40633,79,0.195,301,-222,48,249,H1
"Jim Wells County, TX",2009-2010,40633,40880,247,0.608,264,-17,48,249,H1
"Jim Wells County, TX",2010-2011,40880,41195,315,0.771,269,46,48,249,H1
"Jim Wells County, TX",2011-2012,41195,41644,449,1.09,211,238,48,249,H1
"Jim Wells County, TX",2012-2013,41644,41669,25,0.06,233,-208,48,249,H1
"Jim Wells County, TX",2013-2014,41669,41353,-316,-0.758,257,-573,48,249,H1
"Jim Wells County, TX",2014-2015,41378,41382,4,0.01,279,-275,48,249,H1
"Jim Wells County, TX",2015-2016,41382,41115,-267,-0.645,248,-515,48,249,H1
"Jim Wells County, TX",2016-2017,41115,40871,-244,-0.593,236,-480,48,249,H1
"Johnson County, TX",2000-2001,127627,130795,3168,2.482,866,2302,48,251,H1
"Johnson County, TX",2001-2002,130795,133399,2604,1.991,843,1761,48,251,H1
"Johnson County, TX",2002-2003,133399,136264,2865,2.148,948,1917,48,251,H1
"Johnson County, TX",2003-2004,136264,138833,2569,1.885,915,1654,48,251,H1
"Johnson County, TX",2004-2005,138833,140692,1859,1.339,964,895,48,251,H1
"Johnson County, TX",2005-2006,140692,142501,1809,1.286,1.00E+03,809,48,251,H1
"Johnson County, TX",2006-2007,142501,145123,2622,1.84,942,1680,48,251,H1
"Johnson County, TX",2007-2008,145123,148635,3512,2.42,1008,2504,48,251,H1
"Johnson County, TX",2008-2009,148635,150583,1948,1.311,1054,894,48,251,H1
"Johnson County, TX",2009-2010,150583,151297,714,0.474,786,-72,48,251,H1
"Johnson County, TX",2010-2011,151297,152037,740,0.489,625,115,48,251,H1
"Johnson County, TX",2011-2012,152037,153530,1493,0.982,783,710,48,251,H1
"Johnson County, TX",2012-2013,153530,154952,1422,0.926,748,674,48,251,H1
"Johnson County, TX",2013-2014,154952,157456,2504,1.616,748,1756,48,251,H1
"Johnson County, TX",2014-2015,157213,159990,2777,1.766,825,1952,48,251,H1
"Johnson County, TX",2015-2016,159990,162915,2925,1.828,780,2145,48,251,H1
"Johnson County, TX",2016-2017,162915,167301,4386,2.692,754,3632,48,251,H1
"Jones County, TX",2000-2001,20754,20294,-460,-2.216,-18,-442,48,253,H1
"Jones County, TX",2001-2002,20294,20293,-1,-0.005,-53,52,48,253,H1
"Jones County, TX",2002-2003,20293,20355,62,0.306,-26,88,48,253,H1
"Jones County, TX",2003-2004,20355,20298,-57,-0.28,-5,-52,48,253,H1
"Jones County, TX",2004-2005,20298,20232,-66,-0.325,10,-76,48,253,H1
"Jones County, TX",2005-2006,20232,20242,10,0.049,-5,15,48,253,H1
"Jones County, TX",2006-2007,20242,20102,-140,-0.692,-1,-139,48,253,H1
"Jones County, TX",2007-2008,20102,20131,29,0.144,3,26,48,253,H1
"Jones County, TX",2008-2009,20131,20093,-38,-0.189,11,-49,48,253,H1
"Jones County, TX",2009-2010,20093,20263,170,0.846,19,151,48,253,H1
"Jones County, TX",2010-2011,20263,20281,18,0.089,-58,76,48,253,H1
"Jones County, TX",2011-2012,20281,19910,-371,-1.829,18,-389,48,253,H1
"Jones County, TX",2012-2013,19910,20068,158,0.794,-10,168,48,253,H1
"Jones County, TX",2013-2014,20068,19936,-132,-0.658,13,-145,48,253,H1
"Jones County, TX",2014-2015,19816,19970,154,0.777,22,132,48,253,H1
"Jones County, TX",2015-2016,19970,19994,24,0.12,-26,50,48,253,H1
"Jones County, TX",2016-2017,19994,19983,-11,-0.055,-4,-7,48,253,H1
"Karnes County, TX",2000-2001,15403,15340,-63,-0.409,1,-64,48,255,H1
"Karnes County, TX",2001-2002,15340,15178,-162,-1.056,14,-176,48,255,H1
"Karnes County, TX",2002-2003,15178,15119,-59,-0.389,26,-85,48,255,H1
"Karnes County, TX",2003-2004,15119,15109,-10,-0.066,48,-58,48,255,H1
"Karnes County, TX",2004-2005,15109,14967,-142,-0.94,13,-155,48,255,H1
"Karnes County, TX",2005-2006,14967,14985,18,0.12,73,-55,48,255,H1
"Karnes County, TX",2006-2007,14985,14900,-85,-0.567,6,-91,48,255,H1
"Karnes County, TX",2007-2008,14900,14867,-33,-0.221,31,-64,48,255,H1
"Karnes County, TX",2008-2009,14867,14805,-62,-0.417,37,-99,48,255,H1
"Karnes County, TX",2009-2010,14805,14865,60,0.405,30,30,48,255,H1
"Karnes County, TX",2010-2011,14865,14970,105,0.706,-24,129,48,255,H1
"Karnes County, TX",2011-2012,14970,14896,-74,-0.494,4,-78,48,255,H1
"Karnes County, TX",2012-2013,14896,14782,-114,-0.765,17,-131,48,255,H1
"Karnes County, TX",2013-2014,14782,14906,124,0.839,9,115,48,255,H1
"Karnes County, TX",2014-2015,14857,14975,118,0.794,25,93,48,255,H1
"Karnes County, TX",2015-2016,14975,15264,289,1.93,86,203,48,255,H1
"Karnes County, TX",2016-2017,15264,15187,-77,-0.504,44,-121,48,255,H1
"Kaufman County, TX",2000-2001,72270,75223,2953,4.086,486,2467,48,257,H1
"Kaufman County, TX",2001-2002,75223,77693,2470,3.284,431,2039,48,257,H1
"Kaufman County, TX",2002-2003,77693,81322,3629,4.671,465,3164,48,257,H1
"Kaufman County, TX",2003-2004,81322,84240,2918,3.588,530,2388,48,257,H1
"Kaufman County, TX",2004-2005,84240,87388,3148,3.737,523,2625,48,257,H1
"Kaufman County, TX",2005-2006,87388,91395,4007,4.585,705,3302,48,257,H1
"Kaufman County, TX",2006-2007,91395,95694,4299,4.704,740,3559,48,257,H1
"Kaufman County, TX",2007-2008,95694,99285,3591,3.753,816,2775,48,257,H1
"Kaufman County, TX",2008-2009,99285,101709,2424,2.441,896,1528,48,257,H1
"Kaufman County, TX",2009-2010,101709,103871,2162,2.126,684,1478,48,257,H1
"Kaufman County, TX",2010-2011,103871,105287,1416,1.363,606,810,48,257,H1
"Kaufman County, TX",2011-2012,105287,106680,1393,1.323,632,761,48,257,H1
"Kaufman County, TX",2012-2013,106680,108521,1841,1.726,628,1213,48,257,H1
"Kaufman County, TX",2013-2014,108521,111236,2715,2.502,620,2095,48,257,H1
"Kaufman County, TX",2014-2015,111295,114690,3395,3.05,672,2723,48,257,H1
"Kaufman County, TX",2015-2016,114690,118046,3356,2.926,686,2670,48,257,H1
"Kaufman County, TX",2016-2017,118046,122883,4837,4.098,713,4124,48,257,H1
"Kendall County, TX",2000-2001,23980,24433,453,1.889,65,388,48,259,H1
"Kendall County, TX",2001-2002,24433,24975,542,2.218,53,489,48,259,H1
"Kendall County, TX",2002-2003,24975,25892,917,3.672,78,839,48,259,H1
"Kendall County, TX",2003-2004,25892,26650,758,2.928,73,685,48,259,H1
"Kendall County, TX",2004-2005,26650,27849,1199,4.499,93,1106,48,259,H1
"Kendall County, TX",2005-2006,27849,29134,1285,4.614,28,1257,48,259,H1
"Kendall County, TX",2006-2007,29134,30330,1196,4.105,27,1169,48,259,H1
"Kendall County, TX",2007-2008,30330,31754,1424,4.695,119,1305,48,259,H1
"Kendall County, TX",2008-2009,31754,32655,901,2.837,175,726,48,259,H1
"Kendall County, TX",2009-2010,32655,33651,996,3.05,28,968,48,259,H1
"Kendall County, TX",2010-2011,33651,34532,881,2.618,6,875,48,259,H1
"Kendall County, TX",2011-2012,34532,35759,1227,3.553,46,1181,48,259,H1
"Kendall County, TX",2012-2013,35759,37469,1710,4.782,-5,1715,48,259,H1
"Kendall County, TX",2013-2014,37469,38880,1411,3.766,25,1386,48,259,H1
"Kendall County, TX",2014-2015,38761,40384,1623,4.187,-19,1642,48,259,H1
"Kendall County, TX",2015-2016,40384,41964,1580,3.912,19,1561,48,259,H1
"Kendall County, TX",2016-2017,41964,44026,2062,4.914,9,2053,48,259,H1
"Kenedy County, TX",2000-2001,420,421,1,0.238,4,-3,48,261,H1
"Kenedy County, TX",2001-2002,421,429,8,1.9,1,7,48,261,H1
"Kenedy County, TX",2002-2003,429,428,-1,-0.233,2,-3,48,261,H1
"Kenedy County, TX",2003-2004,428,440,12,2.804,6,6,48,261,H1
"Kenedy County, TX",2004-2005,440,457,17,3.864,1,16,48,261,H1
"Kenedy County, TX",2005-2006,457,426,-31,-6.783,-6,-25,48,261,H1
"Kenedy County, TX",2006-2007,426,415,-11,-2.582,6,-17,48,261,H1
"Kenedy County, TX",2007-2008,415,410,-5,-1.205,3,-8,48,261,H1
"Kenedy County, TX",2008-2009,410,403,-7,-1.707,4,-11,48,261,H1
"Kenedy County, TX",2009-2010,403,418,15,3.722,3,12,48,261,H1
"Kenedy County, TX",2010-2011,418,435,17,4.067,5,12,48,261,H1
"Kenedy County, TX",2011-2012,435,432,-3,-0.69,-2,-1,48,261,H1
"Kenedy County, TX",2012-2013,432,415,-17,-3.935,8,-25,48,261,H1
"Kenedy County, TX",2013-2014,415,400,-15,-3.614,7,-22,48,261,H1
"Kenedy County, TX",2014-2015,412,407,-5,-1.214,2,-7,48,261,H1
"Kenedy County, TX",2015-2016,407,428,21,5.16,0,21,48,261,H1
"Kenedy County, TX",2016-2017,428,417,-11,-2.57,2,-13,48,261,H1
"Kent County, TX",2000-2001,833,808,-25,-3.001,-7,-18,48,263,H1
"Kent County, TX",2001-2002,808,815,7,0.866,-15,22,48,263,H1
"Kent County, TX",2002-2003,815,795,-20,-2.454,-9,-11,48,263,H1
"Kent County, TX",2003-2004,795,791,-4,-0.503,1,-5,48,263,H1
"Kent County, TX",2004-2005,791,784,-7,-0.885,-18,11,48,263,H1
"Kent County, TX",2005-2006,784,770,-14,-1.786,-15,1,48,263,H1
"Kent County, TX",2006-2007,770,788,18,2.338,-14,32,48,263,H1
"Kent County, TX",2007-2008,788,787,-1,-0.127,-5,4,48,263,H1
"Kent County, TX",2008-2009,787,793,6,0.762,3,3,48,263,H1
"Kent County, TX",2009-2010,793,812,19,2.396,-4,23,48,263,H1
"Kent County, TX",2010-2011,812,823,11,1.355,-6,17,48,263,H1
"Kent County, TX",2011-2012,823,839,16,1.944,-6,22,48,263,H1
"Kent County, TX",2012-2013,839,801,-38,-4.529,-5,-33,48,263,H1
"Kent County, TX",2013-2014,801,785,-16,-1.998,-10,-6,48,263,H1
"Kent County, TX",2014-2015,783,764,-19,-2.427,5,-24,48,263,H1
"Kent County, TX",2015-2016,764,752,-12,-1.571,4,-16,48,263,H1
"Kent County, TX",2016-2017,752,763,11,1.463,-3,14,48,263,H1
"Kerr County, TX",2000-2001,43848,44331,483,1.102,-110,593,48,265,H1
"Kerr County, TX",2001-2002,44331,44894,563,1.27,-147,710,48,265,H1
"Kerr County, TX",2002-2003,44894,45278,384,0.855,-118,502,48,265,H1
"Kerr County, TX",2003-2004,45278,46054,776,1.714,-137,913,48,265,H1
"Kerr County, TX",2004-2005,46054,46809,755,1.639,-126,881,48,265,H1
"Kerr County, TX",2005-2006,46809,47840,1031,2.203,-4,1035,48,265,H1
"Kerr County, TX",2006-2007,47840,48352,512,1.07,-102,614,48,265,H1
"Kerr County, TX",2007-2008,48352,48852,500,1.034,-85,585,48,265,H1
"Kerr County, TX",2008-2009,48852,49427,575,1.177,-64,639,48,265,H1
"Kerr County, TX",2009-2010,49427,49641,214,0.433,-68,282,48,265,H1
"Kerr County, TX",2010-2011,49641,49636,-5,-0.01,-197,192,48,265,H1
"Kerr County, TX",2011-2012,49636,49798,162,0.326,-196,358,48,265,H1
"Kerr County, TX",2012-2013,49798,49932,134,0.269,-205,339,48,265,H1
"Kerr County, TX",2013-2014,49932,50562,630,1.262,-191,821,48,265,H1
"Kerr County, TX",2014-2015,50512,50955,443,0.877,-180,623,48,265,H1
"Kerr County, TX",2015-2016,50955,51296,341,0.669,-147,488,48,265,H1
"Kerr County, TX",2016-2017,51296,51720,424,0.827,-185,609,48,265,H1
"Kimble County, TX",2000-2001,4484,4494,10,0.223,-19,29,48,267,H1
"Kimble County, TX",2001-2002,4494,4521,27,0.601,-10,37,48,267,H1
"Kimble County, TX",2002-2003,4521,4510,-11,-0.243,-18,7,48,267,H1
"Kimble County, TX",2003-2004,4510,4562,52,1.153,-3,55,48,267,H1
"Kimble County, TX",2004-2005,4562,4609,47,1.03,-15,62,48,267,H1
"Kimble County, TX",2005-2006,4609,4578,-31,-0.673,-18,-13,48,267,H1
"Kimble County, TX",2006-2007,4578,4518,-60,-1.311,-24,-36,48,267,H1
"Kimble County, TX",2007-2008,4518,4520,2,0.044,1,1,48,267,H1
"Kimble County, TX",2008-2009,4520,4623,103,2.279,-8,111,48,267,H1
"Kimble County, TX",2009-2010,4623,4583,-40,-0.865,-17,-23,48,267,H1
"Kimble County, TX",2010-2011,4583,4593,10,0.218,-33,43,48,267,H1
"Kimble County, TX",2011-2012,4593,4534,-59,-1.285,-15,-44,48,267,H1
"Kimble County, TX",2012-2013,4534,4462,-72,-1.588,8,-80,48,267,H1
"Kimble County, TX",2013-2014,4462,4438,-24,-0.538,-7,-17,48,267,H1
"Kimble County, TX",2014-2015,4435,4388,-47,-1.06,-12,-35,48,267,H1
"Kimble County, TX",2015-2016,4388,4428,40,0.912,-4,44,48,267,H1
"Kimble County, TX",2016-2017,4428,4410,-18,-0.407,-17,-1,48,267,H1
"King County, TX",2000-2001,358,313,-45,-12.57,-3,-42,48,269,H1
"King County, TX",2001-2002,313,308,-5,-1.597,4,-9,48,269,H1
"King County, TX",2002-2003,308,311,3,0.974,-2,5,48,269,H1
"King County, TX",2003-2004,311,316,5,1.608,2,3,48,269,H1
"King County, TX",2004-2005,316,289,-27,-8.544,-2,-25,48,269,H1
"King County, TX",2005-2006,289,285,-4,-1.384,2,-6,48,269,H1
"King County, TX",2006-2007,285,284,-1,-0.351,1,-2,48,269,H1
"King County, TX",2007-2008,284,272,-12,-4.225,4,-16,48,269,H1
"King County, TX",2008-2009,272,279,7,2.574,2,5,48,269,H1
"King County, TX",2009-2010,279,288,9,3.226,3,6,48,269,H1
"King County, TX",2010-2011,288,258,-30,-10.417,3,-33,48,269,H1
"King County, TX",2011-2012,258,271,13,5.039,1,12,48,269,H1
"King County, TX",2012-2013,271,273,2,0.738,0,2,48,269,H1
"King County, TX",2013-2014,273,262,-11,-4.029,1,-12,48,269,H1
"King County, TX",2014-2015,262,282,20,7.634,0,20,48,269,H1
"King County, TX",2015-2016,282,294,12,4.255,1,11,48,269,H1
"King County, TX",2016-2017,294,296,2,0.68,2,0,48,269,H1
"Kinney County, TX",2000-2001,3387,3419,32,0.945,1,31,48,271,H1
"Kinney County, TX",2001-2002,3419,3463,44,1.287,-7,51,48,271,H1
"Kinney County, TX",2002-2003,3463,3394,-69,-1.992,2,-71,48,271,H1
"Kinney County, TX",2003-2004,3394,3395,1,0.029,2,-1,48,271,H1
"Kinney County, TX",2004-2005,3395,3449,54,1.591,-3,57,48,271,H1
"Kinney County, TX",2005-2006,3449,3488,39,1.131,6,33,48,271,H1
"Kinney County, TX",2006-2007,3488,3546,58,1.663,0,58,48,271,H1
"Kinney County, TX",2007-2008,3546,3507,-39,-1.1,0,-39,48,271,H1
"Kinney County, TX",2008-2009,3507,3568,61,1.739,15,46,48,271,H1
"Kinney County, TX",2009-2010,3568,3601,33,0.925,12,21,48,271,H1
"Kinney County, TX",2010-2011,3601,3611,10,0.278,0,10,48,271,H1
"Kinney County, TX",2011-2012,3611,3628,17,0.471,7,10,48,271,H1
"Kinney County, TX",2012-2013,3628,3623,-5,-0.138,6,-11,48,271,H1
"Kinney County, TX",2013-2014,3623,3526,-97,-2.677,-7,-90,48,271,H1
"Kinney County, TX",2014-2015,3505,3549,44,1.255,-12,56,48,271,H1
"Kinney County, TX",2015-2016,3549,3640,91,2.564,17,74,48,271,H1
"Kinney County, TX",2016-2017,3640,3745,105,2.885,12,93,48,271,H1
"Kleberg County, TX",2000-2001,31590,31315,-275,-0.871,251,-526,48,273,H1
"Kleberg County, TX",2001-2002,31315,31413,98,0.313,257,-159,48,273,H1
"Kleberg County, TX",2002-2003,31413,31339,-74,-0.236,296,-370,48,273,H1
"Kleberg County, TX",2003-2004,31339,31362,23,0.073,269,-246,48,273,H1
"Kleberg County, TX",2004-2005,31362,31242,-120,-0.383,230,-350,48,273,H1
"Kleberg County, TX",2005-2006,31242,31149,-93,-0.298,294,-387,48,273,H1
"Kleberg County, TX",2006-2007,31149,31370,221,0.709,305,-84,48,273,H1
"Kleberg County, TX",2007-2008,31370,31555,185,0.59,373,-188,48,273,H1
"Kleberg County, TX",2008-2009,31555,31876,321,1.017,338,-17,48,273,H1
"Kleberg County, TX",2009-2010,31876,32095,219,0.687,370,-151,48,273,H1
"Kleberg County, TX",2010-2011,32095,32098,3,0.009,214,-211,48,273,H1
"Kleberg County, TX",2011-2012,32098,32180,82,0.255,251,-169,48,273,H1
"Kleberg County, TX",2012-2013,32180,32149,-31,-0.096,276,-307,48,273,H1
"Kleberg County, TX",2013-2014,32149,32190,41,0.128,258,-217,48,273,H1
"Kleberg County, TX",2014-2015,31999,31857,-142,-0.444,270,-412,48,273,H1
"Kleberg County, TX",2015-2016,31857,31347,-510,-1.601,187,-697,48,273,H1
"Kleberg County, TX",2016-2017,31347,31088,-259,-0.826,183,-442,48,273,H1
"Knox County, TX",2000-2001,4253,4070,-183,-4.303,-28,-155,48,275,H1
"Knox County, TX",2001-2002,4070,4044,-26,-0.639,-28,2,48,275,H1
"Knox County, TX",2002-2003,4044,4018,-26,-0.643,-9,-17,48,275,H1
"Knox County, TX",2003-2004,4018,3940,-78,-1.941,-12,-66,48,275,H1
"Knox County, TX",2004-2005,3940,3822,-118,-2.995,-20,-98,48,275,H1
"Knox County, TX",2005-2006,3822,3788,-34,-0.89,-17,-17,48,275,H1
"Knox County, TX",2006-2007,3788,3721,-67,-1.769,-7,-60,48,275,H1
"Knox County, TX",2007-2008,3721,3650,-71,-1.908,1,-72,48,275,H1
"Knox County, TX",2008-2009,3650,3647,-3,-0.082,-6,3,48,275,H1
"Knox County, TX",2009-2010,3647,3729,82,2.248,5,77,48,275,H1
"Knox County, TX",2010-2011,3729,3747,18,0.483,-7,25,48,275,H1
"Knox County, TX",2011-2012,3747,3768,21,0.56,1,20,48,275,H1
"Knox County, TX",2012-2013,3768,3777,9,0.239,-2,11,48,275,H1
"Knox County, TX",2013-2014,3777,3858,81,2.145,6,75,48,275,H1
"Knox County, TX",2014-2015,3850,3860,10,0.26,8,2,48,275,H1
"Knox County, TX",2015-2016,3860,3740,-120,-3.109,-10,-110,48,275,H1
"Knox County, TX",2016-2017,3740,3710,-30,-0.802,-1,-29,48,275,H1
"Lamar County, TX",2000-2001,48596,48522,-74,-0.152,81,-155,48,277,H1
"Lamar County, TX",2001-2002,48522,48826,304,0.627,101,203,48,277,H1
"Lamar County, TX",2002-2003,48826,49159,333,0.682,68,265,48,277,H1
"Lamar County, TX",2003-2004,49159,49233,74,0.151,65,9,48,277,H1
"Lamar County, TX",2004-2005,49233,49344,111,0.225,74,37,48,277,H1
"Lamar County, TX",2005-2006,49344,49386,42,0.085,75,-33,48,277,H1
"Lamar County, TX",2006-2007,49386,49387,1,0.002,88,-87,48,277,H1
"Lamar County, TX",2007-2008,49387,49467,80,0.162,64,16,48,277,H1
"Lamar County, TX",2008-2009,49467,49600,133,0.269,71,62,48,277,H1
"Lamar County, TX",2009-2010,49600,49844,244,0.492,97,147,48,277,H1
"Lamar County, TX",2010-2011,49844,49975,131,0.263,97,34,48,277,H1
"Lamar County, TX",2011-2012,49975,49856,-119,-0.238,76,-195,48,277,H1
"Lamar County, TX",2012-2013,49856,49320,-536,-1.075,2,-538,48,277,H1
"Lamar County, TX",2013-2014,49320,49523,203,0.412,-22,225,48,277,H1
"Lamar County, TX",2014-2015,49457,49440,-17,-0.034,14,-31,48,277,H1
"Lamar County, TX",2015-2016,49440,49565,125,0.253,159,-34,48,277,H1
"Lamar County, TX",2016-2017,49565,49587,22,0.044,55,-33,48,277,H1
"Lamb County, TX",2000-2001,14663,14566,-97,-0.662,23,-120,48,279,H1
"Lamb County, TX",2001-2002,14566,14658,92,0.632,57,35,48,279,H1
"Lamb County, TX",2002-2003,14658,14675,17,0.116,49,-32,48,279,H1
"Lamb County, TX",2003-2004,14675,14584,-91,-0.62,69,-160,48,279,H1
"Lamb County, TX",2004-2005,14584,14583,-1,-0.007,76,-77,48,279,H1
"Lamb County, TX",2005-2006,14583,14338,-245,-1.68,85,-330,48,279,H1
"Lamb County, TX",2006-2007,14338,14270,-68,-0.474,70,-138,48,279,H1
"Lamb County, TX",2007-2008,14270,14036,-234,-1.64,64,-298,48,279,H1
"Lamb County, TX",2008-2009,14036,13791,-245,-1.746,67,-312,48,279,H1
"Lamb County, TX",2009-2010,13791,14010,219,1.588,57,162,48,279,H1
"Lamb County, TX",2010-2011,14010,14105,95,0.678,56,39,48,279,H1
"Lamb County, TX",2011-2012,14105,13931,-174,-1.234,54,-228,48,279,H1
"Lamb County, TX",2012-2013,13931,13757,-174,-1.249,46,-220,48,279,H1
"Lamb County, TX",2013-2014,13757,13574,-183,-1.33,28,-211,48,279,H1
"Lamb County, TX",2014-2015,13585,13385,-200,-1.472,68,-268,48,279,H1
"Lamb County, TX",2015-2016,13385,13223,-162,-1.21,59,-221,48,279,H1
"Lamb County, TX",2016-2017,13223,13210,-13,-0.098,44,-57,48,279,H1
"Lampasas County, TX",2000-2001,17900,18027,127,0.709,29,98,48,281,H1
"Lampasas County, TX",2001-2002,18027,18425,398,2.208,46,352,48,281,H1
"Lampasas County, TX",2002-2003,18425,18579,154,0.836,57,97,48,281,H1
"Lampasas County, TX",2003-2004,18579,19664,1085,5.84,33,1052,48,281,H1
"Lampasas County, TX",2004-2005,19664,18906,-758,-3.855,59,-817,48,281,H1
"Lampasas County, TX",2005-2006,18906,19472,566,2.994,90,476,48,281,H1
"Lampasas County, TX",2006-2007,19472,19728,256,1.315,88,168,48,281,H1
"Lampasas County, TX",2007-2008,19728,19812,84,0.426,39,45,48,281,H1
"Lampasas County, TX",2008-2009,19812,19652,-160,-0.808,53,-213,48,281,H1
"Lampasas County, TX",2009-2010,19652,19755,103,0.524,24,79,48,281,H1
"Lampasas County, TX",2010-2011,19755,19927,172,0.871,26,146,48,281,H1
"Lampasas County, TX",2011-2012,19927,20081,154,0.773,30,124,48,281,H1
"Lampasas County, TX",2012-2013,20081,20179,98,0.488,48,50,48,281,H1
"Lampasas County, TX",2013-2014,20179,20156,-23,-0.114,57,-80,48,281,H1
"Lampasas County, TX",2014-2015,20242,20588,346,1.709,91,255,48,281,H1
"Lampasas County, TX",2015-2016,20588,20657,69,0.335,20,49,48,281,H1
"Lampasas County, TX",2016-2017,20657,21027,370,1.791,23,347,48,281,H1
"La Salle County, TX",2000-2001,5898,5934,36,0.61,41,-5,48,283,H1
"La Salle County, TX",2001-2002,5934,6098,164,2.764,48,116,48,283,H1
"La Salle County, TX",2002-2003,6098,6169,71,1.164,46,25,48,283,H1
"La Salle County, TX",2003-2004,6169,6322,153,2.48,58,95,48,283,H1
"La Salle County, TX",2004-2005,6322,6542,220,3.48,47,173,48,283,H1
"La Salle County, TX",2005-2006,6542,6549,7,0.107,31,-24,48,283,H1
"La Salle County, TX",2006-2007,6549,6675,126,1.924,33,93,48,283,H1
"La Salle County, TX",2007-2008,6675,6653,-22,-0.33,60,-82,48,283,H1
"La Salle County, TX",2008-2009,6653,6771,118,1.774,59,59,48,283,H1
"La Salle County, TX",2009-2010,6771,6898,127,1.876,55,72,48,283,H1
"La Salle County, TX",2010-2011,6898,6989,91,1.319,28,63,48,283,H1
"La Salle County, TX",2011-2012,6989,7126,137,1.96,50,87,48,283,H1
"La Salle County, TX",2012-2013,7126,7429,303,4.252,61,242,48,283,H1
"La Salle County, TX",2013-2014,7429,7474,45,0.606,66,-21,48,283,H1
"La Salle County, TX",2014-2015,7473,7631,158,2.114,58,100,48,283,H1
"La Salle County, TX",2015-2016,7631,7619,-12,-0.157,43,-55,48,283,H1
"La Salle County, TX",2016-2017,7619,7584,-35,-0.459,33,-68,48,283,H1
"Lavaca County, TX",2000-2001,19190,18958,-232,-1.209,-67,-165,48,285,H1
"Lavaca County, TX",2001-2002,18958,19101,143,0.754,-11,154,48,285,H1
"Lavaca County, TX",2002-2003,19101,19152,51,0.267,-42,93,48,285,H1
"Lavaca County, TX",2003-2004,19152,19130,-22,-0.115,-44,22,48,285,H1
"Lavaca County, TX",2004-2005,19130,19185,55,0.288,5,50,48,285,H1
"Lavaca County, TX",2005-2006,19185,19181,-4,-0.021,-39,35,48,285,H1
"Lavaca County, TX",2006-2007,19181,19238,57,0.297,-38,95,48,285,H1
"Lavaca County, TX",2007-2008,19238,19185,-53,-0.275,-7,-46,48,285,H1
"Lavaca County, TX",2008-2009,19185,19226,41,0.214,13,28,48,285,H1
"Lavaca County, TX",2009-2010,19226,19244,18,0.094,22,-4,48,285,H1
"Lavaca County, TX",2010-2011,19244,19227,-17,-0.088,0,-17,48,285,H1
"Lavaca County, TX",2011-2012,19227,19455,228,1.186,-30,258,48,285,H1
"Lavaca County, TX",2012-2013,19455,19543,88,0.452,-19,107,48,285,H1
"Lavaca County, TX",2013-2014,19543,19721,178,0.911,-18,196,48,285,H1
"Lavaca County, TX",2014-2015,19692,19836,144,0.731,-29,173,48,285,H1
"Lavaca County, TX",2015-2016,19836,19910,74,0.373,-11,85,48,285,H1
"Lavaca County, TX",2016-2017,19910,20062,152,0.763,-11,163,48,285,H1
"Lee County, TX",2000-2001,15701,16008,307,1.955,71,236,48,287,H1
"Lee County, TX",2001-2002,16008,16131,123,0.768,81,42,48,287,H1
"Lee County, TX",2002-2003,16131,16234,103,0.639,65,38,48,287,H1
"Lee County, TX",2003-2004,16234,16220,-14,-0.086,88,-102,48,287,H1
"Lee County, TX",2004-2005,16220,16330,110,0.678,45,65,48,287,H1
"Lee County, TX",2005-2006,16330,16348,18,0.11,62,-44,48,287,H1
"Lee County, TX",2006-2007,16348,16421,73,0.447,46,27,48,287,H1
"Lee County, TX",2007-2008,16421,16550,129,0.786,54,75,48,287,H1
"Lee County, TX",2008-2009,16550,16565,15,0.091,53,-38,48,287,H1
"Lee County, TX",2009-2010,16565,16605,40,0.241,57,-17,48,287,H1
"Lee County, TX",2010-2011,16605,16601,-4,-0.024,34,-38,48,287,H1
"Lee County, TX",2011-2012,16601,16548,-53,-0.319,46,-99,48,287,H1
"Lee County, TX",2012-2013,16548,16587,39,0.236,58,-19,48,287,H1
"Lee County, TX",2013-2014,16587,16742,155,0.934,56,99,48,287,H1
"Lee County, TX",2014-2015,16677,16898,221,1.325,45,176,48,287,H1
"Lee County, TX",2015-2016,16898,16998,100,0.592,17,83,48,287,H1
"Lee County, TX",2016-2017,16998,17183,185,1.088,54,131,48,287,H1
"Leon County, TX",2000-2001,15395,15452,57,0.37,-9,66,48,289,H1
"Leon County, TX",2001-2002,15452,15718,266,1.721,13,253,48,289,H1
"Leon County, TX",2002-2003,15718,15795,77,0.49,-52,129,48,289,H1
"Leon County, TX",2003-2004,15795,15837,42,0.266,0,42,48,289,H1
"Leon County, TX",2004-2005,15837,16104,267,1.686,2,265,48,289,H1
"Leon County, TX",2005-2006,16104,16334,230,1.428,-5,235,48,289,H1
"Leon County, TX",2006-2007,16334,16390,56,0.343,1,55,48,289,H1
"Leon County, TX",2007-2008,16390,16832,442,2.697,51,391,48,289,H1
"Leon County, TX",2008-2009,16832,16862,30,0.178,38,-8,48,289,H1
"Leon County, TX",2009-2010,16862,16758,-104,-0.617,9,-113,48,289,H1
"Leon County, TX",2010-2011,16758,16846,88,0.525,4,84,48,289,H1
"Leon County, TX",2011-2012,16846,16763,-83,-0.493,28,-111,48,289,H1
"Leon County, TX",2012-2013,16763,16694,-69,-0.412,-10,-59,48,289,H1
"Leon County, TX",2013-2014,16694,16861,167,1,3,164,48,289,H1
"Leon County, TX",2014-2015,16791,17086,295,1.757,-13,308,48,289,H1
"Leon County, TX",2015-2016,17086,17196,110,0.644,0,110,48,289,H1
"Leon County, TX",2016-2017,17196,17243,47,0.273,2,45,48,289,H1
"Liberty County, TX",2000-2001,70576,71679,1103,1.563,348,755,48,291,H1
"Liberty County, TX",2001-2002,71679,73280,1601,2.234,309,1292,48,291,H1
"Liberty County, TX",2002-2003,73280,73734,454,0.62,410,44,48,291,H1
"Liberty County, TX",2003-2004,73734,74285,551,0.747,428,123,48,291,H1
"Liberty County, TX",2004-2005,74285,74303,18,0.024,356,-338,48,291,H1
"Liberty County, TX",2005-2006,74303,74269,-34,-0.046,375,-409,48,291,H1
"Liberty County, TX",2006-2007,74269,74515,246,0.331,450,-204,48,291,H1
"Liberty County, TX",2007-2008,74515,74915,400,0.537,377,23,48,291,H1
"Liberty County, TX",2008-2009,74915,75041,126,0.168,365,-239,48,291,H1
"Liberty County, TX",2009-2010,75041,75831,790,1.053,333,457,48,291,H1
"Liberty County, TX",2010-2011,75831,76042,211,0.278,322,-111,48,291,H1
"Liberty County, TX",2011-2012,76042,76511,469,0.617,392,77,48,291,H1
"Liberty County, TX",2012-2013,76511,77033,522,0.682,287,235,48,291,H1
"Liberty County, TX",2013-2014,77033,78117,1084,1.407,311,773,48,291,H1
"Liberty County, TX",2014-2015,78200,79654,1454,1.859,368,1086,48,291,H1
"Liberty County, TX",2015-2016,79654,81377,1723,2.163,297,1426,48,291,H1
"Liberty County, TX",2016-2017,81377,83658,2281,2.803,339,1942,48,291,H1
"Limestone County, TX",2000-2001,22053,22159,106,0.481,-25,131,48,293,H1
"Limestone County, TX",2001-2002,22159,22486,327,1.476,41,286,48,293,H1
"Limestone County, TX",2002-2003,22486,22721,235,1.045,7,228,48,293,H1
"Limestone County, TX",2003-2004,22721,22942,221,0.973,0,221,48,293,H1
"Limestone County, TX",2004-2005,22942,22919,-23,-0.1,11,-34,48,293,H1
"Limestone County, TX",2005-2006,22919,23093,174,0.759,-7,181,48,293,H1
"Limestone County, TX",2006-2007,23093,23090,-3,-0.013,55,-58,48,293,H1
"Limestone County, TX",2007-2008,23090,23065,-25,-0.108,8,-33,48,293,H1
"Limestone County, TX",2008-2009,23065,23173,108,0.468,27,81,48,293,H1
"Limestone County, TX",2009-2010,23173,23474,301,1.299,50,251,48,293,H1
"Limestone County, TX",2010-2011,23474,23571,97,0.413,2,95,48,293,H1
"Limestone County, TX",2011-2012,23571,23664,93,0.395,71,22,48,293,H1
"Limestone County, TX",2012-2013,23664,23422,-242,-1.023,51,-293,48,293,H1
"Limestone County, TX",2013-2014,23422,23524,102,0.435,40,62,48,293,H1
"Limestone County, TX",2014-2015,23421,23320,-101,-0.431,17,-118,48,293,H1
"Limestone County, TX",2015-2016,23320,23527,207,0.888,69,138,48,293,H1
"Limestone County, TX",2016-2017,23527,23527,0,0,54,-54,48,293,H1
"Lipscomb County, TX",2000-2001,3025,2948,-77,-2.545,-2,-75,48,295,H1
"Lipscomb County, TX",2001-2002,2948,3033,85,2.883,-1,86,48,295,H1
"Lipscomb County, TX",2002-2003,3033,3097,64,2.11,10,54,48,295,H1
"Lipscomb County, TX",2003-2004,3097,3028,-69,-2.228,7,-76,48,295,H1
"Lipscomb County, TX",2004-2005,3028,3057,29,0.958,6,23,48,295,H1
"Lipscomb County, TX",2005-2006,3057,3115,58,1.897,10,48,48,295,H1
"Lipscomb County, TX",2006-2007,3115,3178,63,2.022,11,52,48,295,H1
"Lipscomb County, TX",2007-2008,3178,3183,5,0.157,16,-11,48,295,H1
"Lipscomb County, TX",2008-2009,3183,3326,143,4.493,26,117,48,295,H1
"Lipscomb County, TX",2009-2010,3326,3283,-43,-1.293,31,-74,48,295,H1
"Lipscomb County, TX",2010-2011,3283,3343,60,1.828,32,28,48,295,H1
"Lipscomb County, TX",2011-2012,3343,3432,89,2.662,3,86,48,295,H1
"Lipscomb County, TX",2012-2013,3432,3479,47,1.369,14,33,48,295,H1
"Lipscomb County, TX",2013-2014,3479,3553,74,2.127,24,50,48,295,H1
"Lipscomb County, TX",2014-2015,3565,3569,4,0.112,20,-16,48,295,H1
"Lipscomb County, TX",2015-2016,3569,3509,-60,-1.681,32,-92,48,295,H1
"Lipscomb County, TX",2016-2017,3509,3378,-131,-3.733,20,-151,48,295,H1
"Live Oak County, TX",2000-2001,12233,12071,-162,-1.324,11,-173,48,297,H1
"Live Oak County, TX",2001-2002,12071,11955,-116,-0.961,22,-138,48,297,H1
"Live Oak County, TX",2002-2003,11955,11768,-187,-1.564,8,-195,48,297,H1
"Live Oak County, TX",2003-2004,11768,11689,-79,-0.671,29,-108,48,297,H1
"Live Oak County, TX",2004-2005,11689,11631,-58,-0.496,39,-97,48,297,H1
"Live Oak County, TX",2005-2006,11631,11559,-72,-0.619,5,-77,48,297,H1
"Live Oak County, TX",2006-2007,11559,11528,-31,-0.268,12,-43,48,297,H1
"Live Oak County, TX",2007-2008,11528,11479,-49,-0.425,16,-65,48,297,H1
"Live Oak County, TX",2008-2009,11479,11410,-69,-0.601,29,-98,48,297,H1
"Live Oak County, TX",2009-2010,11410,11545,135,1.183,44,91,48,297,H1
"Live Oak County, TX",2010-2011,11545,11518,-27,-0.234,-9,-18,48,297,H1
"Live Oak County, TX",2011-2012,11518,11668,150,1.302,8,142,48,297,H1
"Live Oak County, TX",2012-2013,11668,11868,200,1.714,30,170,48,297,H1
"Live Oak County, TX",2013-2014,11868,12091,223,1.879,25,198,48,297,H1
"Live Oak County, TX",2014-2015,12081,12229,148,1.225,21,127,48,297,H1
"Live Oak County, TX",2015-2016,12229,12022,-207,-1.693,12,-219,48,297,H1
"Live Oak County, TX",2016-2017,12022,12174,152,1.264,10,142,48,297,H1
"Llano County, TX",2000-2001,17077,17499,422,2.471,-83,505,48,299,H1
"Llano County, TX",2001-2002,17499,17872,373,2.132,-135,508,48,299,H1
"Llano County, TX",2002-2003,17872,18153,281,1.572,-115,396,48,299,H1
"Llano County, TX",2003-2004,18153,18220,67,0.369,-139,206,48,299,H1
"Llano County, TX",2004-2005,18220,18425,205,1.125,-96,301,48,299,H1
"Llano County, TX",2005-2006,18425,18502,77,0.418,-129,206,48,299,H1
"Llano County, TX",2006-2007,18502,18935,433,2.34,-107,540,48,299,H1
"Llano County, TX",2007-2008,18935,19034,99,0.523,-124,223,48,299,H1
"Llano County, TX",2008-2009,19034,19175,141,0.741,-105,246,48,299,H1
"Llano County, TX",2009-2010,19175,19359,184,0.96,-95,279,48,299,H1
"Llano County, TX",2010-2011,19359,18964,-395,-2.04,-164,-231,48,299,H1
"Llano County, TX",2011-2012,18964,19121,157,0.828,-139,296,48,299,H1
"Llano County, TX",2012-2013,19121,19406,285,1.491,-131,416,48,299,H1
"Llano County, TX",2013-2014,19406,19510,104,0.536,-127,231,48,299,H1
"Llano County, TX",2014-2015,19440,19796,356,1.831,-126,482,48,299,H1
"Llano County, TX",2015-2016,19796,20570,774,3.91,-129,903,48,299,H1
"Llano County, TX",2016-2017,20570,21210,640,3.111,-129,769,48,299,H1
"Loving County, TX",2000-2001,65,66,1,1.538,0,1,48,301,H1
"Loving County, TX",2001-2002,66,75,9,13.636,2,7,48,301,H1
"Loving County, TX",2002-2003,75,72,-3,-4,0,-3,48,301,H1
"Loving County, TX",2003-2004,72,55,-17,-23.611,-1,-16,48,301,H1
"Loving County, TX",2004-2005,55,70,15,27.273,0,15,48,301,H1
"Loving County, TX",2005-2006,70,75,5,7.143,0,5,48,301,H1
"Loving County, TX",2006-2007,75,79,4,5.333,1,3,48,301,H1
"Loving County, TX",2007-2008,79,61,-18,-22.785,1,-19,48,301,H1
"Loving County, TX",2008-2009,61,77,16,26.23,0,16,48,301,H1
"Loving County, TX",2009-2010,77,83,6,7.792,0,6,48,301,H1
"Loving County, TX",2010-2011,83,95,12,14.458,2,10,48,301,H1
"Loving County, TX",2011-2012,95,83,-12,-12.632,0,-12,48,301,H1
"Loving County, TX",2012-2013,83,103,20,24.096,0,20,48,301,H1
"Loving County, TX",2013-2014,103,86,-17,-16.505,0,-17,48,301,H1
"Loving County, TX",2014-2015,87,112,25,28.736,0,25,48,301,H1
"Loving County, TX",2015-2016,112,115,3,2.679,0,3,48,301,H1
"Loving County, TX",2016-2017,115,134,19,16.522,0,19,48,301,H1
"Lubbock County, TX",2000-2001,243109,246616,3507,1.443,1891,1616,48,303,H1
"Lubbock County, TX",2001-2002,246616,249407,2791,1.132,1918,873,48,303,H1
"Lubbock County, TX",2002-2003,249407,253388,3981,1.596,2096,1885,48,303,H1
"Lubbock County, TX",2003-2004,253388,255669,2281,0.9,2059,222,48,303,H1
"Lubbock County, TX",2004-2005,255669,257779,2110,0.825,1993,117,48,303,H1
"Lubbock County, TX",2005-2006,257779,261761,3982,1.545,1917,2065,48,303,H1
"Lubbock County, TX",2006-2007,261761,265215,3454,1.32,2239,1215,48,303,H1
"Lubbock County, TX",2007-2008,265215,268197,2982,1.124,2169,813,48,303,H1
"Lubbock County, TX",2008-2009,268197,274252,6055,2.258,2090,3965,48,303,H1
"Lubbock County, TX",2009-2010,274252,280207,5955,2.171,2486,3469,48,303,H1
"Lubbock County, TX",2010-2011,280207,283399,3192,1.139,1737,1455,48,303,H1
"Lubbock County, TX",2011-2012,283399,286096,2697,0.952,1656,1041,48,303,H1
"Lubbock County, TX",2012-2013,286096,290060,3964,1.386,1774,2190,48,303,H1
"Lubbock County, TX",2013-2014,290060,293974,3914,1.349,1669,2245,48,303,H1
"Lubbock County, TX",2014-2015,295039,299453,4414,1.496,1826,2588,48,303,H1
"Lubbock County, TX",2015-2016,299453,302301,2848,0.951,1784,1064,48,303,H1
"Lubbock County, TX",2016-2017,302301,305225,2924,0.967,1724,1200,48,303,H1
"Lynn County, TX",2000-2001,6489,6444,-45,-0.693,37,-82,48,305,H1
"Lynn County, TX",2001-2002,6444,6421,-23,-0.357,16,-39,48,305,H1
"Lynn County, TX",2002-2003,6421,6232,-189,-2.943,26,-215,48,305,H1
"Lynn County, TX",2003-2004,6232,6172,-60,-0.963,26,-86,48,305,H1
"Lynn County, TX",2004-2005,6172,6178,6,0.097,31,-25,48,305,H1
"Lynn County, TX",2005-2006,6178,6192,14,0.227,25,-11,48,305,H1
"Lynn County, TX",2006-2007,6192,5989,-203,-3.278,36,-239,48,305,H1
"Lynn County, TX",2007-2008,5989,5932,-57,-0.952,56,-113,48,305,H1
"Lynn County, TX",2008-2009,5932,5927,-5,-0.084,48,-53,48,305,H1
"Lynn County, TX",2009-2010,5927,5897,-30,-0.506,47,-77,48,305,H1
"Lynn County, TX",2010-2011,5897,5879,-18,-0.305,18,-36,48,305,H1
"Lynn County, TX",2011-2012,5879,5777,-102,-1.735,21,-123,48,305,H1
"Lynn County, TX",2012-2013,5777,5708,-69,-1.194,34,-103,48,305,H1
"Lynn County, TX",2013-2014,5708,5771,63,1.104,46,17,48,305,H1
"Lynn County, TX",2014-2015,5753,5724,-29,-0.504,46,-75,48,305,H1
"Lynn County, TX",2015-2016,5724,5795,71,1.24,45,26,48,305,H1
"Lynn County, TX",2016-2017,5795,5859,64,1.104,32,32,48,305,H1
"McCulloch County, TX",2000-2001,8175,8034,-141,-1.725,-45,-96,48,307,H1
"McCulloch County, TX",2001-2002,8034,7927,-107,-1.332,-22,-85,48,307,H1
"McCulloch County, TX",2002-2003,7927,8033,106,1.337,5,101,48,307,H1
"McCulloch County, TX",2003-2004,8033,8164,131,1.631,-35,166,48,307,H1
"McCulloch County, TX",2004-2005,8164,8117,-47,-0.576,1,-48,48,307,H1
"McCulloch County, TX",2005-2006,8117,8183,66,0.813,-9,75,48,307,H1
"McCulloch County, TX",2006-2007,8183,8105,-78,-0.953,27,-105,48,307,H1
"McCulloch County, TX",2007-2008,8105,8203,98,1.209,6,92,48,307,H1
"McCulloch County, TX",2008-2009,8203,8365,162,1.975,13,149,48,307,H1
"McCulloch County, TX",2009-2010,8365,8221,-144,-1.721,8,-152,48,307,H1
"McCulloch County, TX",2010-2011,8221,8271,50,0.608,-22,72,48,307,H1
"McCulloch County, TX",2011-2012,8271,8275,4,0.048,0,4,48,307,H1
"McCulloch County, TX",2012-2013,8275,8261,-14,-0.169,-11,-3,48,307,H1
"McCulloch County, TX",2013-2014,8261,8199,-62,-0.751,-19,-43,48,307,H1
"McCulloch County, TX",2014-2015,8200,8341,141,1.72,-22,163,48,307,H1
"McCulloch County, TX",2015-2016,8341,8121,-220,-2.638,-4,-216,48,307,H1
"McCulloch County, TX",2016-2017,8121,7957,-164,-2.019,-12,-152,48,307,H1
"McLennan County, TX",2000-2001,213967,215099,1132,0.529,1319,-187,48,309,H1
"McLennan County, TX",2001-2002,215099,216571,1472,0.684,1254,218,48,309,H1
"McLennan County, TX",2002-2003,216571,218744,2173,1.003,1479,694,48,309,H1
"McLennan County, TX",2003-2004,218744,221353,2609,1.193,1249,1360,48,309,H1
"McLennan County, TX",2004-2005,221353,222794,1441,0.651,1350,91,48,309,H1
"McLennan County, TX",2005-2006,222794,224452,1658,0.744,1447,211,48,309,H1
"McLennan County, TX",2006-2007,224452,226741,2289,1.02,1415,874,48,309,H1
"McLennan County, TX",2007-2008,226741,229037,2296,1.013,1419,877,48,309,H1
"McLennan County, TX",2008-2009,229037,231679,2642,1.154,1532,1110,48,309,H1
"McLennan County, TX",2009-2010,231679,235961,4282,1.848,1733,2549,48,309,H1
"McLennan County, TX",2010-2011,235961,237867,1906,0.808,1449,457,48,309,H1
"McLennan County, TX",2011-2012,237867,239511,1644,0.691,1495,149,48,309,H1
"McLennan County, TX",2012-2013,239511,241807,2296,0.959,1356,940,48,309,H1
"McLennan County, TX",2013-2014,241807,243441,1634,0.676,1402,232,48,309,H1
"McLennan County, TX",2014-2015,243088,245671,2583,1.063,1527,1056,48,309,H1
"McLennan County, TX",2015-2016,245671,247478,1807,0.736,1363,444,48,309,H1
"McLennan County, TX",2016-2017,247478,251259,3781,1.528,1393,2388,48,309,H1
"McMullen County, TX",2000-2001,843,819,-24,-2.847,0,-24,48,311,H1
"McMullen County, TX",2001-2002,819,795,-24,-2.93,-3,-21,48,311,H1
"McMullen County, TX",2002-2003,795,801,6,0.755,-5,11,48,311,H1
"McMullen County, TX",2003-2004,801,735,-66,-8.24,-1,-65,48,311,H1
"McMullen County, TX",2004-2005,735,789,54,7.347,5,49,48,311,H1
"McMullen County, TX",2005-2006,789,765,-24,-3.042,5,-29,48,311,H1
"McMullen County, TX",2006-2007,765,773,8,1.046,3,5,48,311,H1
"McMullen County, TX",2007-2008,773,736,-37,-4.787,0,-37,48,311,H1
"McMullen County, TX",2008-2009,736,699,-37,-5.027,4,-41,48,311,H1
"McMullen County, TX",2009-2010,699,712,13,1.86,0,13,48,311,H1
"McMullen County, TX",2010-2011,712,703,-9,-1.264,3,-12,48,311,H1
"McMullen County, TX",2011-2012,703,738,35,4.979,1,34,48,311,H1
"McMullen County, TX",2012-2013,738,772,34,4.607,-6,40,48,311,H1
"McMullen County, TX",2013-2014,772,805,33,4.275,-3,36,48,311,H1
"McMullen County, TX",2014-2015,804,820,16,1.99,1,15,48,311,H1
"McMullen County, TX",2015-2016,820,815,-5,-0.61,5,-10,48,311,H1
"McMullen County, TX",2016-2017,815,778,-37,-4.54,2,-39,48,311,H1
"Madison County, TX",2000-2001,12967,13680,713,5.499,4,709,48,313,H1
"Madison County, TX",2001-2002,13680,12797,-883,-6.455,10,-893,48,313,H1
"Madison County, TX",2002-2003,12797,12989,192,1.5,39,153,48,313,H1
"Madison County, TX",2003-2004,12989,13146,157,1.209,-8,165,48,313,H1
"Madison County, TX",2004-2005,13146,13136,-10,-0.076,45,-55,48,313,H1
"Madison County, TX",2005-2006,13136,13264,128,0.974,27,101,48,313,H1
"Madison County, TX",2006-2007,13264,13353,89,0.671,30,59,48,313,H1
"Madison County, TX",2007-2008,13353,13340,-13,-0.097,28,-41,48,313,H1
"Madison County, TX",2008-2009,13340,13483,143,1.072,51,92,48,313,H1
"Madison County, TX",2009-2010,13483,13737,254,1.884,58,196,48,313,H1
"Madison County, TX",2010-2011,13737,13727,-10,-0.073,36,-46,48,313,H1
"Madison County, TX",2011-2012,13727,13712,-15,-0.109,24,-39,48,313,H1
"Madison County, TX",2012-2013,13712,13819,107,0.78,45,62,48,313,H1
"Madison County, TX",2013-2014,13819,13861,42,0.304,39,3,48,313,H1
"Madison County, TX",2014-2015,13852,14065,213,1.538,33,180,48,313,H1
"Madison County, TX",2015-2016,14065,14094,29,0.206,29,0,48,313,H1
"Madison County, TX",2016-2017,14094,14222,128,0.908,34,94,48,313,H1
"Marion County, TX",2000-2001,10950,11077,127,1.16,-56,183,48,315,H1
"Marion County, TX",2001-2002,11077,11032,-45,-0.406,-7,-38,48,315,H1
"Marion County, TX",2002-2003,11032,11120,88,0.798,-32,120,48,315,H1
"Marion County, TX",2003-2004,11120,11004,-116,-1.043,-23,-93,48,315,H1
"Marion County, TX",2004-2005,11004,10980,-24,-0.218,-33,9,48,315,H1
"Marion County, TX",2005-2006,10980,10992,12,0.109,-85,97,48,315,H1
"Marion County, TX",2006-2007,10992,10951,-41,-0.373,-41,0,48,315,H1
"Marion County, TX",2007-2008,10951,10748,-203,-1.854,-36,-167,48,315,H1
"Marion County, TX",2008-2009,10748,10669,-79,-0.735,-38,-41,48,315,H1
"Marion County, TX",2009-2010,10669,10513,-156,-1.462,-35,-121,48,315,H1
"Marion County, TX",2010-2011,10513,10452,-61,-0.58,-66,5,48,315,H1
"Marion County, TX",2011-2012,10452,10323,-129,-1.234,-42,-87,48,315,H1
"Marion County, TX",2012-2013,10323,10239,-84,-0.814,-63,-21,48,315,H1
"Marion County, TX",2013-2014,10239,10149,-90,-0.879,-37,-53,48,315,H1
"Marion County, TX",2014-2015,10114,10160,46,0.455,-29,75,48,315,H1
"Marion County, TX",2015-2016,10160,10087,-73,-0.719,-64,-9,48,315,H1
"Marion County, TX",2016-2017,10087,10064,-23,-0.228,-49,26,48,315,H1
"Martin County, TX",2000-2001,4720,4697,-23,-0.487,17,-40,48,317,H1
"Martin County, TX",2001-2002,4697,4654,-43,-0.915,20,-63,48,317,H1
"Martin County, TX",2002-2003,4654,4553,-101,-2.17,19,-120,48,317,H1
"Martin County, TX",2003-2004,4553,4398,-155,-3.404,1,-156,48,317,H1
"Martin County, TX",2004-2005,4398,4447,49,1.114,31,18,48,317,H1
"Martin County, TX",2005-2006,4447,4443,-4,-0.09,17,-21,48,317,H1
"Martin County, TX",2006-2007,4443,4494,51,1.148,21,30,48,317,H1
"Martin County, TX",2007-2008,4494,4558,64,1.424,40,24,48,317,H1
"Martin County, TX",2008-2009,4558,4710,152,3.335,55,97,48,317,H1
"Martin County, TX",2009-2010,4710,4817,107,2.272,60,47,48,317,H1
"Martin County, TX",2010-2011,4817,4911,94,1.951,36,58,48,317,H1
"Martin County, TX",2011-2012,4911,5002,91,1.853,51,40,48,317,H1
"Martin County, TX",2012-2013,5002,5291,289,5.778,55,234,48,317,H1
"Martin County, TX",2013-2014,5291,5460,169,3.194,70,99,48,317,H1
"Martin County, TX",2014-2015,5450,5641,191,3.505,71,120,48,317,H1
"Martin County, TX",2015-2016,5641,5688,47,0.833,73,-26,48,317,H1
"Martin County, TX",2016-2017,5688,5626,-62,-1.09,54,-116,48,317,H1
"Mason County, TX",2000-2001,3734,3743,9,0.241,-20,29,48,319,H1
"Mason County, TX",2001-2002,3743,3725,-18,-0.481,-33,15,48,319,H1
"Mason County, TX",2002-2003,3725,3762,37,0.993,-11,48,48,319,H1
"Mason County, TX",2003-2004,3762,3811,49,1.302,-25,74,48,319,H1
"Mason County, TX",2004-2005,3811,3813,2,0.052,-10,12,48,319,H1
"Mason County, TX",2005-2006,3813,3862,49,1.285,-7,56,48,319,H1
"Mason County, TX",2006-2007,3862,3897,35,0.906,-5,40,48,319,H1
"Mason County, TX",2007-2008,3897,3876,-21,-0.539,4,-25,48,319,H1
"Mason County, TX",2008-2009,3876,3982,106,2.735,-6,112,48,319,H1
"Mason County, TX",2009-2010,3982,4013,31,0.779,-6,37,48,319,H1
"Mason County, TX",2010-2011,4013,4029,16,0.399,-3,19,48,319,H1
"Mason County, TX",2011-2012,4029,4044,15,0.372,-3,18,48,319,H1
"Mason County, TX",2012-2013,4044,4148,104,2.572,-6,110,48,319,H1
"Mason County, TX",2013-2014,4148,4071,-77,-1.856,-5,-72,48,319,H1
"Mason County, TX",2014-2015,4073,4032,-41,-1.007,-5,-36,48,319,H1
"Mason County, TX",2015-2016,4032,4161,129,3.199,3,126,48,319,H1
"Mason County, TX",2016-2017,4161,4222,61,1.466,3,58,48,319,H1
"Matagorda County, TX",2000-2001,37873,37804,-69,-0.182,155,-224,48,321,H1
"Matagorda County, TX",2001-2002,37804,37662,-142,-0.376,191,-333,48,321,H1
"Matagorda County, TX",2002-2003,37662,37695,33,0.088,183,-150,48,321,H1
"Matagorda County, TX",2003-2004,37695,37388,-307,-0.814,190,-497,48,321,H1
"Matagorda County, TX",2004-2005,37388,37132,-256,-0.685,234,-490,48,321,H1
"Matagorda County, TX",2005-2006,37132,36743,-389,-1.048,229,-618,48,321,H1
"Matagorda County, TX",2006-2007,36743,36452,-291,-0.792,201,-492,48,321,H1
"Matagorda County, TX",2007-2008,36452,36708,256,0.702,240,16,48,321,H1
"Matagorda County, TX",2008-2009,36708,36579,-129,-0.351,217,-346,48,321,H1
"Matagorda County, TX",2009-2010,36579,36721,142,0.388,175,-33,48,321,H1
"Matagorda County, TX",2010-2011,36721,36714,-7,-0.019,207,-214,48,321,H1
"Matagorda County, TX",2011-2012,36714,36566,-148,-0.403,191,-339,48,321,H1
"Matagorda County, TX",2012-2013,36566,36537,-29,-0.079,135,-164,48,321,H1
"Matagorda County, TX",2013-2014,36537,36519,-18,-0.049,158,-176,48,321,H1
"Matagorda County, TX",2014-2015,36469,36770,301,0.825,172,129,48,321,H1
"Matagorda County, TX",2015-2016,36770,37117,347,0.944,185,162,48,321,H1
"Matagorda County, TX",2016-2017,37117,36840,-277,-0.746,163,-440,48,321,H1
"Maverick County, TX",2000-2001,47343,47594,251,0.53,731,-480,48,323,H1
"Maverick County, TX",2001-2002,47594,48408,814,1.71,894,-80,48,323,H1
"Maverick County, TX",2002-2003,48408,49123,715,1.477,676,39,48,323,H1
"Maverick County, TX",2003-2004,49123,49627,504,1.026,788,-284,48,323,H1
"Maverick County, TX",2004-2005,49627,50140,513,1.034,802,-289,48,323,H1
"Maverick County, TX",2005-2006,50140,50951,811,1.617,789,22,48,323,H1
"Maverick County, TX",2006-2007,50951,51367,416,0.816,729,-313,48,323,H1
"Maverick County, TX",2007-2008,51367,52190,823,1.602,797,26,48,323,H1
"Maverick County, TX",2008-2009,52190,53434,1244,2.384,795,449,48,323,H1
"Maverick County, TX",2009-2010,53434,54499,1065,1.993,777,288,48,323,H1
"Maverick County, TX",2010-2011,54499,55308,809,1.484,694,115,48,323,H1
"Maverick County, TX",2011-2012,55308,55766,458,0.828,696,-238,48,323,H1
"Maverick County, TX",2012-2013,55766,56510,744,1.334,757,-13,48,323,H1
"Maverick County, TX",2013-2014,56510,57023,513,0.908,762,-249,48,323,H1
"Maverick County, TX",2014-2015,57188,57706,518,0.906,739,-221,48,323,H1
"Maverick County, TX",2015-2016,57706,57989,283,0.49,708,-425,48,323,H1
"Maverick County, TX",2016-2017,57989,58216,227,0.391,728,-501,48,323,H1
"Medina County, TX",2000-2001,39484,40053,569,1.441,179,390,48,325,H1
"Medina County, TX",2001-2002,40053,40707,654,1.633,250,404,48,325,H1
"Medina County, TX",2002-2003,40707,41549,842,2.068,251,591,48,325,H1
"Medina County, TX",2003-2004,41549,42363,814,1.959,227,587,48,325,H1
"Medina County, TX",2004-2005,42363,42977,614,1.449,242,372,48,325,H1
"Medina County, TX",2005-2006,42977,43936,959,2.231,253,706,48,325,H1
"Medina County, TX",2006-2007,43936,44577,641,1.459,200,441,48,325,H1
"Medina County, TX",2007-2008,44577,45131,554,1.243,213,341,48,325,H1
"Medina County, TX",2008-2009,45131,45605,474,1.05,246,228,48,325,H1
"Medina County, TX",2009-2010,45605,46153,548,1.202,196,352,48,325,H1
"Medina County, TX",2010-2011,46153,46546,393,0.852,200,193,48,325,H1
"Medina County, TX",2011-2012,46546,46867,321,0.69,134,187,48,325,H1
"Medina County, TX",2012-2013,46867,47366,499,1.065,103,396,48,325,H1
"Medina County, TX",2013-2014,47366,47894,528,1.115,125,403,48,325,H1
"Medina County, TX",2014-2015,47876,48417,541,1.13,145,396,48,325,H1
"Medina County, TX",2015-2016,48417,49196,779,1.609,170,609,48,325,H1
"Medina County, TX",2016-2017,49196,50066,870,1.768,164,706,48,325,H1
"Menard County, TX",2000-2001,2342,2321,-21,-0.897,-8,-13,48,327,H1
"Menard County, TX",2001-2002,2321,2340,19,0.819,-8,27,48,327,H1
"Menard County, TX",2002-2003,2340,2311,-29,-1.239,-13,-16,48,327,H1
"Menard County, TX",2003-2004,2311,2265,-46,-1.99,-26,-20,48,327,H1
"Menard County, TX",2004-2005,2265,2212,-53,-2.34,-1,-52,48,327,H1
"Menard County, TX",2005-2006,2212,2199,-13,-0.588,-12,-1,48,327,H1
"Menard County, TX",2006-2007,2199,2176,-23,-1.046,-14,-9,48,327,H1
"Menard County, TX",2007-2008,2176,2217,41,1.884,-10,51,48,327,H1
"Menard County, TX",2008-2009,2217,2227,10,0.451,-5,15,48,327,H1
"Menard County, TX",2009-2010,2227,2235,8,0.359,-4,12,48,327,H1
"Menard County, TX",2010-2011,2235,2220,-15,-0.671,-31,16,48,327,H1
"Menard County, TX",2011-2012,2220,2221,1,0.045,-16,17,48,327,H1
"Menard County, TX",2012-2013,2221,2143,-78,-3.512,-2,-76,48,327,H1
"Menard County, TX",2013-2014,2143,2147,4,0.187,3,1,48,327,H1
"Menard County, TX",2014-2015,2150,2164,14,0.651,2,12,48,327,H1
"Menard County, TX",2015-2016,2164,2102,-62,-2.865,-7,-55,48,327,H1
"Menard County, TX",2016-2017,2102,2124,22,1.047,-12,34,48,327,H1
"Midland County, TX",2000-2001,115560,116180,620,0.537,928,-308,48,329,H1
"Midland County, TX",2001-2002,116180,117717,1537,1.323,883,654,48,329,H1
"Midland County, TX",2002-2003,117717,119164,1447,1.229,976,471,48,329,H1
"Midland County, TX",2003-2004,119164,120746,1582,1.328,892,690,48,329,H1
"Midland County, TX",2004-2005,120746,122516,1770,1.466,1088,682,48,329,H1
"Midland County, TX",2005-2006,122516,125844,3328,2.716,1093,2235,48,329,H1
"Midland County, TX",2006-2007,125844,128954,3110,2.471,1290,1820,48,329,H1
"Midland County, TX",2007-2008,128954,132502,3548,2.751,1235,2313,48,329,H1
"Midland County, TX",2008-2009,132502,136238,3736,2.82,1254,2482,48,329,H1
"Midland County, TX",2009-2010,136238,136981,743,0.545,1362,-619,48,329,H1
"Midland County, TX",2010-2011,136981,140085,3104,2.266,1233,1871,48,329,H1
"Midland County, TX",2011-2012,140085,147090,7005,5.001,1423,5582,48,329,H1
"Midland County, TX",2012-2013,147090,151949,4859,3.303,1603,3256,48,329,H1
"Midland County, TX",2013-2014,151949,155830,3881,2.554,1657,2224,48,329,H1
"Midland County, TX",2014-2015,155990,161077,5087,3.261,1799,3288,48,329,H1
"Midland County, TX",2015-2016,161077,163473,2396,1.487,1891,505,48,329,H1
"Midland County, TX",2016-2017,163473,165049,1576,0.964,1872,-296,48,329,H1
"Milam County, TX",2000-2001,24290,24445,155,0.638,73,82,48,331,H1
"Milam County, TX",2001-2002,24445,24981,536,2.193,70,466,48,331,H1
"Milam County, TX",2002-2003,24981,24917,-64,-0.256,74,-138,48,331,H1
"Milam County, TX",2003-2004,24917,25136,219,0.879,99,120,48,331,H1
"Milam County, TX",2004-2005,25136,25017,-119,-0.473,57,-176,48,331,H1
"Milam County, TX",2005-2006,25017,25082,65,0.26,2,63,48,331,H1
"Milam County, TX",2006-2007,25082,24946,-136,-0.542,14,-150,48,331,H1
"Milam County, TX",2007-2008,24946,25065,119,0.477,57,62,48,331,H1
"Milam County, TX",2008-2009,25065,24864,-201,-0.802,119,-320,48,331,H1
"Milam County, TX",2009-2010,24864,24702,-162,-0.652,100,-262,48,331,H1
"Milam County, TX",2010-2011,24702,24646,-56,-0.227,14,-70,48,331,H1
"Milam County, TX",2011-2012,24646,24143,-503,-2.041,30,-533,48,331,H1
"Milam County, TX",2012-2013,24143,24191,48,0.199,53,-5,48,331,H1
"Milam County, TX",2013-2014,24191,24256,65,0.269,50,15,48,331,H1
"Milam County, TX",2014-2015,24254,24513,259,1.068,58,201,48,331,H1
"Milam County, TX",2015-2016,24513,24735,222,0.906,29,193,48,331,H1
"Milam County, TX",2016-2017,24735,25053,318,1.286,39,279,48,331,H1
"Mills County, TX",2000-2001,5107,4983,-124,-2.428,-28,-96,48,333,H1
"Mills County, TX",2001-2002,4983,4973,-10,-0.201,-58,48,48,333,H1
"Mills County, TX",2002-2003,4973,4885,-88,-1.77,-24,-64,48,333,H1
"Mills County, TX",2003-2004,4885,4880,-5,-0.102,-24,19,48,333,H1
"Mills County, TX",2004-2005,4880,4957,77,1.578,-3,80,48,333,H1
"Mills County, TX",2005-2006,4957,4854,-103,-2.078,-30,-73,48,333,H1
"Mills County, TX",2006-2007,4854,4871,17,0.35,-30,47,48,333,H1
"Mills County, TX",2007-2008,4871,4876,5,0.103,-13,18,48,333,H1
"Mills County, TX",2008-2009,4876,4877,1,0.021,-8,9,48,333,H1
"Mills County, TX",2009-2010,4877,4953,76,1.558,-13,89,48,333,H1
"Mills County, TX",2010-2011,4953,4867,-86,-1.736,-28,-58,48,333,H1
"Mills County, TX",2011-2012,4867,4831,-36,-0.74,-32,-4,48,333,H1
"Mills County, TX",2012-2013,4831,4886,55,1.138,-3,58,48,333,H1
"Mills County, TX",2013-2014,4886,4870,-16,-0.327,-21,5,48,333,H1
"Mills County, TX",2014-2015,4886,4900,14,0.287,-11,25,48,333,H1
"Mills County, TX",2015-2016,4900,4894,-6,-0.122,-23,17,48,333,H1
"Mills County, TX",2016-2017,4894,4921,27,0.552,-31,58,48,333,H1
"Mitchell County, TX",2000-2001,9628,9576,-52,-0.54,-3,-49,48,335,H1
"Mitchell County, TX",2001-2002,9576,9420,-156,-1.629,-44,-112,48,335,H1
"Mitchell County, TX",2002-2003,9420,9366,-54,-0.573,-44,-10,48,335,H1
"Mitchell County, TX",2003-2004,9366,9280,-86,-0.918,-13,-73,48,335,H1
"Mitchell County, TX",2004-2005,9280,9322,42,0.453,-15,57,48,335,H1
"Mitchell County, TX",2005-2006,9322,9279,-43,-0.461,13,-56,48,335,H1
"Mitchell County, TX",2006-2007,9279,9339,60,0.647,11,49,48,335,H1
"Mitchell County, TX",2007-2008,9339,9285,-54,-0.578,15,-69,48,335,H1
"Mitchell County, TX",2008-2009,9285,9399,114,1.228,8,106,48,335,H1
"Mitchell County, TX",2009-2010,9399,9409,10,0.106,7,3,48,335,H1
"Mitchell County, TX",2010-2011,9409,9385,-24,-0.255,-16,-8,48,335,H1
"Mitchell County, TX",2011-2012,9385,9312,-73,-0.778,15,-88,48,335,H1
"Mitchell County, TX",2012-2013,9312,8998,-314,-3.372,29,-343,48,335,H1
"Mitchell County, TX",2013-2014,8998,9076,78,0.867,30,48,48,335,H1
"Mitchell County, TX",2014-2015,9081,9067,-14,-0.154,37,-51,48,335,H1
"Mitchell County, TX",2015-2016,9067,8479,-588,-6.485,-4,-584,48,335,H1
"Mitchell County, TX",2016-2017,8479,8468,-11,-0.13,14,-25,48,335,H1
"Montague County, TX",2000-2001,19166,19196,30,0.157,-38,68,48,337,H1
"Montague County, TX",2001-2002,19196,19170,-26,-0.135,-64,38,48,337,H1
"Montague County, TX",2002-2003,19170,19388,218,1.137,-49,267,48,337,H1
"Montague County, TX",2003-2004,19388,19444,56,0.289,-1,57,48,337,H1
"Montague County, TX",2004-2005,19444,19551,107,0.55,-50,157,48,337,H1
"Montague County, TX",2005-2006,19551,19781,230,1.176,-43,273,48,337,H1
"Montague County, TX",2006-2007,19781,19822,41,0.207,19,22,48,337,H1
"Montague County, TX",2007-2008,19822,19882,60,0.303,-17,77,48,337,H1
"Montague County, TX",2008-2009,19882,19768,-114,-0.573,-22,-92,48,337,H1
"Montague County, TX",2009-2010,19768,19720,-48,-0.243,-34,-14,48,337,H1
"Montague County, TX",2010-2011,19720,19741,21,0.106,-26,47,48,337,H1
"Montague County, TX",2011-2012,19741,19529,-212,-1.074,-46,-166,48,337,H1
"Montague County, TX",2012-2013,19529,19435,-94,-0.481,-45,-49,48,337,H1
"Montague County, TX",2013-2014,19435,19416,-19,-0.098,-39,20,48,337,H1
"Montague County, TX",2014-2015,19428,19262,-166,-0.854,-41,-125,48,337,H1
"Montague County, TX",2015-2016,19262,19436,174,0.903,-19,193,48,337,H1
"Montague County, TX",2016-2017,19436,19539,103,0.53,-7,110,48,337,H1
"Montgomery County, TX",2000-2001,297296,311437,14141,4.757,2615,11526,48,339,H1
"Montgomery County, TX",2001-2002,311437,326466,15029,4.826,2682,12347,48,339,H1
"Montgomery County, TX",2002-2003,326466,341499,15033,4.605,2934,12099,48,339,H1
"Montgomery County, TX",2003-2004,341499,357607,16108,4.717,2974,13134,48,339,H1
"Montgomery County, TX",2004-2005,357607,372541,14934,4.176,3093,11841,48,339,H1
"Montgomery County, TX",2005-2006,372541,392497,19956,5.357,3289,16667,48,339,H1
"Montgomery County, TX",2006-2007,392497,411416,18919,4.82,3575,15344,48,339,H1
"Montgomery County, TX",2007-2008,411416,429818,18402,4.473,3827,14575,48,339,H1
"Montgomery County, TX",2008-2009,429818,445836,16018,3.727,3923,12095,48,339,H1
"Montgomery County, TX",2009-2010,445836,459421,13585,3.047,3005,10580,48,339,H1
"Montgomery County, TX",2010-2011,459421,471836,12415,2.702,3428,8987,48,339,H1
"Montgomery County, TX",2011-2012,471836,485119,13283,2.815,3408,9875,48,339,H1
"Montgomery County, TX",2012-2013,485119,499818,14699,3.03,3326,11373,48,339,H1
"Montgomery County, TX",2013-2014,499818,518947,19129,3.827,3307,15822,48,339,H1
"Montgomery County, TX",2014-2015,519054,537559,18505,3.565,3490,15015,48,339,H1
"Montgomery County, TX",2015-2016,537559,554522,16963,3.156,3786,13177,48,339,H1
"Montgomery County, TX",2016-2017,554522,570934,16412,2.96,3723,12689,48,339,H1
"Moore County, TX",2000-2001,20121,20281,160,0.795,280,-120,48,341,H1
"Moore County, TX",2001-2002,20281,20155,-126,-0.621,238,-364,48,341,H1
"Moore County, TX",2002-2003,20155,20223,68,0.337,312,-244,48,341,H1
"Moore County, TX",2003-2004,20223,20389,166,0.821,299,-133,48,341,H1
"Moore County, TX",2004-2005,20389,20312,-77,-0.378,288,-365,48,341,H1
"Moore County, TX",2005-2006,20312,20558,246,1.211,262,-16,48,341,H1
"Moore County, TX",2006-2007,20558,20469,-89,-0.433,266,-355,48,341,H1
"Moore County, TX",2007-2008,20469,20917,448,2.189,279,169,48,341,H1
"Moore County, TX",2008-2009,20917,21575,658,3.146,328,330,48,341,H1
"Moore County, TX",2009-2010,21575,21996,421,1.951,327,94,48,341,H1
"Moore County, TX",2010-2011,21996,22093,97,0.441,266,-169,48,341,H1
"Moore County, TX",2011-2012,22093,22399,306,1.385,263,43,48,341,H1
"Moore County, TX",2012-2013,22399,22223,-176,-0.786,314,-490,48,341,H1
"Moore County, TX",2013-2014,22223,22148,-75,-0.337,280,-355,48,341,H1
"Moore County, TX",2014-2015,22293,22255,-38,-0.17,303,-341,48,341,H1
"Moore County, TX",2015-2016,22255,21935,-320,-1.438,318,-638,48,341,H1
"Moore County, TX",2016-2017,21935,22097,162,0.739,324,-162,48,341,H1
"Morris County, TX",2000-2001,13027,13179,152,1.167,-39,191,48,343,H1
"Morris County, TX",2001-2002,13179,13170,-9,-0.068,-40,31,48,343,H1
"Morris County, TX",2002-2003,13170,13139,-31,-0.235,-10,-21,48,343,H1
"Morris County, TX",2003-2004,13139,12983,-156,-1.187,-43,-113,48,343,H1
"Morris County, TX",2004-2005,12983,13012,29,0.223,-25,54,48,343,H1
"Morris County, TX",2005-2006,13012,13168,156,1.199,9,147,48,343,H1
"Morris County, TX",2006-2007,13168,13251,83,0.63,5,78,48,343,H1
"Morris County, TX",2007-2008,13251,13092,-159,-1.2,-7,-152,48,343,H1
"Morris County, TX",2008-2009,13092,12954,-138,-1.054,-7,-131,48,343,H1
"Morris County, TX",2009-2010,12954,12921,-33,-0.255,-2,-31,48,343,H1
"Morris County, TX",2010-2011,12921,12820,-101,-0.782,-15,-86,48,343,H1
"Morris County, TX",2011-2012,12820,12757,-63,-0.491,-10,-53,48,343,H1
"Morris County, TX",2012-2013,12757,12782,25,0.196,14,11,48,343,H1
"Morris County, TX",2013-2014,12782,12743,-39,-0.305,25,-64,48,343,H1
"Morris County, TX",2014-2015,12691,12516,-175,-1.379,11,-186,48,343,H1
"Morris County, TX",2015-2016,12516,12490,-26,-0.208,5,-31,48,343,H1
"Morris County, TX",2016-2017,12490,12467,-23,-0.184,0,-23,48,343,H1
"Motley County, TX",2000-2001,1435,1340,-95,-6.62,-11,-84,48,345,H1
"Motley County, TX",2001-2002,1340,1311,-29,-2.164,-4,-25,48,345,H1
"Motley County, TX",2002-2003,1311,1319,8,0.61,5,3,48,345,H1
"Motley County, TX",2003-2004,1319,1270,-49,-3.715,-2,-47,48,345,H1
"Motley County, TX",2004-2005,1270,1257,-13,-1.024,-5,-8,48,345,H1
"Motley County, TX",2005-2006,1257,1236,-21,-1.671,-9,-12,48,345,H1
"Motley County, TX",2006-2007,1236,1228,-8,-0.647,-4,-4,48,345,H1
"Motley County, TX",2007-2008,1228,1197,-31,-2.524,2,-33,48,345,H1
"Motley County, TX",2008-2009,1197,1200,3,0.251,7,-4,48,345,H1
"Motley County, TX",2009-2010,1200,1205,5,0.417,5,0,48,345,H1
"Motley County, TX",2010-2011,1205,1211,6,0.498,-13,19,48,345,H1
"Motley County, TX",2011-2012,1211,1195,-16,-1.321,-6,-10,48,345,H1
"Motley County, TX",2012-2013,1195,1193,-2,-0.167,0,-2,48,345,H1
"Motley County, TX",2013-2014,1193,1153,-40,-3.353,-2,-38,48,345,H1
"Motley County, TX",2014-2015,1153,1148,-5,-0.434,-8,3,48,345,H1
"Motley County, TX",2015-2016,1148,1172,24,2.091,-7,31,48,345,H1
"Motley County, TX",2016-2017,1172,1230,58,4.949,-6,64,48,345,H1
"Nacogdoches County, TX",2000-2001,59224,59541,317,0.535,327,-10,48,347,H1
"Nacogdoches County, TX",2001-2002,59541,59422,-119,-0.2,310,-429,48,347,H1
"Nacogdoches County, TX",2002-2003,59422,59816,394,0.663,423,-29,48,347,H1
"Nacogdoches County, TX",2003-2004,59816,60427,611,1.021,339,272,48,347,H1
"Nacogdoches County, TX",2004-2005,60427,60939,512,0.847,429,83,48,347,H1
"Nacogdoches County, TX",2005-2006,60939,61750,811,1.331,375,436,48,347,H1
"Nacogdoches County, TX",2006-2007,61750,62274,524,0.849,417,107,48,347,H1
"Nacogdoches County, TX",2007-2008,62274,62957,683,1.097,447,236,48,347,H1
"Nacogdoches County, TX",2008-2009,62957,64012,1055,1.676,478,577,48,347,H1
"Nacogdoches County, TX",2009-2010,64012,64645,633,0.989,590,43,48,347,H1
"Nacogdoches County, TX",2010-2011,64645,65632,987,1.527,354,633,48,347,H1
"Nacogdoches County, TX",2011-2012,65632,65841,209,0.318,359,-150,48,347,H1
"Nacogdoches County, TX",2012-2013,65841,65190,-651,-0.989,328,-979,48,347,H1
"Nacogdoches County, TX",2013-2014,65190,65301,111,0.17,325,-214,48,347,H1
"Nacogdoches County, TX",2014-2015,65271,65664,393,0.602,320,73,48,347,H1
"Nacogdoches County, TX",2015-2016,65664,65662,-2,-0.003,307,-309,48,347,H1
"Nacogdoches County, TX",2016-2017,65662,65580,-82,-0.125,269,-351,48,347,H1
"Navarro County, TX",2000-2001,45202,45577,375,0.83,164,211,48,349,H1
"Navarro County, TX",2001-2002,45577,45937,360,0.79,151,209,48,349,H1
"Navarro County, TX",2002-2003,45937,46078,141,0.307,250,-109,48,349,H1
"Navarro County, TX",2003-2004,46078,46545,467,1.013,114,353,48,349,H1
"Navarro County, TX",2004-2005,46545,46854,309,0.664,197,112,48,349,H1
"Navarro County, TX",2005-2006,46854,47338,484,1.033,172,312,48,349,H1
"Navarro County, TX",2006-2007,47338,47272,-66,-0.139,250,-316,48,349,H1
"Navarro County, TX",2007-2008,47272,47408,136,0.288,189,-53,48,349,H1
"Navarro County, TX",2008-2009,47408,47584,176,0.371,205,-29,48,349,H1
"Navarro County, TX",2009-2010,47584,47848,264,0.555,193,71,48,349,H1
"Navarro County, TX",2010-2011,47848,48056,208,0.435,202,6,48,349,H1
"Navarro County, TX",2011-2012,48056,48131,75,0.156,180,-105,48,349,H1
"Navarro County, TX",2012-2013,48131,48133,2,0.004,238,-236,48,349,H1
"Navarro County, TX",2013-2014,48133,48195,62,0.129,173,-111,48,349,H1
"Navarro County, TX",2014-2015,48034,48323,289,0.602,155,134,48,349,H1
"Navarro County, TX",2015-2016,48323,48375,52,0.108,142,-90,48,349,H1
"Navarro County, TX",2016-2017,48375,48701,326,0.674,130,196,48,349,H1
"Newton County, TX",2000-2001,15038,15023,-15,-0.1,5,-20,48,351,H1
"Newton County, TX",2001-2002,15023,14945,-78,-0.519,3,-81,48,351,H1
"Newton County, TX",2002-2003,14945,14938,-7,-0.047,-13,6,48,351,H1
"Newton County, TX",2003-2004,14938,14560,-378,-2.53,-28,-350,48,351,H1
"Newton County, TX",2004-2005,14560,14625,65,0.446,-2,67,48,351,H1
"Newton County, TX",2005-2006,14625,14349,-276,-1.887,-47,-229,48,351,H1
"Newton County, TX",2006-2007,14349,14335,-14,-0.098,-32,18,48,351,H1
"Newton County, TX",2007-2008,14335,14393,58,0.405,-17,75,48,351,H1
"Newton County, TX",2008-2009,14393,14446,53,0.368,-7,60,48,351,H1
"Newton County, TX",2009-2010,14446,14439,-7,-0.048,-20,13,48,351,H1
"Newton County, TX",2010-2011,14439,14501,62,0.429,-8,70,48,351,H1
"Newton County, TX",2011-2012,14501,14328,-173,-1.193,-13,-160,48,351,H1
"Newton County, TX",2012-2013,14328,14209,-119,-0.831,-16,-103,48,351,H1
"Newton County, TX",2013-2014,14209,14138,-71,-0.5,-37,-34,48,351,H1
"Newton County, TX",2014-2015,14146,13986,-160,-1.131,-37,-123,48,351,H1
"Newton County, TX",2015-2016,13986,14186,200,1.43,-12,212,48,351,H1
"Newton County, TX",2016-2017,14186,13952,-234,-1.65,-43,-191,48,351,H1
"Nolan County, TX",2000-2001,15947,15503,-444,-2.784,58,-502,48,353,H1
"Nolan County, TX",2001-2002,15503,15194,-309,-1.993,40,-349,48,353,H1
"Nolan County, TX",2002-2003,15194,15148,-46,-0.303,39,-85,48,353,H1
"Nolan County, TX",2003-2004,15148,15013,-135,-0.891,16,-151,48,353,H1
"Nolan County, TX",2004-2005,15013,14745,-268,-1.785,30,-298,48,353,H1
"Nolan County, TX",2005-2006,14745,14740,-5,-0.034,75,-80,48,353,H1
"Nolan County, TX",2006-2007,14740,14750,10,0.068,40,-30,48,353,H1
"Nolan County, TX",2007-2008,14750,15093,343,2.325,70,273,48,353,H1
"Nolan County, TX",2008-2009,15093,15128,35,0.232,78,-43,48,353,H1
"Nolan County, TX",2009-2010,15128,15240,112,0.74,83,29,48,353,H1
"Nolan County, TX",2010-2011,15240,15121,-119,-0.781,-30,-89,48,353,H1
"Nolan County, TX",2011-2012,15121,14877,-244,-1.614,29,-273,48,353,H1
"Nolan County, TX",2012-2013,14877,15077,200,1.344,36,164,48,353,H1
"Nolan County, TX",2013-2014,15077,15093,16,0.106,27,-11,48,353,H1
"Nolan County, TX",2014-2015,15105,15107,2,0.013,50,-48,48,353,H1
"Nolan County, TX",2015-2016,15107,14968,-139,-0.92,55,-194,48,353,H1
"Nolan County, TX",2016-2017,14968,14770,-198,-1.323,18,-216,48,353,H1
"Nueces County, TX",2000-2001,313673,313670,-3,-0.001,2670,-2673,48,355,H1
"Nueces County, TX",2001-2002,313670,316256,2586,0.824,2704,-118,48,355,H1
"Nueces County, TX",2002-2003,316256,317632,1376,0.435,2418,-1042,48,355,H1
"Nueces County, TX",2003-2004,317632,321879,4247,1.337,2465,1782,48,355,H1
"Nueces County, TX",2004-2005,321879,325515,3636,1.13,2651,985,48,355,H1
"Nueces County, TX",2005-2006,325515,329113,3598,1.105,2622,976,48,355,H1
"Nueces County, TX",2006-2007,329113,330512,1399,0.425,2493,-1094,48,355,H1
"Nueces County, TX",2007-2008,330512,333526,3014,0.912,2480,534,48,355,H1
"Nueces County, TX",2008-2009,333526,338220,4694,1.407,2567,2127,48,355,H1
"Nueces County, TX",2009-2010,338220,340320,2100,0.621,2645,-545,48,355,H1
"Nueces County, TX",2010-2011,340320,343216,2896,0.851,2063,833,48,355,H1
"Nueces County, TX",2011-2012,343216,347933,4717,1.374,2029,2688,48,355,H1
"Nueces County, TX",2012-2013,347933,352962,5029,1.445,2083,2946,48,355,H1
"Nueces County, TX",2013-2014,352962,356221,3259,0.923,2160,1099,48,355,H1
"Nueces County, TX",2014-2015,356494,359715,3221,0.904,2277,944,48,355,H1
"Nueces County, TX",2015-2016,359715,361529,1814,0.504,1968,-154,48,355,H1
"Nueces County, TX",2016-2017,361529,361221,-308,-0.085,1963,-2271,48,355,H1
"Ochiltree County, TX",2000-2001,8988,9134,146,1.624,85,61,48,357,H1
"Ochiltree County, TX",2001-2002,9134,9106,-28,-0.307,76,-104,48,357,H1
"Ochiltree County, TX",2002-2003,9106,8981,-125,-1.373,82,-207,48,357,H1
"Ochiltree County, TX",2003-2004,8981,9149,168,1.871,105,63,48,357,H1
"Ochiltree County, TX",2004-2005,9149,9384,235,2.569,118,117,48,357,H1
"Ochiltree County, TX",2005-2006,9384,9557,173,1.844,82,91,48,357,H1
"Ochiltree County, TX",2006-2007,9557,9812,255,2.668,103,152,48,357,H1
"Ochiltree County, TX",2007-2008,9812,9962,150,1.529,150,0,48,357,H1
"Ochiltree County, TX",2008-2009,9962,10225,263,2.64,134,129,48,357,H1
"Ochiltree County, TX",2009-2010,10225,10173,-52,-0.509,131,-183,48,357,H1
"Ochiltree County, TX",2010-2011,10173,10443,270,2.654,123,147,48,357,H1
"Ochiltree County, TX",2011-2012,10443,10621,178,1.704,88,90,48,357,H1
"Ochiltree County, TX",2012-2013,10621,10734,113,1.064,91,22,48,357,H1
"Ochiltree County, TX",2013-2014,10734,10758,24,0.224,98,-74,48,357,H1
"Ochiltree County, TX",2014-2015,10720,10747,27,0.252,110,-83,48,357,H1
"Ochiltree County, TX",2015-2016,10747,10295,-452,-4.206,131,-583,48,357,H1
"Ochiltree County, TX",2016-2017,10295,10073,-222,-2.156,105,-327,48,357,H1
"Oldham County, TX",2000-2001,2186,2132,-54,-2.47,5,-59,48,359,H1
"Oldham County, TX",2001-2002,2132,2069,-63,-2.955,5,-68,48,359,H1
"Oldham County, TX",2002-2003,2069,2072,3,0.145,11,-8,48,359,H1
"Oldham County, TX",2003-2004,2072,2039,-33,-1.593,7,-40,48,359,H1
"Oldham County, TX",2004-2005,2039,2010,-29,-1.422,16,-45,48,359,H1
"Oldham County, TX",2005-2006,2010,2010,0,0,1,-1,48,359,H1
"Oldham County, TX",2006-2007,2010,1992,-18,-0.896,5,-23,48,359,H1
"Oldham County, TX",2007-2008,1992,2004,12,0.602,11,1,48,359,H1
"Oldham County, TX",2008-2009,2004,2040,36,1.796,18,18,48,359,H1
"Oldham County, TX",2009-2010,2040,2050,10,0.49,23,-13,48,359,H1
"Oldham County, TX",2010-2011,2050,2075,25,1.22,0,25,48,359,H1
"Oldham County, TX",2011-2012,2075,2047,-28,-1.349,7,-35,48,359,H1
"Oldham County, TX",2012-2013,2047,2100,53,2.589,10,43,48,359,H1
"Oldham County, TX",2013-2014,2100,2070,-30,-1.429,14,-44,48,359,H1
"Oldham County, TX",2014-2015,2072,2069,-3,-0.145,22,-25,48,359,H1
"Oldham County, TX",2015-2016,2069,2074,5,0.242,8,-3,48,359,H1
"Oldham County, TX",2016-2017,2074,2114,40,1.929,16,24,48,359,H1
"Orange County, TX",2000-2001,84930,84108,-822,-0.968,229,-1051,48,361,H1
"Orange County, TX",2001-2002,84108,83813,-295,-0.351,186,-481,48,361,H1
"Orange County, TX",2002-2003,83813,83553,-260,-0.31,243,-503,48,361,H1
"Orange County, TX",2003-2004,83553,83580,27,0.032,201,-174,48,361,H1
"Orange County, TX",2004-2005,83580,83500,-80,-0.096,140,-220,48,361,H1
"Orange County, TX",2005-2006,83500,81687,-1813,-2.171,186,-1999,48,361,H1
"Orange County, TX",2006-2007,81687,82255,568,0.695,325,243,48,361,H1
"Orange County, TX",2007-2008,82255,82612,357,0.434,226,131,48,361,H1
"Orange County, TX",2008-2009,82612,81586,-1026,-1.242,152,-1178,48,361,H1
"Orange County, TX",2009-2010,81586,81993,407,0.499,150,257,48,361,H1
"Orange County, TX",2010-2011,81993,82328,335,0.409,105,230,48,361,H1
"Orange County, TX",2011-2012,82328,82951,623,0.757,210,413,48,361,H1
"Orange County, TX",2012-2013,82951,82980,29,0.035,172,-143,48,361,H1
"Orange County, TX",2013-2014,82980,83433,453,0.546,210,243,48,361,H1
"Orange County, TX",2014-2015,83519,84260,741,0.887,291,450,48,361,H1
"Orange County, TX",2015-2016,84260,84508,248,0.294,230,18,48,361,H1
"Orange County, TX",2016-2017,84508,85047,539,0.638,217,322,48,361,H1
"Palo Pinto County, TX",2000-2001,27074,27128,54,0.199,-5,59,48,363,H1
"Palo Pinto County, TX",2001-2002,27128,27144,16,0.059,-5,21,48,363,H1
"Palo Pinto County, TX",2002-2003,27144,27294,150,0.553,36,114,48,363,H1
"Palo Pinto County, TX",2003-2004,27294,27276,-18,-0.066,8,-26,48,363,H1
"Palo Pinto County, TX",2004-2005,27276,27511,235,0.862,71,164,48,363,H1
"Palo Pinto County, TX",2005-2006,27511,27859,348,1.265,122,226,48,363,H1
"Palo Pinto County, TX",2006-2007,27859,27679,-180,-0.646,131,-311,48,363,H1
"Palo Pinto County, TX",2007-2008,27679,27916,237,0.856,92,145,48,363,H1
"Palo Pinto County, TX",2008-2009,27916,28071,155,0.555,84,71,48,363,H1
"Palo Pinto County, TX",2009-2010,28071,28102,31,0.11,97,-66,48,363,H1
"Palo Pinto County, TX",2010-2011,28102,28137,35,0.125,33,2,48,363,H1
"Palo Pinto County, TX",2011-2012,28137,27883,-254,-0.903,107,-361,48,363,H1
"Palo Pinto County, TX",2012-2013,27883,27924,41,0.147,86,-45,48,363,H1
"Palo Pinto County, TX",2013-2014,27924,28096,172,0.616,65,107,48,363,H1
"Palo Pinto County, TX",2014-2015,27976,27895,-81,-0.29,39,-120,48,363,H1
"Palo Pinto County, TX",2015-2016,27895,28132,237,0.85,-6,243,48,363,H1
"Palo Pinto County, TX",2016-2017,28132,28570,438,1.557,-2,440,48,363,H1
"Panola County, TX",2000-2001,22764,22773,9,0.04,42,-33,48,365,H1
"Panola County, TX",2001-2002,22773,22953,180,0.79,41,139,48,365,H1
"Panola County, TX",2002-2003,22953,23021,68,0.296,39,29,48,365,H1
"Panola County, TX",2003-2004,23021,22892,-129,-0.56,47,-176,48,365,H1
"Panola County, TX",2004-2005,22892,23140,248,1.083,27,221,48,365,H1
"Panola County, TX",2005-2006,23140,23456,316,1.366,38,278,48,365,H1
"Panola County, TX",2006-2007,23456,23351,-105,-0.448,18,-123,48,365,H1
"Panola County, TX",2007-2008,23351,23537,186,0.797,62,124,48,365,H1
"Panola County, TX",2008-2009,23537,23678,141,0.599,95,46,48,365,H1
"Panola County, TX",2009-2010,23678,23781,103,0.435,66,37,48,365,H1
"Panola County, TX",2010-2011,23781,24026,245,1.03,45,200,48,365,H1
"Panola County, TX",2011-2012,24026,23998,-28,-0.117,30,-58,48,365,H1
"Panola County, TX",2012-2013,23998,23825,-173,-0.721,13,-186,48,365,H1
"Panola County, TX",2013-2014,23825,23769,-56,-0.235,15,-71,48,365,H1
"Panola County, TX",2014-2015,23839,23766,-73,-0.306,63,-136,48,365,H1
"Panola County, TX",2015-2016,23766,23440,-326,-1.372,20,-346,48,365,H1
"Panola County, TX",2016-2017,23440,23243,-197,-0.84,-6,-191,48,365,H1
"Parker County, TX",2000-2001,89159,91660,2501,2.805,377,2124,48,367,H1
"Parker County, TX",2001-2002,91660,94092,2432,2.653,355,2077,48,367,H1
"Parker County, TX",2002-2003,94092,97041,2949,3.134,495,2454,48,367,H1
"Parker County, TX",2003-2004,97041,99320,2279,2.348,372,1907,48,367,H1
"Parker County, TX",2004-2005,99320,101891,2571,2.589,423,2148,48,367,H1
"Parker County, TX",2005-2006,101891,105387,3496,3.431,430,3066,48,367,H1
"Parker County, TX",2006-2007,105387,109408,4021,3.815,530,3491,48,367,H1
"Parker County, TX",2007-2008,109408,112911,3503,3.202,574,2929,48,367,H1
"Parker County, TX",2008-2009,112911,115802,2891,2.56,573,2318,48,367,H1
"Parker County, TX",2009-2010,115802,117294,1492,1.288,363,1129,48,367,H1
"Parker County, TX",2010-2011,117294,118500,1206,1.028,312,894,48,367,H1
"Parker County, TX",2011-2012,118500,119757,1257,1.061,372,885,48,367,H1
"Parker County, TX",2012-2013,119757,120207,450,0.376,406,44,48,367,H1
"Parker County, TX",2013-2014,120207,123164,2957,2.46,368,2589,48,367,H1
"Parker County, TX",2014-2015,122565,126042,3477,2.837,347,3130,48,367,H1
"Parker County, TX",2015-2016,126042,128861,2819,2.237,420,2399,48,367,H1
"Parker County, TX",2016-2017,128861,133463,4602,3.571,411,4191,48,367,H1
"Parmer County, TX",2000-2001,9991,9842,-149,-1.491,83,-232,48,369,H1
"Parmer County, TX",2001-2002,9842,10032,190,1.931,70,120,48,369,H1
"Parmer County, TX",2002-2003,10032,10155,123,1.226,107,16,48,369,H1
"Parmer County, TX",2003-2004,10155,10168,13,0.128,93,-80,48,369,H1
"Parmer County, TX",2004-2005,10168,10099,-69,-0.679,92,-161,48,369,H1
"Parmer County, TX",2005-2006,10099,10035,-64,-0.634,67,-131,48,369,H1
"Parmer County, TX",2006-2007,10035,10075,40,0.399,73,-33,48,369,H1
"Parmer County, TX",2007-2008,10075,9994,-81,-0.804,86,-167,48,369,H1
"Parmer County, TX",2008-2009,9994,10082,88,0.881,101,-13,48,369,H1
"Parmer County, TX",2009-2010,10082,10285,203,2.013,130,73,48,369,H1
"Parmer County, TX",2010-2011,10285,10297,12,0.117,65,-53,48,369,H1
"Parmer County, TX",2011-2012,10297,10162,-135,-1.311,79,-214,48,369,H1
"Parmer County, TX",2012-2013,10162,9970,-192,-1.889,96,-288,48,369,H1
"Parmer County, TX",2013-2014,9970,9908,-62,-0.622,117,-179,48,369,H1
"Parmer County, TX",2014-2015,9881,9749,-132,-1.336,124,-256,48,369,H1
"Parmer County, TX",2015-2016,9749,9818,69,0.708,113,-44,48,369,H1
"Parmer County, TX",2016-2017,9818,9842,24,0.244,131,-107,48,369,H1
"Pecos County, TX",2000-2001,16667,16284,-383,-2.298,117,-500,48,371,H1
"Pecos County, TX",2001-2002,16284,16084,-200,-1.228,69,-269,48,371,H1
"Pecos County, TX",2002-2003,16084,15709,-375,-2.332,73,-448,48,371,H1
"Pecos County, TX",2003-2004,15709,15554,-155,-0.987,107,-262,48,371,H1
"Pecos County, TX",2004-2005,15554,15385,-169,-1.087,130,-299,48,371,H1
"Pecos County, TX",2005-2006,15385,15403,18,0.117,97,-79,48,371,H1
"Pecos County, TX",2006-2007,15403,15321,-82,-0.532,120,-202,48,371,H1
"Pecos County, TX",2007-2008,15321,15251,-70,-0.457,154,-224,48,371,H1
"Pecos County, TX",2008-2009,15251,15490,239,1.567,134,105,48,371,H1
"Pecos County, TX",2009-2010,15490,15536,46,0.297,134,-88,48,371,H1
"Pecos County, TX",2010-2011,15536,15639,103,0.663,122,-19,48,371,H1
"Pecos County, TX",2011-2012,15639,15591,-48,-0.307,88,-136,48,371,H1
"Pecos County, TX",2012-2013,15591,15724,133,0.853,125,8,48,371,H1
"Pecos County, TX",2013-2014,15724,15893,169,1.075,127,42,48,371,H1
"Pecos County, TX",2014-2015,15907,16203,296,1.861,161,135,48,371,H1
"Pecos County, TX",2015-2016,16203,15877,-326,-2.012,103,-429,48,371,H1
"Pecos County, TX",2016-2017,15877,15634,-243,-1.531,93,-336,48,371,H1
"Polk County, TX",2000-2001,41539,42945,1406,3.385,-13,1419,48,373,H1
"Polk County, TX",2001-2002,42945,43928,983,2.289,-97,1080,48,373,H1
"Polk County, TX",2002-2003,43928,44779,851,1.937,-72,923,48,373,H1
"Polk County, TX",2003-2004,44779,45315,536,1.197,-86,622,48,373,H1
"Polk County, TX",2004-2005,45315,45472,157,0.346,-58,215,48,373,H1
"Polk County, TX",2005-2006,45472,45495,23,0.051,-51,74,48,373,H1
"Polk County, TX",2006-2007,45495,45727,232,0.51,-73,305,48,373,H1
"Polk County, TX",2007-2008,45727,45794,67,0.147,-113,180,48,373,H1
"Polk County, TX",2008-2009,45794,45537,-257,-0.561,-103,-154,48,373,H1
"Polk County, TX",2009-2010,45537,45443,-94,-0.206,-101,7,48,373,H1
"Polk County, TX",2010-2011,45443,45645,202,0.445,-95,297,48,373,H1
"Polk County, TX",2011-2012,45645,45745,100,0.219,-112,212,48,373,H1
"Polk County, TX",2012-2013,45745,45871,126,0.275,-93,219,48,373,H1
"Polk County, TX",2013-2014,45871,46079,208,0.453,-119,327,48,373,H1
"Polk County, TX",2014-2015,46192,46972,780,1.689,-101,881,48,373,H1
"Polk County, TX",2015-2016,46972,47735,763,1.624,-69,832,48,373,H1
"Polk County, TX",2016-2017,47735,49162,1427,2.989,-75,1502,48,373,H1
"Potter County, TX",2000-2001,113762,114307,545,0.479,1105,-560,48,375,H1
"Potter County, TX",2001-2002,114307,115427,1120,0.98,838,282,48,375,H1
"Potter County, TX",2002-2003,115427,117067,1640,1.421,930,710,48,375,H1
"Potter County, TX",2003-2004,117067,117682,615,0.525,1229,-614,48,375,H1
"Potter County, TX",2004-2005,117682,118771,1089,0.925,1095,-6,48,375,H1
"Potter County, TX",2005-2006,118771,119780,1009,0.85,1126,-117,48,375,H1
"Potter County, TX",2006-2007,119780,119537,-243,-0.203,1116,-1359,48,375,H1
"Potter County, TX",2007-2008,119537,119740,203,0.17,946,-743,48,375,H1
"Potter County, TX",2008-2009,119740,120118,378,0.316,1006,-628,48,375,H1
"Potter County, TX",2009-2010,120118,121390,1272,1.059,1060,212,48,375,H1
"Potter County, TX",2010-2011,121390,122350,960,0.791,911,49,48,375,H1
"Potter County, TX",2011-2012,122350,122754,404,0.33,893,-489,48,375,H1
"Potter County, TX",2012-2013,122754,122146,-608,-0.495,921,-1529,48,375,H1
"Potter County, TX",2013-2014,122146,121627,-519,-0.425,891,-1410,48,375,H1
"Potter County, TX",2014-2015,122276,121802,-474,-0.388,936,-1410,48,375,H1
"Potter County, TX",2015-2016,121802,120542,-1260,-1.034,655,-1915,48,375,H1
"Potter County, TX",2016-2017,120542,120458,-84,-0.07,706,-790,48,375,H1
"Presidio County, TX",2000-2001,7355,7409,54,0.734,119,-65,48,377,H1
"Presidio County, TX",2001-2002,7409,7534,125,1.687,114,11,48,377,H1
"Presidio County, TX",2002-2003,7534,7583,49,0.65,109,-60,48,377,H1
"Presidio County, TX",2003-2004,7583,7561,-22,-0.29,112,-134,48,377,H1
"Presidio County, TX",2004-2005,7561,7719,158,2.09,148,10,48,377,H1
"Presidio County, TX",2005-2006,7719,7638,-81,-1.049,109,-190,48,377,H1
"Presidio County, TX",2006-2007,7638,7712,74,0.969,119,-45,48,377,H1
"Presidio County, TX",2007-2008,7712,7683,-29,-0.376,120,-149,48,377,H1
"Presidio County, TX",2008-2009,7683,7593,-90,-1.171,110,-200,48,377,H1
"Presidio County, TX",2009-2010,7593,7874,281,3.701,102,179,48,377,H1
"Presidio County, TX",2010-2011,7874,7741,-133,-1.689,97,-230,48,377,H1
"Presidio County, TX",2011-2012,7741,7540,-201,-2.597,61,-262,48,377,H1
"Presidio County, TX",2012-2013,7540,7264,-276,-3.66,72,-348,48,377,H1
"Presidio County, TX",2013-2014,7264,6976,-288,-3.965,50,-338,48,377,H1
"Presidio County, TX",2014-2015,7040,6876,-164,-2.33,68,-232,48,377,H1
"Presidio County, TX",2015-2016,6876,7166,290,4.218,81,209,48,377,H1
"Presidio County, TX",2016-2017,7166,7156,-10,-0.14,74,-84,48,377,H1
"Rains County, TX",2000-2001,9196,9664,468,5.089,-5,473,48,379,H1
"Rains County, TX",2001-2002,9664,9985,321,3.322,-23,344,48,379,H1
"Rains County, TX",2002-2003,9985,10290,305,3.055,21,284,48,379,H1
"Rains County, TX",2003-2004,10290,10446,156,1.516,-11,167,48,379,H1
"Rains County, TX",2004-2005,10446,10589,143,1.369,-3,146,48,379,H1
"Rains County, TX",2005-2006,10589,10830,241,2.276,19,222,48,379,H1
"Rains County, TX",2006-2007,10830,10994,164,1.514,6,158,48,379,H1
"Rains County, TX",2007-2008,10994,11022,28,0.255,-9,37,48,379,H1
"Rains County, TX",2008-2009,11022,10956,-66,-0.599,-6,-60,48,379,H1
"Rains County, TX",2009-2010,10956,10931,-25,-0.228,-35,10,48,379,H1
"Rains County, TX",2010-2011,10931,11023,92,0.842,-11,103,48,379,H1
"Rains County, TX",2011-2012,11023,10938,-85,-0.771,-17,-68,48,379,H1
"Rains County, TX",2012-2013,10938,11016,78,0.713,-27,105,48,379,H1
"Rains County, TX",2013-2014,11016,11032,16,0.145,-8,24,48,379,H1
"Rains County, TX",2014-2015,11029,11161,132,1.197,-8,140,48,379,H1
"Rains County, TX",2015-2016,11161,11307,146,1.308,-67,213,48,379,H1
"Rains County, TX",2016-2017,11307,11762,455,4.024,-27,482,48,379,H1
"Randall County, TX",2000-2001,104609,105399,790,0.755,508,282,48,381,H1
"Randall County, TX",2001-2002,105399,106286,887,0.842,584,303,48,381,H1
"Randall County, TX",2002-2003,106286,107607,1321,1.243,655,666,48,381,H1
"Randall County, TX",2003-2004,107607,109441,1834,1.704,579,1255,48,381,H1
"Randall County, TX",2004-2005,109441,111113,1672,1.528,621,1051,48,381,H1
"Randall County, TX",2005-2006,111113,112464,1351,1.216,643,708,48,381,H1
"Randall County, TX",2006-2007,112464,114782,2318,2.061,698,1620,48,381,H1
"Randall County, TX",2007-2008,114782,116518,1736,1.512,746,990,48,381,H1
"Randall County, TX",2008-2009,116518,119084,2566,2.202,783,1783,48,381,H1
"Randall County, TX",2009-2010,119084,121190,2106,1.768,983,1123,48,381,H1
"Randall County, TX",2010-2011,121190,123359,2169,1.79,737,1432,48,381,H1
"Randall County, TX",2011-2012,123359,124897,1538,1.247,638,900,48,381,H1
"Randall County, TX",2012-2013,124897,126644,1747,1.399,700,1047,48,381,H1
"Randall County, TX",2013-2014,126644,128220,1576,1.244,675,901,48,381,H1
"Randall County, TX",2014-2015,128684,130269,1585,1.232,735,850,48,381,H1
"Randall County, TX",2015-2016,130269,132457,2188,1.68,602,1586,48,381,H1
"Randall County, TX",2016-2017,132457,134442,1985,1.499,620,1365,48,381,H1
"Reagan County, TX",2000-2001,3290,3230,-60,-1.824,17,-77,48,383,H1
"Reagan County, TX",2001-2002,3230,3189,-41,-1.269,13,-54,48,383,H1
"Reagan County, TX",2002-2003,3189,3130,-59,-1.85,31,-90,48,383,H1
"Reagan County, TX",2003-2004,3130,3161,31,0.99,29,2,48,383,H1
"Reagan County, TX",2004-2005,3161,3143,-18,-0.569,17,-35,48,383,H1
"Reagan County, TX",2005-2006,3143,3160,17,0.541,12,5,48,383,H1
"Reagan County, TX",2006-2007,3160,3260,100,3.165,30,70,48,383,H1
"Reagan County, TX",2007-2008,3260,3339,79,2.423,43,36,48,383,H1
"Reagan County, TX",2008-2009,3339,3377,38,1.138,53,-15,48,383,H1
"Reagan County, TX",2009-2010,3377,3351,-26,-0.77,48,-74,48,383,H1
"Reagan County, TX",2010-2011,3351,3393,42,1.253,27,15,48,383,H1
"Reagan County, TX",2011-2012,3393,3476,83,2.446,18,65,48,383,H1
"Reagan County, TX",2012-2013,3476,3627,151,4.344,50,101,48,383,H1
"Reagan County, TX",2013-2014,3627,3755,128,3.529,46,82,48,383,H1
"Reagan County, TX",2014-2015,3746,3792,46,1.228,76,-30,48,383,H1
"Reagan County, TX",2015-2016,3792,3738,-54,-1.424,54,-108,48,383,H1
"Reagan County, TX",2016-2017,3738,3710,-28,-0.749,53,-81,48,383,H1
"Real County, TX",2000-2001,3067,3020,-47,-1.532,-6,-41,48,385,H1
"Real County, TX",2001-2002,3020,3020,0,0,-6,6,48,385,H1
"Real County, TX",2002-2003,3020,3123,103,3.411,-10,113,48,385,H1
"Real County, TX",2003-2004,3123,3138,15,0.48,-15,30,48,385,H1
"Real County, TX",2004-2005,3138,3154,16,0.51,-11,27,48,385,H1
"Real County, TX",2005-2006,3154,3264,110,3.488,-9,119,48,385,H1
"Real County, TX",2006-2007,3264,3308,44,1.348,-14,58,48,385,H1
"Real County, TX",2007-2008,3308,3241,-67,-2.025,10,-77,48,385,H1
"Real County, TX",2008-2009,3241,3274,33,1.018,1,32,48,385,H1
"Real County, TX",2009-2010,3274,3324,50,1.527,3,47,48,385,H1
"Real County, TX",2010-2011,3324,3429,105,3.159,-19,124,48,385,H1
"Real County, TX",2011-2012,3429,3372,-57,-1.662,-17,-40,48,385,H1
"Real County, TX",2012-2013,3372,3329,-43,-1.275,-23,-20,48,385,H1
"Real County, TX",2013-2014,3329,3371,42,1.262,-18,60,48,385,H1
"Real County, TX",2014-2015,3359,3307,-52,-1.548,-11,-41,48,385,H1
"Real County, TX",2015-2016,3307,3397,90,2.721,-5,95,48,385,H1
"Real County, TX",2016-2017,3397,3429,32,0.942,-14,46,48,385,H1
"Red River County, TX",2000-2001,14297,14156,-141,-0.986,-70,-71,48,387,H1
"Red River County, TX",2001-2002,14156,13914,-242,-1.71,-80,-162,48,387,H1
"Red River County, TX",2002-2003,13914,13703,-211,-1.516,-58,-153,48,387,H1
"Red River County, TX",2003-2004,13703,13584,-119,-0.868,-69,-50,48,387,H1
"Red River County, TX",2004-2005,13584,13444,-140,-1.031,-93,-47,48,387,H1
"Red River County, TX",2005-2006,13444,13237,-207,-1.54,-58,-149,48,387,H1
"Red River County, TX",2006-2007,13237,13072,-165,-1.247,-37,-128,48,387,H1
"Red River County, TX",2007-2008,13072,12922,-150,-1.147,-27,-123,48,387,H1
"Red River County, TX",2008-2009,12922,12835,-87,-0.673,-34,-53,48,387,H1
"Red River County, TX",2009-2010,12835,12851,16,0.125,-32,48,48,387,H1
"Red River County, TX",2010-2011,12851,12695,-156,-1.214,-58,-98,48,387,H1
"Red River County, TX",2011-2012,12695,12712,17,0.134,-51,68,48,387,H1
"Red River County, TX",2012-2013,12712,12505,-207,-1.628,-39,-168,48,387,H1
"Red River County, TX",2013-2014,12505,12446,-59,-0.472,-45,-14,48,387,H1
"Red River County, TX",2014-2015,12472,12455,-17,-0.136,-20,3,48,387,H1
"Red River County, TX",2015-2016,12455,12217,-238,-1.911,-29,-209,48,387,H1
"Red River County, TX",2016-2017,12217,12229,12,0.098,-54,66,48,387,H1
"Reeves County, TX",2000-2001,13115,13022,-93,-0.709,99,-192,48,389,H1
"Reeves County, TX",2001-2002,13022,13017,-5,-0.038,101,-106,48,389,H1
"Reeves County, TX",2002-2003,13017,12910,-107,-0.822,111,-218,48,389,H1
"Reeves County, TX",2003-2004,12910,12721,-189,-1.464,57,-246,48,389,H1
"Reeves County, TX",2004-2005,12721,12675,-46,-0.362,29,-75,48,389,H1
"Reeves County, TX",2005-2006,12675,12747,72,0.568,56,16,48,389,H1
"Reeves County, TX",2006-2007,12747,13039,292,2.291,101,191,48,389,H1
"Reeves County, TX",2007-2008,13039,13211,172,1.319,90,82,48,389,H1
"Reeves County, TX",2008-2009,13211,13550,339,2.566,59,280,48,389,H1
"Reeves County, TX",2009-2010,13550,13813,263,1.941,81,182,48,389,H1
"Reeves County, TX",2010-2011,13813,13761,-52,-0.376,74,-126,48,389,H1
"Reeves County, TX",2011-2012,13761,13892,131,0.952,61,70,48,389,H1
"Reeves County, TX",2012-2013,13892,14077,185,1.332,63,122,48,389,H1
"Reeves County, TX",2013-2014,14077,14349,272,1.932,79,193,48,389,H1
"Reeves County, TX",2014-2015,14391,14732,341,2.37,110,231,48,389,H1
"Reeves County, TX",2015-2016,14732,15069,337,2.288,99,238,48,389,H1
"Reeves County, TX",2016-2017,15069,15281,212,1.407,103,109,48,389,H1
"Refugio County, TX",2000-2001,7827,7765,-62,-0.792,25,-87,48,391,H1
"Refugio County, TX",2001-2002,7765,7665,-100,-1.288,-2,-98,48,391,H1
"Refugio County, TX",2002-2003,7665,7563,-102,-1.331,-5,-97,48,391,H1
"Refugio County, TX",2003-2004,7563,7630,67,0.886,2,65,48,391,H1
"Refugio County, TX",2004-2005,7630,7601,-29,-0.38,-8,-21,48,391,H1
"Refugio County, TX",2005-2006,7601,7548,-53,-0.697,9,-62,48,391,H1
"Refugio County, TX",2006-2007,7548,7414,-134,-1.775,16,-150,48,391,H1
"Refugio County, TX",2007-2008,7414,7430,16,0.216,23,-7,48,391,H1
"Refugio County, TX",2008-2009,7430,7410,-20,-0.269,21,-41,48,391,H1
"Refugio County, TX",2009-2010,7410,7357,-53,-0.715,20,-73,48,391,H1
"Refugio County, TX",2010-2011,7357,7310,-47,-0.639,-17,-30,48,391,H1
"Refugio County, TX",2011-2012,7310,7238,-72,-0.985,-13,-59,48,391,H1
"Refugio County, TX",2012-2013,7238,7268,30,0.414,23,7,48,391,H1
"Refugio County, TX",2013-2014,7268,7302,34,0.468,18,16,48,391,H1
"Refugio County, TX",2014-2015,7302,7289,-13,-0.178,50,-63,48,391,H1
"Refugio County, TX",2015-2016,7289,7293,4,0.055,16,-12,48,391,H1
"Refugio County, TX",2016-2017,7293,7224,-69,-0.946,22,-91,48,391,H1
"Roberts County, TX",2000-2001,884,880,-4,-0.452,-2,-2,48,393,H1
"Roberts County, TX",2001-2002,880,862,-18,-2.045,-3,-15,48,393,H1
"Roberts County, TX",2002-2003,862,825,-37,-4.292,-8,-29,48,393,H1
"Roberts County, TX",2003-2004,825,841,16,1.939,-12,28,48,393,H1
"Roberts County, TX",2004-2005,841,855,14,1.665,2,12,48,393,H1
"Roberts County, TX",2005-2006,855,849,-6,-0.702,4,-10,48,393,H1
"Roberts County, TX",2006-2007,849,887,38,4.476,12,26,48,393,H1
"Roberts County, TX",2007-2008,887,904,17,1.917,9,8,48,393,H1
"Roberts County, TX",2008-2009,904,929,25,2.765,12,13,48,393,H1
"Roberts County, TX",2009-2010,929,925,-4,-0.431,7,-11,48,393,H1
"Roberts County, TX",2010-2011,925,933,8,0.865,4,4,48,393,H1
"Roberts County, TX",2011-2012,933,950,17,1.822,4,13,48,393,H1
"Roberts County, TX",2012-2013,950,923,-27,-2.842,-5,-22,48,393,H1
"Roberts County, TX",2013-2014,923,928,5,0.542,2,3,48,393,H1
"Roberts County, TX",2014-2015,921,916,-5,-0.543,4,-9,48,393,H1
"Roberts County, TX",2015-2016,916,916,0,0,7,-7,48,393,H1
"Roberts County, TX",2016-2017,916,938,22,2.402,4,18,48,393,H1
"Robertson County, TX",2000-2001,16062,16132,70,0.436,44,26,48,395,H1
"Robertson County, TX",2001-2002,16132,16053,-79,-0.49,-10,-69,48,395,H1
"Robertson County, TX",2002-2003,16053,16074,21,0.131,37,-16,48,395,H1
"Robertson County, TX",2003-2004,16074,16260,186,1.157,34,152,48,395,H1
"Robertson County, TX",2004-2005,16260,16509,249,1.531,16,233,48,395,H1
"Robertson County, TX",2005-2006,16509,16581,72,0.436,37,35,48,395,H1
"Robertson County, TX",2006-2007,16581,16546,-35,-0.211,31,-66,48,395,H1
"Robertson County, TX",2007-2008,16546,16535,-11,-0.066,46,-57,48,395,H1
"Robertson County, TX",2008-2009,16535,16604,69,0.417,57,12,48,395,H1
"Robertson County, TX",2009-2010,16604,16588,-16,-0.096,71,-87,48,395,H1
"Robertson County, TX",2010-2011,16588,16693,105,0.633,26,79,48,395,H1
"Robertson County, TX",2011-2012,16693,16490,-203,-1.216,17,-220,48,395,H1
"Robertson County, TX",2012-2013,16490,16461,-29,-0.176,43,-72,48,395,H1
"Robertson County, TX",2013-2014,16461,16500,39,0.237,54,-15,48,395,H1
"Robertson County, TX",2014-2015,16448,16659,211,1.283,45,166,48,395,H1
"Robertson County, TX",2015-2016,16659,16858,199,1.195,67,132,48,395,H1
"Robertson County, TX",2016-2017,16858,17203,345,2.047,46,299,48,395,H1
"Rockwall County, TX",2000-2001,43755,46697,2942,6.724,409,2533,48,397,H1
"Rockwall County, TX",2001-2002,46697,50078,3381,7.24,379,3002,48,397,H1
"Rockwall County, TX",2002-2003,50078,53397,3319,6.628,496,2823,48,397,H1
"Rockwall County, TX",2003-2004,53397,56477,3080,5.768,514,2566,48,397,H1
"Rockwall County, TX",2004-2005,56477,60349,3872,6.856,582,3290,48,397,H1
"Rockwall County, TX",2005-2006,60349,66117,5768,9.558,655,5113,48,397,H1
"Rockwall County, TX",2006-2007,66117,70851,4734,7.16,572,4162,48,397,H1
"Rockwall County, TX",2007-2008,70851,73929,3078,4.344,743,2335,48,397,H1
"Rockwall County, TX",2008-2009,73929,76654,2725,3.686,962,1763,48,397,H1
"Rockwall County, TX",2009-2010,76654,78967,2313,3.017,721,1592,48,397,H1
"Rockwall County, TX",2010-2011,78967,81136,2169,2.747,521,1648,48,397,H1
"Rockwall County, TX",2011-2012,81136,82992,1856,2.288,458,1398,48,397,H1
"Rockwall County, TX",2012-2013,82992,85290,2298,2.769,474,1824,48,397,H1
"Rockwall County, TX",2013-2014,85290,87809,2519,2.953,511,2008,48,397,H1
"Rockwall County, TX",2014-2015,87635,90861,3226,3.681,509,2717,48,397,H1
"Rockwall County, TX",2015-2016,90861,93419,2558,2.815,583,1975,48,397,H1
"Rockwall County, TX",2016-2017,93419,96788,3369,3.606,530,2839,48,397,H1
"Runnels County, TX",2000-2001,11458,11148,-310,-2.706,22,-332,48,399,H1
"Runnels County, TX",2001-2002,11148,11002,-146,-1.31,-31,-115,48,399,H1
"Runnels County, TX",2002-2003,11002,10815,-187,-1.7,4,-191,48,399,H1
"Runnels County, TX",2003-2004,10815,10774,-41,-0.379,-14,-27,48,399,H1
"Runnels County, TX",2004-2005,10774,10842,68,0.631,-6,74,48,399,H1
"Runnels County, TX",2005-2006,10842,10587,-255,-2.352,-21,-234,48,399,H1
"Runnels County, TX",2006-2007,10587,10506,-81,-0.765,8,-89,48,399,H1
"Runnels County, TX",2007-2008,10506,10444,-62,-0.59,-2,-60,48,399,H1
"Runnels County, TX",2008-2009,10444,10392,-52,-0.498,-9,-43,48,399,H1
"Runnels County, TX",2009-2010,10392,10506,114,1.097,9,105,48,399,H1
"Runnels County, TX",2010-2011,10506,10561,55,0.524,-12,67,48,399,H1
"Runnels County, TX",2011-2012,10561,10422,-139,-1.316,-34,-105,48,399,H1
"Runnels County, TX",2012-2013,10422,10302,-120,-1.151,-26,-94,48,399,H1
"Runnels County, TX",2013-2014,10302,10416,114,1.107,-37,151,48,399,H1
"Runnels County, TX",2014-2015,10406,10551,145,1.393,-13,158,48,399,H1
"Runnels County, TX",2015-2016,10551,10255,-296,-2.805,-8,-288,48,399,H1
"Runnels County, TX",2016-2017,10255,10266,11,0.107,-17,28,48,399,H1
"Rusk County, TX",2000-2001,47456,47837,381,0.803,88,293,48,401,H1
"Rusk County, TX",2001-2002,47837,48244,407,0.851,0,407,48,401,H1
"Rusk County, TX",2002-2003,48244,48540,296,0.614,78,218,48,401,H1
"Rusk County, TX",2003-2004,48540,49160,620,1.277,53,567,48,401,H1
"Rusk County, TX",2004-2005,49160,49703,543,1.105,138,405,48,401,H1
"Rusk County, TX",2005-2006,49703,50415,712,1.433,133,579,48,401,H1
"Rusk County, TX",2006-2007,50415,51278,863,1.712,218,645,48,401,H1
"Rusk County, TX",2007-2008,51278,52195,917,1.788,205,712,48,401,H1
"Rusk County, TX",2008-2009,52195,52799,604,1.157,173,431,48,401,H1
"Rusk County, TX",2009-2010,52799,53386,587,1.112,123,464,48,401,H1
"Rusk County, TX",2010-2011,53386,53768,382,0.716,127,255,48,401,H1
"Rusk County, TX",2011-2012,53768,55743,1975,3.673,163,1812,48,401,H1
"Rusk County, TX",2012-2013,55743,53973,-1770,-3.175,100,-1870,48,401,H1
"Rusk County, TX",2013-2014,53973,53923,-50,-0.093,127,-177,48,401,H1
"Rusk County, TX",2014-2015,53270,53070,-200,-0.375,77,-277,48,401,H1
"Rusk County, TX",2015-2016,53070,52856,-214,-0.403,101,-315,48,401,H1
"Rusk County, TX",2016-2017,52856,52833,-23,-0.044,78,-101,48,401,H1
"Sabine County, TX",2000-2001,10388,10435,47,0.452,-69,116,48,403,H1
"Sabine County, TX",2001-2002,10435,10477,42,0.402,-80,122,48,403,H1
"Sabine County, TX",2002-2003,10477,10482,5,0.048,-55,60,48,403,H1
"Sabine County, TX",2003-2004,10482,10498,16,0.153,-48,64,48,403,H1
"Sabine County, TX",2004-2005,10498,10445,-53,-0.505,-63,10,48,403,H1
"Sabine County, TX",2005-2006,10445,10583,138,1.321,-32,170,48,403,H1
"Sabine County, TX",2006-2007,10583,10541,-42,-0.397,-76,34,48,403,H1
"Sabine County, TX",2007-2008,10541,10565,24,0.228,-73,97,48,403,H1
"Sabine County, TX",2008-2009,10565,10721,156,1.477,-48,204,48,403,H1
"Sabine County, TX",2009-2010,10721,10865,144,1.343,-57,201,48,403,H1
"Sabine County, TX",2010-2011,10865,10681,-184,-1.694,-85,-99,48,403,H1
"Sabine County, TX",2011-2012,10681,10469,-212,-1.985,-61,-151,48,403,H1
"Sabine County, TX",2012-2013,10469,10389,-80,-0.764,-100,20,48,403,H1
"Sabine County, TX",2013-2014,10389,10350,-39,-0.375,-54,15,48,403,H1
"Sabine County, TX",2014-2015,10339,10368,29,0.28,-26,55,48,403,H1
"Sabine County, TX",2015-2016,10368,10385,17,0.164,-62,79,48,403,H1
"Sabine County, TX",2016-2017,10385,10461,76,0.732,-50,126,48,403,H1
"San Augustine County, TX",2000-2001,8959,8860,-99,-1.105,-5,-94,48,405,H1
"San Augustine County, TX",2001-2002,8860,8985,125,1.411,-16,141,48,405,H1
"San Augustine County, TX",2002-2003,8985,9034,49,0.545,-14,63,48,405,H1
"San Augustine County, TX",2003-2004,9034,9085,51,0.565,-53,104,48,405,H1
"San Augustine County, TX",2004-2005,9085,9060,-25,-0.275,-18,-7,48,405,H1
"San Augustine County, TX",2005-2006,9060,9128,68,0.751,-35,103,48,405,H1
"San Augustine County, TX",2006-2007,9128,9048,-80,-0.876,6,-86,48,405,H1
"San Augustine County, TX",2007-2008,9048,9039,-9,-0.099,-31,22,48,405,H1
"San Augustine County, TX",2008-2009,9039,8938,-101,-1.117,-24,-77,48,405,H1
"San Augustine County, TX",2009-2010,8938,8846,-92,-1.029,-8,-84,48,405,H1
"San Augustine County, TX",2010-2011,8846,8853,7,0.079,-91,98,48,405,H1
"San Augustine County, TX",2011-2012,8853,8836,-17,-0.192,-17,0,48,405,H1
"San Augustine County, TX",2012-2013,8836,8741,-95,-1.075,-11,-84,48,405,H1
"San Augustine County, TX",2013-2014,8741,8610,-131,-1.499,-10,-121,48,405,H1
"San Augustine County, TX",2014-2015,8584,8473,-111,-1.293,-34,-77,48,405,H1
"San Augustine County, TX",2015-2016,8473,8283,-190,-2.242,-41,-149,48,405,H1
"San Augustine County, TX",2016-2017,8283,8253,-30,-0.362,-49,19,48,405,H1
"San Jacinto County, TX",2000-2001,22549,22897,348,1.543,66,282,48,407,H1
"San Jacinto County, TX",2001-2002,22897,23415,518,2.262,50,468,48,407,H1
"San Jacinto County, TX",2002-2003,23415,24100,685,2.925,39,646,48,407,H1
"San Jacinto County, TX",2003-2004,24100,24756,656,2.722,-6,662,48,407,H1
"San Jacinto County, TX",2004-2005,24756,25014,258,1.042,35,223,48,407,H1
"San Jacinto County, TX",2005-2006,25014,25151,137,0.548,54,83,48,407,H1
"San Jacinto County, TX",2006-2007,25151,25719,568,2.258,14,554,48,407,H1
"San Jacinto County, TX",2007-2008,25719,25889,170,0.661,-5,175,48,407,H1
"San Jacinto County, TX",2008-2009,25889,26086,197,0.761,25,172,48,407,H1
"San Jacinto County, TX",2009-2010,26086,26439,353,1.353,5,348,48,407,H1
"San Jacinto County, TX",2010-2011,26439,26814,375,1.418,-30,405,48,407,H1
"San Jacinto County, TX",2011-2012,26814,2.70E+04,186,0.694,-8,194,48,407,H1
"San Jacinto County, TX",2012-2013,2.70E+04,26804,-196,-0.726,9,-205,48,407,H1
"San Jacinto County, TX",2013-2014,26804,27099,295,1.101,16,279,48,407,H1
"San Jacinto County, TX",2014-2015,27096,27413,317,1.17,41,276,48,407,H1
"San Jacinto County, TX",2015-2016,27413,27757,344,1.255,-23,367,48,407,H1
"San Jacinto County, TX",2016-2017,27757,28270,513,1.848,-4,517,48,407,H1
"San Patricio County, TX",2000-2001,67333,66690,-643,-0.955,696,-1339,48,409,H1
"San Patricio County, TX",2001-2002,66690,66820,130,0.195,591,-461,48,409,H1
"San Patricio County, TX",2002-2003,66820,66440,-380,-0.569,517,-897,48,409,H1
"San Patricio County, TX",2003-2004,66440,66990,550,0.828,647,-97,48,409,H1
"San Patricio County, TX",2004-2005,66990,67232,242,0.361,692,-450,48,409,H1
"San Patricio County, TX",2005-2006,67232,67022,-210,-0.312,588,-798,48,409,H1
"San Patricio County, TX",2006-2007,67022,66723,-299,-0.446,628,-927,48,409,H1
"San Patricio County, TX",2007-2008,66723,66417,-306,-0.459,600,-906,48,409,H1
"San Patricio County, TX",2008-2009,66417,65751,-666,-1.003,601,-1267,48,409,H1
"San Patricio County, TX",2009-2010,65751,64502,-1249,-1.9,496,-1745,48,409,H1
"San Patricio County, TX",2010-2011,64502,64500,-2,-0.003,299,-301,48,409,H1
"San Patricio County, TX",2011-2012,64500,65372,872,1.352,306,566,48,409,H1
"San Patricio County, TX",2012-2013,65372,66257,885,1.354,334,551,48,409,H1
"San Patricio County, TX",2013-2014,66257,66915,658,0.993,391,267,48,409,H1
"San Patricio County, TX",2014-2015,66924,67357,433,0.647,469,-36,48,409,H1
"San Patricio County, TX",2015-2016,67357,67262,-95,-0.141,378,-473,48,409,H1
"San Patricio County, TX",2016-2017,67262,67215,-47,-0.07,444,-491,48,409,H1
"San Saba County, TX",2000-2001,6268,6181,-87,-1.388,-24,-63,48,411,H1
"San Saba County, TX",2001-2002,6181,6042,-139,-2.249,-29,-110,48,411,H1
"San Saba County, TX",2002-2003,6042,5981,-61,-1.01,-40,-21,48,411,H1
"San Saba County, TX",2003-2004,5981,6045,64,1.07,-4,68,48,411,H1
"San Saba County, TX",2004-2005,6045,5982,-63,-1.042,-9,-54,48,411,H1
"San Saba County, TX",2005-2006,5982,5985,3,0.05,-10,13,48,411,H1
"San Saba County, TX",2006-2007,5985,5985,0,0,-2,2,48,411,H1
"San Saba County, TX",2007-2008,5985,5965,-20,-0.334,3,-23,48,411,H1
"San Saba County, TX",2008-2009,5965,6026,61,1.023,3,58,48,411,H1
"San Saba County, TX",2009-2010,6026,6139,113,1.875,-3,116,48,411,H1
"San Saba County, TX",2010-2011,6139,6046,-93,-1.515,-5,-88,48,411,H1
"San Saba County, TX",2011-2012,6046,5988,-58,-0.959,11,-69,48,411,H1
"San Saba County, TX",2012-2013,5988,5712,-276,-4.609,0,-276,48,411,H1
"San Saba County, TX",2013-2014,5712,5622,-90,-1.576,5,-95,48,411,H1
"San Saba County, TX",2014-2015,5830,5901,71,1.218,0,71,48,411,H1
"San Saba County, TX",2015-2016,5901,5872,-29,-0.491,6,-35,48,411,H1
"San Saba County, TX",2016-2017,5872,5959,87,1.482,-5,92,48,411,H1
"Schleicher County, TX",2000-2001,2929,3016,87,2.97,12,75,48,413,H1
"Schleicher County, TX",2001-2002,3016,3036,20,0.663,12,8,48,413,H1
"Schleicher County, TX",2002-2003,3036,2958,-78,-2.569,-9,-69,48,413,H1
"Schleicher County, TX",2003-2004,2958,2991,33,1.116,-10,43,48,413,H1
"Schleicher County, TX",2004-2005,2991,3071,80,2.675,22,58,48,413,H1
"Schleicher County, TX",2005-2006,3071,3085,14,0.456,4,10,48,413,H1
"Schleicher County, TX",2006-2007,3085,3198,113,3.663,18,95,48,413,H1
"Schleicher County, TX",2007-2008,3198,3255,57,1.782,22,35,48,413,H1
"Schleicher County, TX",2008-2009,3255,3311,56,1.72,24,32,48,413,H1
"Schleicher County, TX",2009-2010,3311,3499,188,5.678,24,164,48,413,H1
"Schleicher County, TX",2010-2011,3499,3300,-199,-5.687,20,-219,48,413,H1
"Schleicher County, TX",2011-2012,3300,3249,-51,-1.545,5,-56,48,413,H1
"Schleicher County, TX",2012-2013,3249,3197,-52,-1.6,15,-67,48,413,H1
"Schleicher County, TX",2013-2014,3197,3162,-35,-1.095,18,-53,48,413,H1
"Schleicher County, TX",2014-2015,3159,3211,52,1.646,23,29,48,413,H1
"Schleicher County, TX",2015-2016,3211,3064,-147,-4.578,11,-158,48,413,H1
"Schleicher County, TX",2016-2017,3064,3001,-63,-2.056,9,-72,48,413,H1
"Scurry County, TX",2000-2001,16251,15838,-413,-2.541,31,-444,48,415,H1
"Scurry County, TX",2001-2002,15838,15982,144,0.909,61,83,48,415,H1
"Scurry County, TX",2002-2003,15982,15931,-51,-0.319,40,-91,48,415,H1
"Scurry County, TX",2003-2004,15931,16118,187,1.174,64,123,48,415,H1
"Scurry County, TX",2004-2005,16118,16085,-33,-0.205,59,-92,48,415,H1
"Scurry County, TX",2005-2006,16085,16232,147,0.914,95,52,48,415,H1
"Scurry County, TX",2006-2007,16232,16431,199,1.226,93,106,48,415,H1
"Scurry County, TX",2007-2008,16431,16478,47,0.286,91,-44,48,415,H1
"Scurry County, TX",2008-2009,16478,16806,328,1.991,89,239,48,415,H1
"Scurry County, TX",2009-2010,16806,16954,148,0.881,103,45,48,415,H1
"Scurry County, TX",2010-2011,16954,16887,-67,-0.395,106,-173,48,415,H1
"Scurry County, TX",2011-2012,16887,17106,219,1.297,63,156,48,415,H1
"Scurry County, TX",2012-2013,17106,17267,161,0.941,106,55,48,415,H1
"Scurry County, TX",2013-2014,17267,17328,61,0.353,108,-47,48,415,H1
"Scurry County, TX",2014-2015,17356,17615,259,1.492,94,165,48,415,H1
"Scurry County, TX",2015-2016,17615,17430,-185,-1.05,103,-288,48,415,H1
"Scurry County, TX",2016-2017,17430,17050,-380,-2.18,80,-460,48,415,H1
"Shackelford County, TX",2000-2001,3297,3334,37,1.122,-8,45,48,417,H1
"Shackelford County, TX",2001-2002,3334,3388,54,1.62,3,51,48,417,H1
"Shackelford County, TX",2002-2003,3388,3349,-39,-1.151,-20,-19,48,417,H1
"Shackelford County, TX",2003-2004,3349,3290,-59,-1.762,-15,-44,48,417,H1
"Shackelford County, TX",2004-2005,3290,3286,-4,-0.122,-11,7,48,417,H1
"Shackelford County, TX",2005-2006,3286,3287,1,0.03,-3,4,48,417,H1
"Shackelford County, TX",2006-2007,3287,3357,70,2.13,10,60,48,417,H1
"Shackelford County, TX",2007-2008,3357,3314,-43,-1.281,8,-51,48,417,H1
"Shackelford County, TX",2008-2009,3314,3362,48,1.448,-5,53,48,417,H1
"Shackelford County, TX",2009-2010,3362,3367,5,0.149,-8,13,48,417,H1
"Shackelford County, TX",2010-2011,3367,3342,-25,-0.743,-5,-20,48,417,H1
"Shackelford County, TX",2011-2012,3342,3370,28,0.838,6,22,48,417,H1
"Shackelford County, TX",2012-2013,3370,3374,4,0.119,5,-1,48,417,H1
"Shackelford County, TX",2013-2014,3374,3343,-31,-0.919,10,-41,48,417,H1
"Shackelford County, TX",2014-2015,3323,3350,27,0.813,5,22,48,417,H1
"Shackelford County, TX",2015-2016,3350,3364,14,0.418,18,-4,48,417,H1
"Shackelford County, TX",2016-2017,3364,3328,-36,-1.07,4,-40,48,417,H1
"Shelby County, TX",2000-2001,25212,25171,-41,-0.163,94,-135,48,419,H1
"Shelby County, TX",2001-2002,25171,25155,-16,-0.064,96,-112,48,419,H1
"Shelby County, TX",2002-2003,25155,25407,252,1.002,103,149,48,419,H1
"Shelby County, TX",2003-2004,25407,25212,-195,-0.768,50,-245,48,419,H1
"Shelby County, TX",2004-2005,25212,25299,87,0.345,89,-2,48,419,H1
"Shelby County, TX",2005-2006,25299,25324,25,0.099,86,-61,48,419,H1
"Shelby County, TX",2006-2007,25324,25433,109,0.43,107,2,48,419,H1
"Shelby County, TX",2007-2008,25433,25381,-52,-0.204,135,-187,48,419,H1
"Shelby County, TX",2008-2009,25381,25520,139,0.548,126,13,48,419,H1
"Shelby County, TX",2009-2010,25520,25427,-93,-0.364,125,-218,48,419,H1
"Shelby County, TX",2010-2011,25427,25695,268,1.054,66,202,48,419,H1
"Shelby County, TX",2011-2012,25695,25988,293,1.14,68,225,48,419,H1
"Shelby County, TX",2012-2013,25988,25865,-123,-0.473,120,-243,48,419,H1
"Shelby County, TX",2013-2014,25865,25515,-350,-1.353,56,-406,48,419,H1
"Shelby County, TX",2014-2015,25581,25402,-179,-0.7,72,-251,48,419,H1
"Shelby County, TX",2015-2016,25402,25777,375,1.476,128,247,48,419,H1
"Shelby County, TX",2016-2017,25777,25513,-264,-1.024,95,-359,48,419,H1
"Sherman County, TX",2000-2001,3181,3131,-50,-1.572,-1,-49,48,421,H1
"Sherman County, TX",2001-2002,3131,3164,33,1.054,16,17,48,421,H1
"Sherman County, TX",2002-2003,3164,3113,-51,-1.612,12,-63,48,421,H1
"Sherman County, TX",2003-2004,3113,3045,-68,-2.184,12,-80,48,421,H1
"Sherman County, TX",2004-2005,3045,2970,-75,-2.463,13,-88,48,421,H1
"Sherman County, TX",2005-2006,2970,2946,-24,-0.808,11,-35,48,421,H1
"Sherman County, TX",2006-2007,2946,2969,23,0.781,11,12,48,421,H1
"Sherman County, TX",2007-2008,2969,3035,66,2.223,30,36,48,421,H1
"Sherman County, TX",2008-2009,3035,3018,-17,-0.56,30,-47,48,421,H1
"Sherman County, TX",2009-2010,3018,3030,12,0.398,20,-8,48,421,H1
"Sherman County, TX",2010-2011,3030,3035,5,0.165,10,-5,48,421,H1
"Sherman County, TX",2011-2012,3035,3067,32,1.054,16,16,48,421,H1
"Sherman County, TX",2012-2013,3067,3085,18,0.587,17,1,48,421,H1
"Sherman County, TX",2013-2014,3085,3084,-1,-0.032,21,-22,48,421,H1
"Sherman County, TX",2014-2015,3077,3072,-5,-0.162,35,-40,48,421,H1
"Sherman County, TX",2015-2016,3072,3075,3,0.098,16,-13,48,421,H1
"Sherman County, TX",2016-2017,3075,3067,-8,-0.26,27,-35,48,421,H1
"Smith County, TX",2000-2001,175658,177836,2178,1.24,834,1344,48,423,H1
"Smith County, TX",2001-2002,177836,181107,3271,1.839,974,2297,48,423,H1
"Smith County, TX",2002-2003,181107,184254,3147,1.738,1105,2042,48,423,H1
"Smith County, TX",2003-2004,184254,187300,3046,1.653,1225,1821,48,423,H1
"Smith County, TX",2004-2005,187300,191362,4062,2.169,1250,2812,48,423,H1
"Smith County, TX",2005-2006,191362,196124,4762,2.488,1373,3389,48,423,H1
"Smith County, TX",2006-2007,196124,199953,3829,1.952,1450,2379,48,423,H1
"Smith County, TX",2007-2008,199953,203263,3310,1.655,1318,1992,48,423,H1
"Smith County, TX",2008-2009,203263,207111,3848,1.893,1344,2504,48,423,H1
"Smith County, TX",2009-2010,207111,210455,3344,1.615,1417,1927,48,423,H1
"Smith County, TX",2010-2011,210455,212765,2310,1.098,1049,1261,48,423,H1
"Smith County, TX",2011-2012,212765,214941,2176,1.023,1029,1147,48,423,H1
"Smith County, TX",2012-2013,214941,216670,1729,0.804,1079,650,48,423,H1
"Smith County, TX",2013-2014,216670,218842,2172,1.002,1054,1118,48,423,H1
"Smith County, TX",2014-2015,220050,222936,2886,1.312,1182,1704,48,423,H1
"Smith County, TX",2015-2016,222936,225305,2369,1.063,1019,1350,48,423,H1
"Smith County, TX",2016-2017,225305,227727,2422,1.075,1095,1327,48,423,H1
"Somervell County, TX",2000-2001,6940,7017,77,1.11,11,66,48,425,H1
"Somervell County, TX",2001-2002,7017,7229,212,3.021,5,207,48,425,H1
"Somervell County, TX",2002-2003,7229,7400,171,2.365,18,153,48,425,H1
"Somervell County, TX",2003-2004,7400,7502,102,1.378,23,79,48,425,H1
"Somervell County, TX",2004-2005,7502,7629,127,1.693,23,104,48,425,H1
"Somervell County, TX",2005-2006,7629,7853,224,2.936,13,211,48,425,H1
"Somervell County, TX",2006-2007,7853,7996,143,1.821,19,124,48,425,H1
"Somervell County, TX",2007-2008,7996,8233,237,2.964,38,199,48,425,H1
"Somervell County, TX",2008-2009,8233,8415,182,2.211,20,162,48,425,H1
"Somervell County, TX",2009-2010,8415,8509,94,1.117,5,89,48,425,H1
"Somervell County, TX",2010-2011,8509,8452,-57,-0.67,3,-60,48,425,H1
"Somervell County, TX",2011-2012,8452,8594,142,1.68,18,124,48,425,H1
"Somervell County, TX",2012-2013,8594,8624,30,0.349,7,23,48,425,H1
"Somervell County, TX",2013-2014,8624,8694,70,0.812,7,63,48,425,H1
"Somervell County, TX",2014-2015,8665,8739,74,0.854,4,70,48,425,H1
"Somervell County, TX",2015-2016,8739,8680,-59,-0.675,6,-65,48,425,H1
"Somervell County, TX",2016-2017,8680,8845,165,1.901,-12,177,48,425,H1
"Starr County, TX",2000-2001,53733,54294,561,1.044,1160,-599,48,427,H1
"Starr County, TX",2001-2002,54294,55412,1118,2.059,1208,-90,48,427,H1
"Starr County, TX",2002-2003,55412,56704,1292,2.332,1190,102,48,427,H1
"Starr County, TX",2003-2004,56704,57857,1153,2.033,1188,-35,48,427,H1
"Starr County, TX",2004-2005,57857,58284,427,0.738,1202,-775,48,427,H1
"Starr County, TX",2005-2006,58284,59050,766,1.314,1286,-520,48,427,H1
"Starr County, TX",2006-2007,59050,59529,479,0.811,1079,-600,48,427,H1
"Starr County, TX",2007-2008,59529,59763,234,0.393,1084,-850,48,427,H1
"Starr County, TX",2008-2009,59763,60384,621,1.039,1195,-574,48,427,H1
"Starr County, TX",2009-2010,60384,61178,794,1.315,1142,-348,48,427,H1
"Starr County, TX",2010-2011,61178,61727,549,0.897,1056,-507,48,427,H1
"Starr County, TX",2011-2012,61727,61951,224,0.363,951,-727,48,427,H1
"Starr County, TX",2012-2013,61951,62390,439,0.709,962,-523,48,427,H1
"Starr County, TX",2013-2014,62390,62955,565,0.906,974,-409,48,427,H1
"Starr County, TX",2014-2015,63149,63795,646,1.023,1015,-369,48,427,H1
"Starr County, TX",2015-2016,63795,63931,136,0.213,833,-697,48,427,H1
"Starr County, TX",2016-2017,63931,64454,523,0.818,866,-343,48,427,H1
"Stephens County, TX",2000-2001,9636,9455,-181,-1.878,28,-209,48,429,H1
"Stephens County, TX",2001-2002,9455,9374,-81,-0.857,26,-107,48,429,H1
"Stephens County, TX",2002-2003,9374,9407,33,0.352,-9,42,48,429,H1
"Stephens County, TX",2003-2004,9407,9327,-80,-0.85,22,-102,48,429,H1
"Stephens County, TX",2004-2005,9327,9409,82,0.879,7,75,48,429,H1
"Stephens County, TX",2005-2006,9409,9450,41,0.436,27,14,48,429,H1
"Stephens County, TX",2006-2007,9450,9513,63,0.667,23,40,48,429,H1
"Stephens County, TX",2007-2008,9513,9556,43,0.452,35,8,48,429,H1
"Stephens County, TX",2008-2009,9556,9675,119,1.245,44,75,48,429,H1
"Stephens County, TX",2009-2010,9675,9595,-80,-0.827,42,-122,48,429,H1
"Stephens County, TX",2010-2011,9595,9507,-88,-0.917,-45,-43,48,429,H1
"Stephens County, TX",2011-2012,9507,9570,63,0.663,-2,65,48,429,H1
"Stephens County, TX",2012-2013,9570,9350,-220,-2.299,-6,-214,48,429,H1
"Stephens County, TX",2013-2014,9350,9405,55,0.588,12,43,48,429,H1
"Stephens County, TX",2014-2015,9375,9440,65,0.693,27,38,48,429,H1
"Stephens County, TX",2015-2016,9440,9408,-32,-0.339,2,-34,48,429,H1
"Stephens County, TX",2016-2017,9408,9337,-71,-0.755,0,-71,48,429,H1
"Sterling County, TX",2000-2001,1358,1341,-17,-1.252,9,-26,48,431,H1
"Sterling County, TX",2001-2002,1341,1326,-15,-1.119,-3,-12,48,431,H1
"Sterling County, TX",2002-2003,1326,1285,-41,-3.092,-3,-38,48,431,H1
"Sterling County, TX",2003-2004,1285,1261,-24,-1.868,-4,-20,48,431,H1
"Sterling County, TX",2004-2005,1261,1198,-63,-4.996,-1,-62,48,431,H1
"Sterling County, TX",2005-2006,1198,1124,-74,-6.177,-9,-65,48,431,H1
"Sterling County, TX",2006-2007,1124,1152,28,2.491,2,26,48,431,H1
"Sterling County, TX",2007-2008,1152,1169,17,1.476,8,9,48,431,H1
"Sterling County, TX",2008-2009,1169,1160,-9,-0.77,4,-13,48,431,H1
"Sterling County, TX",2009-2010,1160,1137,-23,-1.983,5,-28,48,431,H1
"Sterling County, TX",2010-2011,1137,1168,31,2.726,-2,33,48,431,H1
"Sterling County, TX",2011-2012,1168,1188,20,1.712,-5,25,48,431,H1
"Sterling County, TX",2012-2013,1188,1230,42,3.535,6,36,48,431,H1
"Sterling County, TX",2013-2014,1230,1339,109,8.862,-5,114,48,431,H1
"Sterling County, TX",2014-2015,1352,1352,0,0,3,-3,48,431,H1
"Sterling County, TX",2015-2016,1352,1351,-1,-0.074,14,-15,48,431,H1
"Sterling County, TX",2016-2017,1351,1295,-56,-4.145,3,-59,48,431,H1
"Stonewall County, TX",2000-2001,1664,1568,-96,-5.769,-8,-88,48,433,H1
"Stonewall County, TX",2001-2002,1568,1487,-81,-5.166,8,-89,48,433,H1
"Stonewall County, TX",2002-2003,1487,1452,-35,-2.354,-14,-21,48,433,H1
"Stonewall County, TX",2003-2004,1452,1427,-25,-1.722,5,-30,48,433,H1
"Stonewall County, TX",2004-2005,1427,1393,-34,-2.383,-11,-23,48,433,H1
"Stonewall County, TX",2005-2006,1393,1425,32,2.297,-10,42,48,433,H1
"Stonewall County, TX",2006-2007,1425,1439,14,0.982,-4,18,48,433,H1
"Stonewall County, TX",2007-2008,1439,1443,4,0.278,4,0,48,433,H1
"Stonewall County, TX",2008-2009,1443,1433,-10,-0.693,18,-28,48,433,H1
"Stonewall County, TX",2009-2010,1433,1495,62,4.327,11,51,48,433,H1
"Stonewall County, TX",2010-2011,1495,1479,-16,-1.07,-9,-7,48,433,H1
"Stonewall County, TX",2011-2012,1479,1470,-9,-0.609,-16,7,48,433,H1
"Stonewall County, TX",2012-2013,1470,1430,-40,-2.721,-4,-36,48,433,H1
"Stonewall County, TX",2013-2014,1430,1403,-27,-1.888,3,-30,48,433,H1
"Stonewall County, TX",2014-2015,1397,1410,13,0.931,1,12,48,433,H1
"Stonewall County, TX",2015-2016,1410,1402,-8,-0.567,-4,-4,48,433,H1
"Stonewall County, TX",2016-2017,1402,1388,-14,-0.999,6,-20,48,433,H1
"Sutton County, TX",2000-2001,4024,4032,8,0.199,34,-26,48,435,H1
"Sutton County, TX",2001-2002,4032,4072,40,0.992,30,10,48,435,H1
"Sutton County, TX",2002-2003,4072,4029,-43,-1.056,18,-61,48,435,H1
"Sutton County, TX",2003-2004,4029,4124,95,2.358,34,61,48,435,H1
"Sutton County, TX",2004-2005,4124,4203,79,1.916,28,51,48,435,H1
"Sutton County, TX",2005-2006,4203,4299,96,2.284,30,66,48,435,H1
"Sutton County, TX",2006-2007,4299,4314,15,0.349,24,-9,48,435,H1
"Sutton County, TX",2007-2008,4314,4321,7,0.162,51,-44,48,435,H1
"Sutton County, TX",2008-2009,4321,4272,-49,-1.134,56,-105,48,435,H1
"Sutton County, TX",2009-2010,4272,4060,-212,-4.963,50,-262,48,435,H1
"Sutton County, TX",2010-2011,4060,4011,-49,-1.207,25,-74,48,435,H1
"Sutton County, TX",2011-2012,4011,3930,-81,-2.019,12,-93,48,435,H1
"Sutton County, TX",2012-2013,3930,4001,71,1.807,34,37,48,435,H1
"Sutton County, TX",2013-2014,4001,3972,-29,-0.725,34,-63,48,435,H1
"Sutton County, TX",2014-2015,3971,3913,-58,-1.461,32,-90,48,435,H1
"Sutton County, TX",2015-2016,3913,3865,-48,-1.227,36,-84,48,435,H1
"Sutton County, TX",2016-2017,3865,3767,-98,-2.536,30,-128,48,435,H1
"Swisher County, TX",2000-2001,8341,8248,-93,-1.115,62,-155,48,437,H1
"Swisher County, TX",2001-2002,8248,8071,-177,-2.146,25,-202,48,437,H1
"Swisher County, TX",2002-2003,8071,8062,-9,-0.112,41,-50,48,437,H1
"Swisher County, TX",2003-2004,8062,8004,-58,-0.719,60,-118,48,437,H1
"Swisher County, TX",2004-2005,8004,7910,-94,-1.174,63,-157,48,437,H1
"Swisher County, TX",2005-2006,7910,7901,-9,-0.114,28,-37,48,437,H1
"Swisher County, TX",2006-2007,7901,7855,-46,-0.582,52,-98,48,437,H1
"Swisher County, TX",2007-2008,7855,7802,-53,-0.675,60,-113,48,437,H1
"Swisher County, TX",2008-2009,7802,7680,-122,-1.564,71,-193,48,437,H1
"Swisher County, TX",2009-2010,7680,7895,215,2.799,55,160,48,437,H1
"Swisher County, TX",2010-2011,7895,7825,-70,-0.887,28,-98,48,437,H1
"Swisher County, TX",2011-2012,7825,7882,57,0.728,40,17,48,437,H1
"Swisher County, TX",2012-2013,7882,7761,-121,-1.535,36,-157,48,437,H1
"Swisher County, TX",2013-2014,7761,7581,-180,-2.319,32,-212,48,437,H1
"Swisher County, TX",2014-2015,7584,7533,-51,-0.672,46,-97,48,437,H1
"Swisher County, TX",2015-2016,7533,7440,-93,-1.235,26,-119,48,437,H1
"Swisher County, TX",2016-2017,7440,7515,75,1.008,32,43,48,437,H1
"Tarrant County, TX",2000-2001,1456919,1490204,33285,2.285,16177,17108,48,439,H1
"Tarrant County, TX",2001-2002,1490204,1524249,34045,2.285,16612,17433,48,439,H1
"Tarrant County, TX",2002-2003,1524249,1553086,28837,1.892,17878,10959,48,439,H1
"Tarrant County, TX",2003-2004,1553086,1580595,27509,1.771,18007,9502,48,439,H1
"Tarrant County, TX",2004-2005,1580595,1612048,31453,1.99,17755,13698,48,439,H1
"Tarrant County, TX",2005-2006,1612048,1662005,49957,3.099,18611,31346,48,439,H1
"Tarrant County, TX",2006-2007,1662005,1707157,45152,2.717,19173,25979,48,439,H1
"Tarrant County, TX",2007-2008,1707157,1745602,38445,2.252,19092,19353,48,439,H1
"Tarrant County, TX",2008-2009,1745602,1784078,38476,2.204,19429,19047,48,439,H1
"Tarrant County, TX",2009-2010,1784078,1816784,32706,1.833,19939,12767,48,439,H1
"Tarrant County, TX",2010-2011,1816784,1848435,31651,1.742,16412,15239,48,439,H1
"Tarrant County, TX",2011-2012,1848435,1882822,34387,1.86,16674,17713,48,439,H1
"Tarrant County, TX",2012-2013,1882822,1913943,31121,1.653,15817,15304,48,439,H1
"Tarrant County, TX",2013-2014,1913943,1945360,31417,1.641,16011,15406,48,439,H1
"Tarrant County, TX",2014-2015,1946346,1982498,36152,1.857,16295,19857,48,439,H1
"Tarrant County, TX",2015-2016,1982498,2021746,39248,1.98,15897,23351,48,439,H1
"Tarrant County, TX",2016-2017,2021746,2054475,32729,1.619,15687,17042,48,439,H1
"Taylor County, TX",2000-2001,126649,125920,-729,-0.576,860,-1589,48,441,H1
"Taylor County, TX",2001-2002,125920,125920,0,0,819,-819,48,441,H1
"Taylor County, TX",2002-2003,125920,125542,-378,-0.3,825,-1203,48,441,H1
"Taylor County, TX",2003-2004,125542,126702,1160,0.924,820,340,48,441,H1
"Taylor County, TX",2004-2005,126702,127248,546,0.431,908,-362,48,441,H1
"Taylor County, TX",2005-2006,127248,127838,590,0.464,926,-336,48,441,H1
"Taylor County, TX",2006-2007,127838,128503,665,0.52,939,-274,48,441,H1
"Taylor County, TX",2007-2008,128503,128903,400,0.311,900,-500,48,441,H1
"Taylor County, TX",2008-2009,128903,130247,1344,1.043,864,480,48,441,H1
"Taylor County, TX",2009-2010,130247,131863,1616,1.241,984,632,48,441,H1
"Taylor County, TX",2010-2011,131863,132822,959,0.727,888,71,48,441,H1
"Taylor County, TX",2011-2012,132822,134104,1282,0.965,774,508,48,441,H1
"Taylor County, TX",2012-2013,134104,133866,-238,-0.177,766,-1004,48,441,H1
"Taylor County, TX",2013-2014,133866,135143,1277,0.954,720,557,48,441,H1
"Taylor County, TX",2014-2015,135044,136051,1007,0.746,698,309,48,441,H1
"Taylor County, TX",2015-2016,136051,135962,-89,-0.065,726,-815,48,441,H1
"Taylor County, TX",2016-2017,135962,136290,328,0.241,686,-358,48,441,H1
"Terrell County, TX",2000-2001,1059,1017,-42,-3.966,1,-43,48,443,H1
"Terrell County, TX",2001-2002,1017,1009,-8,-0.787,-3,-5,48,443,H1
"Terrell County, TX",2002-2003,1009,995,-14,-1.388,-10,-4,48,443,H1
"Terrell County, TX",2003-2004,995,939,-56,-5.628,-4,-52,48,443,H1
"Terrell County, TX",2004-2005,939,942,3,0.319,0,3,48,443,H1
"Terrell County, TX",2005-2006,942,921,-21,-2.229,-1,-20,48,443,H1
"Terrell County, TX",2006-2007,921,886,-35,-3.8,2,-37,48,443,H1
"Terrell County, TX",2007-2008,886,884,-2,-0.226,6,-8,48,443,H1
"Terrell County, TX",2008-2009,884,930,46,5.204,5,41,48,443,H1
"Terrell County, TX",2009-2010,930,1007,77,8.28,8,69,48,443,H1
"Terrell County, TX",2010-2011,1007,955,-52,-5.164,-3,-49,48,443,H1
"Terrell County, TX",2011-2012,955,926,-29,-3.037,4,-33,48,443,H1
"Terrell County, TX",2012-2013,926,905,-21,-2.268,-2,-19,48,443,H1
"Terrell County, TX",2013-2014,905,927,22,2.431,3,19,48,443,H1
"Terrell County, TX",2014-2015,893,837,-56,-6.271,-6,-50,48,443,H1
"Terrell County, TX",2015-2016,837,818,-19,-2.27,-2,-17,48,443,H1
"Terrell County, TX",2016-2017,818,810,-8,-0.978,-2,-6,48,443,H1
"Terry County, TX",2000-2001,12705,12473,-232,-1.826,56,-288,48,445,H1
"Terry County, TX",2001-2002,12473,12559,86,0.689,79,7,48,445,H1
"Terry County, TX",2002-2003,12559,12534,-25,-0.199,89,-114,48,445,H1
"Terry County, TX",2003-2004,12534,12532,-2,-0.016,70,-72,48,445,H1
"Terry County, TX",2004-2005,12532,12417,-115,-0.918,68,-183,48,445,H1
"Terry County, TX",2005-2006,12417,12448,31,0.25,84,-53,48,445,H1
"Terry County, TX",2006-2007,12448,12424,-24,-0.193,100,-124,48,445,H1
"Terry County, TX",2007-2008,12424,12394,-30,-0.241,97,-127,48,445,H1
"Terry County, TX",2008-2009,12394,12550,156,1.259,78,78,48,445,H1
"Terry County, TX",2009-2010,12550,12663,113,0.9,113,0,48,445,H1
"Terry County, TX",2010-2011,12663,12653,-10,-0.079,48,-58,48,445,H1
"Terry County, TX",2011-2012,12653,12610,-43,-0.34,64,-107,48,445,H1
"Terry County, TX",2012-2013,12610,12739,129,1.023,112,17,48,445,H1
"Terry County, TX",2013-2014,12739,12739,0,0,78,-78,48,445,H1
"Terry County, TX",2014-2015,12773,12739,-34,-0.266,73,-107,48,445,H1
"Terry County, TX",2015-2016,12739,12826,87,0.683,84,3,48,445,H1
"Terry County, TX",2016-2017,12826,12715,-111,-0.865,67,-178,48,445,H1
"Throckmorton County, TX",2000-2001,1831,1791,-40,-2.185,3,-43,48,447,H1
"Throckmorton County, TX",2001-2002,1791,1739,-52,-2.903,-8,-44,48,447,H1
"Throckmorton County, TX",2002-2003,1739,1702,-37,-2.128,-22,-15,48,447,H1
"Throckmorton County, TX",2003-2004,1702,1652,-50,-2.938,-22,-28,48,447,H1
"Throckmorton County, TX",2004-2005,1652,1695,43,2.603,-8,51,48,447,H1
"Throckmorton County, TX",2005-2006,1695,1710,15,0.885,-7,22,48,447,H1
"Throckmorton County, TX",2006-2007,1710,1653,-57,-3.333,-3,-54,48,447,H1
"Throckmorton County, TX",2007-2008,1653,1635,-18,-1.089,1,-19,48,447,H1
"Throckmorton County, TX",2008-2009,1635,1654,19,1.162,3,16,48,447,H1
"Throckmorton County, TX",2009-2010,1654,1630,-24,-1.451,5,-29,48,447,H1
"Throckmorton County, TX",2010-2011,1630,1637,7,0.429,-8,15,48,447,H1
"Throckmorton County, TX",2011-2012,1637,1601,-36,-2.199,-9,-27,48,447,H1
"Throckmorton County, TX",2012-2013,1601,1598,-3,-0.187,4,-7,48,447,H1
"Throckmorton County, TX",2013-2014,1598,1608,10,0.626,6,4,48,447,H1
"Throckmorton County, TX",2014-2015,1614,1579,-35,-2.169,3,-38,48,447,H1
"Throckmorton County, TX",2015-2016,1579,1548,-31,-1.963,-2,-29,48,447,H1
"Throckmorton County, TX",2016-2017,1548,1527,-21,-1.357,2,-23,48,447,H1
"Titus County, TX",2000-2001,28138,28100,-38,-0.135,256,-294,48,449,H1
"Titus County, TX",2001-2002,28100,28387,287,1.021,235,52,48,449,H1
"Titus County, TX",2002-2003,28387,28947,560,1.973,271,289,48,449,H1
"Titus County, TX",2003-2004,28947,29461,514,1.776,301,213,48,449,H1
"Titus County, TX",2004-2005,29461,28803,-658,-2.233,334,-992,48,449,H1
"Titus County, TX",2005-2006,28803,29541,738,2.562,332,406,48,449,H1
"Titus County, TX",2006-2007,29541,30231,690,2.336,407,283,48,449,H1
"Titus County, TX",2007-2008,30231,30963,732,2.421,361,371,48,449,H1
"Titus County, TX",2008-2009,30963,31749,786,2.539,319,467,48,449,H1
"Titus County, TX",2009-2010,31749,32408,659,2.076,350,309,48,449,H1
"Titus County, TX",2010-2011,32408,32441,33,0.102,236,-203,48,449,H1
"Titus County, TX",2011-2012,32441,32693,252,0.777,248,4,48,449,H1
"Titus County, TX",2012-2013,32693,32654,-39,-0.119,228,-267,48,449,H1
"Titus County, TX",2013-2014,32654,32506,-148,-0.453,245,-393,48,449,H1
"Titus County, TX",2014-2015,32487,32623,136,0.419,242,-106,48,449,H1
"Titus County, TX",2015-2016,32623,32615,-8,-0.025,235,-243,48,449,H1
"Titus County, TX",2016-2017,32615,32904,289,0.886,248,41,48,449,H1
"Tom Green County, TX",2000-2001,104083,103923,-160,-0.154,576,-736,48,451,H1
"Tom Green County, TX",2001-2002,103923,104035,112,0.108,494,-382,48,451,H1
"Tom Green County, TX",2002-2003,104035,104330,295,0.284,684,-389,48,451,H1
"Tom Green County, TX",2003-2004,104330,104744,414,0.397,556,-142,48,451,H1
"Tom Green County, TX",2004-2005,104744,104974,230,0.22,613,-383,48,451,H1
"Tom Green County, TX",2005-2006,104974,106125,1151,1.096,635,516,48,451,H1
"Tom Green County, TX",2006-2007,106125,106680,555,0.523,731,-176,48,451,H1
"Tom Green County, TX",2007-2008,106680,107639,959,0.899,705,254,48,451,H1
"Tom Green County, TX",2008-2009,107639,108879,1240,1.152,679,561,48,451,H1
"Tom Green County, TX",2009-2010,108879,110673,1794,1.648,759,1035,48,451,H1
"Tom Green County, TX",2010-2011,110673,111823,1150,1.039,530,620,48,451,H1
"Tom Green County, TX",2011-2012,111823,113521,1698,1.518,530,1168,48,451,H1
"Tom Green County, TX",2012-2013,113521,114955,1434,1.263,526,908,48,451,H1
"Tom Green County, TX",2013-2014,114955,116608,1653,1.438,524,1129,48,451,H1
"Tom Green County, TX",2014-2015,116881,118105,1224,1.047,587,637,48,451,H1
"Tom Green County, TX",2015-2016,118105,117792,-313,-0.265,652,-965,48,451,H1
"Tom Green County, TX",2016-2017,117792,118019,227,0.193,584,-357,48,451,H1
"Travis County, TX",2000-2001,819692,844877,25185,3.072,10342,14843,48,453,H1
"Travis County, TX",2001-2002,844877,848090,3213,0.38,10527,-7314,48,453,H1
"Travis County, TX",2002-2003,848090,856315,8225,0.97,10429,-2204,48,453,H1
"Travis County, TX",2003-2004,856315,870809,14494,1.693,10884,3610,48,453,H1
"Travis County, TX",2004-2005,870809,891266,20457,2.349,10947,9510,48,453,H1
"Travis County, TX",2005-2006,891266,925151,33885,3.802,11325,22560,48,453,H1
"Travis County, TX",2006-2007,925151,955399,30248,3.27,12005,18243,48,453,H1
"Travis County, TX",2007-2008,955399,980699,25300,2.648,11941,13359,48,453,H1
"Travis County, TX",2008-2009,980699,1006503,25804,2.631,11705,14099,48,453,H1
"Travis County, TX",2009-2010,1006503,1030443,23940,2.379,12700,11240,48,453,H1
"Travis County, TX",2010-2011,1030443,1062609,32166,3.122,10997,21169,48,453,H1
"Travis County, TX",2011-2012,1062609,1097104,34495,3.246,10881,23614,48,453,H1
"Travis County, TX",2012-2013,1097104,1122748,25644,2.337,10669,14975,48,453,H1
"Travis County, TX",2013-2014,1122748,1151145,28397,2.529,10835,17562,48,453,H1
"Travis County, TX",2014-2015,1150996,1176558,25562,2.221,10918,14644,48,453,H1
"Travis County, TX",2015-2016,1176558,1204582,28024,2.382,10725,17299,48,453,H1
"Travis County, TX",2016-2017,1204582,1226698,22116,1.836,10571,11545,48,453,H1
"Trinity County, TX",2000-2001,13793,13852,59,0.428,-26,85,48,455,H1
"Trinity County, TX",2001-2002,13852,14033,181,1.307,-26,207,48,455,H1
"Trinity County, TX",2002-2003,14033,14156,123,0.877,-29,152,48,455,H1
"Trinity County, TX",2003-2004,14156,14246,90,0.636,-78,168,48,455,H1
"Trinity County, TX",2004-2005,14246,14395,149,1.046,-41,190,48,455,H1
"Trinity County, TX",2005-2006,14395,14376,-19,-0.132,-30,11,48,455,H1
"Trinity County, TX",2006-2007,14376,14425,49,0.341,-75,124,48,455,H1
"Trinity County, TX",2007-2008,14425,14380,-45,-0.312,-42,-3,48,455,H1
"Trinity County, TX",2008-2009,14380,14472,92,0.64,-20,112,48,455,H1
"Trinity County, TX",2009-2010,14472,14697,225,1.555,-41,266,48,455,H1
"Trinity County, TX",2010-2011,14697,14636,-61,-0.415,-50,-11,48,455,H1
"Trinity County, TX",2011-2012,14636,14300,-336,-2.296,-107,-229,48,455,H1
"Trinity County, TX",2012-2013,14300,14401,101,0.706,-92,193,48,455,H1
"Trinity County, TX",2013-2014,14401,14224,-177,-1.229,-85,-92,48,455,H1
"Trinity County, TX",2014-2015,14241,14402,161,1.131,-81,242,48,455,H1
"Trinity County, TX",2015-2016,14402,14513,111,0.771,-93,204,48,455,H1
"Trinity County, TX",2016-2017,14513,14667,154,1.061,-65,219,48,455,H1
"Tyler County, TX",2000-2001,20854,20657,-197,-0.945,-9,-188,48,457,H1
"Tyler County, TX",2001-2002,20657,20825,168,0.813,-30,198,48,457,H1
"Tyler County, TX",2002-2003,20825,20823,-2,-0.01,-37,35,48,457,H1
"Tyler County, TX",2003-2004,20823,21038,215,1.033,-24,239,48,457,H1
"Tyler County, TX",2004-2005,21038,20935,-103,-0.49,-35,-68,48,457,H1
"Tyler County, TX",2005-2006,20935,21034,99,0.473,15,84,48,457,H1
"Tyler County, TX",2006-2007,21034,21279,245,1.165,-8,253,48,457,H1
"Tyler County, TX",2007-2008,21279,21570,291,1.368,19,272,48,457,H1
"Tyler County, TX",2008-2009,21570,21737,167,0.774,20,147,48,457,H1
"Tyler County, TX",2009-2010,21737,21763,26,0.12,-12,38,48,457,H1
"Tyler County, TX",2010-2011,21763,21673,-90,-0.414,-38,-52,48,457,H1
"Tyler County, TX",2011-2012,21673,21452,-221,-1.02,-55,-166,48,457,H1
"Tyler County, TX",2012-2013,21452,21453,1,0.005,-30,31,48,457,H1
"Tyler County, TX",2013-2014,21453,21418,-35,-0.163,-6,-29,48,457,H1
"Tyler County, TX",2014-2015,21389,21347,-42,-0.196,1,-43,48,457,H1
"Tyler County, TX",2015-2016,21347,21434,87,0.408,-57,144,48,457,H1
"Tyler County, TX",2016-2017,21434,21539,105,0.49,-24,129,48,457,H1
"Upshur County, TX",2000-2001,35402,35746,344,0.972,8,336,48,459,H1
"Upshur County, TX",2001-2002,35746,36739,993,2.778,116,877,48,459,H1
"Upshur County, TX",2002-2003,36739,37232,493,1.342,7,486,48,459,H1
"Upshur County, TX",2003-2004,37232,37530,298,0.8,69,229,48,459,H1
"Upshur County, TX",2004-2005,37530,37957,427,1.138,58,369,48,459,H1
"Upshur County, TX",2005-2006,37957,38004,47,0.124,115,-68,48,459,H1
"Upshur County, TX",2006-2007,38004,38275,271,0.713,121,150,48,459,H1
"Upshur County, TX",2007-2008,38275,38706,431,1.126,83,348,48,459,H1
"Upshur County, TX",2008-2009,38706,39084,378,0.977,116,262,48,459,H1
"Upshur County, TX",2009-2010,39084,39388,304,0.778,68,236,48,459,H1
"Upshur County, TX",2010-2011,39388,39770,382,0.97,58,324,48,459,H1
"Upshur County, TX",2011-2012,39770,39952,182,0.458,21,161,48,459,H1
"Upshur County, TX",2012-2013,39952,39790,-162,-0.405,63,-225,48,459,H1
"Upshur County, TX",2013-2014,39790,40354,564,1.417,74,490,48,459,H1
"Upshur County, TX",2014-2015,40366,40603,237,0.587,115,122,48,459,H1
"Upshur County, TX",2015-2016,40603,40864,261,0.643,20,241,48,459,H1
"Upshur County, TX",2016-2017,40864,41281,417,1.02,29,388,48,459,H1
"Upton County, TX",2000-2001,3376,3231,-145,-4.295,5,-150,48,461,H1
"Upton County, TX",2001-2002,3231,3273,42,1.3,11,31,48,461,H1
"Upton County, TX",2002-2003,3273,3202,-71,-2.169,24,-95,48,461,H1
"Upton County, TX",2003-2004,3202,3168,-34,-1.062,25,-59,48,461,H1
"Upton County, TX",2004-2005,3168,3117,-51,-1.61,29,-80,48,461,H1
"Upton County, TX",2005-2006,3117,3174,57,1.829,9,48,48,461,H1
"Upton County, TX",2006-2007,3174,3123,-51,-1.607,12,-63,48,461,H1
"Upton County, TX",2007-2008,3123,3231,108,3.458,29,79,48,461,H1
"Upton County, TX",2008-2009,3231,3327,96,2.971,52,44,48,461,H1
"Upton County, TX",2009-2010,3327,3346,19,0.571,44,-25,48,461,H1
"Upton County, TX",2010-2011,3346,3285,-61,-1.823,3,-64,48,461,H1
"Upton County, TX",2011-2012,3285,3254,-31,-0.944,11,-42,48,461,H1
"Upton County, TX",2012-2013,3254,3358,104,3.196,36,68,48,461,H1
"Upton County, TX",2013-2014,3358,3454,96,2.859,42,54,48,461,H1
"Upton County, TX",2014-2015,3465,3651,186,5.368,51,135,48,461,H1
"Upton County, TX",2015-2016,3651,3697,46,1.26,43,3,48,461,H1
"Upton County, TX",2016-2017,3697,3663,-34,-0.92,47,-81,48,461,H1
"Uvalde County, TX",2000-2001,25900,25939,39,0.151,239,-200,48,463,H1
"Uvalde County, TX",2001-2002,25939,26309,370,1.426,234,136,48,463,H1
"Uvalde County, TX",2002-2003,26309,26258,-51,-0.194,194,-245,48,463,H1
"Uvalde County, TX",2003-2004,26258,26205,-53,-0.202,207,-260,48,463,H1
"Uvalde County, TX",2004-2005,26205,26368,163,0.622,260,-97,48,463,H1
"Uvalde County, TX",2005-2006,26368,26301,-67,-0.254,212,-279,48,463,H1
"Uvalde County, TX",2006-2007,26301,26217,-84,-0.319,236,-320,48,463,H1
"Uvalde County, TX",2007-2008,26217,26206,-11,-0.042,240,-251,48,463,H1
"Uvalde County, TX",2008-2009,26206,26223,17,0.065,232,-215,48,463,H1
"Uvalde County, TX",2009-2010,26223,26448,225,0.858,209,16,48,463,H1
"Uvalde County, TX",2010-2011,26448,26574,126,0.476,192,-66,48,463,H1
"Uvalde County, TX",2011-2012,26574,26760,186,0.7,148,38,48,463,H1
"Uvalde County, TX",2012-2013,26760,26916,156,0.583,121,35,48,463,H1
"Uvalde County, TX",2013-2014,26916,27117,201,0.747,146,55,48,463,H1
"Uvalde County, TX",2014-2015,27214,27245,31,0.114,184,-153,48,463,H1
"Uvalde County, TX",2015-2016,27245,27106,-139,-0.51,158,-297,48,463,H1
"Uvalde County, TX",2016-2017,27106,27132,26,0.096,164,-138,48,463,H1
"Val Verde County, TX",2000-2001,45020,45144,124,0.275,536,-412,48,465,H1
"Val Verde County, TX",2001-2002,45144,45495,351,0.778,539,-188,48,465,H1
"Val Verde County, TX",2002-2003,45495,46184,689,1.514,669,20,48,465,H1
"Val Verde County, TX",2003-2004,46184,46941,757,1.639,681,76,48,465,H1
"Val Verde County, TX",2004-2005,46941,47108,167,0.356,672,-505,48,465,H1
"Val Verde County, TX",2005-2006,47108,47401,293,0.622,612,-319,48,465,H1
"Val Verde County, TX",2006-2007,47401,47676,275,0.58,606,-331,48,465,H1
"Val Verde County, TX",2007-2008,47676,47882,206,0.432,687,-481,48,465,H1
"Val Verde County, TX",2008-2009,47882,48463,581,1.213,585,-4,48,465,H1
"Val Verde County, TX",2009-2010,48463,49008,545,1.125,547,-2,48,465,H1
"Val Verde County, TX",2010-2011,49008,49001,-7,-0.014,549,-556,48,465,H1
"Val Verde County, TX",2011-2012,49001,48953,-48,-0.098,539,-587,48,465,H1
"Val Verde County, TX",2012-2013,48953,49059,106,0.217,499,-393,48,465,H1
"Val Verde County, TX",2013-2014,49059,48974,-85,-0.173,518,-603,48,465,H1
"Val Verde County, TX",2014-2015,48916,48988,72,0.147,545,-473,48,465,H1
"Val Verde County, TX",2015-2016,48988,48953,-35,-0.071,533,-568,48,465,H1
"Val Verde County, TX",2016-2017,48953,49205,252,0.515,525,-273,48,465,H1
"Van Zandt County, TX",2000-2001,48324,48932,608,1.258,82,526,48,467,H1
"Van Zandt County, TX",2001-2002,48932,49953,1021,2.087,8,1013,48,467,H1
"Van Zandt County, TX",2002-2003,49953,50293,340,0.681,36,304,48,467,H1
"Van Zandt County, TX",2003-2004,50293,51366,1073,2.133,46,1027,48,467,H1
"Van Zandt County, TX",2004-2005,51366,51579,213,0.415,-22,235,48,467,H1
"Van Zandt County, TX",2005-2006,51579,52194,615,1.192,86,529,48,467,H1
"Van Zandt County, TX",2006-2007,52194,52151,-43,-0.082,7,-50,48,467,H1
"Van Zandt County, TX",2007-2008,52151,52470,319,0.612,6,313,48,467,H1
"Van Zandt County, TX",2008-2009,52470,52359,-111,-0.212,48,-159,48,467,H1
"Van Zandt County, TX",2009-2010,52359,52656,297,0.567,6,291,48,467,H1
"Van Zandt County, TX",2010-2011,52656,52644,-12,-0.023,-97,85,48,467,H1
"Van Zandt County, TX",2011-2012,52644,52355,-289,-0.549,-77,-212,48,467,H1
"Van Zandt County, TX",2012-2013,52355,52462,107,0.204,-15,122,48,467,H1
"Van Zandt County, TX",2013-2014,52462,52910,448,0.854,-27,475,48,467,H1
"Van Zandt County, TX",2014-2015,52839,53547,708,1.34,-4,712,48,467,H1
"Van Zandt County, TX",2015-2016,53547,54377,830,1.55,14,816,48,467,H1
"Van Zandt County, TX",2016-2017,54377,55182,805,1.48,-16,821,48,467,H1
"Victoria County, TX",2000-2001,83937,84491,554,0.66,691,-137,48,469,H1
"Victoria County, TX",2001-2002,84491,84573,82,0.097,676,-594,48,469,H1
"Victoria County, TX",2002-2003,84573,84674,101,0.119,662,-561,48,469,H1
"Victoria County, TX",2003-2004,84674,84718,44,0.052,632,-588,48,469,H1
"Victoria County, TX",2004-2005,84718,84453,-265,-0.313,609,-874,48,469,H1
"Victoria County, TX",2005-2006,84453,84528,75,0.089,622,-547,48,469,H1
"Victoria County, TX",2006-2007,84528,85261,733,0.867,670,63,48,469,H1
"Victoria County, TX",2007-2008,85261,85762,501,0.588,717,-216,48,469,H1
"Victoria County, TX",2008-2009,85762,86635,873,1.018,625,248,48,469,H1
"Victoria County, TX",2009-2010,86635,86849,214,0.247,632,-418,48,469,H1
"Victoria County, TX",2010-2011,86849,87444,595,0.685,543,52,48,469,H1
"Victoria County, TX",2011-2012,87444,89276,1832,2.095,487,1345,48,469,H1
"Victoria County, TX",2012-2013,89276,90123,847,0.949,529,318,48,469,H1
"Victoria County, TX",2013-2014,90123,91081,958,1.063,549,409,48,469,H1
"Victoria County, TX",2014-2015,91217,92382,1165,1.277,597,568,48,469,H1
"Victoria County, TX",2015-2016,92382,92379,-3,-0.003,491,-494,48,469,H1
"Victoria County, TX",2016-2017,92379,92084,-295,-0.319,485,-780,48,469,H1
"Walker County, TX",2000-2001,61768,62444,676,1.094,195,481,48,471,H1
"Walker County, TX",2001-2002,62444,62216,-228,-0.365,156,-384,48,471,H1
"Walker County, TX",2002-2003,62216,63609,1393,2.239,215,1178,48,471,H1
"Walker County, TX",2003-2004,63609,64551,942,1.481,167,775,48,471,H1
"Walker County, TX",2004-2005,64551,65676,1125,1.743,237,888,48,471,H1
"Walker County, TX",2005-2006,65676,65591,-85,-0.129,183,-268,48,471,H1
"Walker County, TX",2006-2007,65591,65517,-74,-0.113,214,-288,48,471,H1
"Walker County, TX",2007-2008,65517,65726,209,0.319,180,29,48,471,H1
"Walker County, TX",2008-2009,65726,66748,1022,1.555,187,835,48,471,H1
"Walker County, TX",2009-2010,66748,68219,1471,2.204,239,1232,48,471,H1
"Walker County, TX",2010-2011,68219,68296,77,0.113,121,-44,48,471,H1
"Walker County, TX",2011-2012,68296,68656,360,0.527,69,291,48,471,H1
"Walker County, TX",2012-2013,68656,69452,796,1.159,137,659,48,471,H1
"Walker County, TX",2013-2014,69452,69789,337,0.485,66,271,48,471,H1
"Walker County, TX",2014-2015,69798,70699,901,1.291,87,814,48,471,H1
"Walker County, TX",2015-2016,70699,71701,1002,1.417,133,869,48,471,H1
"Walker County, TX",2016-2017,71701,72245,544,0.759,83,461,48,471,H1
"Waller County, TX",2000-2001,32843,33747,904,2.752,266,638,48,473,H1
"Waller County, TX",2001-2002,33747,35060,1313,3.891,261,1052,48,473,H1
"Waller County, TX",2002-2003,35060,36333,1273,3.631,289,984,48,473,H1
"Waller County, TX",2003-2004,36333,36850,517,1.423,230,287,48,473,H1
"Waller County, TX",2004-2005,36850,37242,392,1.064,273,119,48,473,H1
"Waller County, TX",2005-2006,37242,38260,1018,2.733,301,717,48,473,H1
"Waller County, TX",2006-2007,38260,39809,1549,4.049,361,1188,48,473,H1
"Waller County, TX",2007-2008,39809,40578,769,1.932,345,424,48,473,H1
"Waller County, TX",2008-2009,40578,42087,1509,3.719,312,1197,48,473,H1
"Waller County, TX",2009-2010,42087,43441,1354,3.217,279,1075,48,473,H1
"Waller County, TX",2010-2011,43441,44028,587,1.351,280,307,48,473,H1
"Waller County, TX",2011-2012,44028,44353,325,0.738,306,19,48,473,H1
"Waller County, TX",2012-2013,44353,45484,1131,2.55,292,839,48,473,H1
"Waller County, TX",2013-2014,45484,46820,1336,2.937,300,1036,48,473,H1
"Waller County, TX",2014-2015,46798,48656,1858,3.97,338,1520,48,473,H1
"Waller County, TX",2015-2016,48656,50058,1402,2.881,294,1108,48,473,H1
"Waller County, TX",2016-2017,50058,51307,1249,2.495,348,901,48,473,H1
"Ward County, TX",2000-2001,10808,10459,-349,-3.229,51,-400,48,475,H1
"Ward County, TX",2001-2002,10459,10337,-122,-1.166,41,-163,48,475,H1
"Ward County, TX",2002-2003,10337,10237,-100,-0.967,57,-157,48,475,H1
"Ward County, TX",2003-2004,10237,10189,-48,-0.469,34,-82,48,475,H1
"Ward County, TX",2004-2005,10189,10232,43,0.422,64,-21,48,475,H1
"Ward County, TX",2005-2006,10232,10301,69,0.674,40,29,48,475,H1
"Ward County, TX",2006-2007,10301,10275,-26,-0.252,44,-70,48,475,H1
"Ward County, TX",2007-2008,10275,10588,313,3.046,78,235,48,475,H1
"Ward County, TX",2008-2009,10588,10734,146,1.379,104,42,48,475,H1
"Ward County, TX",2009-2010,10734,10612,-122,-1.137,99,-221,48,475,H1
"Ward County, TX",2010-2011,10612,10696,84,0.792,37,47,48,475,H1
"Ward County, TX",2011-2012,10696,10876,180,1.683,48,132,48,475,H1
"Ward County, TX",2012-2013,10876,11245,369,3.393,83,286,48,475,H1
"Ward County, TX",2013-2014,11245,11625,380,3.379,104,276,48,475,H1
"Ward County, TX",2014-2015,11613,11721,108,0.93,139,-31,48,475,H1
"Ward County, TX",2015-2016,11721,11589,-132,-1.126,64,-196,48,475,H1
"Ward County, TX",2016-2017,11589,11472,-117,-1.01,90,-207,48,475,H1
"Washington County, TX",2000-2001,30423,30433,10,0.033,80,-70,48,477,H1
"Washington County, TX",2001-2002,30433,30741,308,1.012,26,282,48,477,H1
"Washington County, TX",2002-2003,30741,30995,254,0.826,64,190,48,477,H1
"Washington County, TX",2003-2004,30995,31330,335,1.081,51,284,48,477,H1
"Washington County, TX",2004-2005,31330,31710,380,1.213,70,310,48,477,H1
"Washington County, TX",2005-2006,31710,32199,489,1.542,76,413,48,477,H1
"Washington County, TX",2006-2007,32199,32434,235,0.73,76,159,48,477,H1
"Washington County, TX",2007-2008,32434,32869,435,1.341,83,352,48,477,H1
"Washington County, TX",2008-2009,32869,33459,590,1.795,86,504,48,477,H1
"Washington County, TX",2009-2010,33459,33749,290,0.867,72,218,48,477,H1
"Washington County, TX",2010-2011,33749,33972,223,0.661,64,159,48,477,H1
"Washington County, TX",2011-2012,33972,33866,-106,-0.312,-1,-105,48,477,H1
"Washington County, TX",2012-2013,33866,34169,303,0.895,67,236,48,477,H1
"Washington County, TX",2013-2014,34169,34438,269,0.787,45,224,48,477,H1
"Washington County, TX",2014-2015,34413,34765,352,1.023,55,297,48,477,H1
"Washington County, TX",2015-2016,34765,34821,56,0.161,51,5,48,477,H1
"Washington County, TX",2016-2017,34821,35043,222,0.638,45,177,48,477,H1
"Webb County, TX",2000-2001,194576,200347,5771,2.966,4827,944,48,479,H1
"Webb County, TX",2001-2002,200347,206001,5654,2.822,4913,741,48,479,H1
"Webb County, TX",2002-2003,206001,211786,5785,2.808,4957,828,48,479,H1
"Webb County, TX",2003-2004,211786,217858,6072,2.867,5027,1045,48,479,H1
"Webb County, TX",2004-2005,217858,223703,5845,2.683,5052,793,48,479,H1
"Webb County, TX",2005-2006,223703,229307,5604,2.505,4873,731,48,479,H1
"Webb County, TX",2006-2007,229307,234594,5287,2.306,5029,258,48,479,H1
"Webb County, TX",2007-2008,234594,240287,5693,2.427,4995,698,48,479,H1
"Webb County, TX",2008-2009,240287,245908,5621,2.339,5006,615,48,479,H1
"Webb County, TX",2009-2010,245908,251308,5400,2.196,4756,644,48,479,H1
"Webb County, TX",2010-2011,251308,255618,4310,1.715,4326,-16,48,479,H1
"Webb County, TX",2011-2012,255618,259986,4368,1.709,4184,184,48,479,H1
"Webb County, TX",2012-2013,259986,263772,3786,1.456,4227,-441,48,479,H1
"Webb County, TX",2013-2014,263772,266673,2901,1.1,4246,-1345,48,479,H1
"Webb County, TX",2014-2015,267018,269721,2703,1.012,4371,-1668,48,479,H1
"Webb County, TX",2015-2016,269721,272401,2680,0.994,3955,-1275,48,479,H1
"Webb County, TX",2016-2017,272401,274794,2393,0.878,3895,-1502,48,479,H1
"Wharton County, TX",2000-2001,41220,40991,-229,-0.556,215,-444,48,481,H1
"Wharton County, TX",2001-2002,40991,40915,-76,-0.185,163,-239,48,481,H1
"Wharton County, TX",2002-2003,40915,41026,111,0.271,264,-153,48,481,H1
"Wharton County, TX",2003-2004,41026,40992,-34,-0.083,193,-227,48,481,H1
"Wharton County, TX",2004-2005,40992,40987,-5,-0.012,279,-284,48,481,H1
"Wharton County, TX",2005-2006,40987,41073,86,0.21,233,-147,48,481,H1
"Wharton County, TX",2006-2007,41073,40845,-228,-0.555,272,-500,48,481,H1
"Wharton County, TX",2007-2008,40845,40893,48,0.118,274,-226,48,481,H1
"Wharton County, TX",2008-2009,40893,40998,105,0.257,272,-167,48,481,H1
"Wharton County, TX",2009-2010,40998,41316,318,0.776,255,63,48,481,H1
"Wharton County, TX",2010-2011,41316,41250,-66,-0.16,157,-223,48,481,H1
"Wharton County, TX",2011-2012,41250,41147,-103,-0.25,139,-242,48,481,H1
"Wharton County, TX",2012-2013,41147,41215,68,0.165,115,-47,48,481,H1
"Wharton County, TX",2013-2014,41215,41168,-47,-0.114,135,-182,48,481,H1
"Wharton County, TX",2014-2015,41197,41486,289,0.702,161,128,48,481,H1
"Wharton County, TX",2015-2016,41486,41634,148,0.357,184,-36,48,481,H1
"Wharton County, TX",2016-2017,41634,41968,334,0.802,175,159,48,481,H1
"Wheeler County, TX",2000-2001,5253,5170,-83,-1.58,-43,-40,48,483,H1
"Wheeler County, TX",2001-2002,5170,5094,-76,-1.47,-17,-59,48,483,H1
"Wheeler County, TX",2002-2003,5094,4926,-168,-3.298,-28,-140,48,483,H1
"Wheeler County, TX",2003-2004,4926,4934,8,0.162,-19,27,48,483,H1
"Wheeler County, TX",2004-2005,4934,4945,11,0.223,-10,21,48,483,H1
"Wheeler County, TX",2005-2006,4945,5055,110,2.224,-13,123,48,483,H1
"Wheeler County, TX",2006-2007,5055,5138,83,1.642,3,80,48,483,H1
"Wheeler County, TX",2007-2008,5138,5199,61,1.187,30,31,48,483,H1
"Wheeler County, TX",2008-2009,5199,5375,176,3.385,15,161,48,483,H1
"Wheeler County, TX",2009-2010,5375,5407,32,0.595,7,25,48,483,H1
"Wheeler County, TX",2010-2011,5407,5467,60,1.11,15,45,48,483,H1
"Wheeler County, TX",2011-2012,5467,5607,140,2.561,1,139,48,483,H1
"Wheeler County, TX",2012-2013,5607,5740,133,2.372,9,124,48,483,H1
"Wheeler County, TX",2013-2014,5740,5714,-26,-0.453,14,-40,48,483,H1
"Wheeler County, TX",2014-2015,5678,5657,-21,-0.37,10,-31,48,483,H1
"Wheeler County, TX",2015-2016,5657,5548,-109,-1.927,36,-145,48,483,H1
"Wheeler County, TX",2016-2017,5548,5358,-190,-3.425,23,-213,48,483,H1
"Wichita County, TX",2000-2001,131817,130790,-1027,-0.779,535,-1562,48,485,H1
"Wichita County, TX",2001-2002,130790,130761,-29,-0.022,615,-644,48,485,H1
"Wichita County, TX",2002-2003,130761,130411,-350,-0.268,606,-956,48,485,H1
"Wichita County, TX",2003-2004,130411,131677,1266,0.971,673,593,48,485,H1
"Wichita County, TX",2004-2005,131677,130767,-910,-0.691,499,-1409,48,485,H1
"Wichita County, TX",2005-2006,130767,131376,609,0.466,676,-67,48,485,H1
"Wichita County, TX",2006-2007,131376,130564,-812,-0.618,591,-1403,48,485,H1
"Wichita County, TX",2007-2008,130564,130340,-224,-0.172,674,-898,48,485,H1
"Wichita County, TX",2008-2009,130340,130913,573,0.44,652,-79,48,485,H1
"Wichita County, TX",2009-2010,130913,131791,878,0.671,761,117,48,485,H1
"Wichita County, TX",2010-2011,131791,130820,-971,-0.737,465,-1436,48,485,H1
"Wichita County, TX",2011-2012,130820,131702,882,0.674,493,389,48,485,H1
"Wichita County, TX",2012-2013,131702,132343,641,0.487,474,167,48,485,H1
"Wichita County, TX",2013-2014,132343,132355,12,0.009,456,-444,48,485,H1
"Wichita County, TX",2014-2015,132955,131705,-1250,-0.94,476,-1726,48,485,H1
"Wichita County, TX",2015-2016,131705,131310,-395,-0.3,355,-750,48,485,H1
"Wichita County, TX",2016-2017,131310,1.32E+05,690,0.525,323,367,48,485,H1
"Wilbarger County, TX",2000-2001,14613,14299,-314,-2.149,-5,-309,48,487,H1
"Wilbarger County, TX",2001-2002,14299,14248,-51,-0.357,41,-92,48,487,H1
"Wilbarger County, TX",2002-2003,14248,14023,-225,-1.579,4,-229,48,487,H1
"Wilbarger County, TX",2003-2004,14023,13879,-144,-1.027,28,-172,48,487,H1
"Wilbarger County, TX",2004-2005,13879,13830,-49,-0.353,49,-98,48,487,H1
"Wilbarger County, TX",2005-2006,13830,13835,5,0.036,44,-39,48,487,H1
"Wilbarger County, TX",2006-2007,13835,13746,-89,-0.643,24,-113,48,487,H1
"Wilbarger County, TX",2007-2008,13746,13506,-240,-1.746,29,-269,48,487,H1
"Wilbarger County, TX",2008-2009,13506,13575,69,0.511,72,-3,48,487,H1
"Wilbarger County, TX",2009-2010,13575,13505,-70,-0.516,91,-161,48,487,H1
"Wilbarger County, TX",2010-2011,13505,13431,-74,-0.548,19,-93,48,487,H1
"Wilbarger County, TX",2011-2012,13431,13262,-169,-1.258,42,-211,48,487,H1
"Wilbarger County, TX",2012-2013,13262,13154,-108,-0.814,-6,-102,48,487,H1
"Wilbarger County, TX",2013-2014,13154,12973,-181,-1.376,41,-222,48,487,H1
"Wilbarger County, TX",2014-2015,12944,13027,83,0.641,26,57,48,487,H1
"Wilbarger County, TX",2015-2016,13027,12894,-133,-1.021,29,-162,48,487,H1
"Wilbarger County, TX",2016-2017,12894,12764,-130,-1.008,24,-154,48,487,H1
"Willacy County, TX",2000-2001,20076,20016,-60,-0.299,310,-370,48,489,H1
"Willacy County, TX",2001-2002,20016,20198,182,0.909,271,-89,48,489,H1
"Willacy County, TX",2002-2003,20198,20418,220,1.089,282,-62,48,489,H1
"Willacy County, TX",2003-2004,20418,20767,349,1.709,287,62,48,489,H1
"Willacy County, TX",2004-2005,20767,21229,462,2.225,279,183,48,489,H1
"Willacy County, TX",2005-2006,21229,21463,234,1.102,227,7,48,489,H1
"Willacy County, TX",2006-2007,21463,21576,113,0.526,279,-166,48,489,H1
"Willacy County, TX",2007-2008,21576,21763,187,0.867,261,-74,48,489,H1
"Willacy County, TX",2008-2009,21763,21862,99,0.455,282,-183,48,489,H1
"Willacy County, TX",2009-2010,21862,22202,340,1.555,259,81,48,489,H1
"Willacy County, TX",2010-2011,22202,22114,-88,-0.396,178,-266,48,489,H1
"Willacy County, TX",2011-2012,22114,22107,-7,-0.032,152,-159,48,489,H1
"Willacy County, TX",2012-2013,22107,21953,-154,-0.697,154,-308,48,489,H1
"Willacy County, TX",2013-2014,21953,21903,-50,-0.228,145,-195,48,489,H1
"Willacy County, TX",2014-2015,21917,21903,-14,-0.064,149,-163,48,489,H1
"Willacy County, TX",2015-2016,21903,21760,-143,-0.653,107,-250,48,489,H1
"Willacy County, TX",2016-2017,21760,21584,-176,-0.809,103,-279,48,489,H1
"Williamson County, TX",2000-2001,255379,276940,21561,8.443,3508,18053,48,491,H1
"Williamson County, TX",2001-2002,276940,290112,13172,4.756,3697,9475,48,491,H1
"Williamson County, TX",2002-2003,290112,302895,12783,4.406,3710,9073,48,491,H1
"Williamson County, TX",2003-2004,302895,316532,13637,4.502,3772,9865,48,491,H1
"Williamson County, TX",2004-2005,316532,332169,15637,4.94,4152,11485,48,491,H1
"Williamson County, TX",2005-2006,332169,351970,19801,5.961,4090,15711,48,491,H1
"Williamson County, TX",2006-2007,351970,373723,21753,6.18,4392,17361,48,491,H1
"Williamson County, TX",2007-2008,373723,395437,21714,5.81,4814,16900,48,491,H1
"Williamson County, TX",2008-2009,395437,410800,15363,3.885,4779,10584,48,491,H1
"Williamson County, TX",2009-2010,410800,426541,15741,3.832,4440,11301,48,491,H1
"Williamson County, TX",2010-2011,426541,442482,15941,3.737,4169,11772,48,491,H1
"Williamson County, TX",2011-2012,442482,456593,14111,3.189,3921,10190,48,491,H1
"Williamson County, TX",2012-2013,456593,471225,14632,3.205,3943,10689,48,491,H1
"Williamson County, TX",2013-2014,471225,489250,18025,3.825,3964,14061,48,491,H1
"Williamson County, TX",2014-2015,489428,508514,19086,3.9,4022,15064,48,491,H1
"Williamson County, TX",2015-2016,508514,527769,19255,3.787,3758,15497,48,491,H1
"Williamson County, TX",2016-2017,527769,547545,19776,3.747,3963,15813,48,491,H1
"Wilson County, TX",2000-2001,32721,33408,687,2.1,176,511,48,493,H1
"Wilson County, TX",2001-2002,33408,34254,846,2.532,169,677,48,493,H1
"Wilson County, TX",2002-2003,34254,35458,1204,3.515,188,1016,48,493,H1
"Wilson County, TX",2003-2004,35458,36721,1263,3.562,116,1147,48,493,H1
"Wilson County, TX",2004-2005,36721,37706,985,2.682,169,816,48,493,H1
"Wilson County, TX",2005-2006,37706,39007,1301,3.45,147,1154,48,493,H1
"Wilson County, TX",2006-2007,39007,40354,1347,3.453,162,1185,48,493,H1
"Wilson County, TX",2007-2008,40354,41657,1303,3.229,217,1086,48,493,H1
"Wilson County, TX",2008-2009,41657,42181,524,1.258,222,302,48,493,H1
"Wilson County, TX",2009-2010,42181,43074,893,2.117,105,788,48,493,H1
"Wilson County, TX",2010-2011,43074,43697,623,1.446,98,525,48,493,H1
"Wilson County, TX",2011-2012,43697,44432,735,1.682,205,530,48,493,H1
"Wilson County, TX",2012-2013,44432,45438,1006,2.264,143,863,48,493,H1
"Wilson County, TX",2013-2014,45438,46402,964,2.122,172,792,48,493,H1
"Wilson County, TX",2014-2015,46440,47520,1080,2.326,172,908,48,493,H1
"Wilson County, TX",2015-2016,47520,48190,670,1.41,189,481,48,493,H1
"Wilson County, TX",2016-2017,48190,49304,1114,2.312,187,927,48,493,H1
"Winkler County, TX",2000-2001,7083,7056,-27,-0.381,47,-74,48,495,H1
"Winkler County, TX",2001-2002,7056,6960,-96,-1.361,7,-103,48,495,H1
"Winkler County, TX",2002-2003,6960,6738,-222,-3.19,31,-253,48,495,H1
"Winkler County, TX",2003-2004,6738,6735,-3,-0.045,42,-45,48,495,H1
"Winkler County, TX",2004-2005,6735,6578,-157,-2.331,10,-167,48,495,H1
"Winkler County, TX",2005-2006,6578,6642,64,0.973,26,38,48,495,H1
"Winkler County, TX",2006-2007,6642,6775,133,2.002,28,105,48,495,H1
"Winkler County, TX",2007-2008,6775,7024,249,3.675,79,170,48,495,H1
"Winkler County, TX",2008-2009,7024,7128,104,1.481,75,29,48,495,H1
"Winkler County, TX",2009-2010,7128,7084,-44,-0.617,73,-117,48,495,H1
"Winkler County, TX",2010-2011,7084,7146,62,0.875,51,11,48,495,H1
"Winkler County, TX",2011-2012,7146,7344,198,2.771,36,162,48,495,H1
"Winkler County, TX",2012-2013,7344,7624,280,3.813,92,188,48,495,H1
"Winkler County, TX",2013-2014,7624,7821,197,2.584,104,93,48,495,H1
"Winkler County, TX",2014-2015,7798,8005,207,2.655,98,109,48,495,H1
"Winkler County, TX",2015-2016,8005,7872,-133,-1.661,78,-211,48,495,H1
"Winkler County, TX",2016-2017,7872,7574,-298,-3.786,72,-370,48,495,H1
"Wise County, TX",2000-2001,49373,50927,1554,3.147,299,1255,48,497,H1
"Wise County, TX",2001-2002,50927,52381,1454,2.855,258,1196,48,497,H1
"Wise County, TX",2002-2003,52381,53691,1310,2.501,243,1067,48,497,H1
"Wise County, TX",2003-2004,53691,54497,806,1.501,237,569,48,497,H1
"Wise County, TX",2004-2005,54497,55613,1116,2.048,272,844,48,497,H1
"Wise County, TX",2005-2006,55613,56569,956,1.719,308,648,48,497,H1
"Wise County, TX",2006-2007,56569,57247,678,1.199,338,340,48,497,H1
"Wise County, TX",2007-2008,57247,58181,934,1.632,311,623,48,497,H1
"Wise County, TX",2008-2009,58181,59134,953,1.638,281,672,48,497,H1
"Wise County, TX",2009-2010,59134,59102,-32,-0.054,210,-242,48,497,H1
"Wise County, TX",2010-2011,59102,59936,834,1.411,332,502,48,497,H1
"Wise County, TX",2011-2012,59936,60387,451,0.752,206,245,48,497,H1
"Wise County, TX",2012-2013,60387,61003,616,1.02,302,314,48,497,H1
"Wise County, TX",2013-2014,61003,61638,635,1.041,259,376,48,497,H1
"Wise County, TX",2014-2015,61813,62953,1140,1.844,243,897,48,497,H1
"Wise County, TX",2015-2016,62953,64465,1512,2.402,159,1353,48,497,H1
"Wise County, TX",2016-2017,64465,66181,1716,2.662,204,1512,48,497,H1
"Wood County, TX",2000-2001,36811,37288,477,1.296,-72,549,48,499,H1
"Wood County, TX",2001-2002,37288,37633,345,0.925,-105,450,48,499,H1
"Wood County, TX",2002-2003,37633,38915,1282,3.407,-105,1387,48,499,H1
"Wood County, TX",2003-2004,38915,39600,685,1.76,-76,761,48,499,H1
"Wood County, TX",2004-2005,39600,39917,317,0.801,-68,385,48,499,H1
"Wood County, TX",2005-2006,39917,41099,1182,2.961,-45,1227,48,499,H1
"Wood County, TX",2006-2007,41099,41414,315,0.766,-77,392,48,499,H1
"Wood County, TX",2007-2008,41414,41722,308,0.744,-108,416,48,499,H1
"Wood County, TX",2008-2009,41722,41870,148,0.355,-116,264,48,499,H1
"Wood County, TX",2009-2010,41870,42031,161,0.385,-123,284,48,499,H1
"Wood County, TX",2010-2011,42031,42177,146,0.347,-133,279,48,499,H1
"Wood County, TX",2011-2012,42177,42525,348,0.825,-205,553,48,499,H1
"Wood County, TX",2012-2013,42525,42570,45,0.106,-203,248,48,499,H1
"Wood County, TX",2013-2014,42570,42852,282,0.662,-182,464,48,499,H1
"Wood County, TX",2014-2015,42985,43356,371,0.863,-183,554,48,499,H1
"Wood County, TX",2015-2016,43356,43823,467,1.077,-210,677,48,499,H1
"Wood County, TX",2016-2017,43823,44314,491,1.12,-212,703,48,499,H1
"Yoakum County, TX",2000-2001,7274,7299,25,0.344,81,-56,48,501,H1
"Yoakum County, TX",2001-2002,7299,7212,-87,-1.192,55,-142,48,501,H1
"Yoakum County, TX",2002-2003,7212,7235,23,0.319,63,-40,48,501,H1
"Yoakum County, TX",2003-2004,7235,7362,127,1.755,75,52,48,501,H1
"Yoakum County, TX",2004-2005,7362,7404,42,0.57,85,-43,48,501,H1
"Yoakum County, TX",2005-2006,7404,7404,0,0,67,-67,48,501,H1
"Yoakum County, TX",2006-2007,7404,7588,184,2.485,93,91,48,501,H1
"Yoakum County, TX",2007-2008,7588,7765,177,2.333,110,67,48,501,H1
"Yoakum County, TX",2008-2009,7765,7908,143,1.842,94,49,48,501,H1
"Yoakum County, TX",2009-2010,7908,7835,-73,-0.923,86,-159,48,501,H1
"Yoakum County, TX",2010-2011,7835,7971,136,1.736,68,68,48,501,H1
"Yoakum County, TX",2011-2012,7971,8018,47,0.59,62,-15,48,501,H1
"Yoakum County, TX",2012-2013,8018,8160,142,1.771,122,20,48,501,H1
"Yoakum County, TX",2013-2014,8160,8286,126,1.544,110,16,48,501,H1
"Yoakum County, TX",2014-2015,8326,8546,220,2.642,152,68,48,501,H1
"Yoakum County, TX",2015-2016,8546,8625,79,0.924,113,-34,48,501,H1
"Yoakum County, TX",2016-2017,8625,8568,-57,-0.661,111,-168,48,501,H1
"Young County, TX",2000-2001,17846,17659,-187,-1.048,-34,-153,48,503,H1
"Young County, TX",2001-2002,17659,17665,6,0.034,-38,44,48,503,H1
"Young County, TX",2002-2003,17665,17892,227,1.285,-20,247,48,503,H1
"Young County, TX",2003-2004,17892,17921,29,0.162,-8,37,48,503,H1
"Young County, TX",2004-2005,17921,17801,-120,-0.67,-49,-71,48,503,H1
"Young County, TX",2005-2006,17801,18227,426,2.393,-6,432,48,503,H1
"Young County, TX",2006-2007,18227,18135,-92,-0.505,-37,-55,48,503,H1
"Young County, TX",2007-2008,18135,18104,-31,-0.171,-32,1,48,503,H1
"Young County, TX",2008-2009,18104,18466,362,2,-9,371,48,503,H1
"Young County, TX",2009-2010,18466,18529,63,0.341,7,56,48,503,H1
"Young County, TX",2010-2011,18529,18344,-185,-0.998,-21,-164,48,503,H1
"Young County, TX",2011-2012,18344,18290,-54,-0.294,-19,-35,48,503,H1
"Young County, TX",2012-2013,18290,18356,66,0.361,-5,71,48,503,H1
"Young County, TX",2013-2014,18356,18350,-6,-0.033,-1,-5,48,503,H1
"Young County, TX",2014-2015,18340,18270,-70,-0.382,4,-74,48,503,H1
"Young County, TX",2015-2016,18270,18079,-191,-1.045,-35,-156,48,503,H1
"Young County, TX",2016-2017,18079,17979,-100,-0.553,-27,-73,48,503,H1
"Zapata County, TX",2000-2001,12088,12266,178,1.473,152,26,48,505,H1
"Zapata County, TX",2001-2002,12266,12514,248,2.022,208,40,48,505,H1
"Zapata County, TX",2002-2003,12514,12584,70,0.559,158,-88,48,505,H1
"Zapata County, TX",2003-2004,12584,12727,143,1.136,233,-90,48,505,H1
"Zapata County, TX",2004-2005,12727,13043,316,2.483,227,89,48,505,H1
"Zapata County, TX",2005-2006,13043,13069,26,0.199,219,-193,48,505,H1
"Zapata County, TX",2006-2007,13069,13388,319,2.441,241,78,48,505,H1
"Zapata County, TX",2007-2008,13388,13640,252,1.882,266,-14,48,505,H1
"Zapata County, TX",2008-2009,13640,13876,236,1.73,217,19,48,505,H1
"Zapata County, TX",2009-2010,13876,14056,180,1.297,207,-27,48,505,H1
"Zapata County, TX",2010-2011,14056,14192,136,0.968,238,-102,48,505,H1
"Zapata County, TX",2011-2012,14192,14232,40,0.282,193,-153,48,505,H1
"Zapata County, TX",2012-2013,14232,14356,124,0.871,202,-78,48,505,H1
"Zapata County, TX",2013-2014,14356,14319,-37,-0.258,177,-214,48,505,H1
"Zapata County, TX",2014-2015,14333,14374,41,0.286,165,-124,48,505,H1
"Zapata County, TX",2015-2016,14374,14449,75,0.522,147,-72,48,505,H1
"Zapata County, TX",2016-2017,14449,14322,-127,-0.879,155,-282,48,505,H1
"Zavala County, TX",2000-2001,11636,11596,-40,-0.344,129,-169,48,507,H1
"Zavala County, TX",2001-2002,11596,11616,20,0.172,105,-85,48,507,H1
"Zavala County, TX",2002-2003,11616,11513,-103,-0.887,116,-219,48,507,H1
"Zavala County, TX",2003-2004,11513,11512,-1,-0.009,115,-116,48,507,H1
"Zavala County, TX",2004-2005,11512,11565,53,0.46,158,-105,48,507,H1
"Zavala County, TX",2005-2006,11565,11642,77,0.666,113,-36,48,507,H1
"Zavala County, TX",2006-2007,11642,11657,15,0.129,140,-125,48,507,H1
"Zavala County, TX",2007-2008,11657,11725,68,0.583,164,-96,48,507,H1
"Zavala County, TX",2008-2009,11725,11544,-181,-1.544,144,-325,48,507,H1
"Zavala County, TX",2009-2010,11544,11730,186,1.611,120,66,48,507,H1
"Zavala County, TX",2010-2011,11730,11861,131,1.117,132,-1,48,507,H1
"Zavala County, TX",2011-2012,11861,11996,135,1.138,109,26,48,507,H1
"Zavala County, TX",2012-2013,11996,12211,215,1.792,121,94,48,507,H1
"Zavala County, TX",2013-2014,12211,12267,56,0.459,130,-74,48,507,H1
"Zavala County, TX",2014-2015,12170,12235,65,0.534,129,-64,48,507,H1
"Zavala County, TX",2015-2016,12235,12091,-144,-1.177,63,-207,48,507,H1
"Zavala County, TX",2016-2017,12091,11948,-143,-1.183,82,-225,48,507,H1
Utah,2000-2001,2244502,2283715,39213,1.747,35182,4031,49,0,STATE
Utah,2001-2002,2283715,2324815,41100,1.8,35206,5894,49,0,STATE
Utah,2002-2003,2324815,2360137,35322,1.519,36635,-1313,49,0,STATE
Utah,2003-2004,2360137,2401580,41443,1.756,37203,4240,49,0,STATE
Utah,2004-2005,2401580,2457719,56139,2.338,37482,18657,49,0,STATE
Utah,2005-2006,2457719,2525507,67788,2.758,39245,28543,49,0,STATE
Utah,2006-2007,2525507,2597746,72239,2.86,40668,31571,49,0,STATE
Utah,2007-2008,2597746,2663029,65283,2.513,41714,23569,49,0,STATE
Utah,2008-2009,2663029,2723421,60392,2.268,42558,17834,49,0,STATE
Utah,2009-2010,2723421,2775426,52005,1.91,41627,10378,49,0,STATE
Utah,2010-2011,2775426,2816440,41014,1.478,36913,4101,49,0,STATE
Utah,2011-2012,2816440,2856343,39903,1.417,34974,4929,49,0,STATE
Utah,2012-2013,2856343,2903685,47342,1.657,35582,11760,49,0,STATE
Utah,2013-2014,2903685,2944498,40813,1.406,35100,5713,49,0,STATE
Utah,2014-2015,2944498,2995919,51421,1.746,35934,15487,49,0,STATE
Utah,2015-2016,2995919,3044321,48402,1.616,34149,14253,49,0,STATE
Utah,2016-2017,3044321,3101833,57512,1.889,34886,22626,49,0,STATE
"Beaver County, UT",2000-2001,5998,5999,1,0.017,68,-67,49,1,H1
"Beaver County, UT",2001-2002,5999,6058,59,0.983,68,-9,49,1,H1
"Beaver County, UT",2002-2003,6058,6039,-19,-0.314,61,-80,49,1,H1
"Beaver County, UT",2003-2004,6039,6077,38,0.629,65,-27,49,1,H1
"Beaver County, UT",2004-2005,6077,6192,115,1.892,70,45,49,1,H1
"Beaver County, UT",2005-2006,6192,6281,89,1.437,28,61,49,1,H1
"Beaver County, UT",2006-2007,6281,6266,-15,-0.239,34,-49,49,1,H1
"Beaver County, UT",2007-2008,6266,6413,147,2.346,95,52,49,1,H1
"Beaver County, UT",2008-2009,6413,6552,139,2.167,78,61,49,1,H1
"Beaver County, UT",2009-2010,6552,6640,88,1.343,67,21,49,1,H1
"Beaver County, UT",2010-2011,6640,6521,-119,-1.792,68,-187,49,1,H1
"Beaver County, UT",2011-2012,6521,6486,-35,-0.537,70,-105,49,1,H1
"Beaver County, UT",2012-2013,6486,6462,-24,-0.37,63,-87,49,1,H1
"Beaver County, UT",2013-2014,6462,6461,-1,-0.015,66,-67,49,1,H1
"Beaver County, UT",2014-2015,6454,6354,-100,-1.549,54,-154,49,1,H1
"Beaver County, UT",2015-2016,6354,6454,100,1.574,55,45,49,1,H1
"Beaver County, UT",2016-2017,6454,6386,-68,-1.054,65,-133,49,1,H1
"Box Elder County, UT",2000-2001,42882,43362,480,1.119,506,-26,49,3,H1
"Box Elder County, UT",2001-2002,43362,44038,676,1.559,492,184,49,3,H1
"Box Elder County, UT",2002-2003,44038,44548,510,1.158,496,14,49,3,H1
"Box Elder County, UT",2003-2004,44548,44666,118,0.265,482,-364,49,3,H1
"Box Elder County, UT",2004-2005,44666,45090,424,0.949,581,-157,49,3,H1
"Box Elder County, UT",2005-2006,45090,45948,858,1.903,635,223,49,3,H1
"Box Elder County, UT",2006-2007,45948,47193,1245,2.71,604,641,49,3,H1
"Box Elder County, UT",2007-2008,47193,48437,1244,2.636,664,580,49,3,H1
"Box Elder County, UT",2008-2009,48437,49372,935,1.93,684,251,49,3,H1
"Box Elder County, UT",2009-2010,49372,50153,781,1.582,568,213,49,3,H1
"Box Elder County, UT",2010-2011,50153,50262,109,0.217,578,-469,49,3,H1
"Box Elder County, UT",2011-2012,50262,50269,7,0.014,532,-525,49,3,H1
"Box Elder County, UT",2012-2013,50269,50864,595,1.184,495,100,49,3,H1
"Box Elder County, UT",2013-2014,50864,51518,654,1.286,543,111,49,3,H1
"Box Elder County, UT",2014-2015,51484,52097,613,1.191,525,88,49,3,H1
"Box Elder County, UT",2015-2016,52097,52974,877,1.683,557,320,49,3,H1
"Box Elder County, UT",2016-2017,52974,54079,1105,2.086,568,537,49,3,H1
"Cache County, UT",2000-2001,91861,92831,970,1.056,1765,-795,49,5,H1
"Cache County, UT",2001-2002,92831,95493,2662,2.868,1854,808,49,5,H1
"Cache County, UT",2002-2003,95493,97101,1608,1.684,1900,-292,49,5,H1
"Cache County, UT",2003-2004,97101,98854,1753,1.805,2039,-286,49,5,H1
"Cache County, UT",2004-2005,98854,100501,1647,1.666,2070,-423,49,5,H1
"Cache County, UT",2005-2006,100501,101236,735,0.731,2010,-1275,49,5,H1
"Cache County, UT",2006-2007,101236,103624,2388,2.359,1982,406,49,5,H1
"Cache County, UT",2007-2008,103624,106824,3200,3.088,2034,1166,49,5,H1
"Cache County, UT",2008-2009,106824,110291,3467,3.246,2266,1201,49,5,H1
"Cache County, UT",2009-2010,110291,113299,3008,2.727,2380,628,49,5,H1
"Cache County, UT",2010-2011,113299,114842,1543,1.362,2003,-460,49,5,H1
"Cache County, UT",2011-2012,114842,115958,1116,0.972,1860,-744,49,5,H1
"Cache County, UT",2012-2013,115958,117326,1368,1.18,1935,-567,49,5,H1
"Cache County, UT",2013-2014,117326,118343,1017,0.867,1874,-857,49,5,H1
"Cache County, UT",2014-2015,118340,120783,2443,2.064,1852,591,49,5,H1
"Cache County, UT",2015-2016,120783,122342,1559,1.291,1879,-320,49,5,H1
"Cache County, UT",2016-2017,122342,124438,2096,1.713,1906,190,49,5,H1
"Carbon County, UT",2000-2001,20491,19937,-554,-2.704,111,-665,49,7,H1
"Carbon County, UT",2001-2002,19937,20114,177,0.888,113,64,49,7,H1
"Carbon County, UT",2002-2003,20114,20146,32,0.159,77,-45,49,7,H1
"Carbon County, UT",2003-2004,20146,20026,-120,-0.596,124,-244,49,7,H1
"Carbon County, UT",2004-2005,20026,19870,-156,-0.779,108,-264,49,7,H1
"Carbon County, UT",2005-2006,19870,20072,202,1.017,98,104,49,7,H1
"Carbon County, UT",2006-2007,20072,20554,482,2.401,122,360,49,7,H1
"Carbon County, UT",2007-2008,20554,20596,42,0.204,106,-64,49,7,H1
"Carbon County, UT",2008-2009,20596,21143,547,2.656,113,434,49,7,H1
"Carbon County, UT",2009-2010,21143,21416,273,1.291,150,123,49,7,H1
"Carbon County, UT",2010-2011,21416,21328,-88,-0.411,107,-195,49,7,H1
"Carbon County, UT",2011-2012,21328,21254,-74,-0.347,139,-213,49,7,H1
"Carbon County, UT",2012-2013,21254,20931,-323,-1.52,70,-393,49,7,H1
"Carbon County, UT",2013-2014,20931,20660,-271,-1.295,107,-378,49,7,H1
"Carbon County, UT",2014-2015,20620,20479,-141,-0.684,104,-245,49,7,H1
"Carbon County, UT",2015-2016,20479,20371,-108,-0.527,98,-206,49,7,H1
"Carbon County, UT",2016-2017,20371,20295,-76,-0.373,113,-189,49,7,H1
"Daggett County, UT",2000-2001,926,929,3,0.324,11,-8,49,9,H1
"Daggett County, UT",2001-2002,929,907,-22,-2.368,4,-26,49,9,H1
"Daggett County, UT",2002-2003,907,914,7,0.772,7,0,49,9,H1
"Daggett County, UT",2003-2004,914,952,38,4.158,5,33,49,9,H1
"Daggett County, UT",2004-2005,952,967,15,1.576,4,11,49,9,H1
"Daggett County, UT",2005-2006,967,984,17,1.758,7,10,49,9,H1
"Daggett County, UT",2006-2007,984,974,-10,-1.016,9,-19,49,9,H1
"Daggett County, UT",2007-2008,974,993,19,1.951,5,14,49,9,H1
"Daggett County, UT",2008-2009,993,1037,44,4.431,10,34,49,9,H1
"Daggett County, UT",2009-2010,1037,1067,30,2.893,8,22,49,9,H1
"Daggett County, UT",2010-2011,1067,1158,91,8.529,6,85,49,9,H1
"Daggett County, UT",2011-2012,1158,1086,-72,-6.218,3,-75,49,9,H1
"Daggett County, UT",2012-2013,1086,1130,44,4.052,5,39,49,9,H1
"Daggett County, UT",2013-2014,1130,1117,-13,-1.15,10,-23,49,9,H1
"Daggett County, UT",2014-2015,1120,1109,-11,-0.982,7,-18,49,9,H1
"Daggett County, UT",2015-2016,1109,1081,-28,-2.525,0,-28,49,9,H1
"Daggett County, UT",2016-2017,1081,1029,-52,-4.81,2,-54,49,9,H1
"Davis County, UT",2000-2001,240422,244687,4265,1.774,3819,446,49,11,H1
"Davis County, UT",2001-2002,244687,249676,4989,2.039,3849,1140,49,11,H1
"Davis County, UT",2002-2003,249676,255582,5906,2.365,4091,1815,49,11,H1
"Davis County, UT",2003-2004,255582,262189,6607,2.585,4431,2176,49,11,H1
"Davis County, UT",2004-2005,262189,269208,7019,2.677,4306,2713,49,11,H1
"Davis County, UT",2005-2006,269208,278800,9592,3.563,4681,4911,49,11,H1
"Davis County, UT",2006-2007,278800,288236,9436,3.385,4789,4647,49,11,H1
"Davis County, UT",2007-2008,288236,295801,7565,2.625,4802,2763,49,11,H1
"Davis County, UT",2008-2009,295801,301965,6164,2.084,5069,1095,49,11,H1
"Davis County, UT",2009-2010,301965,307779,5814,1.925,4714,1100,49,11,H1
"Davis County, UT",2010-2011,307779,311986,4207,1.367,4275,-68,49,11,H1
"Davis County, UT",2011-2012,311986,316018,4032,1.292,4230,-198,49,11,H1
"Davis County, UT",2012-2013,316018,322754,6736,2.132,4342,2394,49,11,H1
"Davis County, UT",2013-2014,322754,329692,6938,2.15,4354,2584,49,11,H1
"Davis County, UT",2014-2015,329694,336043,6349,1.926,4365,1984,49,11,H1
"Davis County, UT",2015-2016,336043,341329,5286,1.573,4136,1150,49,11,H1
"Davis County, UT",2016-2017,341329,347637,6308,1.848,4258,2050,49,11,H1
"Duchesne County, UT",2000-2001,14449,14652,203,1.405,180,23,49,13,H1
"Duchesne County, UT",2001-2002,14652,14969,317,2.164,163,154,49,13,H1
"Duchesne County, UT",2002-2003,14969,15002,33,0.22,198,-165,49,13,H1
"Duchesne County, UT",2003-2004,15002,15101,99,0.66,158,-59,49,13,H1
"Duchesne County, UT",2004-2005,15101,15473,372,2.463,195,177,49,13,H1
"Duchesne County, UT",2005-2006,15473,15823,350,2.262,215,135,49,13,H1
"Duchesne County, UT",2006-2007,15823,16651,828,5.233,237,591,49,13,H1
"Duchesne County, UT",2007-2008,16651,17412,761,4.57,317,444,49,13,H1
"Duchesne County, UT",2008-2009,17412,18536,1124,6.455,302,822,49,13,H1
"Duchesne County, UT",2009-2010,18536,18612,76,0.41,249,-173,49,13,H1
"Duchesne County, UT",2010-2011,18612,18732,120,0.645,251,-131,49,13,H1
"Duchesne County, UT",2011-2012,18732,19061,329,1.756,284,45,49,13,H1
"Duchesne County, UT",2012-2013,19061,20106,1045,5.482,335,710,49,13,H1
"Duchesne County, UT",2013-2014,20106,20380,274,1.363,363,-89,49,13,H1
"Duchesne County, UT",2014-2015,20319,20862,543,2.672,308,235,49,13,H1
"Duchesne County, UT",2015-2016,20862,20315,-547,-2.622,287,-834,49,13,H1
"Duchesne County, UT",2016-2017,20315,20026,-289,-1.423,281,-570,49,13,H1
"Emery County, UT",2000-2001,10850,10614,-236,-2.175,102,-338,49,15,H1
"Emery County, UT",2001-2002,10614,10548,-66,-0.622,84,-150,49,15,H1
"Emery County, UT",2002-2003,10548,10545,-3,-0.028,90,-93,49,15,H1
"Emery County, UT",2003-2004,10545,10460,-85,-0.806,78,-163,49,15,H1
"Emery County, UT",2004-2005,10460,10471,11,0.105,93,-82,49,15,H1
"Emery County, UT",2005-2006,10471,10445,-26,-0.248,109,-135,49,15,H1
"Emery County, UT",2006-2007,10445,10566,121,1.158,110,11,49,15,H1
"Emery County, UT",2007-2008,10566,10740,174,1.647,79,95,49,15,H1
"Emery County, UT",2008-2009,10740,10896,156,1.453,98,58,49,15,H1
"Emery County, UT",2009-2010,10896,10971,75,0.688,92,-17,49,15,H1
"Emery County, UT",2010-2011,10971,10953,-18,-0.164,100,-118,49,15,H1
"Emery County, UT",2011-2012,10953,10901,-52,-0.475,94,-146,49,15,H1
"Emery County, UT",2012-2013,10901,10716,-185,-1.697,52,-237,49,15,H1
"Emery County, UT",2013-2014,10716,10631,-85,-0.793,57,-142,49,15,H1
"Emery County, UT",2014-2015,10632,10370,-262,-2.464,57,-319,49,15,H1
"Emery County, UT",2015-2016,10370,10222,-148,-1.427,61,-209,49,15,H1
"Emery County, UT",2016-2017,10222,10077,-145,-1.419,55,-200,49,15,H1
"Garfield County, UT",2000-2001,4747,4705,-42,-0.885,17,-59,49,17,H1
"Garfield County, UT",2001-2002,4705,4650,-55,-1.169,26,-81,49,17,H1
"Garfield County, UT",2002-2003,4650,4605,-45,-0.968,24,-69,49,17,H1
"Garfield County, UT",2003-2004,4605,4552,-53,-1.151,28,-81,49,17,H1
"Garfield County, UT",2004-2005,4552,4582,30,0.659,40,-10,49,17,H1
"Garfield County, UT",2005-2006,4582,4670,88,1.921,37,51,49,17,H1
"Garfield County, UT",2006-2007,4670,4850,180,3.854,39,141,49,17,H1
"Garfield County, UT",2007-2008,4850,5010,160,3.299,23,137,49,17,H1
"Garfield County, UT",2008-2009,5010,5068,58,1.158,38,20,49,17,H1
"Garfield County, UT",2009-2010,5068,5183,115,2.269,40,75,49,17,H1
"Garfield County, UT",2010-2011,5183,5167,-16,-0.309,3,-19,49,17,H1
"Garfield County, UT",2011-2012,5167,5088,-79,-1.529,10,-89,49,17,H1
"Garfield County, UT",2012-2013,5088,5065,-23,-0.452,35,-58,49,17,H1
"Garfield County, UT",2013-2014,5065,5024,-41,-0.809,23,-64,49,17,H1
"Garfield County, UT",2014-2015,5016,5009,-7,-0.14,28,-35,49,17,H1
"Garfield County, UT",2015-2016,5009,5.00E+03,-9,-0.18,33,-42,49,17,H1
"Garfield County, UT",2016-2017,5.00E+03,5078,78,1.56,26,52,49,17,H1
"Grand County, UT",2000-2001,8420,8436,16,0.19,44,-28,49,19,H1
"Grand County, UT",2001-2002,8436,8556,120,1.422,42,78,49,19,H1
"Grand County, UT",2002-2003,8556,8556,0,0,40,-40,49,19,H1
"Grand County, UT",2003-2004,8556,8528,-28,-0.327,41,-69,49,19,H1
"Grand County, UT",2004-2005,8528,8657,129,1.513,60,69,49,19,H1
"Grand County, UT",2005-2006,8657,8787,130,1.502,52,78,49,19,H1
"Grand County, UT",2006-2007,8787,8838,51,0.58,47,4,49,19,H1
"Grand County, UT",2007-2008,8838,8981,143,1.618,68,75,49,19,H1
"Grand County, UT",2008-2009,8981,9034,53,0.59,47,6,49,19,H1
"Grand County, UT",2009-2010,9034,9316,282,3.122,38,244,49,19,H1
"Grand County, UT",2010-2011,9316,9288,-28,-0.301,62,-90,49,19,H1
"Grand County, UT",2011-2012,9288,9341,53,0.571,33,20,49,19,H1
"Grand County, UT",2012-2013,9341,9367,26,0.278,58,-32,49,19,H1
"Grand County, UT",2013-2014,9367,9429,62,0.662,53,9,49,19,H1
"Grand County, UT",2014-2015,9451,9516,65,0.688,61,4,49,19,H1
"Grand County, UT",2015-2016,9516,9656,140,1.471,71,69,49,19,H1
"Grand County, UT",2016-2017,9656,9674,18,0.186,68,-50,49,19,H1
"Iron County, UT",2000-2001,34002,34771,769,2.262,614,155,49,21,H1
"Iron County, UT",2001-2002,34771,35728,957,2.752,574,383,49,21,H1
"Iron County, UT",2002-2003,35728,36202,474,1.327,576,-102,49,21,H1
"Iron County, UT",2003-2004,36202,37223,1021,2.82,627,394,49,21,H1
"Iron County, UT",2004-2005,37223,39555,2332,6.265,661,1671,49,21,H1
"Iron County, UT",2005-2006,39555,4.20E+04,2445,6.181,718,1727,49,21,H1
"Iron County, UT",2006-2007,4.20E+04,43645,1645,3.917,700,945,49,21,H1
"Iron County, UT",2007-2008,43645,44547,902,2.067,707,195,49,21,H1
"Iron County, UT",2008-2009,44547,45693,1146,2.573,751,395,49,21,H1
"Iron County, UT",2009-2010,45693,46264,571,1.25,774,-203,49,21,H1
"Iron County, UT",2010-2011,46264,46658,394,0.852,615,-221,49,21,H1
"Iron County, UT",2011-2012,46658,46730,72,0.154,539,-467,49,21,H1
"Iron County, UT",2012-2013,46730,46706,-24,-0.051,574,-598,49,21,H1
"Iron County, UT",2013-2014,46706,47269,563,1.205,537,26,49,21,H1
"Iron County, UT",2014-2015,47259,48368,1109,2.347,549,560,49,21,H1
"Iron County, UT",2015-2016,48368,49796,1428,2.952,594,834,49,21,H1
"Iron County, UT",2016-2017,49796,51001,1205,2.42,626,579,49,21,H1
"Juab County, UT",2000-2001,8268,8388,120,1.451,115,5,49,23,H1
"Juab County, UT",2001-2002,8388,8482,94,1.121,147,-53,49,23,H1
"Juab County, UT",2002-2003,8482,8622,140,1.651,111,29,49,23,H1
"Juab County, UT",2003-2004,8622,8803,181,2.099,105,76,49,23,H1
"Juab County, UT",2004-2005,8803,8926,123,1.397,89,34,49,23,H1
"Juab County, UT",2005-2006,8926,9175,249,2.79,128,121,49,23,H1
"Juab County, UT",2006-2007,9175,9607,432,4.708,107,325,49,23,H1
"Juab County, UT",2007-2008,9607,10024,417,4.341,165,252,49,23,H1
"Juab County, UT",2008-2009,10024,10209,185,1.846,150,35,49,23,H1
"Juab County, UT",2009-2010,10209,10261,52,0.509,98,-46,49,23,H1
"Juab County, UT",2010-2011,10261,10343,82,0.799,114,-32,49,23,H1
"Juab County, UT",2011-2012,10343,10328,-15,-0.145,106,-121,49,23,H1
"Juab County, UT",2012-2013,10328,10327,-1,-0.01,131,-132,49,23,H1
"Juab County, UT",2013-2014,10327,10486,159,1.54,99,60,49,23,H1
"Juab County, UT",2014-2015,10456,10594,138,1.32,94,44,49,23,H1
"Juab County, UT",2015-2016,10594,11003,409,3.861,147,262,49,23,H1
"Juab County, UT",2016-2017,11003,11250,247,2.245,124,123,49,23,H1
"Kane County, UT",2000-2001,6094,6.00E+03,-94,-1.543,6,-100,49,25,H1
"Kane County, UT",2001-2002,6.00E+03,6081,81,1.35,35,46,49,25,H1
"Kane County, UT",2002-2003,6081,6133,52,0.855,37,15,49,25,H1
"Kane County, UT",2003-2004,6133,6200,67,1.092,13,54,49,25,H1
"Kane County, UT",2004-2005,6200,6369,169,2.726,50,119,49,25,H1
"Kane County, UT",2005-2006,6369,6678,309,4.852,39,270,49,25,H1
"Kane County, UT",2006-2007,6678,6778,100,1.497,13,87,49,25,H1
"Kane County, UT",2007-2008,6778,6853,75,1.107,32,43,49,25,H1
"Kane County, UT",2008-2009,6853,7001,148,2.16,46,102,49,25,H1
"Kane County, UT",2009-2010,7001,7153,152,2.171,37,115,49,25,H1
"Kane County, UT",2010-2011,7153,7237,84,1.174,18,66,49,25,H1
"Kane County, UT",2011-2012,7237,7217,-20,-0.276,20,-40,49,25,H1
"Kane County, UT",2012-2013,7217,7242,25,0.346,19,6,49,25,H1
"Kane County, UT",2013-2014,7242,7254,12,0.166,10,2,49,25,H1
"Kane County, UT",2014-2015,7235,7131,-104,-1.437,14,-118,49,25,H1
"Kane County, UT",2015-2016,7131,7326,195,2.735,26,169,49,25,H1
"Kane County, UT",2016-2017,7326,7567,241,3.29,25,216,49,25,H1
"Millard County, UT",2000-2001,12385,12294,-91,-0.735,85,-176,49,27,H1
"Millard County, UT",2001-2002,12294,12223,-71,-0.578,94,-165,49,27,H1
"Millard County, UT",2002-2003,12223,12168,-55,-0.45,59,-114,49,27,H1
"Millard County, UT",2003-2004,12168,12017,-151,-1.241,57,-208,49,27,H1
"Millard County, UT",2004-2005,12017,11935,-82,-0.682,106,-188,49,27,H1
"Millard County, UT",2005-2006,11935,11946,11,0.092,79,-68,49,27,H1
"Millard County, UT",2006-2007,11946,11954,8,0.067,86,-78,49,27,H1
"Millard County, UT",2007-2008,11954,12146,192,1.606,132,60,49,27,H1
"Millard County, UT",2008-2009,12146,12343,197,1.622,123,74,49,27,H1
"Millard County, UT",2009-2010,12343,12523,180,1.458,115,65,49,27,H1
"Millard County, UT",2010-2011,12523,12609,86,0.687,102,-16,49,27,H1
"Millard County, UT",2011-2012,12609,12543,-66,-0.523,87,-153,49,27,H1
"Millard County, UT",2012-2013,12543,12628,85,0.678,91,-6,49,27,H1
"Millard County, UT",2013-2014,12628,12606,-22,-0.174,104,-126,49,27,H1
"Millard County, UT",2014-2015,12555,12645,90,0.717,104,-14,49,27,H1
"Millard County, UT",2015-2016,12645,12682,37,0.293,98,-61,49,27,H1
"Millard County, UT",2016-2017,12682,12863,181,1.427,112,69,49,27,H1
"Morgan County, UT",2000-2001,7165,7337,172,2.401,88,84,49,29,H1
"Morgan County, UT",2001-2002,7337,7488,151,2.058,60,91,49,29,H1
"Morgan County, UT",2002-2003,7488,7572,84,1.122,71,13,49,29,H1
"Morgan County, UT",2003-2004,7572,7725,153,2.021,72,81,49,29,H1
"Morgan County, UT",2004-2005,7725,7977,252,3.262,88,164,49,29,H1
"Morgan County, UT",2005-2006,7977,8342,365,4.576,108,257,49,29,H1
"Morgan County, UT",2006-2007,8342,8771,429,5.143,119,310,49,29,H1
"Morgan County, UT",2007-2008,8771,9126,355,4.047,106,249,49,29,H1
"Morgan County, UT",2008-2009,9126,9318,192,2.104,131,61,49,29,H1
"Morgan County, UT",2009-2010,9318,9519,201,2.157,96,105,49,29,H1
"Morgan County, UT",2010-2011,9519,9650,131,1.376,103,28,49,29,H1
"Morgan County, UT",2011-2012,9650,9802,152,1.575,87,65,49,29,H1
"Morgan County, UT",2012-2013,9802,10198,396,4.04,124,272,49,29,H1
"Morgan County, UT",2013-2014,10198,10608,410,4.02,130,280,49,29,H1
"Morgan County, UT",2014-2015,10617,11065,448,4.22,135,313,49,29,H1
"Morgan County, UT",2015-2016,11065,11373,308,2.784,118,190,49,29,H1
"Morgan County, UT",2016-2017,11373,11873,500,4.396,126,374,49,29,H1
"Piute County, UT",2000-2001,1436,1414,-22,-1.532,6,-28,49,31,H1
"Piute County, UT",2001-2002,1414,1417,3,0.212,3,0,49,31,H1
"Piute County, UT",2002-2003,1417,1409,-8,-0.565,-6,-2,49,31,H1
"Piute County, UT",2003-2004,1409,1430,21,1.49,0,21,49,31,H1
"Piute County, UT",2004-2005,1430,1430,0,0,7,-7,49,31,H1
"Piute County, UT",2005-2006,1430,1429,-1,-0.07,-7,6,49,31,H1
"Piute County, UT",2006-2007,1429,1419,-10,-0.7,1,-11,49,31,H1
"Piute County, UT",2007-2008,1419,1511,92,6.483,10,82,49,31,H1
"Piute County, UT",2008-2009,1511,1528,17,1.125,20,-3,49,31,H1
"Piute County, UT",2009-2010,1528,1556,28,1.832,12,16,49,31,H1
"Piute County, UT",2010-2011,1556,1523,-33,-2.121,-4,-29,49,31,H1
"Piute County, UT",2011-2012,1523,1528,5,0.328,-7,12,49,31,H1
"Piute County, UT",2012-2013,1528,1523,-5,-0.327,4,-9,49,31,H1
"Piute County, UT",2013-2014,1523,1484,-39,-2.561,1,-40,49,31,H1
"Piute County, UT",2014-2015,1486,1517,31,2.086,6,25,49,31,H1
"Piute County, UT",2015-2016,1517,1463,-54,-3.56,-3,-51,49,31,H1
"Piute County, UT",2016-2017,1463,1420,-43,-2.939,3,-46,49,31,H1
"Rich County, UT",2000-2001,1965,1932,-33,-1.679,11,-44,49,33,H1
"Rich County, UT",2001-2002,1932,1947,15,0.776,8,7,49,33,H1
"Rich County, UT",2002-2003,1947,2039,92,4.725,22,70,49,33,H1
"Rich County, UT",2003-2004,2039,2051,12,0.589,23,-11,49,33,H1
"Rich County, UT",2004-2005,2051,2055,4,0.195,18,-14,49,33,H1
"Rich County, UT",2005-2006,2055,2035,-20,-0.973,22,-42,49,33,H1
"Rich County, UT",2006-2007,2035,2124,89,4.373,26,63,49,33,H1
"Rich County, UT",2007-2008,2124,2227,103,4.849,20,83,49,33,H1
"Rich County, UT",2008-2009,2227,2253,26,1.167,32,-6,49,33,H1
"Rich County, UT",2009-2010,2253,2257,4,0.178,31,-27,49,33,H1
"Rich County, UT",2010-2011,2257,2320,63,2.791,18,45,49,33,H1
"Rich County, UT",2011-2012,2320,2279,-41,-1.767,34,-75,49,33,H1
"Rich County, UT",2012-2013,2279,2276,-3,-0.132,21,-24,49,33,H1
"Rich County, UT",2013-2014,2276,2293,17,0.747,14,3,49,33,H1
"Rich County, UT",2014-2015,2293,2311,18,0.785,22,-4,49,33,H1
"Rich County, UT",2015-2016,2311,2306,-5,-0.216,20,-25,49,33,H1
"Rich County, UT",2016-2017,2306,2391,85,3.686,20,65,49,33,H1
"Salt Lake County, UT",2000-2001,901018,910750,9732,1.08,13195,-3463,49,35,H1
"Salt Lake County, UT",2001-2002,910750,918152,7402,0.813,12783,-5381,49,35,H1
"Salt Lake County, UT",2002-2003,918152,924802,6650,0.724,13348,-6698,49,35,H1
"Salt Lake County, UT",2003-2004,924802,934140,9338,1.01,13216,-3878,49,35,H1
"Salt Lake County, UT",2004-2005,934140,947963,13823,1.48,13067,756,49,35,H1
"Salt Lake County, UT",2005-2006,947963,966798,18835,1.987,13660,5175,49,35,H1
"Salt Lake County, UT",2006-2007,966798,983719,16921,1.75,14206,2715,49,35,H1
"Salt Lake County, UT",2007-2008,983719,999553,15834,1.61,14175,1659,49,35,H1
"Salt Lake County, UT",2008-2009,999553,1016795,17242,1.725,13834,3408,49,35,H1
"Salt Lake County, UT",2009-2010,1016795,1032942,16147,1.588,14455,1692,49,35,H1
"Salt Lake County, UT",2010-2011,1032942,1048397,15455,1.496,12321,3134,49,35,H1
"Salt Lake County, UT",2011-2012,1048397,1064402,16005,1.527,11712,4293,49,35,H1
"Salt Lake County, UT",2012-2013,1064402,1080866,16464,1.547,12266,4198,49,35,H1
"Salt Lake County, UT",2013-2014,1080866,1091742,10876,1.006,12072,-1196,49,35,H1
"Salt Lake County, UT",2014-2015,1092888,1107314,14426,1.32,12011,2415,49,35,H1
"Salt Lake County, UT",2015-2016,1107314,1121379,14065,1.27,11050,3015,49,35,H1
"Salt Lake County, UT",2016-2017,1121379,1135649,14270,1.273,10974,3296,49,35,H1
"San Juan County, UT",2000-2001,14334,13495,-839,-5.853,170,-1009,49,37,H1
"San Juan County, UT",2001-2002,13495,13662,167,1.237,150,17,49,37,H1
"San Juan County, UT",2002-2003,13662,13571,-91,-0.666,169,-260,49,37,H1
"San Juan County, UT",2003-2004,13571,13723,152,1.12,176,-24,49,37,H1
"San Juan County, UT",2004-2005,13723,13653,-70,-0.51,174,-244,49,37,H1
"San Juan County, UT",2005-2006,13653,13679,26,0.19,163,-137,49,37,H1
"San Juan County, UT",2006-2007,13679,14028,349,2.551,187,162,49,37,H1
"San Juan County, UT",2007-2008,14028,14436,408,2.908,169,239,49,37,H1
"San Juan County, UT",2008-2009,14436,14514,78,0.54,213,-135,49,37,H1
"San Juan County, UT",2009-2010,14514,14805,291,2.005,182,109,49,37,H1
"San Juan County, UT",2010-2011,14805,14776,-29,-0.196,133,-162,49,37,H1
"San Juan County, UT",2011-2012,14776,14899,123,0.832,148,-25,49,37,H1
"San Juan County, UT",2012-2013,14899,14990,91,0.611,170,-79,49,37,H1
"San Juan County, UT",2013-2014,14990,15251,261,1.741,161,100,49,37,H1
"San Juan County, UT",2014-2015,15252,15772,520,3.409,146,374,49,37,H1
"San Juan County, UT",2015-2016,15772,15329,-443,-2.809,131,-574,49,37,H1
"San Juan County, UT",2016-2017,15329,15356,27,0.176,156,-129,49,37,H1
"Sanpete County, UT",2000-2001,22806,23294,488,2.14,225,263,49,39,H1
"Sanpete County, UT",2001-2002,23294,23566,272,1.168,223,49,49,39,H1
"Sanpete County, UT",2002-2003,23566,23866,300,1.273,204,96,49,39,H1
"Sanpete County, UT",2003-2004,23866,24217,351,1.471,225,126,49,39,H1
"Sanpete County, UT",2004-2005,24217,24607,390,1.61,246,144,49,39,H1
"Sanpete County, UT",2005-2006,24607,25051,444,1.804,254,190,49,39,H1
"Sanpete County, UT",2006-2007,25051,25846,795,3.174,240,555,49,39,H1
"Sanpete County, UT",2007-2008,25846,26959,1113,4.306,268,845,49,39,H1
"Sanpete County, UT",2008-2009,26959,27511,552,2.048,282,270,49,39,H1
"Sanpete County, UT",2009-2010,27511,27871,360,1.309,245,115,49,39,H1
"Sanpete County, UT",2010-2011,27871,28027,156,0.56,234,-78,49,39,H1
"Sanpete County, UT",2011-2012,28027,28029,2,0.007,216,-214,49,39,H1
"Sanpete County, UT",2012-2013,28029,28243,214,0.763,197,17,49,39,H1
"Sanpete County, UT",2013-2014,28243,28477,234,0.829,248,-14,49,39,H1
"Sanpete County, UT",2014-2015,28348,28778,430,1.517,235,195,49,39,H1
"Sanpete County, UT",2015-2016,28778,29303,525,1.824,214,311,49,39,H1
"Sanpete County, UT",2016-2017,29303,30035,732,2.498,222,510,49,39,H1
"Sevier County, UT",2000-2001,18877,18975,98,0.519,200,-102,49,41,H1
"Sevier County, UT",2001-2002,18975,19088,113,0.596,169,-56,49,41,H1
"Sevier County, UT",2002-2003,19088,19192,104,0.545,180,-76,49,41,H1
"Sevier County, UT",2003-2004,19192,19412,220,1.146,182,38,49,41,H1
"Sevier County, UT",2004-2005,19412,19415,3,0.015,155,-152,49,41,H1
"Sevier County, UT",2005-2006,19415,19844,429,2.21,184,245,49,41,H1
"Sevier County, UT",2006-2007,19844,20236,392,1.975,171,221,49,41,H1
"Sevier County, UT",2007-2008,20236,20599,363,1.794,154,209,49,41,H1
"Sevier County, UT",2008-2009,20599,20694,95,0.461,208,-113,49,41,H1
"Sevier County, UT",2009-2010,20694,20804,110,0.532,188,-78,49,41,H1
"Sevier County, UT",2010-2011,20804,20903,99,0.476,141,-42,49,41,H1
"Sevier County, UT",2011-2012,20903,20735,-168,-0.804,110,-278,49,41,H1
"Sevier County, UT",2012-2013,20735,20844,109,0.526,109,0,49,41,H1
"Sevier County, UT",2013-2014,20844,20773,-71,-0.341,95,-166,49,41,H1
"Sevier County, UT",2014-2015,20847,20984,137,0.657,120,17,49,41,H1
"Sevier County, UT",2015-2016,20984,21147,163,0.777,130,33,49,41,H1
"Sevier County, UT",2016-2017,21147,21316,169,0.799,128,41,49,41,H1
"Summit County, UT",2000-2001,29964,30803,839,2.8,378,461,49,43,H1
"Summit County, UT",2001-2002,30803,31536,733,2.38,394,339,49,43,H1
"Summit County, UT",2002-2003,31536,32353,817,2.591,420,397,49,43,H1
"Summit County, UT",2003-2004,32353,33271,918,2.837,451,467,49,43,H1
"Summit County, UT",2004-2005,33271,34137,866,2.603,448,418,49,43,H1
"Summit County, UT",2005-2006,34137,34242,105,0.308,418,-313,49,43,H1
"Summit County, UT",2006-2007,34242,34647,405,1.183,453,-48,49,43,H1
"Summit County, UT",2007-2008,34647,35229,582,1.68,423,159,49,43,H1
"Summit County, UT",2008-2009,35229,35838,609,1.729,413,196,49,43,H1
"Summit County, UT",2009-2010,35838,36503,665,1.856,392,273,49,43,H1
"Summit County, UT",2010-2011,36503,37429,926,2.537,345,581,49,43,H1
"Summit County, UT",2011-2012,37429,37893,464,1.24,317,147,49,43,H1
"Summit County, UT",2012-2013,37893,38453,560,1.478,290,270,49,43,H1
"Summit County, UT",2013-2014,38453,39105,652,1.696,299,353,49,43,H1
"Summit County, UT",2014-2015,39136,39633,497,1.27,280,217,49,43,H1
"Summit County, UT",2015-2016,39633,40390,757,1.91,270,487,49,43,H1
"Summit County, UT",2016-2017,40390,41106,716,1.773,275,441,49,43,H1
"Tooele County, UT",2000-2001,41519,43331,1812,4.364,752,1060,49,45,H1
"Tooele County, UT",2001-2002,43331,44998,1667,3.847,787,880,49,45,H1
"Tooele County, UT",2002-2003,44998,46652,1654,3.676,823,831,49,45,H1
"Tooele County, UT",2003-2004,46652,47894,1242,2.662,801,441,49,45,H1
"Tooele County, UT",2004-2005,47894,49258,1364,2.848,776,588,49,45,H1
"Tooele County, UT",2005-2006,49258,51483,2225,4.517,861,1364,49,45,H1
"Tooele County, UT",2006-2007,51483,53821,2338,4.541,841,1497,49,45,H1
"Tooele County, UT",2007-2008,53821,55909,2088,3.88,866,1222,49,45,H1
"Tooele County, UT",2008-2009,55909,57218,1309,2.341,897,412,49,45,H1
"Tooele County, UT",2009-2010,57218,58490,1272,2.223,745,527,49,45,H1
"Tooele County, UT",2010-2011,58490,59237,747,1.277,688,59,49,45,H1
"Tooele County, UT",2011-2012,59237,59820,583,0.984,664,-81,49,45,H1
"Tooele County, UT",2012-2013,59820,60718,898,1.501,706,192,49,45,H1
"Tooele County, UT",2013-2014,60718,61598,880,1.449,690,190,49,45,H1
"Tooele County, UT",2014-2015,61625,62952,1327,2.153,695,632,49,45,H1
"Tooele County, UT",2015-2016,62952,64599,1647,2.616,630,1017,49,45,H1
"Tooele County, UT",2016-2017,64599,67456,2857,4.423,659,2198,49,45,H1
"Uintah County, UT",2000-2001,25215,25786,571,2.265,314,257,49,47,H1
"Uintah County, UT",2001-2002,25786,26395,609,2.362,314,295,49,47,H1
"Uintah County, UT",2002-2003,26395,26561,166,0.629,328,-162,49,47,H1
"Uintah County, UT",2003-2004,26561,26994,433,1.63,300,133,49,47,H1
"Uintah County, UT",2004-2005,26994,27661,667,2.471,349,318,49,47,H1
"Uintah County, UT",2005-2006,27661,28662,1001,3.619,430,571,49,47,H1
"Uintah County, UT",2006-2007,28662,29920,1258,4.389,432,826,49,47,H1
"Uintah County, UT",2007-2008,29920,31009,1089,3.64,480,609,49,47,H1
"Uintah County, UT",2008-2009,31009,32931,1922,6.198,468,1454,49,47,H1
"Uintah County, UT",2009-2010,32931,32429,-502,-1.524,437,-939,49,47,H1
"Uintah County, UT",2010-2011,32429,33258,829,2.556,405,424,49,47,H1
"Uintah County, UT",2011-2012,33258,34636,1378,4.143,458,920,49,47,H1
"Uintah County, UT",2012-2013,34636,35690,1054,3.043,542,512,49,47,H1
"Uintah County, UT",2013-2014,35690,36867,1177,3.298,514,663,49,47,H1
"Uintah County, UT",2014-2015,36963,37928,965,2.611,554,411,49,47,H1
"Uintah County, UT",2015-2016,37928,36194,-1734,-4.572,360,-2094,49,47,H1
"Uintah County, UT",2016-2017,36194,35150,-1044,-2.884,336,-1380,49,47,H1
"Utah County, UT",2000-2001,371811,385671,13860,3.728,8553,5307,49,49,H1
"Utah County, UT",2001-2002,385671,397190,11519,2.987,8690,2829,49,49,H1
"Utah County, UT",2002-2003,397190,406158,8968,2.258,8980,-12,49,49,H1
"Utah County, UT",2003-2004,406158,416220,10062,2.477,9192,870,49,49,H1
"Utah County, UT",2004-2005,416220,430697,14477,3.478,9359,5118,49,49,H1
"Utah County, UT",2005-2006,430697,448296,17599,4.086,9762,7837,49,49,H1
"Utah County, UT",2006-2007,448296,469574,21278,4.746,10150,11128,49,49,H1
"Utah County, UT",2007-2008,469574,487615,18041,3.842,10669,7372,49,49,H1
"Utah County, UT",2008-2009,487615,504801,17186,3.525,11153,6033,49,49,H1
"Utah County, UT",2009-2010,504801,519569,14768,2.926,11189,3579,49,49,H1
"Utah County, UT",2010-2011,519569,530053,10484,2.018,10127,357,49,49,H1
"Utah County, UT",2011-2012,530053,539602,9549,1.802,9445,104,49,49,H1
"Utah County, UT",2012-2013,539602,551926,12324,2.284,10091,2233,49,49,H1
"Utah County, UT",2013-2014,551926,560974,9048,1.639,9913,-865,49,49,H1
"Utah County, UT",2014-2015,561534,575205,13671,2.435,9839,3832,49,49,H1
"Utah County, UT",2015-2016,575205,590475,15270,2.655,9799,5471,49,49,H1
"Utah County, UT",2016-2017,590475,606425,15950,2.701,10148,5802,49,49,H1
"Wasatch County, UT",2000-2001,15421,16205,784,5.084,220,564,49,51,H1
"Wasatch County, UT",2001-2002,16205,16975,770,4.752,259,511,49,51,H1
"Wasatch County, UT",2002-2003,16975,17765,790,4.654,282,508,49,51,H1
"Wasatch County, UT",2003-2004,17765,18349,584,3.287,287,297,49,51,H1
"Wasatch County, UT",2004-2005,18349,19410,1061,5.782,300,761,49,51,H1
"Wasatch County, UT",2005-2006,19410,20755,1345,6.929,265,1080,49,51,H1
"Wasatch County, UT",2006-2007,20755,21413,658,3.17,309,349,49,51,H1
"Wasatch County, UT",2007-2008,21413,22120,707,3.302,334,373,49,51,H1
"Wasatch County, UT",2008-2009,22120,22886,766,3.463,322,444,49,51,H1
"Wasatch County, UT",2009-2010,22886,23673,787,3.439,231,556,49,51,H1
"Wasatch County, UT",2010-2011,23673,24427,754,3.185,247,507,49,51,H1
"Wasatch County, UT",2011-2012,24427,25374,947,3.877,273,674,49,51,H1
"Wasatch County, UT",2012-2013,25374,26563,1189,4.686,313,876,49,51,H1
"Wasatch County, UT",2013-2014,26563,27714,1151,4.333,313,838,49,51,H1
"Wasatch County, UT",2014-2015,27785,29161,1376,4.952,342,1034,49,51,H1
"Wasatch County, UT",2015-2016,29161,30571,1410,4.835,292,1118,49,51,H1
"Wasatch County, UT",2016-2017,30571,32106,1535,5.021,305,1230,49,51,H1
"Washington County, UT",2000-2001,91206,94512,3306,3.625,1076,2230,49,53,H1
"Washington County, UT",2001-2002,94512,99274,4762,5.039,1234,3528,49,53,H1
"Washington County, UT",2002-2003,99274,104188,4914,4.95,1324,3590,49,53,H1
"Washington County, UT",2003-2004,104188,110207,6019,5.777,1414,4605,49,53,H1
"Washington County, UT",2004-2005,110207,1.19E+05,8793,7.979,1496,7297,49,53,H1
"Washington County, UT",2005-2006,1.19E+05,126796,7796,6.551,1763,6033,49,53,H1
"Washington County, UT",2006-2007,126796,132277,5481,4.323,1884,3597,49,53,H1
"Washington County, UT",2007-2008,132277,135552,3275,2.476,1902,1373,49,53,H1
"Washington County, UT",2008-2009,135552,137088,1536,1.133,1842,-306,49,53,H1
"Washington County, UT",2009-2010,137088,138406,1318,0.961,1369,-51,49,53,H1
"Washington County, UT",2010-2011,138406,141502,3096,2.237,1330,1766,49,53,H1
"Washington County, UT",2011-2012,141502,144643,3141,2.22,1097,2044,49,53,H1
"Washington County, UT",2012-2013,144643,147719,3076,2.127,1048,2028,49,53,H1
"Washington County, UT",2013-2014,147719,151948,4229,2.863,1094,3135,49,53,H1
"Washington County, UT",2014-2015,151876,155602,3726,2.453,1124,2602,49,53,H1
"Washington County, UT",2015-2016,155602,159237,3635,2.336,831,2804,49,53,H1
"Washington County, UT",2016-2017,159237,165662,6425,4.035,901,5524,49,53,H1
"Wayne County, UT",2000-2001,2533,2532,-1,-0.039,18,-19,49,55,H1
"Wayne County, UT",2001-2002,2532,2559,27,1.066,29,-2,49,55,H1
"Wayne County, UT",2002-2003,2559,2527,-32,-1.25,13,-45,49,55,H1
"Wayne County, UT",2003-2004,2527,2505,-22,-0.871,22,-44,49,55,H1
"Wayne County, UT",2004-2005,2505,2510,5,0.2,15,-10,49,55,H1
"Wayne County, UT",2005-2006,2510,2594,84,3.347,17,67,49,55,H1
"Wayne County, UT",2006-2007,2594,2648,54,2.082,6,48,49,55,H1
"Wayne County, UT",2007-2008,2648,2731,83,3.134,25,58,49,55,H1
"Wayne County, UT",2008-2009,2731,2788,57,2.087,38,19,49,55,H1
"Wayne County, UT",2009-2010,2788,2767,-21,-0.753,37,-58,49,55,H1
"Wayne County, UT",2010-2011,2767,2758,-9,-0.325,14,-23,49,55,H1
"Wayne County, UT",2011-2012,2758,2732,-26,-0.943,8,-34,49,55,H1
"Wayne County, UT",2012-2013,2732,2732,0,0,3,-3,49,55,H1
"Wayne County, UT",2013-2014,2732,2723,-9,-0.329,2,-11,49,55,H1
"Wayne County, UT",2014-2015,2713,2692,-21,-0.774,5,-26,49,55,H1
"Wayne County, UT",2015-2016,2692,2685,-7,-0.26,21,-28,49,55,H1
"Wayne County, UT",2016-2017,2685,2719,34,1.266,14,20,49,55,H1
"Weber County, UT",2000-2001,197437,200073,2636,1.335,2533,103,49,57,H1
"Weber County, UT",2001-2002,200073,203045,2972,1.485,2558,414,49,57,H1
"Weber County, UT",2002-2003,203045,205319,2274,1.12,2710,-436,49,57,H1
"Weber County, UT",2003-2004,205319,207794,2475,1.205,2589,-114,49,57,H1
"Weber County, UT",2004-2005,207794,210150,2356,1.134,2551,-195,49,57,H1
"Weber County, UT",2005-2006,210150,212656,2506,1.192,2509,-3,49,57,H1
"Weber County, UT",2006-2007,212656,217567,4911,2.309,2764,2147,49,57,H1
"Weber County, UT",2007-2008,217567,223676,6109,2.808,2884,3225,49,57,H1
"Weber County, UT",2008-2009,223676,228118,4442,1.986,2930,1512,49,57,H1
"Weber County, UT",2009-2010,228118,232118,4.00E+03,1.753,2688,1312,49,57,H1
"Weber County, UT",2010-2011,232118,233980,1862,0.802,2508,-646,49,57,H1
"Weber County, UT",2011-2012,233980,236540,2560,1.094,2407,153,49,57,H1
"Weber County, UT",2012-2013,236540,238422,1882,0.796,2327,-445,49,57,H1
"Weber County, UT",2013-2014,238422,240475,2053,0.861,2395,-342,49,57,H1
"Weber County, UT",2014-2015,240500,243645,3145,1.308,2298,847,49,57,H1
"Weber County, UT",2015-2016,243645,247319,3674,1.508,2244,1430,49,57,H1
"Weber County, UT",2016-2017,247319,251769,4450,1.799,2390,2060,49,57,H1
Vermont,2000-2001,609618,612223,2605,0.427,1375,1230,50,0,STATE
Vermont,2001-2002,612223,615442,3219,0.526,1246,1973,50,0,STATE
Vermont,2002-2003,615442,617858,2416,0.393,1396,1020,50,0,STATE
Vermont,2003-2004,617858,619920,2062,0.334,1511,551,50,0,STATE
Vermont,2004-2005,619920,621215,1295,0.209,1368,-73,50,0,STATE
Vermont,2005-2006,621215,622892,1677,0.27,1228,449,50,0,STATE
Vermont,2006-2007,622892,623481,589,0.095,1399,-810,50,0,STATE
Vermont,2007-2008,623481,624151,670,0.107,1424,-754,50,0,STATE
Vermont,2008-2009,624151,624817,666,0.107,1201,-535,50,0,STATE
Vermont,2009-2010,624817,625984,1167,0.187,1063,104,50,0,STATE
Vermont,2010-2011,625984,626687,703,0.112,621,82,50,0,STATE
Vermont,2011-2012,626687,626398,-289,-0.046,635,-924,50,0,STATE
Vermont,2012-2013,626398,627129,731,0.117,416,315,50,0,STATE
Vermont,2013-2014,627129,626767,-362,-0.058,495,-857,50,0,STATE
Vermont,2014-2015,626767,626042,-725,-0.116,686,-1411,50,0,STATE
Vermont,2015-2016,626042,623354,-2688,-0.429,231,-2919,50,0,STATE
Vermont,2016-2017,623354,623657,303,0.049,310,-7,50,0,STATE
"Addison County, VT",2000-2001,36002,36055,53,0.147,111,-58,50,1,H1
"Addison County, VT",2001-2002,36055,36320,265,0.735,99,166,50,1,H1
"Addison County, VT",2002-2003,36320,36432,112,0.308,72,40,50,1,H1
"Addison County, VT",2003-2004,36432,36580,148,0.406,90,58,50,1,H1
"Addison County, VT",2004-2005,36580,36611,31,0.085,119,-88,50,1,H1
"Addison County, VT",2005-2006,36611,36758,147,0.402,95,52,50,1,H1
"Addison County, VT",2006-2007,36758,36886,128,0.348,65,63,50,1,H1
"Addison County, VT",2007-2008,36886,36905,19,0.052,123,-104,50,1,H1
"Addison County, VT",2008-2009,36905,36847,-58,-0.157,87,-145,50,1,H1
"Addison County, VT",2009-2010,36847,36811,-36,-0.098,37,-73,50,1,H1
"Addison County, VT",2010-2011,36811,36861,50,0.136,10,40,50,1,H1
"Addison County, VT",2011-2012,36861,36837,-24,-0.065,-30,6,50,1,H1
"Addison County, VT",2012-2013,36837,36898,61,0.166,32,29,50,1,H1
"Addison County, VT",2013-2014,36898,37009,111,0.301,28,83,50,1,H1
"Addison County, VT",2014-2015,37035,37035,0,0,10,-10,50,1,H1
"Addison County, VT",2015-2016,37035,36844,-191,-0.516,29,-220,50,1,H1
"Addison County, VT",2016-2017,36844,36776,-68,-0.185,-2,-66,50,1,H1
"Bennington County, VT",2000-2001,36965,36974,9,0.024,-51,60,50,3,H1
"Bennington County, VT",2001-2002,36974,37105,131,0.354,-6,137,50,3,H1
"Bennington County, VT",2002-2003,37105,37083,-22,-0.059,-16,-6,50,3,H1
"Bennington County, VT",2003-2004,37083,37062,-21,-0.057,-4,-17,50,3,H1
"Bennington County, VT",2004-2005,37062,36960,-102,-0.275,-58,-44,50,3,H1
"Bennington County, VT",2005-2006,36960,37127,167,0.452,-24,191,50,3,H1
"Bennington County, VT",2006-2007,37127,37077,-50,-0.135,-35,-15,50,3,H1
"Bennington County, VT",2007-2008,37077,37168,91,0.245,-24,115,50,3,H1
"Bennington County, VT",2008-2009,37168,37151,-17,-0.046,-23,6,50,3,H1
"Bennington County, VT",2009-2010,37151,37077,-74,-0.199,-11,-63,50,3,H1
"Bennington County, VT",2010-2011,37077,36812,-265,-0.715,-122,-143,50,3,H1
"Bennington County, VT",2011-2012,36812,36669,-143,-0.388,-89,-54,50,3,H1
"Bennington County, VT",2012-2013,36669,36692,23,0.063,-65,88,50,3,H1
"Bennington County, VT",2013-2014,36692,36445,-247,-0.673,-90,-157,50,3,H1
"Bennington County, VT",2014-2015,36412,36317,-95,-0.261,-116,21,50,3,H1
"Bennington County, VT",2015-2016,36317,35854,-463,-1.275,-118,-345,50,3,H1
"Bennington County, VT",2016-2017,35854,35594,-260,-0.725,-110,-150,50,3,H1
"Caledonia County, VT",2000-2001,29662,29704,42,0.142,23,19,50,5,H1
"Caledonia County, VT",2001-2002,29704,30046,342,1.151,28,314,50,5,H1
"Caledonia County, VT",2002-2003,30046,30188,142,0.473,16,126,50,5,H1
"Caledonia County, VT",2003-2004,30188,30642,454,1.504,102,352,50,5,H1
"Caledonia County, VT",2004-2005,30642,30881,239,0.78,95,144,50,5,H1
"Caledonia County, VT",2005-2006,30881,31252,371,1.201,66,305,50,5,H1
"Caledonia County, VT",2006-2007,31252,31238,-14,-0.045,75,-89,50,5,H1
"Caledonia County, VT",2007-2008,31238,31167,-71,-0.227,62,-133,50,5,H1
"Caledonia County, VT",2008-2009,31167,31213,46,0.148,69,-23,50,5,H1
"Caledonia County, VT",2009-2010,31213,31189,-24,-0.077,44,-68,50,5,H1
"Caledonia County, VT",2010-2011,31189,31130,-59,-0.189,10,-69,50,5,H1
"Caledonia County, VT",2011-2012,31130,31095,-35,-0.112,-25,-10,50,5,H1
"Caledonia County, VT",2012-2013,31095,31151,56,0.18,0,56,50,5,H1
"Caledonia County, VT",2013-2014,31151,30981,-170,-0.546,2,-172,50,5,H1
"Caledonia County, VT",2014-2015,30941,30780,-161,-0.52,12,-173,50,5,H1
"Caledonia County, VT",2015-2016,30780,30167,-613,-1.992,-33,-580,50,5,H1
"Caledonia County, VT",2016-2017,30167,30164,-3,-0.01,-22,19,50,5,H1
"Chittenden County, VT",2000-2001,147161,148441,1280,0.87,742,538,50,7,H1
"Chittenden County, VT",2001-2002,148441,149639,1198,0.807,653,545,50,7,H1
"Chittenden County, VT",2002-2003,149639,150410,771,0.515,639,132,50,7,H1
"Chittenden County, VT",2003-2004,150410,151445,1035,0.688,703,332,50,7,H1
"Chittenden County, VT",2004-2005,151445,152163,718,0.474,652,66,50,7,H1
"Chittenden County, VT",2005-2006,152163,152861,698,0.459,621,77,50,7,H1
"Chittenden County, VT",2006-2007,152861,153625,764,0.5,698,66,50,7,H1
"Chittenden County, VT",2007-2008,153625,154659,1034,0.673,656,378,50,7,H1
"Chittenden County, VT",2008-2009,154659,155793,1134,0.733,656,478,50,7,H1
"Chittenden County, VT",2009-2010,155793,156762,969,0.622,639,330,50,7,H1
"Chittenden County, VT",2010-2011,156762,157679,917,0.585,559,358,50,7,H1
"Chittenden County, VT",2011-2012,157679,158641,962,0.61,554,408,50,7,H1
"Chittenden County, VT",2012-2013,158641,159818,1177,0.742,597,580,50,7,H1
"Chittenden County, VT",2013-2014,159818,160531,713,0.446,602,111,50,7,H1
"Chittenden County, VT",2014-2015,160743,161382,639,0.398,568,71,50,7,H1
"Chittenden County, VT",2015-2016,161382,161522,140,0.087,516,-376,50,7,H1
"Chittenden County, VT",2016-2017,161522,162372,850,0.526,480,370,50,7,H1
"Essex County, VT",2000-2001,6445,6467,22,0.341,-3,25,50,9,H1
"Essex County, VT",2001-2002,6467,6503,36,0.557,14,22,50,9,H1
"Essex County, VT",2002-2003,6503,6480,-23,-0.354,10,-33,50,9,H1
"Essex County, VT",2003-2004,6480,6478,-2,-0.031,-31,29,50,9,H1
"Essex County, VT",2004-2005,6478,6450,-28,-0.432,2,-30,50,9,H1
"Essex County, VT",2005-2006,6450,6341,-109,-1.69,-18,-91,50,9,H1
"Essex County, VT",2006-2007,6341,6421,80,1.262,-14,94,50,9,H1
"Essex County, VT",2007-2008,6421,6404,-17,-0.265,-2,-15,50,9,H1
"Essex County, VT",2008-2009,6404,6331,-73,-1.14,-27,-46,50,9,H1
"Essex County, VT",2009-2010,6331,6297,-34,-0.537,-17,-17,50,9,H1
"Essex County, VT",2010-2011,6297,6323,26,0.413,9,17,50,9,H1
"Essex County, VT",2011-2012,6323,6216,-107,-1.692,-9,-98,50,9,H1
"Essex County, VT",2012-2013,6216,6196,-20,-0.322,-4,-16,50,9,H1
"Essex County, VT",2013-2014,6196,6125,-71,-1.146,-6,-65,50,9,H1
"Essex County, VT",2014-2015,6129,6163,34,0.555,-11,45,50,9,H1
"Essex County, VT",2015-2016,6163,6240,77,1.249,-9,86,50,9,H1
"Essex County, VT",2016-2017,6240,6230,-10,-0.16,-4,-6,50,9,H1
"Franklin County, VT",2000-2001,45530,45900,370,0.813,206,164,50,11,H1
"Franklin County, VT",2001-2002,45900,46305,405,0.882,218,187,50,11,H1
"Franklin County, VT",2002-2003,46305,46590,285,0.615,216,69,50,11,H1
"Franklin County, VT",2003-2004,46590,46942,352,0.756,270,82,50,11,H1
"Franklin County, VT",2004-2005,46942,47192,250,0.533,266,-16,50,11,H1
"Franklin County, VT",2005-2006,47192,47392,200,0.424,255,-55,50,11,H1
"Franklin County, VT",2006-2007,47392,47455,63,0.133,263,-200,50,11,H1
"Franklin County, VT",2007-2008,47455,47462,7,0.015,220,-213,50,11,H1
"Franklin County, VT",2008-2009,47462,47620,158,0.333,218,-60,50,11,H1
"Franklin County, VT",2009-2010,47620,47788,168,0.353,206,-38,50,11,H1
"Franklin County, VT",2010-2011,47788,48175,387,0.81,171,216,50,11,H1
"Franklin County, VT",2011-2012,48175,48253,78,0.162,232,-154,50,11,H1
"Franklin County, VT",2012-2013,48253,48272,19,0.039,205,-186,50,11,H1
"Franklin County, VT",2013-2014,48272,48642,370,0.766,219,151,50,11,H1
"Franklin County, VT",2014-2015,48618,48799,181,0.372,220,-39,50,11,H1
"Franklin County, VT",2015-2016,48799,48974,175,0.359,168,7,50,11,H1
"Franklin County, VT",2016-2017,48974,49025,51,0.104,184,-133,50,11,H1
"Grand Isle County, VT",2000-2001,6909,7020,111,1.607,23,88,50,13,H1
"Grand Isle County, VT",2001-2002,7020,7108,88,1.254,7,81,50,13,H1
"Grand Isle County, VT",2002-2003,7108,7201,93,1.308,29,64,50,13,H1
"Grand Isle County, VT",2003-2004,7201,7265,64,0.889,28,36,50,13,H1
"Grand Isle County, VT",2004-2005,7265,7282,17,0.234,19,-2,50,13,H1
"Grand Isle County, VT",2005-2006,7282,7173,-109,-1.497,2,-111,50,13,H1
"Grand Isle County, VT",2006-2007,7173,7152,-21,-0.293,16,-37,50,13,H1
"Grand Isle County, VT",2007-2008,7152,7211,59,0.825,18,41,50,13,H1
"Grand Isle County, VT",2008-2009,7211,7022,-189,-2.621,26,-215,50,13,H1
"Grand Isle County, VT",2009-2010,7022,6958,-64,-0.911,3,-67,50,13,H1
"Grand Isle County, VT",2010-2011,6958,6983,25,0.359,11,14,50,13,H1
"Grand Isle County, VT",2011-2012,6983,6980,-3,-0.043,-6,3,50,13,H1
"Grand Isle County, VT",2012-2013,6980,6982,2,0.029,6,-4,50,13,H1
"Grand Isle County, VT",2013-2014,6982,6994,12,0.172,9,3,50,13,H1
"Grand Isle County, VT",2014-2015,6974,6861,-113,-1.62,6,-119,50,13,H1
"Grand Isle County, VT",2015-2016,6861,6933,72,1.049,6,66,50,13,H1
"Grand Isle County, VT",2016-2017,6933,6998,65,0.938,0,65,50,13,H1
"Lamoille County, VT",2000-2001,23285,23378,93,0.399,74,19,50,15,H1
"Lamoille County, VT",2001-2002,23378,23475,97,0.415,82,15,50,15,H1
"Lamoille County, VT",2002-2003,23475,23539,64,0.273,123,-59,50,15,H1
"Lamoille County, VT",2003-2004,23539,23444,-95,-0.404,88,-183,50,15,H1
"Lamoille County, VT",2004-2005,23444,23421,-23,-0.098,123,-146,50,15,H1
"Lamoille County, VT",2005-2006,23421,23642,221,0.944,128,93,50,15,H1
"Lamoille County, VT",2006-2007,23642,23778,136,0.575,136,0,50,15,H1
"Lamoille County, VT",2007-2008,23778,23971,193,0.812,124,69,50,15,H1
"Lamoille County, VT",2008-2009,23971,24193,222,0.926,66,156,50,15,H1
"Lamoille County, VT",2009-2010,24193,24517,324,1.339,43,281,50,15,H1
"Lamoille County, VT",2010-2011,24517,24659,142,0.579,61,81,50,15,H1
"Lamoille County, VT",2011-2012,24659,24905,246,0.998,75,171,50,15,H1
"Lamoille County, VT",2012-2013,24905,25050,145,0.582,83,62,50,15,H1
"Lamoille County, VT",2013-2014,25050,25082,32,0.128,74,-42,50,15,H1
"Lamoille County, VT",2014-2015,25143,25235,92,0.366,67,25,50,15,H1
"Lamoille County, VT",2015-2016,25235,25274,39,0.155,26,13,50,15,H1
"Lamoille County, VT",2016-2017,25274,25337,63,0.249,65,-2,50,15,H1
"Orange County, VT",2000-2001,28381,28696,315,1.11,79,236,50,17,H1
"Orange County, VT",2001-2002,28696,28735,39,0.136,49,-10,50,17,H1
"Orange County, VT",2002-2003,28735,28921,186,0.647,18,168,50,17,H1
"Orange County, VT",2003-2004,28921,29040,119,0.411,60,59,50,17,H1
"Orange County, VT",2004-2005,29040,29066,26,0.09,65,-39,50,17,H1
"Orange County, VT",2005-2006,29066,29249,183,0.63,59,124,50,17,H1
"Orange County, VT",2006-2007,29249,29119,-130,-0.444,41,-171,50,17,H1
"Orange County, VT",2007-2008,29119,29032,-87,-0.299,80,-167,50,17,H1
"Orange County, VT",2008-2009,29032,28965,-67,-0.231,58,-125,50,17,H1
"Orange County, VT",2009-2010,28965,28941,-24,-0.083,18,-42,50,17,H1
"Orange County, VT",2010-2011,28941,29025,84,0.29,47,37,50,17,H1
"Orange County, VT",2011-2012,29025,28933,-92,-0.317,38,-130,50,17,H1
"Orange County, VT",2012-2013,28933,28879,-54,-0.187,38,-92,50,17,H1
"Orange County, VT",2013-2014,28879,28859,-20,-0.069,19,-39,50,17,H1
"Orange County, VT",2014-2015,28868,28899,31,0.107,34,-3,50,17,H1
"Orange County, VT",2015-2016,28899,28917,18,0.062,2,16,50,17,H1
"Orange County, VT",2016-2017,28917,28974,57,0.197,-4,61,50,17,H1
"Orleans County, VT",2000-2001,26321,26443,122,0.464,-9,131,50,19,H1
"Orleans County, VT",2001-2002,26443,26540,97,0.367,-1,98,50,19,H1
"Orleans County, VT",2002-2003,26540,26908,368,1.387,29,339,50,19,H1
"Orleans County, VT",2003-2004,26908,27064,156,0.58,27,129,50,19,H1
"Orleans County, VT",2004-2005,27064,27224,160,0.591,-7,167,50,19,H1
"Orleans County, VT",2005-2006,27224,27215,-9,-0.033,-8,-1,50,19,H1
"Orleans County, VT",2006-2007,27215,27332,117,0.43,72,45,50,19,H1
"Orleans County, VT",2007-2008,27332,27269,-63,-0.23,-2,-61,50,19,H1
"Orleans County, VT",2008-2009,27269,27234,-35,-0.128,-23,-12,50,19,H1
"Orleans County, VT",2009-2010,27234,27225,-9,-0.033,-7,-2,50,19,H1
"Orleans County, VT",2010-2011,27225,27162,-63,-0.231,-21,-42,50,19,H1
"Orleans County, VT",2011-2012,27162,27159,-3,-0.011,-13,10,50,19,H1
"Orleans County, VT",2012-2013,27159,27170,11,0.041,-45,56,50,19,H1
"Orleans County, VT",2013-2014,27170,27082,-88,-0.324,-7,-81,50,19,H1
"Orleans County, VT",2014-2015,27086,27100,14,0.052,-10,24,50,19,H1
"Orleans County, VT",2015-2016,27100,26751,-349,-1.288,-50,-299,50,19,H1
"Orleans County, VT",2016-2017,26751,26841,90,0.336,-23,113,50,19,H1
"Rutland County, VT",2000-2001,63373,63132,-241,-0.38,58,-299,50,21,H1
"Rutland County, VT",2001-2002,63132,62982,-150,-0.238,-39,-111,50,21,H1
"Rutland County, VT",2002-2003,62982,63113,131,0.208,53,78,50,21,H1
"Rutland County, VT",2003-2004,63113,62997,-116,-0.184,-26,-90,50,21,H1
"Rutland County, VT",2004-2005,62997,63003,6,0.01,-30,36,50,21,H1
"Rutland County, VT",2005-2006,63003,62894,-109,-0.173,-32,-77,50,21,H1
"Rutland County, VT",2006-2007,62894,62618,-276,-0.439,-70,-206,50,21,H1
"Rutland County, VT",2007-2008,62618,62368,-250,-0.399,-27,-223,50,21,H1
"Rutland County, VT",2008-2009,62368,61946,-422,-0.677,-40,-382,50,21,H1
"Rutland County, VT",2009-2010,61946,61573,-373,-0.602,-49,-324,50,21,H1
"Rutland County, VT",2010-2011,61573,61243,-330,-0.536,-124,-206,50,21,H1
"Rutland County, VT",2011-2012,61243,60875,-368,-0.601,-80,-288,50,21,H1
"Rutland County, VT",2012-2013,60875,60545,-330,-0.542,-103,-227,50,21,H1
"Rutland County, VT",2013-2014,60545,60086,-459,-0.758,-82,-377,50,21,H1
"Rutland County, VT",2014-2015,60150,59736,-414,-0.688,-92,-322,50,21,H1
"Rutland County, VT",2015-2016,59736,59172,-564,-0.944,-168,-396,50,21,H1
"Rutland County, VT",2016-2017,59172,59087,-85,-0.144,-130,45,50,21,H1
"Washington County, VT",2000-2001,58072,58526,454,0.782,76,378,50,23,H1
"Washington County, VT",2001-2002,58526,58889,363,0.62,137,226,50,23,H1
"Washington County, VT",2002-2003,58889,58958,69,0.117,167,-98,50,23,H1
"Washington County, VT",2003-2004,58958,59081,123,0.209,145,-22,50,23,H1
"Washington County, VT",2004-2005,59081,59366,285,0.482,141,144,50,23,H1
"Washington County, VT",2005-2006,59366,59414,48,0.081,71,-23,50,23,H1
"Washington County, VT",2006-2007,59414,59275,-139,-0.234,127,-266,50,23,H1
"Washington County, VT",2007-2008,59275,59278,3,0.005,149,-146,50,23,H1
"Washington County, VT",2008-2009,59278,59353,75,0.127,105,-30,50,23,H1
"Washington County, VT",2009-2010,59353,59550,197,0.332,107,90,50,23,H1
"Washington County, VT",2010-2011,59550,59543,-7,-0.012,86,-93,50,23,H1
"Washington County, VT",2011-2012,59543,59351,-192,-0.322,115,-307,50,23,H1
"Washington County, VT",2012-2013,59351,59221,-130,-0.219,21,-151,50,23,H1
"Washington County, VT",2013-2014,59221,58998,-223,-0.377,34,-257,50,23,H1
"Washington County, VT",2014-2015,58940,58612,-328,-0.556,41,-369,50,23,H1
"Washington County, VT",2015-2016,58612,58365,-247,-0.421,25,-272,50,23,H1
"Washington County, VT",2016-2017,58365,58290,-75,-0.129,20,-95,50,23,H1
"Windham County, VT",2000-2001,44074,43998,-76,-0.172,15,-91,50,25,H1
"Windham County, VT",2001-2002,43998,44122,124,0.282,22,102,50,25,H1
"Windham County, VT",2002-2003,44122,44353,231,0.524,34,197,50,25,H1
"Windham County, VT",2003-2004,44353,44241,-112,-0.253,68,-180,50,25,H1
"Windham County, VT",2004-2005,44241,44187,-54,-0.122,27,-81,50,25,H1
"Windham County, VT",2005-2006,44187,44390,203,0.459,35,168,50,25,H1
"Windham County, VT",2006-2007,44390,44444,54,0.122,55,-1,50,25,H1
"Windham County, VT",2007-2008,44444,44407,-37,-0.083,43,-80,50,25,H1
"Windham County, VT",2008-2009,44407,44441,34,0.077,18,16,50,25,H1
"Windham County, VT",2009-2010,44441,44503,62,0.14,28,34,50,25,H1
"Windham County, VT",2010-2011,44503,44229,-274,-0.616,-19,-255,50,25,H1
"Windham County, VT",2011-2012,44229,43997,-232,-0.525,-62,-170,50,25,H1
"Windham County, VT",2012-2013,43997,43808,-189,-0.43,3,-192,50,25,H1
"Windham County, VT",2013-2014,43808,43714,-94,-0.215,6,-100,50,25,H1
"Windham County, VT",2014-2015,43766,43386,-380,-0.868,13,-393,50,25,H1
"Windham County, VT",2015-2016,43386,43147,-239,-0.551,-51,-188,50,25,H1
"Windham County, VT",2016-2017,43147,42869,-278,-0.644,-67,-211,50,25,H1
"Windsor County, VT",2000-2001,57438,57489,51,0.089,31,20,50,27,H1
"Windsor County, VT",2001-2002,57489,57673,184,0.32,-17,201,50,27,H1
"Windsor County, VT",2002-2003,57673,57682,9,0.016,6,3,50,27,H1
"Windsor County, VT",2003-2004,57682,57639,-43,-0.075,-9,-34,50,27,H1
"Windsor County, VT",2004-2005,57639,57409,-230,-0.399,-46,-184,50,27,H1
"Windsor County, VT",2005-2006,57409,57184,-225,-0.392,-22,-203,50,27,H1
"Windsor County, VT",2006-2007,57184,57061,-123,-0.215,-30,-93,50,27,H1
"Windsor County, VT",2007-2008,57061,56850,-211,-0.37,4,-215,50,27,H1
"Windsor County, VT",2008-2009,56850,56708,-142,-0.25,11,-153,50,27,H1
"Windsor County, VT",2009-2010,56708,56601,-107,-0.189,22,-129,50,27,H1
"Windsor County, VT",2010-2011,56601,56626,25,0.044,-60,85,50,27,H1
"Windsor County, VT",2011-2012,56626,56227,-399,-0.705,-64,-335,50,27,H1
"Windsor County, VT",2012-2013,56227,56173,-54,-0.096,-69,15,50,27,H1
"Windsor County, VT",2013-2014,56173,56014,-159,-0.283,-40,-119,50,27,H1
"Windsor County, VT",2014-2015,55962,55737,-225,-0.402,-56,-169,50,27,H1
"Windsor County, VT",2015-2016,55737,55194,-543,-0.974,-112,-431,50,27,H1
"Windsor County, VT",2016-2017,55194,55100,-94,-0.17,-77,-17,50,27,H1
Washington,2000-2001,5910512,5985722,75210,1.272,36213,38997,53,0,STATE
Washington,2001-2002,5985722,6052349,66627,1.113,34213,32414,53,0,STATE
Washington,2002-2003,6052349,6104115,51766,0.855,34402,17364,53,0,STATE
Washington,2003-2004,6104115,6178645,74530,1.221,36007,38523,53,0,STATE
Washington,2004-2005,6178645,6257305,78660,1.273,35553,43107,53,0,STATE
Washington,2005-2006,6257305,6370753,113448,1.813,39309,74139,53,0,STATE
Washington,2006-2007,6370753,6461587,90834,1.426,41854,48980,53,0,STATE
Washington,2007-2008,6461587,6562231,100644,1.558,40738,59906,53,0,STATE
Washington,2008-2009,6562231,6667426,105195,1.603,39835,65360,53,0,STATE
Washington,2009-2010,6667426,6743060,75634,1.134,40089,35545,53,0,STATE
Washington,2010-2011,6743060,6823229,80169,1.189,36869,43300,53,0,STATE
Washington,2011-2012,6823229,6897292,74063,1.085,37278,36785,53,0,STATE
Washington,2012-2013,6897292,6973281,75989,1.102,35922,40067,53,0,STATE
Washington,2013-2014,6973281,7063166,89885,1.289,34915,54970,53,0,STATE
Washington,2014-2015,7063166,7170351,107185,1.518,35608,71577,53,0,STATE
Washington,2015-2016,7170351,7280934,110583,1.542,33950,76633,53,0,STATE
Washington,2016-2017,7280934,7405743,124809,1.714,34002,90807,53,0,STATE
"Adams County, WA",2000-2001,16458,16259,-199,-1.209,207,-406,53,1,H1
"Adams County, WA",2001-2002,16259,16445,186,1.144,245,-59,53,1,H1
"Adams County, WA",2002-2003,16445,16612,167,1.016,243,-76,53,1,H1
"Adams County, WA",2003-2004,16612,16664,52,0.313,252,-200,53,1,H1
"Adams County, WA",2004-2005,16664,16918,254,1.524,282,-28,53,1,H1
"Adams County, WA",2005-2006,16918,16997,79,0.467,337,-258,53,1,H1
"Adams County, WA",2006-2007,16997,17413,416,2.447,284,132,53,1,H1
"Adams County, WA",2007-2008,17413,17782,369,2.119,311,58,53,1,H1
"Adams County, WA",2008-2009,17782,18405,623,3.504,330,293,53,1,H1
"Adams County, WA",2009-2010,18405,18760,355,1.929,350,5,53,1,H1
"Adams County, WA",2010-2011,18760,18830,70,0.373,309,-239,53,1,H1
"Adams County, WA",2011-2012,18830,18914,84,0.446,305,-221,53,1,H1
"Adams County, WA",2012-2013,18914,19073,159,0.841,289,-130,53,1,H1
"Adams County, WA",2013-2014,19073,19179,106,0.556,279,-173,53,1,H1
"Adams County, WA",2014-2015,19194,19254,60,0.313,283,-223,53,1,H1
"Adams County, WA",2015-2016,19254,19262,8,0.042,221,-213,53,1,H1
"Adams County, WA",2016-2017,19262,19506,244,1.267,234,10,53,1,H1
"Asotin County, WA",2000-2001,20546,20447,-99,-0.482,44,-143,53,3,H1
"Asotin County, WA",2001-2002,20447,20490,43,0.21,42,1,53,3,H1
"Asotin County, WA",2002-2003,20490,20487,-3,-0.015,52,-55,53,3,H1
"Asotin County, WA",2003-2004,20487,20783,296,1.445,80,216,53,3,H1
"Asotin County, WA",2004-2005,20783,20908,125,0.601,23,102,53,3,H1
"Asotin County, WA",2005-2006,20908,21133,225,1.076,60,165,53,3,H1
"Asotin County, WA",2006-2007,21133,21188,55,0.26,18,37,53,3,H1
"Asotin County, WA",2007-2008,21188,21393,205,0.968,23,182,53,3,H1
"Asotin County, WA",2008-2009,21393,21415,22,0.103,59,-37,53,3,H1
"Asotin County, WA",2009-2010,21415,21697,282,1.317,36,246,53,3,H1
"Asotin County, WA",2010-2011,21697,21911,214,0.986,36,178,53,3,H1
"Asotin County, WA",2011-2012,21911,21873,-38,-0.173,-12,-26,53,3,H1
"Asotin County, WA",2012-2013,21873,22104,231,1.056,-15,246,53,3,H1
"Asotin County, WA",2013-2014,22104,22189,85,0.385,9,76,53,3,H1
"Asotin County, WA",2014-2015,22188,22105,-83,-0.374,1,-84,53,3,H1
"Asotin County, WA",2015-2016,22105,22310,205,0.927,-37,242,53,3,H1
"Asotin County, WA",2016-2017,22310,22535,225,1.009,-39,264,53,3,H1
"Benton County, WA",2000-2001,143131,145909,2778,1.941,1117,1661,53,5,H1
"Benton County, WA",2001-2002,145909,150323,4414,3.025,1188,3226,53,5,H1
"Benton County, WA",2002-2003,150323,153596,3273,2.177,1161,2112,53,5,H1
"Benton County, WA",2003-2004,153596,155689,2093,1.363,1200,893,53,5,H1
"Benton County, WA",2004-2005,155689,157726,2037,1.308,1079,958,53,5,H1
"Benton County, WA",2005-2006,157726,159564,1838,1.165,1219,619,53,5,H1
"Benton County, WA",2006-2007,159564,161669,2105,1.319,1266,839,53,5,H1
"Benton County, WA",2007-2008,161669,166573,4904,3.033,1321,3583,53,5,H1
"Benton County, WA",2008-2009,166573,171122,4549,2.731,1269,3280,53,5,H1
"Benton County, WA",2009-2010,171122,176456,5334,3.117,1213,4121,53,5,H1
"Benton County, WA",2010-2011,176456,180475,4019,2.278,1264,2755,53,5,H1
"Benton County, WA",2011-2012,180475,182396,1921,1.064,1387,534,53,5,H1
"Benton County, WA",2012-2013,182396,184453,2057,1.128,1263,794,53,5,H1
"Benton County, WA",2013-2014,184453,186486,2033,1.102,1307,726,53,5,H1
"Benton County, WA",2014-2015,186647,190309,3662,1.962,1281,2381,53,5,H1
"Benton County, WA",2015-2016,190309,193484,3175,1.668,1263,1912,53,5,H1
"Benton County, WA",2016-2017,193484,198171,4687,2.422,1298,3389,53,5,H1
"Chelan County, WA",2000-2001,66648,66574,-74,-0.111,414,-488,53,7,H1
"Chelan County, WA",2001-2002,66574,66742,168,0.252,353,-185,53,7,H1
"Chelan County, WA",2002-2003,66742,67173,431,0.646,335,96,53,7,H1
"Chelan County, WA",2003-2004,67173,67882,709,1.055,305,404,53,7,H1
"Chelan County, WA",2004-2005,67882,68747,865,1.274,348,517,53,7,H1
"Chelan County, WA",2005-2006,68747,69536,789,1.148,395,394,53,7,H1
"Chelan County, WA",2006-2007,69536,70214,678,0.975,409,269,53,7,H1
"Chelan County, WA",2007-2008,70214,70813,599,0.853,357,242,53,7,H1
"Chelan County, WA",2008-2009,70813,71679,866,1.223,339,527,53,7,H1
"Chelan County, WA",2009-2010,71679,72727,1048,1.462,396,652,53,7,H1
"Chelan County, WA",2010-2011,72727,73300,573,0.788,299,274,53,7,H1
"Chelan County, WA",2011-2012,73300,73670,370,0.505,267,103,53,7,H1
"Chelan County, WA",2012-2013,73670,74037,367,0.498,264,103,53,7,H1
"Chelan County, WA",2013-2014,74037,74588,551,0.744,275,276,53,7,H1
"Chelan County, WA",2014-2015,74598,75644,1046,1.402,255,791,53,7,H1
"Chelan County, WA",2015-2016,75644,75968,324,0.428,183,141,53,7,H1
"Chelan County, WA",2016-2017,75968,76533,565,0.744,272,293,53,7,H1
"Clallam County, WA",2000-2001,64269,64756,487,0.758,-87,574,53,9,H1
"Clallam County, WA",2001-2002,64756,65777,1021,1.577,-221,1242,53,9,H1
"Clallam County, WA",2002-2003,65777,66301,524,0.797,-246,770,53,9,H1
"Clallam County, WA",2003-2004,66301,67411,1110,1.674,-196,1306,53,9,H1
"Clallam County, WA",2004-2005,67411,68720,1309,1.942,-263,1572,53,9,H1
"Clallam County, WA",2005-2006,68720,69642,922,1.342,-219,1141,53,9,H1
"Clallam County, WA",2006-2007,69642,70186,544,0.781,-240,784,53,9,H1
"Clallam County, WA",2007-2008,70186,70769,583,0.831,-231,814,53,9,H1
"Clallam County, WA",2008-2009,70769,71077,308,0.435,-181,489,53,9,H1
"Clallam County, WA",2009-2010,71077,71526,449,0.632,-205,654,53,9,H1
"Clallam County, WA",2010-2011,71526,71783,257,0.359,-236,493,53,9,H1
"Clallam County, WA",2011-2012,71783,71848,65,0.091,-284,349,53,9,H1
"Clallam County, WA",2012-2013,71848,72250,402,0.56,-269,671,53,9,H1
"Clallam County, WA",2013-2014,72250,72715,465,0.644,-285,750,53,9,H1
"Clallam County, WA",2014-2015,72668,73486,818,1.126,-281,1099,53,9,H1
"Clallam County, WA",2015-2016,73486,74098,612,0.833,-331,943,53,9,H1
"Clallam County, WA",2016-2017,74098,75474,1376,1.857,-328,1704,53,9,H1
"Clark County, WA",2000-2001,347208,357211,10003,2.881,3067,6936,53,11,H1
"Clark County, WA",2001-2002,357211,366405,9194,2.574,2895,6299,53,11,H1
"Clark County, WA",2002-2003,366405,374098,7693,2.1,2852,4841,53,11,H1
"Clark County, WA",2003-2004,374098,384931,10833,2.896,2870,7963,53,11,H1
"Clark County, WA",2004-2005,384931,394277,9346,2.428,2921,6425,53,11,H1
"Clark County, WA",2005-2006,394277,401698,7421,1.882,3030,4391,53,11,H1
"Clark County, WA",2006-2007,401698,408820,7122,1.773,3275,3847,53,11,H1
"Clark County, WA",2007-2008,408820,415282,6462,1.581,3160,3302,53,11,H1
"Clark County, WA",2008-2009,415282,421236,5954,1.434,3101,2853,53,11,H1
"Clark County, WA",2009-2010,421236,426869,5633,1.337,2616,3017,53,11,H1
"Clark County, WA",2010-2011,426869,432668,5799,1.358,2516,3283,53,11,H1
"Clark County, WA",2011-2012,432668,437505,4837,1.118,2317,2520,53,11,H1
"Clark County, WA",2012-2013,437505,443312,5807,1.327,2363,3444,53,11,H1
"Clark County, WA",2013-2014,443312,451008,7696,1.736,2173,5523,53,11,H1
"Clark County, WA",2014-2015,450441,459495,9054,2.01,2185,6869,53,11,H1
"Clark County, WA",2015-2016,459495,465548,6053,1.317,2042,4011,53,11,H1
"Clark County, WA",2016-2017,465548,474643,9095,1.954,2068,7027,53,11,H1
"Columbia County, WA",2000-2001,4069,4034,-35,-0.86,-21,-14,53,13,H1
"Columbia County, WA",2001-2002,4034,3995,-39,-0.967,-9,-30,53,13,H1
"Columbia County, WA",2002-2003,3995,4003,8,0.2,-9,17,53,13,H1
"Columbia County, WA",2003-2004,4003,4027,24,0.6,-14,38,53,13,H1
"Columbia County, WA",2004-2005,4027,3974,-53,-1.316,-14,-39,53,13,H1
"Columbia County, WA",2005-2006,3974,3895,-79,-1.988,-22,-57,53,13,H1
"Columbia County, WA",2006-2007,3895,3897,2,0.051,0,2,53,13,H1
"Columbia County, WA",2007-2008,3897,3903,6,0.154,-19,25,53,13,H1
"Columbia County, WA",2008-2009,3903,3977,74,1.896,-10,84,53,13,H1
"Columbia County, WA",2009-2010,3977,4112,135,3.395,-15,150,53,13,H1
"Columbia County, WA",2010-2011,4112,4022,-90,-2.189,-22,-68,53,13,H1
"Columbia County, WA",2011-2012,4022,4001,-21,-0.522,-20,-1,53,13,H1
"Columbia County, WA",2012-2013,4001,4036,35,0.875,9,26,53,13,H1
"Columbia County, WA",2013-2014,4036,3985,-51,-1.264,-10,-41,53,13,H1
"Columbia County, WA",2014-2015,3974,3944,-30,-0.755,-8,-22,53,13,H1
"Columbia County, WA",2015-2016,3944,3997,53,1.344,0,53,53,13,H1
"Columbia County, WA",2016-2017,3997,4047,50,1.251,-10,60,53,13,H1
"Cowlitz County, WA",2000-2001,92984,93608,624,0.671,346,278,53,15,H1
"Cowlitz County, WA",2001-2002,93608,94325,717,0.766,326,391,53,15,H1
"Cowlitz County, WA",2002-2003,94325,94516,191,0.202,193,-2,53,15,H1
"Cowlitz County, WA",2003-2004,94516,95541,1025,1.084,230,795,53,15,H1
"Cowlitz County, WA",2004-2005,95541,96536,995,1.041,252,743,53,15,H1
"Cowlitz County, WA",2005-2006,96536,99162,2626,2.72,253,2373,53,15,H1
"Cowlitz County, WA",2006-2007,99162,100744,1582,1.595,366,1216,53,15,H1
"Cowlitz County, WA",2007-2008,100744,101688,944,0.937,367,577,53,15,H1
"Cowlitz County, WA",2008-2009,101688,102126,438,0.431,363,75,53,15,H1
"Cowlitz County, WA",2009-2010,102126,102392,266,0.26,302,-36,53,15,H1
"Cowlitz County, WA",2010-2011,102392,102329,-63,-0.062,311,-374,53,15,H1
"Cowlitz County, WA",2011-2012,102329,101777,-552,-0.539,161,-713,53,15,H1
"Cowlitz County, WA",2012-2013,101777,101729,-48,-0.047,55,-103,53,15,H1
"Cowlitz County, WA",2013-2014,101729,102133,404,0.397,84,320,53,15,H1
"Cowlitz County, WA",2014-2015,102214,103468,1254,1.227,118,1136,53,15,H1
"Cowlitz County, WA",2015-2016,103468,104756,1288,1.245,103,1185,53,15,H1
"Cowlitz County, WA",2016-2017,104756,106910,2154,2.056,149,2005,53,15,H1
"Douglas County, WA",2000-2001,32674,32787,113,0.346,213,-100,53,17,H1
"Douglas County, WA",2001-2002,32787,33044,257,0.784,195,62,53,17,H1
"Douglas County, WA",2002-2003,33044,33481,437,1.322,180,257,53,17,H1
"Douglas County, WA",2003-2004,33481,34086,605,1.807,164,441,53,17,H1
"Douglas County, WA",2004-2005,34086,34622,536,1.572,236,300,53,17,H1
"Douglas County, WA",2005-2006,34622,35558,936,2.703,229,707,53,17,H1
"Douglas County, WA",2006-2007,35558,36503,945,2.658,314,631,53,17,H1
"Douglas County, WA",2007-2008,36503,37216,713,1.953,277,436,53,17,H1
"Douglas County, WA",2008-2009,37216,37935,719,1.932,302,417,53,17,H1
"Douglas County, WA",2009-2010,37935,38534,599,1.579,249,350,53,17,H1
"Douglas County, WA",2010-2011,38534,38791,257,0.667,234,23,53,17,H1
"Douglas County, WA",2011-2012,38791,39325,534,1.377,235,299,53,17,H1
"Douglas County, WA",2012-2013,39325,39459,134,0.341,208,-74,53,17,H1
"Douglas County, WA",2013-2014,39459,39804,345,0.874,206,139,53,17,H1
"Douglas County, WA",2014-2015,39822,40534,712,1.788,216,496,53,17,H1
"Douglas County, WA",2015-2016,40534,41272,738,1.821,199,539,53,17,H1
"Douglas County, WA",2016-2017,41272,41945,673,1.631,225,448,53,17,H1
"Ferry County, WA",2000-2001,7276,7285,9,0.124,24,-15,53,19,H1
"Ferry County, WA",2001-2002,7285,7280,-5,-0.069,12,-17,53,19,H1
"Ferry County, WA",2002-2003,7280,7424,144,1.978,30,114,53,19,H1
"Ferry County, WA",2003-2004,7424,7478,54,0.727,-1,55,53,19,H1
"Ferry County, WA",2004-2005,7478,7495,17,0.227,-17,34,53,19,H1
"Ferry County, WA",2005-2006,7495,7562,67,0.894,-2,69,53,19,H1
"Ferry County, WA",2006-2007,7562,7430,-132,-1.746,-12,-120,53,19,H1
"Ferry County, WA",2007-2008,7430,7439,9,0.121,-2,11,53,19,H1
"Ferry County, WA",2008-2009,7439,7538,99,1.331,12,87,53,19,H1
"Ferry County, WA",2009-2010,7538,7549,11,0.146,-8,19,53,19,H1
"Ferry County, WA",2010-2011,7549,7689,140,1.855,-30,170,53,19,H1
"Ferry County, WA",2011-2012,7689,7719,30,0.39,-8,38,53,19,H1
"Ferry County, WA",2012-2013,7719,7663,-56,-0.725,-7,-49,53,19,H1
"Ferry County, WA",2013-2014,7663,7667,4,0.052,-10,14,53,19,H1
"Ferry County, WA",2014-2015,7651,7582,-69,-0.902,-3,-66,53,19,H1
"Ferry County, WA",2015-2016,7582,7542,-40,-0.528,-3,-37,53,19,H1
"Ferry County, WA",2016-2017,7542,7594,52,0.689,-14,66,53,19,H1
"Franklin County, WA",2000-2001,49565,50511,946,1.909,844,102,53,21,H1
"Franklin County, WA",2001-2002,50511,52365,1854,3.67,878,976,53,21,H1
"Franklin County, WA",2002-2003,52365,55447,3082,5.886,1003,2079,53,21,H1
"Franklin County, WA",2003-2004,55447,58165,2718,4.902,1018,1700,53,21,H1
"Franklin County, WA",2004-2005,58165,61360,3195,5.493,1153,2042,53,21,H1
"Franklin County, WA",2005-2006,61360,64585,3225,5.256,1209,2016,53,21,H1
"Franklin County, WA",2006-2007,64585,67586,3001,4.647,1269,1732,53,21,H1
"Franklin County, WA",2007-2008,67586,70775,3189,4.718,1369,1820,53,21,H1
"Franklin County, WA",2008-2009,70775,74478,3703,5.232,1444,2259,53,21,H1
"Franklin County, WA",2009-2010,74478,79122,4644,6.235,1380,3264,53,21,H1
"Franklin County, WA",2010-2011,79122,83164,4042,5.109,1334,2708,53,21,H1
"Franklin County, WA",2011-2012,83164,85831,2667,3.207,1385,1282,53,21,H1
"Franklin County, WA",2012-2013,85831,86614,783,0.912,1293,-510,53,21,H1
"Franklin County, WA",2013-2014,86614,87809,1195,1.38,1209,-14,53,21,H1
"Franklin County, WA",2014-2015,87822,88807,985,1.122,1235,-250,53,21,H1
"Franklin County, WA",2015-2016,88807,90315,1508,1.698,1297,211,53,21,H1
"Franklin County, WA",2016-2017,90315,92125,1810,2.004,1226,584,53,21,H1
"Garfield County, WA",2000-2001,2383,2313,-70,-2.937,-3,-67,53,23,H1
"Garfield County, WA",2001-2002,2313,2293,-20,-0.865,-16,-4,53,23,H1
"Garfield County, WA",2002-2003,2293,2316,23,1.003,-3,26,53,23,H1
"Garfield County, WA",2003-2004,2316,2270,-46,-1.986,-16,-30,53,23,H1
"Garfield County, WA",2004-2005,2270,2274,4,0.176,-12,16,53,23,H1
"Garfield County, WA",2005-2006,2274,2245,-29,-1.275,-8,-21,53,23,H1
"Garfield County, WA",2006-2007,2245,2203,-42,-1.871,-9,-33,53,23,H1
"Garfield County, WA",2007-2008,2203,2244,41,1.861,-4,45,53,23,H1
"Garfield County, WA",2008-2009,2244,2237,-7,-0.312,3,-10,53,23,H1
"Garfield County, WA",2009-2010,2237,2265,28,1.252,5,23,53,23,H1
"Garfield County, WA",2010-2011,2265,2248,-17,-0.751,-6,-11,53,23,H1
"Garfield County, WA",2011-2012,2248,2225,-23,-1.023,-18,-5,53,23,H1
"Garfield County, WA",2012-2013,2225,2248,23,1.034,-7,30,53,23,H1
"Garfield County, WA",2013-2014,2248,2215,-33,-1.468,-1,-32,53,23,H1
"Garfield County, WA",2014-2015,2212,2219,7,0.316,3,4,53,23,H1
"Garfield County, WA",2015-2016,2219,2257,38,1.712,9,29,53,23,H1
"Garfield County, WA",2016-2017,2257,2210,-47,-2.082,3,-50,53,23,H1
"Grant County, WA",2000-2001,74918,76044,1126,1.503,887,239,53,25,H1
"Grant County, WA",2001-2002,76044,76944,900,1.184,811,89,53,25,H1
"Grant County, WA",2002-2003,76944,77955,1011,1.314,790,221,53,25,H1
"Grant County, WA",2003-2004,77955,78734,779,0.999,888,-109,53,25,H1
"Grant County, WA",2004-2005,78734,79531,797,1.012,833,-36,53,25,H1
"Grant County, WA",2005-2006,79531,81036,1505,1.892,957,548,53,25,H1
"Grant County, WA",2006-2007,81036,82645,1609,1.986,933,676,53,25,H1
"Grant County, WA",2007-2008,82645,84944,2299,2.782,1015,1284,53,25,H1
"Grant County, WA",2008-2009,84944,87340,2396,2.821,1006,1390,53,25,H1
"Grant County, WA",2009-2010,87340,89592,2252,2.578,982,1270,53,25,H1
"Grant County, WA",2010-2011,89592,90781,1189,1.327,967,222,53,25,H1
"Grant County, WA",2011-2012,90781,91688,907,0.999,896,11,53,25,H1
"Grant County, WA",2012-2013,91688,92084,396,0.432,885,-489,53,25,H1
"Grant County, WA",2013-2014,92084,93147,1063,1.154,903,160,53,25,H1
"Grant County, WA",2014-2015,92838,93259,421,0.453,865,-444,53,25,H1
"Grant County, WA",2015-2016,93259,93904,645,0.692,771,-126,53,25,H1
"Grant County, WA",2016-2017,93904,95158,1254,1.335,801,453,53,25,H1
"Grays Harbor County, WA",2000-2001,67075,67896,821,1.224,-98,919,53,27,H1
"Grays Harbor County, WA",2001-2002,67896,68264,368,0.542,-26,394,53,27,H1
"Grays Harbor County, WA",2002-2003,68264,69065,801,1.173,103,698,53,27,H1
"Grays Harbor County, WA",2003-2004,69065,69775,710,1.028,21,689,53,27,H1
"Grays Harbor County, WA",2004-2005,69775,70423,648,0.929,52,596,53,27,H1
"Grays Harbor County, WA",2005-2006,70423,71256,833,1.183,140,693,53,27,H1
"Grays Harbor County, WA",2006-2007,71256,71827,571,0.801,107,464,53,27,H1
"Grays Harbor County, WA",2007-2008,71827,72027,200,0.278,78,122,53,27,H1
"Grays Harbor County, WA",2008-2009,72027,72468,441,0.612,137,304,53,27,H1
"Grays Harbor County, WA",2009-2010,72468,72833,365,0.504,96,269,53,27,H1
"Grays Harbor County, WA",2010-2011,72833,72311,-522,-0.717,29,-551,53,27,H1
"Grays Harbor County, WA",2011-2012,72311,71705,-606,-0.838,30,-636,53,27,H1
"Grays Harbor County, WA",2012-2013,71705,71001,-704,-0.982,-36,-668,53,27,H1
"Grays Harbor County, WA",2013-2014,71001,70818,-183,-0.258,-16,-167,53,27,H1
"Grays Harbor County, WA",2014-2015,70836,71122,286,0.404,-52,338,53,27,H1
"Grays Harbor County, WA",2015-2016,71122,71625,503,0.707,-75,578,53,27,H1
"Grays Harbor County, WA",2016-2017,71625,72697,1072,1.497,-53,1125,53,27,H1
"Island County, WA",2000-2001,71886,73884,1998,2.779,377,1621,53,29,H1
"Island County, WA",2001-2002,73884,74840,956,1.294,339,617,53,29,H1
"Island County, WA",2002-2003,74840,74670,-170,-0.227,388,-558,53,29,H1
"Island County, WA",2003-2004,74670,77667,2997,4.014,352,2645,53,29,H1
"Island County, WA",2004-2005,77667,77589,-78,-0.1,388,-466,53,29,H1
"Island County, WA",2005-2006,77589,79136,1547,1.994,373,1174,53,29,H1
"Island County, WA",2006-2007,79136,78726,-410,-0.518,354,-764,53,29,H1
"Island County, WA",2007-2008,78726,78375,-351,-0.446,241,-592,53,29,H1
"Island County, WA",2008-2009,78375,78248,-127,-0.162,115,-242,53,29,H1
"Island County, WA",2009-2010,78248,78692,444,0.567,155,289,53,29,H1
"Island County, WA",2010-2011,78692,78969,277,0.352,235,42,53,29,H1
"Island County, WA",2011-2012,78969,79230,261,0.331,253,8,53,29,H1
"Island County, WA",2012-2013,79230,78589,-641,-0.809,263,-904,53,29,H1
"Island County, WA",2013-2014,78589,79275,686,0.873,230,456,53,29,H1
"Island County, WA",2014-2015,79235,80593,1358,1.714,245,1113,53,29,H1
"Island County, WA",2015-2016,80593,81638,1045,1.297,218,827,53,29,H1
"Island County, WA",2016-2017,81638,83159,1521,1.863,232,1289,53,29,H1
"Jefferson County, WA",2000-2001,26414,26845,431,1.632,-56,487,53,31,H1
"Jefferson County, WA",2001-2002,26845,27201,356,1.326,-48,404,53,31,H1
"Jefferson County, WA",2002-2003,27201,27588,387,1.423,-83,470,53,31,H1
"Jefferson County, WA",2003-2004,27588,27949,361,1.309,-95,456,53,31,H1
"Jefferson County, WA",2004-2005,27949,28506,557,1.993,-102,659,53,31,H1
"Jefferson County, WA",2005-2006,28506,29239,733,2.571,-101,834,53,31,H1
"Jefferson County, WA",2006-2007,29239,29346,107,0.366,-72,179,53,31,H1
"Jefferson County, WA",2007-2008,29346,29648,302,1.029,-97,399,53,31,H1
"Jefferson County, WA",2008-2009,29648,29714,66,0.223,-107,173,53,31,H1
"Jefferson County, WA",2009-2010,29714,29904,190,0.639,-137,327,53,31,H1
"Jefferson County, WA",2010-2011,29904,29868,-36,-0.12,-165,129,53,31,H1
"Jefferson County, WA",2011-2012,29868,29823,-45,-0.151,-145,100,53,31,H1
"Jefferson County, WA",2012-2013,29823,30067,244,0.818,-114,358,53,31,H1
"Jefferson County, WA",2013-2014,30067,30228,161,0.535,-138,299,53,31,H1
"Jefferson County, WA",2014-2015,30206,30466,260,0.861,-137,397,53,31,H1
"Jefferson County, WA",2015-2016,30466,30909,443,1.454,-186,629,53,31,H1
"Jefferson County, WA",2016-2017,30909,31234,325,1.051,-185,510,53,31,H1
"King County, WA",2000-2001,1739009,1754090,15081,0.867,10503,4578,53,33,H1
"King County, WA",2001-2002,1754090,1758685,4595,0.262,10315,-5720,53,33,H1
"King County, WA",2002-2003,1758685,1763440,4755,0.27,10477,-5722,53,33,H1
"King County, WA",2003-2004,1763440,1775297,11857,0.672,11196,661,53,33,H1
"King County, WA",2004-2005,1775297,1795268,19971,1.125,11340,8631,53,33,H1
"King County, WA",2005-2006,1795268,1822967,27699,1.543,12040,15659,53,33,H1
"King County, WA",2006-2007,1822967,1847986,25019,1.372,12974,12045,53,33,H1
"King County, WA",2007-2008,1847986,1875020,27034,1.463,12300,14734,53,33,H1
"King County, WA",2008-2009,1875020,1912012,36992,1.973,11448,25544,53,33,H1
"King County, WA",2009-2010,1912012,1937424,25412,1.329,13166,12246,53,33,H1
"King County, WA",2010-2011,1937424,1972113,34689,1.79,12350,22339,53,33,H1
"King County, WA",2011-2012,1972113,2008526,36413,1.846,12523,23890,53,33,H1
"King County, WA",2012-2013,2008526,2046956,38430,1.913,12838,25592,53,33,H1
"King County, WA",2013-2014,2046956,2079967,33011,1.613,12797,20214,53,33,H1
"King County, WA",2014-2015,2082288,2117125,34837,1.673,12714,22123,53,33,H1
"King County, WA",2015-2016,2117125,2155962,38837,1.834,12531,26306,53,33,H1
"King County, WA",2016-2017,2155962,2188649,32687,1.516,12517,20170,53,33,H1
"Kitsap County, WA",2000-2001,232720,234513,1793,0.77,1187,606,53,35,H1
"Kitsap County, WA",2001-2002,234513,238129,3616,1.542,1158,2458,53,35,H1
"Kitsap County, WA",2002-2003,238129,239758,1629,0.684,1274,355,53,35,H1
"Kitsap County, WA",2003-2004,239758,241960,2202,0.918,1157,1045,53,35,H1
"Kitsap County, WA",2004-2005,241960,239806,-2154,-0.89,1135,-3289,53,35,H1
"Kitsap County, WA",2005-2006,239806,245054,5248,2.188,1298,3950,53,35,H1
"Kitsap County, WA",2006-2007,245054,244105,-949,-0.387,1205,-2154,53,35,H1
"Kitsap County, WA",2007-2008,244105,246912,2807,1.15,981,1826,53,35,H1
"Kitsap County, WA",2008-2009,246912,248800,1888,0.765,1088,800,53,35,H1
"Kitsap County, WA",2009-2010,248800,251650,2850,1.145,1018,1832,53,35,H1
"Kitsap County, WA",2010-2011,251650,254372,2722,1.082,933,1789,53,35,H1
"Kitsap County, WA",2011-2012,254372,254659,287,0.113,1107,-820,53,35,H1
"Kitsap County, WA",2012-2013,254659,253205,-1454,-0.571,887,-2341,53,35,H1
"Kitsap County, WA",2013-2014,253205,254183,978,0.386,801,177,53,35,H1
"Kitsap County, WA",2014-2015,254525,260131,5606,2.203,753,4853,53,35,H1
"Kitsap County, WA",2015-2016,260131,263109,2978,1.145,904,2074,53,35,H1
"Kitsap County, WA",2016-2017,263109,266414,3305,1.256,830,2475,53,35,H1
"Kittitas County, WA",2000-2001,33537,3.40E+04,463,1.381,129,334,53,37,H1
"Kittitas County, WA",2001-2002,3.40E+04,34977,977,2.874,93,884,53,37,H1
"Kittitas County, WA",2002-2003,34977,35726,749,2.141,133,616,53,37,H1
"Kittitas County, WA",2003-2004,35726,36921,1195,3.345,101,1094,53,37,H1
"Kittitas County, WA",2004-2005,36921,37537,616,1.668,103,513,53,37,H1
"Kittitas County, WA",2005-2006,37537,38680,1143,3.045,110,1033,53,37,H1
"Kittitas County, WA",2006-2007,38680,39158,478,1.236,118,360,53,37,H1
"Kittitas County, WA",2007-2008,39158,40015,857,2.189,155,702,53,37,H1
"Kittitas County, WA",2008-2009,40015,40466,451,1.127,179,272,53,37,H1
"Kittitas County, WA",2009-2010,40466,41011,545,1.347,146,399,53,37,H1
"Kittitas County, WA",2010-2011,41011,41575,564,1.375,141,423,53,37,H1
"Kittitas County, WA",2011-2012,41575,41638,63,0.152,134,-71,53,37,H1
"Kittitas County, WA",2012-2013,41638,41781,143,0.343,115,28,53,37,H1
"Kittitas County, WA",2013-2014,41781,42522,741,1.774,138,603,53,37,H1
"Kittitas County, WA",2014-2015,42661,43269,608,1.425,150,458,53,37,H1
"Kittitas County, WA",2015-2016,43269,44928,1659,3.834,104,1555,53,37,H1
"Kittitas County, WA",2016-2017,44928,46205,1277,2.842,138,1139,53,37,H1
"Klickitat County, WA",2000-2001,19204,19161,-43,-0.224,70,-113,53,39,H1
"Klickitat County, WA",2001-2002,19161,19060,-101,-0.527,39,-140,53,39,H1
"Klickitat County, WA",2002-2003,19060,19242,182,0.955,89,93,53,39,H1
"Klickitat County, WA",2003-2004,19242,19232,-10,-0.052,61,-71,53,39,H1
"Klickitat County, WA",2004-2005,19232,19279,47,0.244,42,5,53,39,H1
"Klickitat County, WA",2005-2006,19279,19701,422,2.189,42,380,53,39,H1
"Klickitat County, WA",2006-2007,19701,19898,197,1,65,132,53,39,H1
"Klickitat County, WA",2007-2008,19898,20135,237,1.191,44,193,53,39,H1
"Klickitat County, WA",2008-2009,20135,20164,29,0.144,64,-35,53,39,H1
"Klickitat County, WA",2009-2010,20164,20360,196,0.972,49,147,53,39,H1
"Klickitat County, WA",2010-2011,20360,20664,304,1.493,58,246,53,39,H1
"Klickitat County, WA",2011-2012,20664,20613,-51,-0.247,16,-67,53,39,H1
"Klickitat County, WA",2012-2013,20613,20843,230,1.116,34,196,53,39,H1
"Klickitat County, WA",2013-2014,20843,20861,18,0.086,29,-11,53,39,H1
"Klickitat County, WA",2014-2015,20883,21026,143,0.685,20,123,53,39,H1
"Klickitat County, WA",2015-2016,21026,21306,280,1.332,25,255,53,39,H1
"Klickitat County, WA",2016-2017,21306,21811,505,2.37,8,497,53,39,H1
"Lewis County, WA",2000-2001,68596,68934,338,0.493,158,180,53,41,H1
"Lewis County, WA",2001-2002,68934,69452,518,0.751,72,446,53,41,H1
"Lewis County, WA",2002-2003,69452,70366,914,1.316,131,783,53,41,H1
"Lewis County, WA",2003-2004,70366,71021,655,0.931,12,643,53,41,H1
"Lewis County, WA",2004-2005,71021,72060,1039,1.463,96,943,53,41,H1
"Lewis County, WA",2005-2006,72060,73318,1258,1.746,169,1089,53,41,H1
"Lewis County, WA",2006-2007,73318,74229,911,1.243,215,696,53,41,H1
"Lewis County, WA",2007-2008,74229,74899,670,0.903,182,488,53,41,H1
"Lewis County, WA",2008-2009,74899,75316,417,0.557,154,263,53,41,H1
"Lewis County, WA",2009-2010,75316,75487,171,0.227,122,49,53,41,H1
"Lewis County, WA",2010-2011,75487,75660,173,0.229,55,118,53,41,H1
"Lewis County, WA",2011-2012,75660,75532,-128,-0.169,50,-178,53,41,H1
"Lewis County, WA",2012-2013,75532,75102,-430,-0.569,61,-491,53,41,H1
"Lewis County, WA",2013-2014,75102,75128,26,0.035,55,-29,53,41,H1
"Lewis County, WA",2014-2015,75224,75882,658,0.875,52,606,53,41,H1
"Lewis County, WA",2015-2016,75882,76630,748,0.986,89,659,53,41,H1
"Lewis County, WA",2016-2017,76630,78200,1570,2.049,51,1519,53,41,H1
"Lincoln County, WA",2000-2001,10143,10123,-20,-0.197,-27,7,53,43,H1
"Lincoln County, WA",2001-2002,10123,10092,-31,-0.306,-17,-14,53,43,H1
"Lincoln County, WA",2002-2003,10092,10206,114,1.13,-12,126,53,43,H1
"Lincoln County, WA",2003-2004,10206,10442,236,2.312,-20,256,53,43,H1
"Lincoln County, WA",2004-2005,10442,10350,-92,-0.881,-18,-74,53,43,H1
"Lincoln County, WA",2005-2006,10350,10418,68,0.657,-25,93,53,43,H1
"Lincoln County, WA",2006-2007,10418,10509,91,0.873,21,70,53,43,H1
"Lincoln County, WA",2007-2008,10509,10608,99,0.942,-17,116,53,43,H1
"Lincoln County, WA",2008-2009,10608,10570,-38,-0.358,-2,-36,53,43,H1
"Lincoln County, WA",2009-2010,10570,10563,-7,-0.066,-26,19,53,43,H1
"Lincoln County, WA",2010-2011,10563,10513,-50,-0.473,-21,-29,53,43,H1
"Lincoln County, WA",2011-2012,10513,10437,-76,-0.723,-31,-45,53,43,H1
"Lincoln County, WA",2012-2013,10437,10283,-154,-1.476,-4,-150,53,43,H1
"Lincoln County, WA",2013-2014,10283,10250,-33,-0.321,-20,-13,53,43,H1
"Lincoln County, WA",2014-2015,10253,10321,68,0.663,-12,80,53,43,H1
"Lincoln County, WA",2015-2016,10321,10333,12,0.116,-18,30,53,43,H1
"Lincoln County, WA",2016-2017,10333,10579,246,2.381,-14,260,53,43,H1
"Mason County, WA",2000-2001,49631,50298,667,1.344,42,625,53,45,H1
"Mason County, WA",2001-2002,50298,51215,917,1.823,19,898,53,45,H1
"Mason County, WA",2002-2003,51215,52351,1136,2.218,46,1090,53,45,H1
"Mason County, WA",2003-2004,52351,53819,1468,2.804,59,1409,53,45,H1
"Mason County, WA",2004-2005,53819,55198,1379,2.562,-17,1396,53,45,H1
"Mason County, WA",2005-2006,55198,56872,1674,3.033,76,1598,53,45,H1
"Mason County, WA",2006-2007,56872,58679,1807,3.177,38,1769,53,45,H1
"Mason County, WA",2007-2008,58679,59785,1106,1.885,85,1021,53,45,H1
"Mason County, WA",2008-2009,59785,60333,548,0.917,123,425,53,45,H1
"Mason County, WA",2009-2010,60333,60750,417,0.691,82,335,53,45,H1
"Mason County, WA",2010-2011,60750,60905,155,0.255,-19,174,53,45,H1
"Mason County, WA",2011-2012,60905,60751,-154,-0.253,15,-169,53,45,H1
"Mason County, WA",2012-2013,60751,60521,-230,-0.379,58,-288,53,45,H1
"Mason County, WA",2013-2014,60521,60711,190,0.314,36,154,53,45,H1
"Mason County, WA",2014-2015,60694,61023,329,0.542,-6,335,53,45,H1
"Mason County, WA",2015-2016,61023,62123,1100,1.803,-11,1111,53,45,H1
"Mason County, WA",2016-2017,62123,63710,1587,2.555,-12,1599,53,45,H1
"Okanogan County, WA",2000-2001,39566,39126,-440,-1.112,160,-600,53,47,H1
"Okanogan County, WA",2001-2002,39126,38865,-261,-0.667,113,-374,53,47,H1
"Okanogan County, WA",2002-2003,38865,38575,-290,-0.746,50,-340,53,47,H1
"Okanogan County, WA",2003-2004,38575,38847,272,0.705,123,149,53,47,H1
"Okanogan County, WA",2004-2005,38847,39143,296,0.762,186,110,53,47,H1
"Okanogan County, WA",2005-2006,39143,39322,179,0.457,190,-11,53,47,H1
"Okanogan County, WA",2006-2007,39322,39676,354,0.9,228,126,53,47,H1
"Okanogan County, WA",2007-2008,39676,40235,559,1.409,184,375,53,47,H1
"Okanogan County, WA",2008-2009,40235,40699,464,1.153,185,279,53,47,H1
"Okanogan County, WA",2009-2010,40699,41236,537,1.319,172,365,53,47,H1
"Okanogan County, WA",2010-2011,41236,41325,89,0.216,176,-87,53,47,H1
"Okanogan County, WA",2011-2012,41325,41218,-107,-0.259,138,-245,53,47,H1
"Okanogan County, WA",2012-2013,41218,41136,-82,-0.199,111,-193,53,47,H1
"Okanogan County, WA",2013-2014,41136,41290,154,0.374,97,57,53,47,H1
"Okanogan County, WA",2014-2015,41347,41516,169,0.409,65,104,53,47,H1
"Okanogan County, WA",2015-2016,41516,41479,-37,-0.089,35,-72,53,47,H1
"Okanogan County, WA",2016-2017,41479,41742,263,0.634,15,248,53,47,H1
"Pacific County, WA",2000-2001,20939,20631,-308,-1.471,-114,-194,53,49,H1
"Pacific County, WA",2001-2002,20631,20514,-117,-0.567,-136,19,53,49,H1
"Pacific County, WA",2002-2003,20514,20885,371,1.809,-116,487,53,49,H1
"Pacific County, WA",2003-2004,20885,20953,68,0.326,-102,170,53,49,H1
"Pacific County, WA",2004-2005,20953,21228,275,1.312,-86,361,53,49,H1
"Pacific County, WA",2005-2006,21228,21326,98,0.462,-69,167,53,49,H1
"Pacific County, WA",2006-2007,21326,21415,89,0.417,-62,151,53,49,H1
"Pacific County, WA",2007-2008,21415,21305,-110,-0.514,-83,-27,53,49,H1
"Pacific County, WA",2008-2009,21305,21026,-279,-1.31,-71,-208,53,49,H1
"Pacific County, WA",2009-2010,21026,20899,-127,-0.604,-95,-32,53,49,H1
"Pacific County, WA",2010-2011,20899,20867,-32,-0.153,-105,73,53,49,H1
"Pacific County, WA",2011-2012,20867,20563,-304,-1.457,-74,-230,53,49,H1
"Pacific County, WA",2012-2013,20563,20434,-129,-0.627,-105,-24,53,49,H1
"Pacific County, WA",2013-2014,20434,20561,127,0.622,-114,241,53,49,H1
"Pacific County, WA",2014-2015,20551,20848,297,1.445,-123,420,53,49,H1
"Pacific County, WA",2015-2016,20848,21209,361,1.732,-115,476,53,49,H1
"Pacific County, WA",2016-2017,21209,21626,417,1.966,-123,540,53,49,H1
"Pend Oreille County, WA",2000-2001,11672,11807,135,1.157,5,130,53,51,H1
"Pend Oreille County, WA",2001-2002,11807,11934,127,1.076,7,120,53,51,H1
"Pend Oreille County, WA",2002-2003,11934,12029,95,0.796,-25,120,53,51,H1
"Pend Oreille County, WA",2003-2004,12029,12244,215,1.787,-27,242,53,51,H1
"Pend Oreille County, WA",2004-2005,12244,12357,113,0.923,-26,139,53,51,H1
"Pend Oreille County, WA",2005-2006,12357,12681,324,2.622,12,312,53,51,H1
"Pend Oreille County, WA",2006-2007,12681,12828,147,1.159,-7,154,53,51,H1
"Pend Oreille County, WA",2007-2008,12828,12985,157,1.224,-9,166,53,51,H1
"Pend Oreille County, WA",2008-2009,12985,13043,58,0.447,-6,64,53,51,H1
"Pend Oreille County, WA",2009-2010,13043,12971,-72,-0.552,-9,-63,53,51,H1
"Pend Oreille County, WA",2010-2011,12971,12946,-25,-0.193,-32,7,53,51,H1
"Pend Oreille County, WA",2011-2012,12946,12998,52,0.402,-28,80,53,51,H1
"Pend Oreille County, WA",2012-2013,12998,12924,-74,-0.569,-20,-54,53,51,H1
"Pend Oreille County, WA",2013-2014,12924,12985,61,0.472,-21,82,53,51,H1
"Pend Oreille County, WA",2014-2015,12941,13088,147,1.136,-27,174,53,51,H1
"Pend Oreille County, WA",2015-2016,13088,13126,38,0.29,-17,55,53,51,H1
"Pend Oreille County, WA",2016-2017,13126,13354,228,1.737,-12,240,53,51,H1
"Pierce County, WA",2000-2001,703993,716447,12454,1.769,4836,7618,53,53,H1
"Pierce County, WA",2001-2002,716447,728091,11644,1.625,4617,7027,53,53,H1
"Pierce County, WA",2002-2003,728091,733969,5878,0.807,4564,1314,53,53,H1
"Pierce County, WA",2003-2004,733969,740137,6168,0.84,4878,1290,53,53,H1
"Pierce County, WA",2004-2005,740137,748148,8011,1.082,4731,3280,53,53,H1
"Pierce County, WA",2005-2006,748148,763408,15260,2.04,5562,9698,53,53,H1
"Pierce County, WA",2006-2007,763408,772484,9076,1.189,5753,3323,53,53,H1
"Pierce County, WA",2007-2008,772484,785400,12916,1.672,5526,7390,53,53,H1
"Pierce County, WA",2008-2009,785400,796483,11083,1.411,5190,5893,53,53,H1
"Pierce County, WA",2009-2010,796483,795448,-1035,-0.13,5446,-6481,53,53,H1
"Pierce County, WA",2010-2011,795448,803486,8038,1.01,5072,2966,53,53,H1
"Pierce County, WA",2011-2012,803486,812363,8877,1.105,5720,3157,53,53,H1
"Pierce County, WA",2012-2013,812363,820219,7856,0.967,5136,2720,53,53,H1
"Pierce County, WA",2013-2014,820219,831928,11709,1.428,4909,6800,53,53,H1
"Pierce County, WA",2014-2015,831161,843954,12793,1.539,5025,7768,53,53,H1
"Pierce County, WA",2015-2016,843954,859752,15798,1.872,4952,10846,53,53,H1
"Pierce County, WA",2016-2017,859752,876764,17012,1.979,4842,12170,53,53,H1
"San Juan County, WA",2000-2001,14120,14334,214,1.516,-12,226,53,55,H1
"San Juan County, WA",2001-2002,14334,14628,294,2.051,-35,329,53,55,H1
"San Juan County, WA",2002-2003,14628,14787,159,1.087,-27,186,53,55,H1
"San Juan County, WA",2003-2004,14787,15071,284,1.921,-12,296,53,55,H1
"San Juan County, WA",2004-2005,15071,15167,96,0.637,-14,110,53,55,H1
"San Juan County, WA",2005-2006,15167,15270,103,0.679,-10,113,53,55,H1
"San Juan County, WA",2006-2007,15270,15400,130,0.851,-17,147,53,55,H1
"San Juan County, WA",2007-2008,15400,15590,190,1.234,-18,208,53,55,H1
"San Juan County, WA",2008-2009,15590,15714,124,0.795,-14,138,53,55,H1
"San Juan County, WA",2009-2010,15714,15757,43,0.274,-37,80,53,55,H1
"San Juan County, WA",2010-2011,15757,15802,45,0.286,-34,79,53,55,H1
"San Juan County, WA",2011-2012,15802,15792,-10,-0.063,-60,50,53,55,H1
"San Juan County, WA",2012-2013,15792,15871,79,0.5,-59,138,53,55,H1
"San Juan County, WA",2013-2014,15871,16015,144,0.907,-32,176,53,55,H1
"San Juan County, WA",2014-2015,16026,16252,226,1.41,-26,252,53,55,H1
"San Juan County, WA",2015-2016,16252,16296,44,0.271,-67,111,53,55,H1
"San Juan County, WA",2016-2017,16296,16715,419,2.571,-58,477,53,55,H1
"Skagit County, WA",2000-2001,103420,104534,1114,1.077,493,621,53,57,H1
"Skagit County, WA",2001-2002,104534,105563,1029,0.984,438,591,53,57,H1
"Skagit County, WA",2002-2003,105563,107369,1806,1.711,285,1521,53,57,H1
"Skagit County, WA",2003-2004,107369,109030,1661,1.547,361,1300,53,57,H1
"Skagit County, WA",2004-2005,109030,110683,1653,1.516,502,1151,53,57,H1
"Skagit County, WA",2005-2006,110683,112621,1938,1.751,384,1554,53,57,H1
"Skagit County, WA",2006-2007,112621,114066,1445,1.283,577,868,53,57,H1
"Skagit County, WA",2007-2008,114066,115808,1742,1.527,502,1240,53,57,H1
"Skagit County, WA",2008-2009,115808,116557,749,0.647,511,238,53,57,H1
"Skagit County, WA",2009-2010,116557,116967,410,0.352,448,-38,53,57,H1
"Skagit County, WA",2010-2011,116967,117740,773,0.661,397,376,53,57,H1
"Skagit County, WA",2011-2012,117740,118005,265,0.225,340,-75,53,57,H1
"Skagit County, WA",2012-2013,118005,118742,737,0.625,341,396,53,57,H1
"Skagit County, WA",2013-2014,118742,120365,1623,1.367,342,1281,53,57,H1
"Skagit County, WA",2014-2015,120325,121846,1521,1.264,286,1235,53,57,H1
"Skagit County, WA",2015-2016,121846,123390,1544,1.267,288,1256,53,57,H1
"Skagit County, WA",2016-2017,123390,125619,2229,1.806,262,1967,53,57,H1
"Skamania County, WA",2000-2001,9895,9833,-62,-0.627,25,-87,53,59,H1
"Skamania County, WA",2001-2002,9833,9886,53,0.539,29,24,53,59,H1
"Skamania County, WA",2002-2003,9886,10046,160,1.618,53,107,53,59,H1
"Skamania County, WA",2003-2004,10046,10236,190,1.891,34,156,53,59,H1
"Skamania County, WA",2004-2005,10236,10303,67,0.655,2,65,53,59,H1
"Skamania County, WA",2005-2006,10303,10583,280,2.718,15,265,53,59,H1
"Skamania County, WA",2006-2007,10583,10786,203,1.918,55,148,53,59,H1
"Skamania County, WA",2007-2008,10786,10918,132,1.224,35,97,53,59,H1
"Skamania County, WA",2008-2009,10918,10955,37,0.339,32,5,53,59,H1
"Skamania County, WA",2009-2010,10955,11099,144,1.314,31,113,53,59,H1
"Skamania County, WA",2010-2011,11099,11124,25,0.225,15,10,53,59,H1
"Skamania County, WA",2011-2012,11124,11151,27,0.243,15,12,53,59,H1
"Skamania County, WA",2012-2013,11151,11255,104,0.933,44,60,53,59,H1
"Skamania County, WA",2013-2014,11255,11340,85,0.755,28,57,53,59,H1
"Skamania County, WA",2014-2015,11338,11339,1,0.009,17,-16,53,59,H1
"Skamania County, WA",2015-2016,11339,11593,254,2.24,21,233,53,59,H1
"Skamania County, WA",2016-2017,11593,11837,244,2.105,8,236,53,59,H1
"Snohomish County, WA",2000-2001,609185,622390,13205,2.168,4777,8428,53,61,H1
"Snohomish County, WA",2001-2002,622390,631526,9136,1.468,4476,4660,53,61,H1
"Snohomish County, WA",2002-2003,631526,635612,4086,0.647,4370,-284,53,61,H1
"Snohomish County, WA",2003-2004,635612,643533,7921,1.246,4613,3308,53,61,H1
"Snohomish County, WA",2004-2005,643533,654849,11316,1.758,4347,6969,53,61,H1
"Snohomish County, WA",2005-2006,654849,670706,15857,2.421,4887,10970,53,61,H1
"Snohomish County, WA",2006-2007,670706,683997,13291,1.982,5113,8178,53,61,H1
"Snohomish County, WA",2007-2008,683997,694622,10625,1.553,5230,5395,53,61,H1
"Snohomish County, WA",2008-2009,694622,706302,11680,1.681,5047,6633,53,61,H1
"Snohomish County, WA",2009-2010,706302,715362,9060,1.283,4778,4282,53,61,H1
"Snohomish County, WA",2010-2011,715362,722421,7059,0.987,4234,2825,53,61,H1
"Snohomish County, WA",2011-2012,722421,732942,10521,1.456,4204,6317,53,61,H1
"Snohomish County, WA",2012-2013,732942,746446,13504,1.842,4619,8885,53,61,H1
"Snohomish County, WA",2013-2014,746446,759583,13137,1.76,4347,8790,53,61,H1
"Snohomish County, WA",2014-2015,759417,772501,13084,1.723,4461,8623,53,61,H1
"Snohomish County, WA",2015-2016,772501,786946,14445,1.87,4466,9979,53,61,H1
"Snohomish County, WA",2016-2017,786946,801633,14687,1.866,4452,10235,53,61,H1
"Spokane County, WA",2000-2001,418803,422922,4119,0.984,1820,2299,53,63,H1
"Spokane County, WA",2001-2002,422922,427107,4185,0.99,1807,2378,53,63,H1
"Spokane County, WA",2002-2003,427107,430710,3603,0.844,1889,1714,53,63,H1
"Spokane County, WA",2003-2004,430710,435268,4558,1.058,1775,2783,53,63,H1
"Spokane County, WA",2004-2005,435268,440439,5171,1.188,1764,3407,53,63,H1
"Spokane County, WA",2005-2006,440439,447517,7078,1.607,2071,5007,53,63,H1
"Spokane County, WA",2006-2007,447517,456150,8633,1.929,2372,6261,53,63,H1
"Spokane County, WA",2007-2008,456150,462263,6113,1.34,2269,3844,53,63,H1
"Spokane County, WA",2008-2009,462263,468235,5972,1.292,2376,3596,53,63,H1
"Spokane County, WA",2009-2010,468235,472019,3784,0.808,2185,1599,53,63,H1
"Spokane County, WA",2010-2011,472019,473381,1362,0.289,1753,-391,53,63,H1
"Spokane County, WA",2011-2012,473381,475704,2323,0.491,1831,492,53,63,H1
"Spokane County, WA",2012-2013,475704,479327,3623,0.762,1854,1769,53,63,H1
"Spokane County, WA",2013-2014,479327,484318,4991,1.041,1767,3224,53,63,H1
"Spokane County, WA",2014-2015,484418,490945,6527,1.347,1767,4760,53,63,H1
"Spokane County, WA",2015-2016,490945,497437,6492,1.322,1506,4986,53,63,H1
"Spokane County, WA",2016-2017,497437,506152,8715,1.752,1459,7256,53,63,H1
"Stevens County, WA",2000-2001,40210,40204,-6,-0.015,56,-62,53,65,H1
"Stevens County, WA",2001-2002,40204,40334,130,0.323,120,10,53,65,H1
"Stevens County, WA",2002-2003,40334,40589,255,0.632,5,250,53,65,H1
"Stevens County, WA",2003-2004,40589,41022,433,1.067,98,335,53,65,H1
"Stevens County, WA",2004-2005,41022,41612,590,1.438,67,523,53,65,H1
"Stevens County, WA",2005-2006,41612,42366,754,1.812,69,685,53,65,H1
"Stevens County, WA",2006-2007,42366,43059,693,1.636,93,600,53,65,H1
"Stevens County, WA",2007-2008,43059,43398,339,0.787,85,254,53,65,H1
"Stevens County, WA",2008-2009,43398,43548,150,0.346,130,20,53,65,H1
"Stevens County, WA",2009-2010,43548,43503,-45,-0.103,37,-82,53,65,H1
"Stevens County, WA",2010-2011,43503,43510,7,0.016,25,-18,53,65,H1
"Stevens County, WA",2011-2012,43510,43610,100,0.23,24,76,53,65,H1
"Stevens County, WA",2012-2013,43610,43433,-177,-0.406,30,-207,53,65,H1
"Stevens County, WA",2013-2014,43433,43650,217,0.5,8,209,53,65,H1
"Stevens County, WA",2014-2015,43556,43791,235,0.54,14,221,53,65,H1
"Stevens County, WA",2015-2016,43791,44214,423,0.966,-53,476,53,65,H1
"Stevens County, WA",2016-2017,44214,44730,516,1.167,-31,547,53,65,H1
"Thurston County, WA",2000-2001,208287,212421,4134,1.985,1101,3033,53,67,H1
"Thurston County, WA",2001-2002,212421,216313,3892,1.832,749,3143,53,67,H1
"Thurston County, WA",2002-2003,216313,219499,3186,1.473,941,2245,53,67,H1
"Thurston County, WA",2003-2004,219499,222985,3486,1.588,950,2536,53,67,H1
"Thurston County, WA",2004-2005,222985,227023,4038,1.811,870,3168,53,67,H1
"Thurston County, WA",2005-2006,227023,232688,5665,2.495,891,4774,53,67,H1
"Thurston County, WA",2006-2007,232688,237772,5084,2.185,1089,3995,53,67,H1
"Thurston County, WA",2007-2008,237772,244332,6560,2.759,1127,5433,53,67,H1
"Thurston County, WA",2008-2009,244332,249936,5604,2.294,1211,4393,53,67,H1
"Thurston County, WA",2009-2010,249936,253046,3110,1.244,1177,1933,53,67,H1
"Thurston County, WA",2010-2011,253046,256481,3435,1.357,1097,2338,53,67,H1
"Thurston County, WA",2011-2012,256481,258713,2232,0.87,1198,1034,53,67,H1
"Thurston County, WA",2012-2013,258713,262561,3848,1.487,1104,2744,53,67,H1
"Thurston County, WA",2013-2014,262561,265851,3290,1.253,1147,2143,53,67,H1
"Thurston County, WA",2014-2015,266048,269536,3488,1.311,1088,2400,53,67,H1
"Thurston County, WA",2015-2016,269536,273923,4387,1.628,869,3518,53,67,H1
"Thurston County, WA",2016-2017,273923,280588,6665,2.433,915,5750,53,67,H1
"Wahkiakum County, WA",2000-2001,3835,3776,-59,-1.538,-21,-38,53,69,H1
"Wahkiakum County, WA",2001-2002,3776,3789,13,0.344,-26,39,53,69,H1
"Wahkiakum County, WA",2002-2003,3789,3662,-127,-3.352,-39,-88,53,69,H1
"Wahkiakum County, WA",2003-2004,3662,3729,67,1.83,-18,85,53,69,H1
"Wahkiakum County, WA",2004-2005,3729,3824,95,2.548,-5,100,53,69,H1
"Wahkiakum County, WA",2005-2006,3824,3936,112,2.929,-18,130,53,69,H1
"Wahkiakum County, WA",2006-2007,3936,3975,39,0.991,-19,58,53,69,H1
"Wahkiakum County, WA",2007-2008,3975,4033,58,1.459,-4,62,53,69,H1
"Wahkiakum County, WA",2008-2009,4033,3995,-38,-0.942,-13,-25,53,69,H1
"Wahkiakum County, WA",2009-2010,3995,3970,-25,-0.626,-30,5,53,69,H1
"Wahkiakum County, WA",2010-2011,3970,4013,43,1.083,-20,63,53,69,H1
"Wahkiakum County, WA",2011-2012,4013,3984,-29,-0.723,-24,-5,53,69,H1
"Wahkiakum County, WA",2012-2013,3984,4044,60,1.506,-13,73,53,69,H1
"Wahkiakum County, WA",2013-2014,4044,4067,23,0.569,-15,38,53,69,H1
"Wahkiakum County, WA",2014-2015,4066,4042,-24,-0.59,-14,-10,53,69,H1
"Wahkiakum County, WA",2015-2016,4042,4176,134,3.315,-10,144,53,69,H1
"Wahkiakum County, WA",2016-2017,4176,4264,88,2.107,-21,109,53,69,H1
"Walla Walla County, WA",2000-2001,55178,55072,-106,-0.192,167,-273,53,71,H1
"Walla Walla County, WA",2001-2002,55072,55666,594,1.079,189,405,53,71,H1
"Walla Walla County, WA",2002-2003,55666,56108,442,0.794,146,296,53,71,H1
"Walla Walla County, WA",2003-2004,56108,56652,544,0.97,219,325,53,71,H1
"Walla Walla County, WA",2004-2005,56652,56569,-83,-0.147,122,-205,53,71,H1
"Walla Walla County, WA",2005-2006,56569,56705,136,0.24,180,-44,53,71,H1
"Walla Walla County, WA",2006-2007,56705,56840,135,0.238,131,4,53,71,H1
"Walla Walla County, WA",2007-2008,56840,57315,475,0.836,184,291,53,71,H1
"Walla Walla County, WA",2008-2009,57315,58103,788,1.375,226,562,53,71,H1
"Walla Walla County, WA",2009-2010,58103,58917,814,1.401,179,635,53,71,H1
"Walla Walla County, WA",2010-2011,58917,59523,606,1.029,170,436,53,71,H1
"Walla Walla County, WA",2011-2012,59523,59458,-65,-0.109,164,-229,53,71,H1
"Walla Walla County, WA",2012-2013,59458,59637,179,0.301,119,60,53,71,H1
"Walla Walla County, WA",2013-2014,59637,59844,207,0.347,122,85,53,71,H1
"Walla Walla County, WA",2014-2015,59771,60338,567,0.949,105,462,53,71,H1
"Walla Walla County, WA",2015-2016,60338,59992,-346,-0.573,71,-417,53,71,H1
"Walla Walla County, WA",2016-2017,59992,60567,575,0.958,58,517,53,71,H1
"Whatcom County, WA",2000-2001,167696,171172,3476,2.073,749,2727,53,73,H1
"Whatcom County, WA",2001-2002,171172,174904,3732,2.18,724,3008,53,73,H1
"Whatcom County, WA",2002-2003,174904,177851,2947,1.685,687,2260,53,73,H1
"Whatcom County, WA",2003-2004,177851,181756,3905,2.196,758,3147,53,73,H1
"Whatcom County, WA",2004-2005,181756,185450,3694,2.032,740,2954,53,73,H1
"Whatcom County, WA",2005-2006,185450,188926,3476,1.874,866,2610,53,73,H1
"Whatcom County, WA",2006-2007,188926,192837,3911,2.07,820,3091,53,73,H1
"Whatcom County, WA",2007-2008,192837,196708,3871,2.007,905,2966,53,73,H1
"Whatcom County, WA",2008-2009,196708,199865,3157,1.605,1010,2147,53,73,H1
"Whatcom County, WA",2009-2010,199865,201518,1653,0.827,908,745,53,73,H1
"Whatcom County, WA",2010-2011,201518,203329,1811,0.899,854,957,53,73,H1
"Whatcom County, WA",2011-2012,203329,204827,1498,0.737,781,717,53,73,H1
"Whatcom County, WA",2012-2013,204827,206248,1421,0.694,684,737,53,73,H1
"Whatcom County, WA",2013-2014,206248,208351,2103,1.02,739,1364,53,73,H1
"Whatcom County, WA",2014-2015,208491,212284,3793,1.819,805,2988,53,73,H1
"Whatcom County, WA",2015-2016,212284,216274,3990,1.88,673,3317,53,73,H1
"Whatcom County, WA",2016-2017,216274,221404,5130,2.372,737,4393,53,73,H1
"Whitman County, WA",2000-2001,40754,40814,60,0.147,175,-115,53,75,H1
"Whitman County, WA",2001-2002,40814,41484,670,1.642,161,509,53,75,H1
"Whitman County, WA",2002-2003,41484,41442,-42,-0.101,202,-244,53,75,H1
"Whitman County, WA",2003-2004,41442,42158,716,1.728,199,517,53,75,H1
"Whitman County, WA",2004-2005,42158,42836,678,1.608,194,484,53,75,H1
"Whitman County, WA",2005-2006,42836,42827,-9,-0.021,204,-213,53,75,H1
"Whitman County, WA",2006-2007,42827,42608,-219,-0.511,183,-402,53,75,H1
"Whitman County, WA",2007-2008,42608,43802,1194,2.802,228,966,53,75,H1
"Whitman County, WA",2008-2009,43802,44705,903,2.062,235,668,53,75,H1
"Whitman County, WA",2009-2010,44705,44778,73,0.163,209,-136,53,75,H1
"Whitman County, WA",2010-2011,44778,45064,286,0.639,195,91,53,75,H1
"Whitman County, WA",2011-2012,45064,46590,1526,3.386,201,1325,53,75,H1
"Whitman County, WA",2012-2013,46590,46758,168,0.361,221,-53,53,75,H1
"Whitman County, WA",2013-2014,46758,46827,69,0.148,249,-180,53,75,H1
"Whitman County, WA",2014-2015,46938,48177,1239,2.64,217,1022,53,75,H1
"Whitman County, WA",2015-2016,48177,48528,351,0.729,135,216,53,75,H1
"Whitman County, WA",2016-2017,48528,49046,518,1.067,187,331,53,75,H1
"Yakima County, WA",2000-2001,222615,222757,142,0.064,2659,-2517,53,77,H1
"Yakima County, WA",2001-2002,222757,223402,645,0.29,2337,-1692,53,77,H1
"Yakima County, WA",2002-2003,223402,225161,1759,0.787,2290,-531,53,77,H1
"Yakima County, WA",2003-2004,225161,227280,2119,0.941,2534,-415,53,77,H1
"Yakima County, WA",2004-2005,227280,228570,1290,0.568,2319,-1029,53,77,H1
"Yakima County, WA",2005-2006,228570,230617,2047,0.896,2515,-468,53,77,H1
"Yakima County, WA",2006-2007,230617,232733,2116,0.918,2647,-531,53,77,H1
"Yakima County, WA",2007-2008,232733,235272,2539,1.091,2681,-142,53,77,H1
"Yakima County, WA",2008-2009,235272,239604,4332,1.841,2550,1782,53,77,H1
"Yakima County, WA",2009-2010,239604,244146,4542,1.896,2718,1824,53,77,H1
"Yakima County, WA",2010-2011,244146,246159,2013,0.825,2492,-479,53,77,H1
"Yakima County, WA",2011-2012,246159,246721,562,0.228,2294,-1732,53,77,H1
"Yakima County, WA",2012-2013,246721,247297,576,0.233,2143,-1567,53,77,H1
"Yakima County, WA",2013-2014,247297,247687,390,0.158,2114,-1724,53,77,H1
"Yakima County, WA",2014-2015,247698,248830,1132,0.457,2071,-939,53,77,H1
"Yakima County, WA",2015-2016,248830,249323,493,0.198,1898,-1405,53,77,H1
"Yakima County, WA",2016-2017,249323,250193,870,0.349,1915,-1045,53,77,H1
West Virginia,2000-2001,1807021,1801481,-5540,-0.307,-596,-4944,54,0,STATE
West Virginia,2001-2002,1801481,1805414,3933,0.218,-240,4173,54,0,STATE
West Virginia,2002-2003,1805414,1812295,6881,0.381,-58,6939,54,0,STATE
West Virginia,2003-2004,1812295,1816438,4143,0.229,-360,4503,54,0,STATE
West Virginia,2004-2005,1816438,1820492,4054,0.223,-507,4561,54,0,STATE
West Virginia,2005-2006,1820492,1827912,7420,0.408,356,7064,54,0,STATE
West Virginia,2006-2007,1827912,1834052,6140,0.336,848,5292,54,0,STATE
West Virginia,2007-2008,1834052,1840310,6258,0.341,232,6026,54,0,STATE
West Virginia,2008-2009,1840310,1847775,7465,0.406,-267,7732,54,0,STATE
West Virginia,2009-2010,1847775,1854225,6450,0.349,-726,7176,54,0,STATE
West Virginia,2010-2011,1854225,1854948,723,0.039,-1448,2171,54,0,STATE
West Virginia,2011-2012,1854948,1856283,1335,0.072,-814,2149,54,0,STATE
West Virginia,2012-2013,1856283,1852985,-3298,-0.178,-1313,-1985,54,0,STATE
West Virginia,2013-2014,1852985,1848751,-4234,-0.228,-912,-3322,54,0,STATE
West Virginia,2014-2015,1848751,1844128,-4623,-0.25,-940,-3683,54,0,STATE
West Virginia,2015-2016,1844128,1828637,-15491,-0.84,-2973,-12518,54,0,STATE
West Virginia,2016-2017,1828637,1815857,-12780,-0.699,-3129,-9651,54,0,STATE
"Barbour County, WV",2000-2001,15560,15436,-124,-0.797,-46,-78,54,1,H1
"Barbour County, WV",2001-2002,15436,15569,133,0.862,-32,165,54,1,H1
"Barbour County, WV",2002-2003,15569,15639,70,0.45,-17,87,54,1,H1
"Barbour County, WV",2003-2004,15639,15629,-10,-0.064,-17,7,54,1,H1
"Barbour County, WV",2004-2005,15629,15722,93,0.595,-11,104,54,1,H1
"Barbour County, WV",2005-2006,15722,15922,200,1.272,-22,222,54,1,H1
"Barbour County, WV",2006-2007,15922,16036,114,0.716,-26,140,54,1,H1
"Barbour County, WV",2007-2008,16036,16241,205,1.278,10,195,54,1,H1
"Barbour County, WV",2008-2009,16241,16479,238,1.465,-7,245,54,1,H1
"Barbour County, WV",2009-2010,16479,16596,117,0.71,-32,149,54,1,H1
"Barbour County, WV",2010-2011,16596,16596,0,0,-23,23,54,1,H1
"Barbour County, WV",2011-2012,16596,16860,264,1.591,20,244,54,1,H1
"Barbour County, WV",2012-2013,16860,16796,-64,-0.38,-24,-40,54,1,H1
"Barbour County, WV",2013-2014,16796,16766,-30,-0.179,-1,-29,54,1,H1
"Barbour County, WV",2014-2015,16708,16704,-4,-0.024,-31,27,54,1,H1
"Barbour County, WV",2015-2016,16704,16720,16,0.096,-50,66,54,1,H1
"Barbour County, WV",2016-2017,16720,16497,-223,-1.334,-41,-182,54,1,H1
"Berkeley County, WV",2000-2001,76357,78428,2071,2.712,372,1699,54,3,H1
"Berkeley County, WV",2001-2002,78428,80875,2447,3.12,438,2009,54,3,H1
"Berkeley County, WV",2002-2003,80875,84524,3649,4.512,496,3153,54,3,H1
"Berkeley County, WV",2003-2004,84524,88258,3734,4.418,457,3277,54,3,H1
"Berkeley County, WV",2004-2005,88258,92114,3856,4.369,491,3365,54,3,H1
"Berkeley County, WV",2005-2006,92114,96318,4204,4.564,607,3597,54,3,H1
"Berkeley County, WV",2006-2007,96318,99132,2814,2.922,739,2075,54,3,H1
"Berkeley County, WV",2007-2008,99132,101629,2497,2.519,647,1850,54,3,H1
"Berkeley County, WV",2008-2009,101629,102830,1201,1.182,571,630,54,3,H1
"Berkeley County, WV",2009-2010,102830,104659,1829,1.779,483,1346,54,3,H1
"Berkeley County, WV",2010-2011,104659,105719,1060,1.013,444,616,54,3,H1
"Berkeley County, WV",2011-2012,105719,107062,1343,1.27,408,935,54,3,H1
"Berkeley County, WV",2012-2013,107062,108684,1622,1.515,569,1053,54,3,H1
"Berkeley County, WV",2013-2014,108684,110497,1813,1.668,477,1336,54,3,H1
"Berkeley County, WV",2014-2015,110394,111901,1507,1.365,476,1031,54,3,H1
"Berkeley County, WV",2015-2016,111901,113270,1369,1.223,338,1031,54,3,H1
"Berkeley County, WV",2016-2017,113270,114920,1650,1.457,375,1275,54,3,H1
"Boone County, WV",2000-2001,25473,25372,-101,-0.396,50,-151,54,5,H1
"Boone County, WV",2001-2002,25372,25505,133,0.524,32,101,54,5,H1
"Boone County, WV",2002-2003,25505,25545,40,0.157,46,-6,54,5,H1
"Boone County, WV",2003-2004,25545,25455,-90,-0.352,13,-103,54,5,H1
"Boone County, WV",2004-2005,25455,25311,-144,-0.566,26,-170,54,5,H1
"Boone County, WV",2005-2006,25311,25101,-210,-0.83,-12,-198,54,5,H1
"Boone County, WV",2006-2007,25101,25115,14,0.056,1,13,54,5,H1
"Boone County, WV",2007-2008,25115,24794,-321,-1.278,-31,-290,54,5,H1
"Boone County, WV",2008-2009,24794,24766,-28,-0.113,-12,-16,54,5,H1
"Boone County, WV",2009-2010,24766,24612,-154,-0.622,-27,-127,54,5,H1
"Boone County, WV",2010-2011,24612,24474,-138,-0.561,-54,-84,54,5,H1
"Boone County, WV",2011-2012,24474,24397,-77,-0.315,-33,-44,54,5,H1
"Boone County, WV",2012-2013,24397,24087,-310,-1.271,-10,-300,54,5,H1
"Boone County, WV",2013-2014,24087,23714,-373,-1.549,-48,-325,54,5,H1
"Boone County, WV",2014-2015,23734,23372,-362,-1.525,-21,-341,54,5,H1
"Boone County, WV",2015-2016,23372,22795,-577,-2.469,-90,-487,54,5,H1
"Boone County, WV",2016-2017,22795,22349,-446,-1.957,-78,-368,54,5,H1
"Braxton County, WV",2000-2001,14713,14702,-11,-0.075,-8,-3,54,7,H1
"Braxton County, WV",2001-2002,14702,14667,-35,-0.238,-26,-9,54,7,H1
"Braxton County, WV",2002-2003,14667,14632,-35,-0.239,-27,-8,54,7,H1
"Braxton County, WV",2003-2004,14632,14696,64,0.437,-51,115,54,7,H1
"Braxton County, WV",2004-2005,14696,14682,-14,-0.095,6,-20,54,7,H1
"Braxton County, WV",2005-2006,14682,14585,-97,-0.661,-25,-72,54,7,H1
"Braxton County, WV",2006-2007,14585,14585,0,0,-14,14,54,7,H1
"Braxton County, WV",2007-2008,14585,14587,2,0.014,-17,19,54,7,H1
"Braxton County, WV",2008-2009,14587,14512,-75,-0.514,-33,-42,54,7,H1
"Braxton County, WV",2009-2010,14512,14525,13,0.09,-36,49,54,7,H1
"Braxton County, WV",2010-2011,14525,14541,16,0.11,8,8,54,7,H1
"Braxton County, WV",2011-2012,14541,14485,-56,-0.385,-23,-33,54,7,H1
"Braxton County, WV",2012-2013,14485,14445,-40,-0.276,-10,-30,54,7,H1
"Braxton County, WV",2013-2014,14445,14463,18,0.125,-2,20,54,7,H1
"Braxton County, WV",2014-2015,14447,14415,-32,-0.221,-24,-8,54,7,H1
"Braxton County, WV",2015-2016,14415,14341,-74,-0.513,-25,-49,54,7,H1
"Braxton County, WV",2016-2017,14341,14237,-104,-0.725,-10,-94,54,7,H1
"Brooke County, WV",2000-2001,25366,25237,-129,-0.509,-59,-70,54,9,H1
"Brooke County, WV",2001-2002,25237,25156,-81,-0.321,-116,35,54,9,H1
"Brooke County, WV",2002-2003,25156,25094,-62,-0.246,-84,22,54,9,H1
"Brooke County, WV",2003-2004,25094,24867,-227,-0.905,-103,-124,54,9,H1
"Brooke County, WV",2004-2005,24867,24703,-164,-0.66,-95,-69,54,9,H1
"Brooke County, WV",2005-2006,24703,24399,-304,-1.231,-109,-195,54,9,H1
"Brooke County, WV",2006-2007,24399,24235,-164,-0.672,-119,-45,54,9,H1
"Brooke County, WV",2007-2008,24235,24168,-67,-0.276,-114,47,54,9,H1
"Brooke County, WV",2008-2009,24168,24153,-15,-0.062,-94,79,54,9,H1
"Brooke County, WV",2009-2010,24153,23991,-162,-0.671,-89,-73,54,9,H1
"Brooke County, WV",2010-2011,23991,23919,-72,-0.3,-173,101,54,9,H1
"Brooke County, WV",2011-2012,23919,23791,-128,-0.535,-164,36,54,9,H1
"Brooke County, WV",2012-2013,23791,23706,-85,-0.357,-124,39,54,9,H1
"Brooke County, WV",2013-2014,23706,23530,-176,-0.742,-134,-42,54,9,H1
"Brooke County, WV",2014-2015,23529,23350,-179,-0.761,-142,-37,54,9,H1
"Brooke County, WV",2015-2016,23350,22707,-643,-2.754,-135,-508,54,9,H1
"Brooke County, WV",2016-2017,22707,22443,-264,-1.163,-133,-131,54,9,H1
"Cabell County, WV",2000-2001,96735,96035,-700,-0.724,39,-739,54,11,H1
"Cabell County, WV",2001-2002,96035,95741,-294,-0.306,39,-333,54,11,H1
"Cabell County, WV",2002-2003,95741,95554,-187,-0.195,-93,-94,54,11,H1
"Cabell County, WV",2003-2004,95554,95239,-315,-0.33,-63,-252,54,11,H1
"Cabell County, WV",2004-2005,95239,94821,-418,-0.439,-127,-291,54,11,H1
"Cabell County, WV",2005-2006,94821,94943,122,0.129,48,74,54,11,H1
"Cabell County, WV",2006-2007,94943,95059,116,0.122,116,0,54,11,H1
"Cabell County, WV",2007-2008,95059,95209,150,0.158,-66,216,54,11,H1
"Cabell County, WV",2008-2009,95209,96040,831,0.873,-52,883,54,11,H1
"Cabell County, WV",2009-2010,96040,96347,307,0.32,46,261,54,11,H1
"Cabell County, WV",2010-2011,96347,96557,210,0.218,-20,230,54,11,H1
"Cabell County, WV",2011-2012,96557,96935,378,0.391,151,227,54,11,H1
"Cabell County, WV",2012-2013,96935,97181,246,0.254,212,34,54,11,H1
"Cabell County, WV",2013-2014,97181,97109,-72,-0.074,161,-233,54,11,H1
"Cabell County, WV",2014-2015,96827,96844,17,0.018,132,-115,54,11,H1
"Cabell County, WV",2015-2016,96844,95669,-1175,-1.213,-79,-1096,54,11,H1
"Cabell County, WV",2016-2017,95669,94958,-711,-0.743,-8,-703,54,11,H1
"Calhoun County, WV",2000-2001,7596,7480,-116,-1.527,-17,-99,54,13,H1
"Calhoun County, WV",2001-2002,7480,7443,-37,-0.495,-22,-15,54,13,H1
"Calhoun County, WV",2002-2003,7443,7409,-34,-0.457,-6,-28,54,13,H1
"Calhoun County, WV",2003-2004,7409,7411,2,0.027,-28,30,54,13,H1
"Calhoun County, WV",2004-2005,7411,7507,96,1.295,-20,116,54,13,H1
"Calhoun County, WV",2005-2006,7507,7531,24,0.32,-2,26,54,13,H1
"Calhoun County, WV",2006-2007,7531,7588,57,0.757,13,44,54,13,H1
"Calhoun County, WV",2007-2008,7588,7621,33,0.435,-19,52,54,13,H1
"Calhoun County, WV",2008-2009,7621,7560,-61,-0.8,-17,-44,54,13,H1
"Calhoun County, WV",2009-2010,7560,7638,78,1.032,-23,101,54,13,H1
"Calhoun County, WV",2010-2011,7638,7639,1,0.013,-5,6,54,13,H1
"Calhoun County, WV",2011-2012,7639,7591,-48,-0.628,-24,-24,54,13,H1
"Calhoun County, WV",2012-2013,7591,7533,-58,-0.764,-20,-38,54,13,H1
"Calhoun County, WV",2013-2014,7533,7513,-20,-0.265,-13,-7,54,13,H1
"Calhoun County, WV",2014-2015,7534,7470,-64,-0.849,9,-73,54,13,H1
"Calhoun County, WV",2015-2016,7470,7367,-103,-1.379,-21,-82,54,13,H1
"Calhoun County, WV",2016-2017,7367,7307,-60,-0.814,-21,-39,54,13,H1
"Clay County, WV",2000-2001,10302,10153,-149,-1.446,7,-156,54,15,H1
"Clay County, WV",2001-2002,10153,10166,13,0.128,9,4,54,15,H1
"Clay County, WV",2002-2003,10166,10061,-105,-1.033,46,-151,54,15,H1
"Clay County, WV",2003-2004,10061,10055,-6,-0.06,18,-24,54,15,H1
"Clay County, WV",2004-2005,10055,9852,-203,-2.019,8,-211,54,15,H1
"Clay County, WV",2005-2006,9852,9695,-157,-1.594,-13,-144,54,15,H1
"Clay County, WV",2006-2007,9695,9696,1,0.01,22,-21,54,15,H1
"Clay County, WV",2007-2008,9696,9603,-93,-0.959,8,-101,54,15,H1
"Clay County, WV",2008-2009,9603,9505,-98,-1.021,7,-105,54,15,H1
"Clay County, WV",2009-2010,9505,9359,-146,-1.536,-14,-132,54,15,H1
"Clay County, WV",2010-2011,9359,9378,19,0.203,19,0,54,15,H1
"Clay County, WV",2011-2012,9378,9251,-127,-1.354,2,-129,54,15,H1
"Clay County, WV",2012-2013,9251,9202,-49,-0.53,8,-57,54,15,H1
"Clay County, WV",2013-2014,9202,8941,-261,-2.836,0,-261,54,15,H1
"Clay County, WV",2014-2015,8939,8910,-29,-0.324,-13,-16,54,15,H1
"Clay County, WV",2015-2016,8910,8843,-67,-0.752,0,-67,54,15,H1
"Clay County, WV",2016-2017,8843,8764,-79,-0.893,2,-81,54,15,H1
"Doddridge County, WV",2000-2001,7396,7588,192,2.596,-19,211,54,17,H1
"Doddridge County, WV",2001-2002,7588,7627,39,0.514,-15,54,54,17,H1
"Doddridge County, WV",2002-2003,7627,7741,114,1.495,0,114,54,17,H1
"Doddridge County, WV",2003-2004,7741,7669,-72,-0.93,-16,-56,54,17,H1
"Doddridge County, WV",2004-2005,7669,7808,139,1.812,-14,153,54,17,H1
"Doddridge County, WV",2005-2006,7808,7848,40,0.512,-6,46,54,17,H1
"Doddridge County, WV",2006-2007,7848,7970,122,1.555,-22,144,54,17,H1
"Doddridge County, WV",2007-2008,7970,8034,64,0.803,12,52,54,17,H1
"Doddridge County, WV",2008-2009,8034,8124,90,1.12,-17,107,54,17,H1
"Doddridge County, WV",2009-2010,8124,8198,74,0.911,-25,99,54,17,H1
"Doddridge County, WV",2010-2011,8198,8183,-15,-0.183,-10,-5,54,17,H1
"Doddridge County, WV",2011-2012,8183,8220,37,0.452,-23,60,54,17,H1
"Doddridge County, WV",2012-2013,8220,8417,197,2.397,-10,207,54,17,H1
"Doddridge County, WV",2013-2014,8417,8391,-26,-0.309,-1,-25,54,17,H1
"Doddridge County, WV",2014-2015,8160,8176,16,0.196,-5,21,54,17,H1
"Doddridge County, WV",2015-2016,8176,8583,407,4.978,7,400,54,17,H1
"Doddridge County, WV",2016-2017,8583,8560,-23,-0.268,7,-30,54,17,H1
"Fayette County, WV",2000-2001,47507,47067,-440,-0.926,-90,-350,54,19,H1
"Fayette County, WV",2001-2002,47067,46935,-132,-0.28,-74,-58,54,19,H1
"Fayette County, WV",2002-2003,46935,47054,119,0.254,-19,138,54,19,H1
"Fayette County, WV",2003-2004,47054,46717,-337,-0.716,-33,-304,54,19,H1
"Fayette County, WV",2004-2005,46717,46229,-488,-1.045,-45,-443,54,19,H1
"Fayette County, WV",2005-2006,46229,46200,-29,-0.063,-19,-10,54,19,H1
"Fayette County, WV",2006-2007,46200,46243,43,0.093,-34,77,54,19,H1
"Fayette County, WV",2007-2008,46243,46171,-72,-0.156,20,-92,54,19,H1
"Fayette County, WV",2008-2009,46171,46034,-137,-0.297,-2,-135,54,19,H1
"Fayette County, WV",2009-2010,46034,45993,-41,-0.089,-28,-13,54,19,H1
"Fayette County, WV",2010-2011,45993,45954,-39,-0.085,-75,36,54,19,H1
"Fayette County, WV",2011-2012,45954,45898,-56,-0.122,-68,12,54,19,H1
"Fayette County, WV",2012-2013,45898,45567,-331,-0.721,-120,-211,54,19,H1
"Fayette County, WV",2013-2014,45567,45132,-435,-0.955,-167,-268,54,19,H1
"Fayette County, WV",2014-2015,45211,44997,-214,-0.473,-119,-95,54,19,H1
"Fayette County, WV",2015-2016,44997,44102,-895,-1.989,-178,-717,54,19,H1
"Fayette County, WV",2016-2017,44102,43521,-581,-1.317,-206,-375,54,19,H1
"Gilmer County, WV",2000-2001,7208,7309,101,1.401,-30,131,54,21,H1
"Gilmer County, WV",2001-2002,7309,7409,100,1.368,2,98,54,21,H1
"Gilmer County, WV",2002-2003,7409,7615,206,2.78,-40,246,54,21,H1
"Gilmer County, WV",2003-2004,7615,7764,149,1.957,-11,160,54,21,H1
"Gilmer County, WV",2004-2005,7764,7905,141,1.816,-21,162,54,21,H1
"Gilmer County, WV",2005-2006,7905,8083,178,2.252,-11,189,54,21,H1
"Gilmer County, WV",2006-2007,8083,8248,165,2.041,-29,194,54,21,H1
"Gilmer County, WV",2007-2008,8248,8408,160,1.94,-6,166,54,21,H1
"Gilmer County, WV",2008-2009,8408,8529,121,1.439,-11,132,54,21,H1
"Gilmer County, WV",2009-2010,8529,8717,188,2.204,-16,204,54,21,H1
"Gilmer County, WV",2010-2011,8717,8765,48,0.551,10,38,54,21,H1
"Gilmer County, WV",2011-2012,8765,8778,13,0.148,-18,31,54,21,H1
"Gilmer County, WV",2012-2013,8778,8650,-128,-1.458,-12,-116,54,21,H1
"Gilmer County, WV",2013-2014,8650,8618,-32,-0.37,-12,-20,54,21,H1
"Gilmer County, WV",2014-2015,8519,8518,-1,-0.012,2,-3,54,21,H1
"Gilmer County, WV",2015-2016,8518,8128,-390,-4.579,-10,-380,54,21,H1
"Gilmer County, WV",2016-2017,8128,8005,-123,-1.513,-23,-100,54,21,H1
"Grant County, WV",2000-2001,11280,11325,45,0.399,-10,55,54,23,H1
"Grant County, WV",2001-2002,11325,11310,-15,-0.132,7,-22,54,23,H1
"Grant County, WV",2002-2003,11310,11406,96,0.849,22,74,54,23,H1
"Grant County, WV",2003-2004,11406,11558,152,1.333,19,133,54,23,H1
"Grant County, WV",2004-2005,11558,11648,90,0.779,-1,91,54,23,H1
"Grant County, WV",2005-2006,11648,11834,186,1.597,-10,196,54,23,H1
"Grant County, WV",2006-2007,11834,11969,135,1.141,20,115,54,23,H1
"Grant County, WV",2007-2008,11969,12022,53,0.443,-3,56,54,23,H1
"Grant County, WV",2008-2009,12022,11963,-59,-0.491,-16,-43,54,23,H1
"Grant County, WV",2009-2010,11963,11900,-63,-0.527,-27,-36,54,23,H1
"Grant County, WV",2010-2011,11900,11929,29,0.244,-5,34,54,23,H1
"Grant County, WV",2011-2012,11929,11841,-88,-0.738,-10,-78,54,23,H1
"Grant County, WV",2012-2013,11841,11788,-53,-0.448,-20,-33,54,23,H1
"Grant County, WV",2013-2014,11788,11687,-101,-0.857,-10,-91,54,23,H1
"Grant County, WV",2014-2015,11719,11766,47,0.401,-1,48,54,23,H1
"Grant County, WV",2015-2016,11766,11643,-123,-1.045,6,-129,54,23,H1
"Grant County, WV",2016-2017,11643,11670,27,0.232,2,25,54,23,H1
"Greenbrier County, WV",2000-2001,34437,34452,15,0.044,-53,68,54,25,H1
"Greenbrier County, WV",2001-2002,34452,34621,169,0.491,-82,251,54,25,H1
"Greenbrier County, WV",2002-2003,34621,34831,210,0.607,-57,267,54,25,H1
"Greenbrier County, WV",2003-2004,34831,34938,107,0.307,-94,201,54,25,H1
"Greenbrier County, WV",2004-2005,34938,35020,82,0.235,-78,160,54,25,H1
"Greenbrier County, WV",2005-2006,35020,35196,176,0.503,-95,271,54,25,H1
"Greenbrier County, WV",2006-2007,35196,35354,158,0.449,-24,182,54,25,H1
"Greenbrier County, WV",2007-2008,35354,35457,103,0.291,-60,163,54,25,H1
"Greenbrier County, WV",2008-2009,35457,35351,-106,-0.299,-69,-37,54,25,H1
"Greenbrier County, WV",2009-2010,35351,35516,165,0.467,-72,237,54,25,H1
"Greenbrier County, WV",2010-2011,35516,35674,158,0.445,-179,337,54,25,H1
"Greenbrier County, WV",2011-2012,35674,35806,132,0.37,-98,230,54,25,H1
"Greenbrier County, WV",2012-2013,35806,35749,-57,-0.159,-63,6,54,25,H1
"Greenbrier County, WV",2013-2014,35749,35450,-299,-0.836,-77,-222,54,25,H1
"Greenbrier County, WV",2014-2015,35460,35516,56,0.158,-123,179,54,25,H1
"Greenbrier County, WV",2015-2016,35516,35494,-22,-0.062,-131,109,54,25,H1
"Greenbrier County, WV",2016-2017,35494,35287,-207,-0.583,-120,-87,54,25,H1
"Hampshire County, WV",2000-2001,20288,20668,380,1.873,24,356,54,27,H1
"Hampshire County, WV",2001-2002,20668,21030,362,1.751,10,352,54,27,H1
"Hampshire County, WV",2002-2003,21030,21436,406,1.931,44,362,54,27,H1
"Hampshire County, WV",2003-2004,21436,21766,330,1.539,-7,337,54,27,H1
"Hampshire County, WV",2004-2005,21766,22361,595,2.734,21,574,54,27,H1
"Hampshire County, WV",2005-2006,22361,23016,655,2.929,49,606,54,27,H1
"Hampshire County, WV",2006-2007,23016,23492,476,2.068,68,408,54,27,H1
"Hampshire County, WV",2007-2008,23492,23664,172,0.732,29,143,54,27,H1
"Hampshire County, WV",2008-2009,23664,23820,156,0.659,12,144,54,27,H1
"Hampshire County, WV",2009-2010,23820,23951,131,0.55,-4,135,54,27,H1
"Hampshire County, WV",2010-2011,23951,23792,-159,-0.664,-53,-106,54,27,H1
"Hampshire County, WV",2011-2012,23792,23678,-114,-0.479,-25,-89,54,27,H1
"Hampshire County, WV",2012-2013,23678,23467,-211,-0.891,-11,-200,54,27,H1
"Hampshire County, WV",2013-2014,23467,23483,16,0.068,-23,39,54,27,H1
"Hampshire County, WV",2014-2015,23441,23353,-88,-0.375,-9,-79,54,27,H1
"Hampshire County, WV",2015-2016,23353,23343,-10,-0.043,-21,11,54,27,H1
"Hampshire County, WV",2016-2017,23343,23471,128,0.548,-19,147,54,27,H1
"Hancock County, WV",2000-2001,32652,32421,-231,-0.707,-103,-128,54,29,H1
"Hancock County, WV",2001-2002,32421,32178,-243,-0.75,-96,-147,54,29,H1
"Hancock County, WV",2002-2003,32178,31925,-253,-0.786,-75,-178,54,29,H1
"Hancock County, WV",2003-2004,31925,31600,-325,-1.018,-103,-222,54,29,H1
"Hancock County, WV",2004-2005,31600,31510,-90,-0.285,-105,15,54,29,H1
"Hancock County, WV",2005-2006,31510,31266,-244,-0.774,-76,-168,54,29,H1
"Hancock County, WV",2006-2007,31266,30887,-379,-1.212,-107,-272,54,29,H1
"Hancock County, WV",2007-2008,30887,30802,-85,-0.275,-83,-2,54,29,H1
"Hancock County, WV",2008-2009,30802,30748,-54,-0.175,-97,43,54,29,H1
"Hancock County, WV",2009-2010,30748,30662,-86,-0.28,-98,12,54,29,H1
"Hancock County, WV",2010-2011,30662,30516,-146,-0.476,-75,-71,54,29,H1
"Hancock County, WV",2011-2012,30516,30328,-188,-0.616,-122,-66,54,29,H1
"Hancock County, WV",2012-2013,30328,30229,-99,-0.326,-106,7,54,29,H1
"Hancock County, WV",2013-2014,30229,30112,-117,-0.387,-122,5,54,29,H1
"Hancock County, WV",2014-2015,30081,29815,-266,-0.884,-159,-107,54,29,H1
"Hancock County, WV",2015-2016,29815,29621,-194,-0.651,-154,-40,54,29,H1
"Hancock County, WV",2016-2017,29621,29448,-173,-0.584,-159,-14,54,29,H1
"Hardy County, WV",2000-2001,12677,12805,128,1.01,33,95,54,31,H1
"Hardy County, WV",2001-2002,12805,12877,72,0.562,-25,97,54,31,H1
"Hardy County, WV",2002-2003,12877,13140,263,2.042,-2,265,54,31,H1
"Hardy County, WV",2003-2004,13140,13325,185,1.408,9,176,54,31,H1
"Hardy County, WV",2004-2005,13325,13529,204,1.531,7,197,54,31,H1
"Hardy County, WV",2005-2006,13529,13611,82,0.606,-9,91,54,31,H1
"Hardy County, WV",2006-2007,13611,13807,196,1.44,64,132,54,31,H1
"Hardy County, WV",2007-2008,13807,13793,-14,-0.101,17,-31,54,31,H1
"Hardy County, WV",2008-2009,13793,13885,92,0.667,8,84,54,31,H1
"Hardy County, WV",2009-2010,13885,14028,143,1.03,9,134,54,31,H1
"Hardy County, WV",2010-2011,14028,13981,-47,-0.335,18,-65,54,31,H1
"Hardy County, WV",2011-2012,13981,13870,-111,-0.794,1,-112,54,31,H1
"Hardy County, WV",2012-2013,13870,13973,103,0.743,-7,110,54,31,H1
"Hardy County, WV",2013-2014,13973,13923,-50,-0.358,-8,-42,54,31,H1
"Hardy County, WV",2014-2015,13956,13852,-104,-0.745,-18,-86,54,31,H1
"Hardy County, WV",2015-2016,13852,13731,-121,-0.874,-16,-105,54,31,H1
"Hardy County, WV",2016-2017,13731,13717,-14,-0.102,-24,10,54,31,H1
"Harrison County, WV",2000-2001,68520,67817,-703,-1.026,-83,-620,54,33,H1
"Harrison County, WV",2001-2002,67817,67778,-39,-0.058,-67,28,54,33,H1
"Harrison County, WV",2002-2003,67778,67707,-71,-0.105,-118,47,54,33,H1
"Harrison County, WV",2003-2004,67707,67900,193,0.285,-60,253,54,33,H1
"Harrison County, WV",2004-2005,67900,67989,89,0.131,43,46,54,33,H1
"Harrison County, WV",2005-2006,67989,68141,152,0.224,-38,190,54,33,H1
"Harrison County, WV",2006-2007,68141,67940,-201,-0.295,-2,-199,54,33,H1
"Harrison County, WV",2007-2008,67940,68441,501,0.737,9,492,54,33,H1
"Harrison County, WV",2008-2009,68441,68696,255,0.373,32,223,54,33,H1
"Harrison County, WV",2009-2010,68696,69240,544,0.792,-3,547,54,33,H1
"Harrison County, WV",2010-2011,69240,69269,29,0.042,-106,135,54,33,H1
"Harrison County, WV",2011-2012,69269,69148,-121,-0.175,-62,-59,54,33,H1
"Harrison County, WV",2012-2013,69148,68926,-222,-0.321,-55,-167,54,33,H1
"Harrison County, WV",2013-2014,68926,68761,-165,-0.239,-85,-80,54,33,H1
"Harrison County, WV",2014-2015,68836,68714,-122,-0.177,-21,-101,54,33,H1
"Harrison County, WV",2015-2016,68714,68280,-434,-0.632,-103,-331,54,33,H1
"Harrison County, WV",2016-2017,68280,67811,-469,-0.687,-95,-374,54,33,H1
"Jackson County, WV",2000-2001,28061,28098,37,0.132,20,17,54,35,H1
"Jackson County, WV",2001-2002,28098,28270,172,0.612,14,158,54,35,H1
"Jackson County, WV",2002-2003,28270,28362,92,0.325,27,65,54,35,H1
"Jackson County, WV",2003-2004,28362,28676,314,1.107,13,301,54,35,H1
"Jackson County, WV",2004-2005,28676,28622,-54,-0.188,31,-85,54,35,H1
"Jackson County, WV",2005-2006,28622,28877,255,0.891,33,222,54,35,H1
"Jackson County, WV",2006-2007,28877,29089,212,0.734,6,206,54,35,H1
"Jackson County, WV",2007-2008,29089,29101,12,0.041,-15,27,54,35,H1
"Jackson County, WV",2008-2009,29101,29155,54,0.186,-15,69,54,35,H1
"Jackson County, WV",2009-2010,29155,29250,95,0.326,-44,139,54,35,H1
"Jackson County, WV",2010-2011,29250,29303,53,0.181,-2,55,54,35,H1
"Jackson County, WV",2011-2012,29303,29280,-23,-0.078,-22,-1,54,35,H1
"Jackson County, WV",2012-2013,29280,29187,-93,-0.318,-24,-69,54,35,H1
"Jackson County, WV",2013-2014,29187,29126,-61,-0.209,-20,-41,54,35,H1
"Jackson County, WV",2014-2015,29181,29237,56,0.192,-7,63,54,35,H1
"Jackson County, WV",2015-2016,29237,29172,-65,-0.222,-30,-35,54,35,H1
"Jackson County, WV",2016-2017,29172,28976,-196,-0.672,-22,-174,54,35,H1
"Jefferson County, WV",2000-2001,42485,43348,863,2.031,175,688,54,37,H1
"Jefferson County, WV",2001-2002,43348,44767,1419,3.274,253,1166,54,37,H1
"Jefferson County, WV",2002-2003,44767,46075,1308,2.922,206,1102,54,37,H1
"Jefferson County, WV",2003-2004,46075,47163,1088,2.361,196,892,54,37,H1
"Jefferson County, WV",2004-2005,47163,48662,1499,3.178,245,1254,54,37,H1
"Jefferson County, WV",2005-2006,48662,50003,1341,2.756,270,1071,54,37,H1
"Jefferson County, WV",2006-2007,50003,51264,1261,2.522,310,951,54,37,H1
"Jefferson County, WV",2007-2008,51264,52184,920,1.795,243,677,54,37,H1
"Jefferson County, WV",2008-2009,52184,53054,870,1.667,224,646,54,37,H1
"Jefferson County, WV",2009-2010,53054,53647,593,1.118,209,384,54,37,H1
"Jefferson County, WV",2010-2011,53647,54364,717,1.337,205,512,54,37,H1
"Jefferson County, WV",2011-2012,54364,54566,202,0.372,179,23,54,37,H1
"Jefferson County, WV",2012-2013,54566,54961,395,0.724,116,279,54,37,H1
"Jefferson County, WV",2013-2014,54961,55713,752,1.368,133,619,54,37,H1
"Jefferson County, WV",2014-2015,55740,56482,742,1.331,177,565,54,37,H1
"Jefferson County, WV",2015-2016,56482,55848,-634,-1.122,108,-742,54,37,H1
"Jefferson County, WV",2016-2017,55848,56338,490,0.877,59,431,54,37,H1
"Kanawha County, WV",2000-2001,199743,197898,-1845,-0.924,-188,-1657,54,39,H1
"Kanawha County, WV",2001-2002,197898,196422,-1476,-0.746,-125,-1351,54,39,H1
"Kanawha County, WV",2002-2003,196422,195960,-462,-0.235,-85,-377,54,39,H1
"Kanawha County, WV",2003-2004,195960,195364,-596,-0.304,-79,-517,54,39,H1
"Kanawha County, WV",2004-2005,195364,193878,-1486,-0.761,-199,-1287,54,39,H1
"Kanawha County, WV",2005-2006,193878,192954,-924,-0.477,-20,-904,54,39,H1
"Kanawha County, WV",2006-2007,192954,192354,-600,-0.311,-146,-454,54,39,H1
"Kanawha County, WV",2007-2008,192354,192414,60,0.031,-56,116,54,39,H1
"Kanawha County, WV",2008-2009,192414,193150,736,0.383,-136,872,54,39,H1
"Kanawha County, WV",2009-2010,193150,193029,-121,-0.063,-60,-61,54,39,H1
"Kanawha County, WV",2010-2011,193029,192027,-1002,-0.519,-368,-634,54,39,H1
"Kanawha County, WV",2011-2012,192027,192152,125,0.065,-42,167,54,39,H1
"Kanawha County, WV",2012-2013,192152,191394,-758,-0.394,-280,-478,54,39,H1
"Kanawha County, WV",2013-2014,191394,190223,-1171,-0.612,-261,-910,54,39,H1
"Kanawha County, WV",2014-2015,190151,188332,-1819,-0.957,-217,-1602,54,39,H1
"Kanawha County, WV",2015-2016,188332,186097,-2235,-1.187,-376,-1859,54,39,H1
"Kanawha County, WV",2016-2017,186097,183293,-2804,-1.507,-479,-2325,54,39,H1
"Lewis County, WV",2000-2001,16832,16802,-30,-0.178,1,-31,54,41,H1
"Lewis County, WV",2001-2002,16802,16681,-121,-0.72,-26,-95,54,41,H1
"Lewis County, WV",2002-2003,16681,16739,58,0.348,-48,106,54,41,H1
"Lewis County, WV",2003-2004,16739,16622,-117,-0.699,-69,-48,54,41,H1
"Lewis County, WV",2004-2005,16622,16593,-29,-0.174,-26,-3,54,41,H1
"Lewis County, WV",2005-2006,16593,16445,-148,-0.892,-15,-133,54,41,H1
"Lewis County, WV",2006-2007,16445,16360,-85,-0.517,-38,-47,54,41,H1
"Lewis County, WV",2007-2008,16360,16422,62,0.379,-24,86,54,41,H1
"Lewis County, WV",2008-2009,16422,16422,0,0,-20,20,54,41,H1
"Lewis County, WV",2009-2010,16422,16387,-35,-0.213,-25,-10,54,41,H1
"Lewis County, WV",2010-2011,16387,16380,-7,-0.043,-14,7,54,41,H1
"Lewis County, WV",2011-2012,16380,16426,46,0.281,-19,65,54,41,H1
"Lewis County, WV",2012-2013,16426,16455,29,0.177,-39,68,54,41,H1
"Lewis County, WV",2013-2014,16455,16414,-41,-0.249,-40,-1,54,41,H1
"Lewis County, WV",2014-2015,16442,16448,6,0.036,-22,28,54,41,H1
"Lewis County, WV",2015-2016,16448,16292,-156,-0.948,-25,-131,54,41,H1
"Lewis County, WV",2016-2017,16292,16226,-66,-0.405,-34,-32,54,41,H1
"Lincoln County, WV",2000-2001,22115,22067,-48,-0.217,-9,-39,54,43,H1
"Lincoln County, WV",2001-2002,22067,22113,46,0.208,52,-6,54,43,H1
"Lincoln County, WV",2002-2003,22113,22218,105,0.475,61,44,54,43,H1
"Lincoln County, WV",2003-2004,22218,22168,-50,-0.225,13,-63,54,43,H1
"Lincoln County, WV",2004-2005,22168,22160,-8,-0.036,3,-11,54,43,H1
"Lincoln County, WV",2005-2006,22160,22064,-96,-0.433,34,-130,54,43,H1
"Lincoln County, WV",2006-2007,22064,21953,-111,-0.503,30,-141,54,43,H1
"Lincoln County, WV",2007-2008,21953,21881,-72,-0.328,9,-81,54,43,H1
"Lincoln County, WV",2008-2009,21881,21794,-87,-0.398,19,-106,54,43,H1
"Lincoln County, WV",2009-2010,21794,21669,-125,-0.574,1,-126,54,43,H1
"Lincoln County, WV",2010-2011,21669,21606,-63,-0.291,3,-66,54,43,H1
"Lincoln County, WV",2011-2012,21606,21638,32,0.148,2,30,54,43,H1
"Lincoln County, WV",2012-2013,21638,21520,-118,-0.545,0,-118,54,43,H1
"Lincoln County, WV",2013-2014,21520,21561,41,0.191,-27,68,54,43,H1
"Lincoln County, WV",2014-2015,21596,21415,-181,-0.838,-14,-167,54,43,H1
"Lincoln County, WV",2015-2016,21415,21096,-319,-1.49,-65,-254,54,43,H1
"Lincoln County, WV",2016-2017,21096,20825,-271,-1.285,-78,-193,54,43,H1
"Logan County, WV",2000-2001,37577,37013,-564,-1.501,-1,-563,54,45,H1
"Logan County, WV",2001-2002,37013,37093,80,0.216,-60,140,54,45,H1
"Logan County, WV",2002-2003,37093,36947,-146,-0.394,15,-161,54,45,H1
"Logan County, WV",2003-2004,36947,36582,-365,-0.988,-60,-305,54,45,H1
"Logan County, WV",2004-2005,36582,36476,-106,-0.29,-82,-24,54,45,H1
"Logan County, WV",2005-2006,36476,36440,-36,-0.099,-105,69,54,45,H1
"Logan County, WV",2006-2007,36440,36443,3,0.008,-26,29,54,45,H1
"Logan County, WV",2007-2008,36443,36548,105,0.288,-60,165,54,45,H1
"Logan County, WV",2008-2009,36548,36645,97,0.265,-61,158,54,45,H1
"Logan County, WV",2009-2010,36645,36725,80,0.218,-88,168,54,45,H1
"Logan County, WV",2010-2011,36725,36453,-272,-0.741,-70,-202,54,45,H1
"Logan County, WV",2011-2012,36453,36336,-117,-0.321,-104,-13,54,45,H1
"Logan County, WV",2012-2013,36336,35981,-355,-0.977,-57,-298,54,45,H1
"Logan County, WV",2013-2014,35981,35348,-633,-1.759,-71,-562,54,45,H1
"Logan County, WV",2014-2015,35310,34707,-603,-1.708,-59,-544,54,45,H1
"Logan County, WV",2015-2016,34707,33644,-1063,-3.063,-215,-848,54,45,H1
"Logan County, WV",2016-2017,33644,32925,-719,-2.137,-160,-559,54,45,H1
"McDowell County, WV",2000-2001,27099,26301,-798,-2.945,-134,-664,54,47,H1
"McDowell County, WV",2001-2002,26301,25730,-571,-2.171,-109,-462,54,47,H1
"McDowell County, WV",2002-2003,25730,24989,-741,-2.88,-65,-676,54,47,H1
"McDowell County, WV",2003-2004,24989,24264,-725,-2.901,-65,-660,54,47,H1
"McDowell County, WV",2004-2005,24264,23711,-553,-2.279,-113,-440,54,47,H1
"McDowell County, WV",2005-2006,23711,23199,-512,-2.159,-76,-436,54,47,H1
"McDowell County, WV",2006-2007,23199,22746,-453,-1.953,-77,-376,54,47,H1
"McDowell County, WV",2007-2008,22746,22494,-252,-1.108,-56,-196,54,47,H1
"McDowell County, WV",2008-2009,22494,22276,-218,-0.969,-74,-144,54,47,H1
"McDowell County, WV",2009-2010,22276,22064,-212,-0.952,-80,-132,54,47,H1
"McDowell County, WV",2010-2011,22064,21690,-374,-1.695,-113,-261,54,47,H1
"McDowell County, WV",2011-2012,21690,21314,-376,-1.734,-122,-254,54,47,H1
"McDowell County, WV",2012-2013,21314,20890,-424,-1.989,-62,-362,54,47,H1
"McDowell County, WV",2013-2014,20890,20448,-442,-2.116,-69,-373,54,47,H1
"McDowell County, WV",2014-2015,20286,19835,-451,-2.223,-72,-379,54,47,H1
"McDowell County, WV",2015-2016,19835,19139,-696,-3.509,-135,-561,54,47,H1
"McDowell County, WV",2016-2017,19139,18456,-683,-3.569,-144,-539,54,47,H1
"Marion County, WV",2000-2001,56474,56060,-414,-0.733,-188,-226,54,49,H1
"Marion County, WV",2001-2002,56060,55997,-63,-0.112,-143,80,54,49,H1
"Marion County, WV",2002-2003,55997,56081,84,0.15,-89,173,54,49,H1
"Marion County, WV",2003-2004,56081,55957,-124,-0.221,-130,6,54,49,H1
"Marion County, WV",2004-2005,55957,56068,111,0.198,-88,199,54,49,H1
"Marion County, WV",2005-2006,56068,56284,216,0.385,-78,294,54,49,H1
"Marion County, WV",2006-2007,56284,56445,161,0.286,-20,181,54,49,H1
"Marion County, WV",2007-2008,56445,56141,-304,-0.539,-44,-260,54,49,H1
"Marion County, WV",2008-2009,56141,56426,285,0.508,-71,356,54,49,H1
"Marion County, WV",2009-2010,56426,56518,92,0.163,-63,155,54,49,H1
"Marion County, WV",2010-2011,56518,56624,106,0.188,27,79,54,49,H1
"Marion County, WV",2011-2012,56624,56787,163,0.288,11,152,54,49,H1
"Marion County, WV",2012-2013,56787,56758,-29,-0.051,-47,18,54,49,H1
"Marion County, WV",2013-2014,56758,56803,45,0.079,-57,102,54,49,H1
"Marion County, WV",2014-2015,56859,56925,66,0.116,21,45,54,49,H1
"Marion County, WV",2015-2016,56925,56477,-448,-0.787,-57,-391,54,49,H1
"Marion County, WV",2016-2017,56477,56337,-140,-0.248,-70,-70,54,49,H1
"Marshall County, WV",2000-2001,35399,35191,-208,-0.588,-5,-203,54,51,H1
"Marshall County, WV",2001-2002,35191,34890,-301,-0.855,-15,-286,54,51,H1
"Marshall County, WV",2002-2003,34890,34736,-154,-0.441,-44,-110,54,51,H1
"Marshall County, WV",2003-2004,34736,34521,-215,-0.619,-65,-150,54,51,H1
"Marshall County, WV",2004-2005,34521,34122,-399,-1.156,-81,-318,54,51,H1
"Marshall County, WV",2005-2006,34122,33814,-308,-0.903,-75,-233,54,51,H1
"Marshall County, WV",2006-2007,33814,33583,-231,-0.683,-51,-180,54,51,H1
"Marshall County, WV",2007-2008,33583,33248,-335,-0.998,-40,-295,54,51,H1
"Marshall County, WV",2008-2009,33248,33116,-132,-0.397,-76,-56,54,51,H1
"Marshall County, WV",2009-2010,33116,33060,-56,-0.169,-49,-7,54,51,H1
"Marshall County, WV",2010-2011,33060,32839,-221,-0.668,-89,-132,54,51,H1
"Marshall County, WV",2011-2012,32839,32684,-155,-0.472,-113,-42,54,51,H1
"Marshall County, WV",2012-2013,32684,32580,-104,-0.318,-49,-55,54,51,H1
"Marshall County, WV",2013-2014,32580,32416,-164,-0.503,-42,-122,54,51,H1
"Marshall County, WV",2014-2015,32310,31978,-332,-1.028,-68,-264,54,51,H1
"Marshall County, WV",2015-2016,31978,31705,-273,-0.854,-101,-172,54,51,H1
"Marshall County, WV",2016-2017,31705,31190,-515,-1.624,-89,-426,54,51,H1
"Mason County, WV",2000-2001,25973,26258,285,1.097,-16,301,54,53,H1
"Mason County, WV",2001-2002,26258,26343,85,0.324,23,62,54,53,H1
"Mason County, WV",2002-2003,26343,26511,168,0.638,-30,198,54,53,H1
"Mason County, WV",2003-2004,26511,26521,10,0.038,30,-20,54,53,H1
"Mason County, WV",2004-2005,26521,26363,-158,-0.596,-31,-127,54,53,H1
"Mason County, WV",2005-2006,26363,26648,285,1.081,-17,302,54,53,H1
"Mason County, WV",2006-2007,26648,26738,90,0.338,6,84,54,53,H1
"Mason County, WV",2007-2008,26738,27097,359,1.343,22,337,54,53,H1
"Mason County, WV",2008-2009,27097,27309,212,0.782,-15,227,54,53,H1
"Mason County, WV",2009-2010,27309,27335,26,0.095,-60,86,54,53,H1
"Mason County, WV",2010-2011,27335,27318,-17,-0.062,-53,36,54,53,H1
"Mason County, WV",2011-2012,27318,27222,-96,-0.351,-28,-68,54,53,H1
"Mason County, WV",2012-2013,27222,27146,-76,-0.279,-48,-28,54,53,H1
"Mason County, WV",2013-2014,27146,27016,-130,-0.479,-49,-81,54,53,H1
"Mason County, WV",2014-2015,27100,27037,-63,-0.232,-59,-4,54,53,H1
"Mason County, WV",2015-2016,27037,26909,-128,-0.473,-88,-40,54,53,H1
"Mason County, WV",2016-2017,26909,26801,-108,-0.401,-69,-39,54,53,H1
"Mercer County, WV",2000-2001,62911,61858,-1053,-1.674,-99,-954,54,55,H1
"Mercer County, WV",2001-2002,61858,62016,158,0.255,-49,207,54,55,H1
"Mercer County, WV",2002-2003,62016,61910,-106,-0.171,-92,-14,54,55,H1
"Mercer County, WV",2003-2004,61910,61694,-216,-0.349,-125,-91,54,55,H1
"Mercer County, WV",2004-2005,61694,61303,-391,-0.634,-112,-279,54,55,H1
"Mercer County, WV",2005-2006,61303,61297,-6,-0.01,-132,126,54,55,H1
"Mercer County, WV",2006-2007,61297,61615,318,0.519,-35,353,54,55,H1
"Mercer County, WV",2007-2008,61615,61848,233,0.378,-166,399,54,55,H1
"Mercer County, WV",2008-2009,61848,62177,329,0.532,-115,444,54,55,H1
"Mercer County, WV",2009-2010,62177,62313,136,0.219,-114,250,54,55,H1
"Mercer County, WV",2010-2011,62313,62437,124,0.199,-139,263,54,55,H1
"Mercer County, WV",2011-2012,62437,62358,-79,-0.127,-145,66,54,55,H1
"Mercer County, WV",2012-2013,62358,61910,-448,-0.718,-105,-343,54,55,H1
"Mercer County, WV",2013-2014,61910,61785,-125,-0.202,-129,4,54,55,H1
"Mercer County, WV",2014-2015,61667,61164,-503,-0.816,-141,-362,54,55,H1
"Mercer County, WV",2015-2016,61164,60494,-670,-1.095,-187,-483,54,55,H1
"Mercer County, WV",2016-2017,60494,59753,-741,-1.225,-182,-559,54,55,H1
"Mineral County, WV",2000-2001,27054,27071,17,0.063,16,1,54,57,H1
"Mineral County, WV",2001-2002,27071,27258,187,0.691,-27,214,54,57,H1
"Mineral County, WV",2002-2003,27258,27381,123,0.451,-2,125,54,57,H1
"Mineral County, WV",2003-2004,27381,27250,-131,-0.478,-41,-90,54,57,H1
"Mineral County, WV",2004-2005,27250,27193,-57,-0.209,-1,-56,54,57,H1
"Mineral County, WV",2005-2006,27193,27324,131,0.482,-55,186,54,57,H1
"Mineral County, WV",2006-2007,27324,27532,208,0.761,12,196,54,57,H1
"Mineral County, WV",2007-2008,27532,27824,292,1.061,31,261,54,57,H1
"Mineral County, WV",2008-2009,27824,28080,256,0.92,11,245,54,57,H1
"Mineral County, WV",2009-2010,28080,28248,168,0.598,18,150,54,57,H1
"Mineral County, WV",2010-2011,28248,28093,-155,-0.549,-35,-120,54,57,H1
"Mineral County, WV",2011-2012,28093,27933,-160,-0.57,-25,-135,54,57,H1
"Mineral County, WV",2012-2013,27933,27707,-226,-0.809,-27,-199,54,57,H1
"Mineral County, WV",2013-2014,27707,27578,-129,-0.466,-46,-83,54,57,H1
"Mineral County, WV",2014-2015,27603,27451,-152,-0.551,-37,-115,54,57,H1
"Mineral County, WV",2015-2016,27451,27322,-129,-0.47,-64,-65,54,57,H1
"Mineral County, WV",2016-2017,27322,27222,-100,-0.366,-63,-37,54,57,H1
"Mingo County, WV",2000-2001,28007,27489,-518,-1.85,23,-541,54,59,H1
"Mingo County, WV",2001-2002,27489,27583,94,0.342,56,38,54,59,H1
"Mingo County, WV",2002-2003,27583,27486,-97,-0.352,51,-148,54,59,H1
"Mingo County, WV",2003-2004,27486,27214,-272,-0.99,21,-293,54,59,H1
"Mingo County, WV",2004-2005,27214,27096,-118,-0.434,-1,-117,54,59,H1
"Mingo County, WV",2005-2006,27096,27054,-42,-0.155,-1,-41,54,59,H1
"Mingo County, WV",2006-2007,27054,27145,91,0.336,5,86,54,59,H1
"Mingo County, WV",2007-2008,27145,26850,-295,-1.087,47,-342,54,59,H1
"Mingo County, WV",2008-2009,26850,26943,93,0.346,9,84,54,59,H1
"Mingo County, WV",2009-2010,26943,26766,-177,-0.657,-1,-176,54,59,H1
"Mingo County, WV",2010-2011,26766,26591,-175,-0.654,14,-189,54,59,H1
"Mingo County, WV",2011-2012,26591,26122,-469,-1.764,5,-474,54,59,H1
"Mingo County, WV",2012-2013,26122,25948,-174,-0.666,-24,-150,54,59,H1
"Mingo County, WV",2013-2014,25948,25716,-232,-0.894,-6,-226,54,59,H1
"Mingo County, WV",2014-2015,25676,25292,-384,-1.496,-50,-334,54,59,H1
"Mingo County, WV",2015-2016,25292,24677,-615,-2.432,-60,-555,54,59,H1
"Mingo County, WV",2016-2017,24677,24127,-550,-2.229,-63,-487,54,59,H1
"Monongalia County, WV",2000-2001,82002,83230,1228,1.498,233,995,54,61,H1
"Monongalia County, WV",2001-2002,83230,84223,993,1.193,178,815,54,61,H1
"Monongalia County, WV",2002-2003,84223,85983,1760,2.09,291,1469,54,61,H1
"Monongalia County, WV",2003-2004,85983,87101,1118,1.3,354,764,54,61,H1
"Monongalia County, WV",2004-2005,87101,88424,1323,1.519,223,1100,54,61,H1
"Monongalia County, WV",2005-2006,88424,89656,1232,1.393,306,926,54,61,H1
"Monongalia County, WV",2006-2007,89656,90764,1108,1.236,293,815,54,61,H1
"Monongalia County, WV",2007-2008,90764,92200,1436,1.582,343,1093,54,61,H1
"Monongalia County, WV",2008-2009,92200,94165,1965,2.131,350,1615,54,61,H1
"Monongalia County, WV",2009-2010,94165,96766,2601,2.762,338,2263,54,61,H1
"Monongalia County, WV",2010-2011,96766,98684,1918,1.982,432,1486,54,61,H1
"Monongalia County, WV",2011-2012,98684,100531,1847,1.872,395,1452,54,61,H1
"Monongalia County, WV",2012-2013,100531,102217,1686,1.677,357,1329,54,61,H1
"Monongalia County, WV",2013-2014,102217,103463,1246,1.219,420,826,54,61,H1
"Monongalia County, WV",2014-2015,102936,104236,1300,1.263,458,842,54,61,H1
"Monongalia County, WV",2015-2016,104236,104771,535,0.513,360,175,54,61,H1
"Monongalia County, WV",2016-2017,104771,105030,259,0.247,393,-134,54,61,H1
"Monroe County, WV",2000-2001,13181,13245,64,0.486,-2,66,54,63,H1
"Monroe County, WV",2001-2002,13245,13257,12,0.091,6,6,54,63,H1
"Monroe County, WV",2002-2003,13257,13349,92,0.694,-24,116,54,63,H1
"Monroe County, WV",2003-2004,13349,13355,6,0.045,-47,53,54,63,H1
"Monroe County, WV",2004-2005,13355,13369,14,0.105,-38,52,54,63,H1
"Monroe County, WV",2005-2006,13369,13382,13,0.097,-4,17,54,63,H1
"Monroe County, WV",2006-2007,13382,13452,70,0.523,-7,77,54,63,H1
"Monroe County, WV",2007-2008,13452,13607,155,1.152,-46,201,54,63,H1
"Monroe County, WV",2008-2009,13607,13543,-64,-0.47,-21,-43,54,63,H1
"Monroe County, WV",2009-2010,13543,13503,-40,-0.295,-37,-3,54,63,H1
"Monroe County, WV",2010-2011,13503,13540,37,0.274,-55,92,54,63,H1
"Monroe County, WV",2011-2012,13540,13492,-48,-0.355,-23,-25,54,63,H1
"Monroe County, WV",2012-2013,13492,13502,10,0.074,-3,13,54,63,H1
"Monroe County, WV",2013-2014,13502,13582,80,0.593,-7,87,54,63,H1
"Monroe County, WV",2014-2015,13553,13506,-47,-0.347,-35,-12,54,63,H1
"Monroe County, WV",2015-2016,13506,13477,-29,-0.215,-39,10,54,63,H1
"Monroe County, WV",2016-2017,13477,13402,-75,-0.557,-30,-45,54,63,H1
"Morgan County, WV",2000-2001,15021,15270,249,1.658,-1,250,54,65,H1
"Morgan County, WV",2001-2002,15270,15461,191,1.251,-44,235,54,65,H1
"Morgan County, WV",2002-2003,15461,15772,311,2.012,-21,332,54,65,H1
"Morgan County, WV",2003-2004,15772,16117,345,2.187,-5,350,54,65,H1
"Morgan County, WV",2004-2005,16117,16462,345,2.141,-40,385,54,65,H1
"Morgan County, WV",2005-2006,16462,17038,576,3.499,-20,596,54,65,H1
"Morgan County, WV",2006-2007,17038,17410,372,2.183,-23,395,54,65,H1
"Morgan County, WV",2007-2008,17410,17520,110,0.632,-44,154,54,65,H1
"Morgan County, WV",2008-2009,17520,17580,60,0.342,-67,127,54,65,H1
"Morgan County, WV",2009-2010,17580,17503,-77,-0.438,-69,-8,54,65,H1
"Morgan County, WV",2010-2011,17503,17440,-63,-0.36,-70,7,54,65,H1
"Morgan County, WV",2011-2012,17440,17433,-7,-0.04,-51,44,54,65,H1
"Morgan County, WV",2012-2013,17433,17422,-11,-0.063,-57,46,54,65,H1
"Morgan County, WV",2013-2014,17422,17453,31,0.178,-72,103,54,65,H1
"Morgan County, WV",2014-2015,17498,17524,26,0.149,-62,88,54,65,H1
"Morgan County, WV",2015-2016,17524,17583,59,0.337,-87,146,54,65,H1
"Morgan County, WV",2016-2017,17583,17686,103,0.586,-90,193,54,65,H1
"Nicholas County, WV",2000-2001,26543,26177,-366,-1.379,-16,-350,54,67,H1
"Nicholas County, WV",2001-2002,26177,26160,-17,-0.065,-11,-6,54,67,H1
"Nicholas County, WV",2002-2003,26160,26063,-97,-0.371,-17,-80,54,67,H1
"Nicholas County, WV",2003-2004,26063,26089,26,0.1,-10,36,54,67,H1
"Nicholas County, WV",2004-2005,26089,26195,106,0.406,-27,133,54,67,H1
"Nicholas County, WV",2005-2006,26195,26205,10,0.038,-2,12,54,67,H1
"Nicholas County, WV",2006-2007,26205,26130,-75,-0.286,-9,-66,54,67,H1
"Nicholas County, WV",2007-2008,26130,26138,8,0.031,-6,14,54,67,H1
"Nicholas County, WV",2008-2009,26138,26253,115,0.44,-10,125,54,67,H1
"Nicholas County, WV",2009-2010,26253,26233,-20,-0.076,-35,15,54,67,H1
"Nicholas County, WV",2010-2011,26233,26149,-84,-0.32,-48,-36,54,67,H1
"Nicholas County, WV",2011-2012,26149,26252,103,0.394,6,97,54,67,H1
"Nicholas County, WV",2012-2013,26252,25987,-265,-1.009,-62,-203,54,67,H1
"Nicholas County, WV",2013-2014,25987,25827,-160,-0.616,-32,-128,54,67,H1
"Nicholas County, WV",2014-2015,25733,25594,-139,-0.54,-59,-80,54,67,H1
"Nicholas County, WV",2015-2016,25594,25291,-303,-1.184,-51,-252,54,67,H1
"Nicholas County, WV",2016-2017,25291,25043,-248,-0.981,-88,-160,54,67,H1
"Ohio County, WV",2000-2001,47343,46636,-707,-1.493,-141,-566,54,69,H1
"Ohio County, WV",2001-2002,46636,46259,-377,-0.808,-127,-250,54,69,H1
"Ohio County, WV",2002-2003,46259,45711,-548,-1.185,-141,-407,54,69,H1
"Ohio County, WV",2003-2004,45711,45424,-287,-0.628,-143,-144,54,69,H1
"Ohio County, WV",2004-2005,45424,45113,-311,-0.685,-110,-201,54,69,H1
"Ohio County, WV",2005-2006,45113,44925,-188,-0.417,-22,-166,54,69,H1
"Ohio County, WV",2006-2007,44925,44714,-211,-0.47,-108,-103,54,69,H1
"Ohio County, WV",2007-2008,44714,44469,-245,-0.548,-102,-143,54,69,H1
"Ohio County, WV",2008-2009,44469,44355,-114,-0.256,-109,-5,54,69,H1
"Ohio County, WV",2009-2010,44355,44479,124,0.28,-107,231,54,69,H1
"Ohio County, WV",2010-2011,44479,44191,-288,-0.647,-119,-169,54,69,H1
"Ohio County, WV",2011-2012,44191,44056,-135,-0.305,-90,-45,54,69,H1
"Ohio County, WV",2012-2013,44056,43728,-328,-0.745,-94,-234,54,69,H1
"Ohio County, WV",2013-2014,43728,43328,-400,-0.915,-69,-331,54,69,H1
"Ohio County, WV",2014-2015,43185,43066,-119,-0.276,-116,-3,54,69,H1
"Ohio County, WV",2015-2016,43066,42598,-468,-1.087,-120,-348,54,69,H1
"Ohio County, WV",2016-2017,42598,42035,-563,-1.322,-125,-438,54,69,H1
"Pendleton County, WV",2000-2001,8166,8112,-54,-0.661,-4,-50,54,71,H1
"Pendleton County, WV",2001-2002,8112,8030,-82,-1.011,-1,-81,54,71,H1
"Pendleton County, WV",2002-2003,8030,8073,43,0.535,29,14,54,71,H1
"Pendleton County, WV",2003-2004,8073,8036,-37,-0.458,0,-37,54,71,H1
"Pendleton County, WV",2004-2005,8036,7941,-95,-1.182,-41,-54,54,71,H1
"Pendleton County, WV",2005-2006,7941,7922,-19,-0.239,-15,-4,54,71,H1
"Pendleton County, WV",2006-2007,7922,7792,-130,-1.641,-21,-109,54,71,H1
"Pendleton County, WV",2007-2008,7792,7761,-31,-0.398,-20,-11,54,71,H1
"Pendleton County, WV",2008-2009,7761,7701,-60,-0.773,-12,-48,54,71,H1
"Pendleton County, WV",2009-2010,7701,7700,-1,-0.013,-10,9,54,71,H1
"Pendleton County, WV",2010-2011,7700,7580,-120,-1.558,-47,-73,54,71,H1
"Pendleton County, WV",2011-2012,7580,7532,-48,-0.633,-14,-34,54,71,H1
"Pendleton County, WV",2012-2013,7532,7443,-89,-1.182,-1,-88,54,71,H1
"Pendleton County, WV",2013-2014,7443,7371,-72,-0.967,0,-72,54,71,H1
"Pendleton County, WV",2014-2015,7288,7229,-59,-0.81,8,-67,54,71,H1
"Pendleton County, WV",2015-2016,7229,6987,-242,-3.348,-8,-234,54,71,H1
"Pendleton County, WV",2016-2017,6987,6996,9,0.129,-8,17,54,71,H1
"Pleasants County, WV",2000-2001,7501,7634,133,1.773,-13,146,54,73,H1
"Pleasants County, WV",2001-2002,7634,7631,-3,-0.039,-7,4,54,73,H1
"Pleasants County, WV",2002-2003,7631,7548,-83,-1.088,-30,-53,54,73,H1
"Pleasants County, WV",2003-2004,7548,7731,183,2.424,-23,206,54,73,H1
"Pleasants County, WV",2004-2005,7731,7680,-51,-0.66,-25,-26,54,73,H1
"Pleasants County, WV",2005-2006,7680,7670,-10,-0.13,-11,1,54,73,H1
"Pleasants County, WV",2006-2007,7670,7698,28,0.365,12,16,54,73,H1
"Pleasants County, WV",2007-2008,7698,7702,4,0.052,-28,32,54,73,H1
"Pleasants County, WV",2008-2009,7702,7672,-30,-0.39,-41,11,54,73,H1
"Pleasants County, WV",2009-2010,7672,7577,-95,-1.238,-42,-53,54,73,H1
"Pleasants County, WV",2010-2011,7577,7599,22,0.29,-35,57,54,73,H1
"Pleasants County, WV",2011-2012,7599,7592,-7,-0.092,-44,37,54,73,H1
"Pleasants County, WV",2012-2013,7592,7596,4,0.053,-24,28,54,73,H1
"Pleasants County, WV",2013-2014,7596,7634,38,0.5,-7,45,54,73,H1
"Pleasants County, WV",2014-2015,7713,7674,-39,-0.506,15,-54,54,73,H1
"Pleasants County, WV",2015-2016,7674,7512,-162,-2.111,8,-170,54,73,H1
"Pleasants County, WV",2016-2017,7512,7512,0,0,7,-7,54,73,H1
"Pocahontas County, WV",2000-2001,9099,8955,-144,-1.583,-34,-110,54,75,H1
"Pocahontas County, WV",2001-2002,8955,9004,49,0.547,-31,80,54,75,H1
"Pocahontas County, WV",2002-2003,9004,9034,30,0.333,-33,63,54,75,H1
"Pocahontas County, WV",2003-2004,9034,9090,56,0.62,-41,97,54,75,H1
"Pocahontas County, WV",2004-2005,9090,8983,-107,-1.177,-53,-54,54,75,H1
"Pocahontas County, WV",2005-2006,8983,8938,-45,-0.501,-35,-10,54,75,H1
"Pocahontas County, WV",2006-2007,8938,8851,-87,-0.973,-25,-62,54,75,H1
"Pocahontas County, WV",2007-2008,8851,8807,-44,-0.497,-22,-22,54,75,H1
"Pocahontas County, WV",2008-2009,8807,8746,-61,-0.693,-35,-26,54,75,H1
"Pocahontas County, WV",2009-2010,8746,8702,-44,-0.503,-31,-13,54,75,H1
"Pocahontas County, WV",2010-2011,8702,8817,115,1.322,-27,142,54,75,H1
"Pocahontas County, WV",2011-2012,8817,8697,-120,-1.361,-10,-110,54,75,H1
"Pocahontas County, WV",2012-2013,8697,8673,-24,-0.276,-29,5,54,75,H1
"Pocahontas County, WV",2013-2014,8673,8662,-11,-0.127,-33,22,54,75,H1
"Pocahontas County, WV",2014-2015,8671,8607,-64,-0.738,-16,-48,54,75,H1
"Pocahontas County, WV",2015-2016,8607,8518,-89,-1.034,-25,-64,54,75,H1
"Pocahontas County, WV",2016-2017,8518,8456,-62,-0.728,-32,-30,54,75,H1
"Preston County, WV",2000-2001,29336,29534,198,0.675,-80,278,54,77,H1
"Preston County, WV",2001-2002,29534,30120,586,1.984,9,577,54,77,H1
"Preston County, WV",2002-2003,30120,30483,363,1.205,-43,406,54,77,H1
"Preston County, WV",2003-2004,30483,30961,478,1.568,28,450,54,77,H1
"Preston County, WV",2004-2005,30961,31513,552,1.783,-20,572,54,77,H1
"Preston County, WV",2005-2006,31513,32238,725,2.301,36,689,54,77,H1
"Preston County, WV",2006-2007,32238,32743,505,1.566,33,472,54,77,H1
"Preston County, WV",2007-2008,32743,33067,324,0.99,-22,346,54,77,H1
"Preston County, WV",2008-2009,33067,33333,266,0.804,-41,307,54,77,H1
"Preston County, WV",2009-2010,33333,33562,229,0.687,-62,291,54,77,H1
"Preston County, WV",2010-2011,33562,33630,68,0.203,-14,82,54,77,H1
"Preston County, WV",2011-2012,33630,33910,280,0.833,29,251,54,77,H1
"Preston County, WV",2012-2013,33910,33708,-202,-0.596,-4,-198,54,77,H1
"Preston County, WV",2013-2014,33708,33788,80,0.237,-18,98,54,77,H1
"Preston County, WV",2014-2015,33899,33940,41,0.121,23,18,54,77,H1
"Preston County, WV",2015-2016,33940,33711,-229,-0.675,-35,-194,54,77,H1
"Preston County, WV",2016-2017,33711,33679,-32,-0.095,-43,11,54,77,H1
"Putnam County, WV",2000-2001,51684,51483,-201,-0.389,197,-398,54,79,H1
"Putnam County, WV",2001-2002,51483,51930,447,0.868,158,289,54,79,H1
"Putnam County, WV",2002-2003,51930,52581,651,1.254,182,469,54,79,H1
"Putnam County, WV",2003-2004,52581,53122,541,1.029,201,340,54,79,H1
"Putnam County, WV",2004-2005,53122,53614,492,0.926,189,303,54,79,H1
"Putnam County, WV",2005-2006,53614,54207,593,1.106,190,403,54,79,H1
"Putnam County, WV",2006-2007,54207,54669,462,0.852,166,296,54,79,H1
"Putnam County, WV",2007-2008,54669,55051,382,0.699,134,248,54,79,H1
"Putnam County, WV",2008-2009,55051,55178,127,0.231,169,-42,54,79,H1
"Putnam County, WV",2009-2010,55178,55694,516,0.935,118,398,54,79,H1
"Putnam County, WV",2010-2011,55694,56140,446,0.801,77,369,54,79,H1
"Putnam County, WV",2011-2012,56140,56589,449,0.8,76,373,54,79,H1
"Putnam County, WV",2012-2013,56589,56586,-3,-0.005,-25,22,54,79,H1
"Putnam County, WV",2013-2014,56586,56770,184,0.325,2,182,54,79,H1
"Putnam County, WV",2014-2015,56863,56848,-15,-0.026,50,-65,54,79,H1
"Putnam County, WV",2015-2016,56848,56692,-156,-0.274,6,-162,54,79,H1
"Putnam County, WV",2016-2017,56692,56792,100,0.176,-6,106,54,79,H1
"Raleigh County, WV",2000-2001,79018,78251,-767,-0.971,-118,-649,54,81,H1
"Raleigh County, WV",2001-2002,78251,78737,486,0.621,-23,509,54,81,H1
"Raleigh County, WV",2002-2003,78737,78465,-272,-0.345,-134,-138,54,81,H1
"Raleigh County, WV",2003-2004,78465,78428,-37,-0.047,10,-47,54,81,H1
"Raleigh County, WV",2004-2005,78428,78341,-87,-0.111,18,-105,54,81,H1
"Raleigh County, WV",2005-2006,78341,78178,-163,-0.208,25,-188,54,81,H1
"Raleigh County, WV",2006-2007,78178,78323,145,0.185,-21,166,54,81,H1
"Raleigh County, WV",2007-2008,78323,78379,56,0.071,21,35,54,81,H1
"Raleigh County, WV",2008-2009,78379,78782,403,0.514,-32,435,54,81,H1
"Raleigh County, WV",2009-2010,78782,78909,127,0.161,-80,207,54,81,H1
"Raleigh County, WV",2010-2011,78909,79233,324,0.411,-3,327,54,81,H1
"Raleigh County, WV",2011-2012,79233,79122,-111,-0.14,-14,-97,54,81,H1
"Raleigh County, WV",2012-2013,79122,78629,-493,-0.623,-68,-425,54,81,H1
"Raleigh County, WV",2013-2014,78629,78241,-388,-0.493,-65,-323,54,81,H1
"Raleigh County, WV",2014-2015,78155,77510,-645,-0.825,-127,-518,54,81,H1
"Raleigh County, WV",2015-2016,77510,76259,-1251,-1.614,-268,-983,54,81,H1
"Raleigh County, WV",2016-2017,76259,75022,-1237,-1.622,-276,-961,54,81,H1
"Randolph County, WV",2000-2001,28259,28373,114,0.403,-36,150,54,83,H1
"Randolph County, WV",2001-2002,28373,28487,114,0.402,-37,151,54,83,H1
"Randolph County, WV",2002-2003,28487,28422,-65,-0.228,-41,-24,54,83,H1
"Randolph County, WV",2003-2004,28422,28648,226,0.795,-32,258,54,83,H1
"Randolph County, WV",2004-2005,28648,28807,159,0.555,-10,169,54,83,H1
"Randolph County, WV",2005-2006,28807,29049,242,0.84,-10,252,54,83,H1
"Randolph County, WV",2006-2007,29049,29113,64,0.22,32,32,54,83,H1
"Randolph County, WV",2007-2008,29113,29236,123,0.422,-24,147,54,83,H1
"Randolph County, WV",2008-2009,29236,29381,145,0.496,-27,172,54,83,H1
"Randolph County, WV",2009-2010,29381,29376,-5,-0.017,-54,49,54,83,H1
"Randolph County, WV",2010-2011,29376,29438,62,0.211,-49,111,54,83,H1
"Randolph County, WV",2011-2012,29438,29420,-18,-0.061,-53,35,54,83,H1
"Randolph County, WV",2012-2013,29420,29566,146,0.496,-9,155,54,83,H1
"Randolph County, WV",2013-2014,29566,29429,-137,-0.463,-30,-107,54,83,H1
"Randolph County, WV",2014-2015,29294,29126,-168,-0.573,-64,-104,54,83,H1
"Randolph County, WV",2015-2016,29126,28962,-164,-0.563,-103,-61,54,83,H1
"Randolph County, WV",2016-2017,28962,28785,-177,-0.611,-94,-83,54,83,H1
"Ritchie County, WV",2000-2001,10346,10333,-13,-0.126,-18,5,54,85,H1
"Ritchie County, WV",2001-2002,10333,10372,39,0.377,17,22,54,85,H1
"Ritchie County, WV",2002-2003,10372,10434,62,0.598,-2,64,54,85,H1
"Ritchie County, WV",2003-2004,10434,10415,-19,-0.182,-21,2,54,85,H1
"Ritchie County, WV",2004-2005,10415,10506,91,0.874,3,88,54,85,H1
"Ritchie County, WV",2005-2006,10506,10588,82,0.781,-36,118,54,85,H1
"Ritchie County, WV",2006-2007,10588,10558,-30,-0.283,-23,-7,54,85,H1
"Ritchie County, WV",2007-2008,10558,10516,-42,-0.398,-15,-27,54,85,H1
"Ritchie County, WV",2008-2009,10516,10478,-38,-0.361,-3,-35,54,85,H1
"Ritchie County, WV",2009-2010,10478,10399,-79,-0.754,-17,-62,54,85,H1
"Ritchie County, WV",2010-2011,10399,10349,-50,-0.481,-26,-24,54,85,H1
"Ritchie County, WV",2011-2012,10349,10269,-80,-0.773,-27,-53,54,85,H1
"Ritchie County, WV",2012-2013,10269,10077,-192,-1.87,-44,-148,54,85,H1
"Ritchie County, WV",2013-2014,10077,10011,-66,-0.655,-45,-21,54,85,H1
"Ritchie County, WV",2014-2015,10009,9982,-27,-0.27,-47,20,54,85,H1
"Ritchie County, WV",2015-2016,9982,9942,-40,-0.401,-33,-7,54,85,H1
"Ritchie County, WV",2016-2017,9942,9774,-168,-1.69,-53,-115,54,85,H1
"Roane County, WV",2000-2001,15461,15428,-33,-0.213,-34,1,54,87,H1
"Roane County, WV",2001-2002,15428,15313,-115,-0.745,-23,-92,54,87,H1
"Roane County, WV",2002-2003,15313,15401,88,0.575,2,86,54,87,H1
"Roane County, WV",2003-2004,15401,15337,-64,-0.416,-14,-50,54,87,H1
"Roane County, WV",2004-2005,15337,15405,68,0.443,11,57,54,87,H1
"Roane County, WV",2005-2006,15405,15442,37,0.24,-15,52,54,87,H1
"Roane County, WV",2006-2007,15442,15215,-227,-1.47,-31,-196,54,87,H1
"Roane County, WV",2007-2008,15215,15048,-167,-1.098,-10,-157,54,87,H1
"Roane County, WV",2008-2009,15048,14966,-82,-0.545,6,-88,54,87,H1
"Roane County, WV",2009-2010,14966,14887,-79,-0.528,-18,-61,54,87,H1
"Roane County, WV",2010-2011,14887,14826,-61,-0.41,-14,-47,54,87,H1
"Roane County, WV",2011-2012,14826,14710,-116,-0.782,9,-125,54,87,H1
"Roane County, WV",2012-2013,14710,14655,-55,-0.374,-38,-17,54,87,H1
"Roane County, WV",2013-2014,14655,14664,9,0.061,-5,14,54,87,H1
"Roane County, WV",2014-2015,14605,14435,-170,-1.164,-23,-147,54,87,H1
"Roane County, WV",2015-2016,14435,14128,-307,-2.127,-45,-262,54,87,H1
"Roane County, WV",2016-2017,14128,14043,-85,-0.602,-57,-28,54,87,H1
"Summers County, WV",2000-2001,14356,14301,-55,-0.383,-34,-21,54,89,H1
"Summers County, WV",2001-2002,14301,14123,-178,-1.245,-69,-109,54,89,H1
"Summers County, WV",2002-2003,14123,14106,-17,-0.12,-46,29,54,89,H1
"Summers County, WV",2003-2004,14106,13997,-109,-0.773,-36,-73,54,89,H1
"Summers County, WV",2004-2005,13997,13950,-47,-0.336,-56,9,54,89,H1
"Summers County, WV",2005-2006,13950,13879,-71,-0.509,-51,-20,54,89,H1
"Summers County, WV",2006-2007,13879,13842,-37,-0.267,-29,-8,54,89,H1
"Summers County, WV",2007-2008,13842,13712,-130,-0.939,-28,-102,54,89,H1
"Summers County, WV",2008-2009,13712,13882,170,1.24,-53,223,54,89,H1
"Summers County, WV",2009-2010,13882,13932,50,0.36,-43,93,54,89,H1
"Summers County, WV",2010-2011,13932,13852,-80,-0.574,-87,7,54,89,H1
"Summers County, WV",2011-2012,13852,13761,-91,-0.657,-64,-27,54,89,H1
"Summers County, WV",2012-2013,13761,13532,-229,-1.664,-49,-180,54,89,H1
"Summers County, WV",2013-2014,13532,13417,-115,-0.85,-39,-76,54,89,H1
"Summers County, WV",2014-2015,13309,13239,-70,-0.526,-49,-21,54,89,H1
"Summers County, WV",2015-2016,13239,13004,-235,-1.775,-46,-189,54,89,H1
"Summers County, WV",2016-2017,13004,12993,-11,-0.085,-34,23,54,89,H1
"Taylor County, WV",2000-2001,16050,16079,29,0.181,-46,75,54,91,H1
"Taylor County, WV",2001-2002,16079,16089,10,0.062,-52,62,54,91,H1
"Taylor County, WV",2002-2003,16089,16160,71,0.441,-27,98,54,91,H1
"Taylor County, WV",2003-2004,16160,16247,87,0.538,-15,102,54,91,H1
"Taylor County, WV",2004-2005,16247,16318,71,0.437,-44,115,54,91,H1
"Taylor County, WV",2005-2006,16318,16498,180,1.103,-34,214,54,91,H1
"Taylor County, WV",2006-2007,16498,16640,142,0.861,11,131,54,91,H1
"Taylor County, WV",2007-2008,16640,16792,152,0.913,-28,180,54,91,H1
"Taylor County, WV",2008-2009,16792,16838,46,0.274,-24,70,54,91,H1
"Taylor County, WV",2009-2010,16838,16877,39,0.232,-40,79,54,91,H1
"Taylor County, WV",2010-2011,16877,16922,45,0.267,-30,75,54,91,H1
"Taylor County, WV",2011-2012,16922,16984,62,0.366,-17,79,54,91,H1
"Taylor County, WV",2012-2013,16984,16992,8,0.047,12,-4,54,91,H1
"Taylor County, WV",2013-2014,16992,17069,77,0.453,-5,82,54,91,H1
"Taylor County, WV",2014-2015,17053,16912,-141,-0.827,-7,-134,54,91,H1
"Taylor County, WV",2015-2016,16912,16947,35,0.207,-7,42,54,91,H1
"Taylor County, WV",2016-2017,16947,16930,-17,-0.1,-14,-3,54,91,H1
"Tucker County, WV",2000-2001,7288,7248,-40,-0.549,-17,-23,54,93,H1
"Tucker County, WV",2001-2002,7248,7332,84,1.159,-16,100,54,93,H1
"Tucker County, WV",2002-2003,7332,7294,-38,-0.518,-31,-7,54,93,H1
"Tucker County, WV",2003-2004,7294,7223,-71,-0.973,-23,-48,54,93,H1
"Tucker County, WV",2004-2005,7223,7178,-45,-0.623,-39,-6,54,93,H1
"Tucker County, WV",2005-2006,7178,7111,-67,-0.933,-4,-63,54,93,H1
"Tucker County, WV",2006-2007,7111,7117,6,0.084,-16,22,54,93,H1
"Tucker County, WV",2007-2008,7117,7160,43,0.604,-23,66,54,93,H1
"Tucker County, WV",2008-2009,7160,7172,12,0.168,-28,40,54,93,H1
"Tucker County, WV",2009-2010,7172,7110,-62,-0.864,-29,-33,54,93,H1
"Tucker County, WV",2010-2011,7110,7047,-63,-0.886,-34,-29,54,93,H1
"Tucker County, WV",2011-2012,7047,6941,-106,-1.504,-36,-70,54,93,H1
"Tucker County, WV",2012-2013,6941,6953,12,0.173,-21,33,54,93,H1
"Tucker County, WV",2013-2014,6953,6927,-26,-0.374,-51,25,54,93,H1
"Tucker County, WV",2014-2015,6947,6966,19,0.273,-33,52,54,93,H1
"Tucker County, WV",2015-2016,6966,7041,75,1.077,-40,115,54,93,H1
"Tucker County, WV",2016-2017,7041,6915,-126,-1.79,-61,-65,54,93,H1
"Tyler County, WV",2000-2001,9569,9533,-36,-0.376,-20,-16,54,95,H1
"Tyler County, WV",2001-2002,9533,9467,-66,-0.692,-19,-47,54,95,H1
"Tyler County, WV",2002-2003,9467,9475,8,0.085,-42,50,54,95,H1
"Tyler County, WV",2003-2004,9475,9517,42,0.443,-38,80,54,95,H1
"Tyler County, WV",2004-2005,9517,9531,14,0.147,-12,26,54,95,H1
"Tyler County, WV",2005-2006,9531,9484,-47,-0.493,-27,-20,54,95,H1
"Tyler County, WV",2006-2007,9484,9423,-61,-0.643,0,-61,54,95,H1
"Tyler County, WV",2007-2008,9423,9363,-60,-0.637,-37,-23,54,95,H1
"Tyler County, WV",2008-2009,9363,9249,-114,-1.218,-37,-77,54,95,H1
"Tyler County, WV",2009-2010,9249,9188,-61,-0.66,-38,-23,54,95,H1
"Tyler County, WV",2010-2011,9188,9105,-83,-0.903,-87,4,54,95,H1
"Tyler County, WV",2011-2012,9105,9033,-72,-0.791,-35,-37,54,95,H1
"Tyler County, WV",2012-2013,9033,8998,-35,-0.387,3,-38,54,95,H1
"Tyler County, WV",2013-2014,8998,9098,100,1.111,-11,111,54,95,H1
"Tyler County, WV",2014-2015,9079,8975,-104,-1.146,-10,-94,54,95,H1
"Tyler County, WV",2015-2016,8975,8958,-17,-0.189,-9,-8,54,95,H1
"Tyler County, WV",2016-2017,8958,8795,-163,-1.82,-23,-140,54,95,H1
"Upshur County, WV",2000-2001,23406,23366,-40,-0.171,-3,-37,54,97,H1
"Upshur County, WV",2001-2002,23366,23420,54,0.231,16,38,54,97,H1
"Upshur County, WV",2002-2003,23420,23766,346,1.477,37,309,54,97,H1
"Upshur County, WV",2003-2004,23766,23820,54,0.227,40,14,54,97,H1
"Upshur County, WV",2004-2005,23820,23654,-166,-0.697,-1,-165,54,97,H1
"Upshur County, WV",2005-2006,23654,23754,100,0.423,16,84,54,97,H1
"Upshur County, WV",2006-2007,23754,23851,97,0.408,18,79,54,97,H1
"Upshur County, WV",2007-2008,23851,23929,78,0.327,10,68,54,97,H1
"Upshur County, WV",2008-2009,23929,24124,195,0.815,11,184,54,97,H1
"Upshur County, WV",2009-2010,24124,24261,137,0.568,6,131,54,97,H1
"Upshur County, WV",2010-2011,24261,24276,15,0.062,-5,20,54,97,H1
"Upshur County, WV",2011-2012,24276,24506,230,0.947,23,207,54,97,H1
"Upshur County, WV",2012-2013,24506,24662,156,0.637,43,113,54,97,H1
"Upshur County, WV",2013-2014,24662,24731,69,0.28,24,45,54,97,H1
"Upshur County, WV",2014-2015,24665,24758,93,0.377,15,78,54,97,H1
"Upshur County, WV",2015-2016,24758,24610,-148,-0.598,-48,-100,54,97,H1
"Upshur County, WV",2016-2017,24610,24465,-145,-0.589,-36,-109,54,97,H1
"Wayne County, WV",2000-2001,42949,42919,-30,-0.07,48,-78,54,99,H1
"Wayne County, WV",2001-2002,42919,42800,-119,-0.277,7,-126,54,99,H1
"Wayne County, WV",2002-2003,42800,42937,137,0.32,13,124,54,99,H1
"Wayne County, WV",2003-2004,42937,42955,18,0.042,-9,27,54,99,H1
"Wayne County, WV",2004-2005,42955,42860,-95,-0.221,-48,-47,54,99,H1
"Wayne County, WV",2005-2006,42860,42717,-143,-0.334,-7,-136,54,99,H1
"Wayne County, WV",2006-2007,42717,42727,10,0.023,19,-9,54,99,H1
"Wayne County, WV",2007-2008,42727,42767,40,0.094,-42,82,54,99,H1
"Wayne County, WV",2008-2009,42767,42637,-130,-0.304,-53,-77,54,99,H1
"Wayne County, WV",2009-2010,42637,42424,-213,-0.5,-63,-150,54,99,H1
"Wayne County, WV",2010-2011,42424,41930,-494,-1.164,-109,-385,54,99,H1
"Wayne County, WV",2011-2012,41930,41672,-258,-0.615,-76,-182,54,99,H1
"Wayne County, WV",2012-2013,41672,41525,-147,-0.353,-72,-75,54,99,H1
"Wayne County, WV",2013-2014,41525,41122,-403,-0.97,-110,-293,54,99,H1
"Wayne County, WV",2014-2015,41258,40971,-287,-0.696,-70,-217,54,99,H1
"Wayne County, WV",2015-2016,40971,40680,-291,-0.71,-114,-177,54,99,H1
"Wayne County, WV",2016-2017,40680,40153,-527,-1.295,-140,-387,54,99,H1
"Webster County, WV",2000-2001,9675,9614,-61,-0.63,-16,-45,54,101,H1
"Webster County, WV",2001-2002,9614,9600,-14,-0.146,-35,21,54,101,H1
"Webster County, WV",2002-2003,9600,9593,-7,-0.073,-11,4,54,101,H1
"Webster County, WV",2003-2004,9593,9612,19,0.198,-33,52,54,101,H1
"Webster County, WV",2004-2005,9612,9463,-149,-1.55,-27,-122,54,101,H1
"Webster County, WV",2005-2006,9463,9391,-72,-0.761,-8,-64,54,101,H1
"Webster County, WV",2006-2007,9391,9260,-131,-1.395,-31,-100,54,101,H1
"Webster County, WV",2007-2008,9260,9260,0,0,-5,5,54,101,H1
"Webster County, WV",2008-2009,9260,9167,-93,-1.004,-25,-68,54,101,H1
"Webster County, WV",2009-2010,9167,9146,-21,-0.229,-37,16,54,101,H1
"Webster County, WV",2010-2011,9146,9148,2,0.022,6,-4,54,101,H1
"Webster County, WV",2011-2012,9148,9016,-132,-1.443,-21,-111,54,101,H1
"Webster County, WV",2012-2013,9016,8881,-135,-1.497,-32,-103,54,101,H1
"Webster County, WV",2013-2014,8881,8834,-47,-0.529,-19,-28,54,101,H1
"Webster County, WV",2014-2015,8830,8755,-75,-0.849,-12,-63,54,101,H1
"Webster County, WV",2015-2016,8755,8575,-180,-2.056,-48,-132,54,101,H1
"Webster County, WV",2016-2017,8575,8372,-203,-2.367,-47,-156,54,101,H1
"Wetzel County, WV",2000-2001,17675,17342,-333,-1.884,-55,-278,54,103,H1
"Wetzel County, WV",2001-2002,17342,17266,-76,-0.438,-10,-66,54,103,H1
"Wetzel County, WV",2002-2003,17266,17186,-80,-0.463,-26,-54,54,103,H1
"Wetzel County, WV",2003-2004,17186,17183,-3,-0.017,-9,6,54,103,H1
"Wetzel County, WV",2004-2005,17183,17101,-82,-0.477,-23,-59,54,103,H1
"Wetzel County, WV",2005-2006,17101,16917,-184,-1.076,5,-189,54,103,H1
"Wetzel County, WV",2006-2007,16917,16764,-153,-0.904,-31,-122,54,103,H1
"Wetzel County, WV",2007-2008,16764,16645,-119,-0.71,-23,-96,54,103,H1
"Wetzel County, WV",2008-2009,16645,16588,-57,-0.342,-10,-47,54,103,H1
"Wetzel County, WV",2009-2010,16588,16557,-31,-0.187,-5,-26,54,103,H1
"Wetzel County, WV",2010-2011,16557,16414,-143,-0.864,-42,-101,54,103,H1
"Wetzel County, WV",2011-2012,16414,16420,6,0.037,-69,75,54,103,H1
"Wetzel County, WV",2012-2013,16420,16191,-229,-1.395,-81,-148,54,103,H1
"Wetzel County, WV",2013-2014,16191,15988,-203,-1.254,-81,-122,54,103,H1
"Wetzel County, WV",2014-2015,15974,15816,-158,-0.989,-59,-99,54,103,H1
"Wetzel County, WV",2015-2016,15816,15641,-175,-1.106,-32,-143,54,103,H1
"Wetzel County, WV",2016-2017,15641,15437,-204,-1.304,-60,-144,54,103,H1
"Wirt County, WV",2000-2001,5874,5858,-16,-0.272,1,-17,54,105,H1
"Wirt County, WV",2001-2002,5858,5816,-42,-0.717,5,-47,54,105,H1
"Wirt County, WV",2002-2003,5816,5774,-42,-0.722,-8,-34,54,105,H1
"Wirt County, WV",2003-2004,5774,5813,39,0.675,0,39,54,105,H1
"Wirt County, WV",2004-2005,5813,5836,23,0.396,1,22,54,105,H1
"Wirt County, WV",2005-2006,5836,5791,-45,-0.771,-11,-34,54,105,H1
"Wirt County, WV",2006-2007,5791,5806,15,0.259,3,12,54,105,H1
"Wirt County, WV",2007-2008,5806,5745,-61,-1.051,1,-62,54,105,H1
"Wirt County, WV",2008-2009,5745,5703,-42,-0.731,-11,-31,54,105,H1
"Wirt County, WV",2009-2010,5703,5734,31,0.544,-22,53,54,105,H1
"Wirt County, WV",2010-2011,5734,5789,55,0.959,-2,57,54,105,H1
"Wirt County, WV",2011-2012,5789,5806,17,0.294,-6,23,54,105,H1
"Wirt County, WV",2012-2013,5806,5875,69,1.188,14,55,54,105,H1
"Wirt County, WV",2013-2014,5875,5845,-30,-0.511,19,-49,54,105,H1
"Wirt County, WV",2014-2015,5837,5880,43,0.737,15,28,54,105,H1
"Wirt County, WV",2015-2016,5880,5770,-110,-1.871,5,-115,54,105,H1
"Wirt County, WV",2016-2017,5770,5794,24,0.416,3,21,54,105,H1
"Wood County, WV",2000-2001,87837,87678,-159,-0.181,40,-199,54,107,H1
"Wood County, WV",2001-2002,87678,87608,-70,-0.08,19,-89,54,107,H1
"Wood County, WV",2002-2003,87608,87200,-408,-0.466,-2,-406,54,107,H1
"Wood County, WV",2003-2004,87200,86892,-308,-0.353,20,-328,54,107,H1
"Wood County, WV",2004-2005,86892,86819,-73,-0.084,79,-152,54,107,H1
"Wood County, WV",2005-2006,86819,86552,-267,-0.308,71,-338,54,107,H1
"Wood County, WV",2006-2007,86552,86489,-63,-0.073,47,-110,54,107,H1
"Wood County, WV",2007-2008,86489,86783,294,0.34,54,240,54,107,H1
"Wood County, WV",2008-2009,86783,86841,58,0.067,-10,68,54,107,H1
"Wood County, WV",2009-2010,86841,86981,140,0.161,13,127,54,107,H1
"Wood County, WV",2010-2011,86981,86798,-183,-0.21,-58,-125,54,107,H1
"Wood County, WV",2011-2012,86798,86561,-237,-0.273,-115,-122,54,107,H1
"Wood County, WV",2012-2013,86561,86400,-161,-0.186,-95,-66,54,107,H1
"Wood County, WV",2013-2014,86400,86237,-163,-0.189,-159,-4,54,107,H1
"Wood County, WV",2014-2015,86441,86452,11,0.013,14,-3,54,107,H1
"Wood County, WV",2015-2016,86452,85718,-734,-0.849,-81,-653,54,107,H1
"Wood County, WV",2016-2017,85718,85104,-614,-0.716,-121,-493,54,107,H1
"Wyoming County, WV",2000-2001,25585,25133,-452,-1.767,-29,-423,54,109,H1
"Wyoming County, WV",2001-2002,25133,24859,-274,-1.09,24,-298,54,109,H1
"Wyoming County, WV",2002-2003,24859,24777,-82,-0.33,46,-128,54,109,H1
"Wyoming County, WV",2003-2004,24777,24482,-295,-1.191,-83,-212,54,109,H1
"Wyoming County, WV",2004-2005,24482,24471,-11,-0.045,-47,36,54,109,H1
"Wyoming County, WV",2005-2006,24471,24288,-183,-0.748,-1,-182,54,109,H1
"Wyoming County, WV",2006-2007,24288,24078,-210,-0.865,-53,-157,54,109,H1
"Wyoming County, WV",2007-2008,24078,23957,-121,-0.503,-50,-71,54,109,H1
"Wyoming County, WV",2008-2009,23957,23899,-58,-0.242,-37,-21,54,109,H1
"Wyoming County, WV",2009-2010,23899,23733,-166,-0.695,-50,-116,54,109,H1
"Wyoming County, WV",2010-2011,23733,23474,-259,-1.091,-81,-178,54,109,H1
"Wyoming County, WV",2011-2012,23474,23251,-223,-0.95,-90,-133,54,109,H1
"Wyoming County, WV",2012-2013,23251,22960,-291,-1.252,-131,-160,54,109,H1
"Wyoming County, WV",2013-2014,22960,22598,-362,-1.577,-127,-235,54,109,H1
"Wyoming County, WV",2014-2015,22540,22151,-389,-1.726,-134,-255,54,109,H1
"Wyoming County, WV",2015-2016,22151,21753,-398,-1.797,-156,-242,54,109,H1
"Wyoming County, WV",2016-2017,21753,21210,-543,-2.496,-149,-394,54,109,H1
Wisconsin,2000-2001,5373999,5406835,32836,0.611,21801,11035,55,0,STATE
Wisconsin,2001-2002,5406835,5445162,38327,0.709,21913,16414,55,0,STATE
Wisconsin,2002-2003,5445162,5479203,34041,0.625,22446,11595,55,0,STATE
Wisconsin,2003-2004,5479203,5514026,34823,0.636,24252,10571,55,0,STATE
Wisconsin,2004-2005,5514026,5546166,32140,0.583,24082,8058,55,0,STATE
Wisconsin,2005-2006,5546166,5577655,31489,0.568,25117,6372,55,0,STATE
Wisconsin,2006-2007,5577655,5610775,33120,0.594,26255,6865,55,0,STATE
Wisconsin,2007-2008,5610775,5640996,30221,0.539,26244,3977,55,0,STATE
Wisconsin,2008-2009,5640996,5669264,28268,0.501,26291,1977,55,0,STATE
Wisconsin,2009-2010,5669264,5690204,20940,0.369,23103,-2163,55,0,STATE
Wisconsin,2010-2011,5690204,5709720,19516,0.343,19304,212,55,0,STATE
Wisconsin,2011-2012,5709720,5726422,16702,0.293,19756,-3054,55,0,STATE
Wisconsin,2012-2013,5726422,5743653,17231,0.301,16853,378,55,0,STATE
Wisconsin,2013-2014,5743653,5759432,15779,0.275,18088,-2309,55,0,STATE
Wisconsin,2014-2015,5759432,5771337,11905,0.207,18875,-6970,55,0,STATE
Wisconsin,2015-2016,5771337,5772917,1580,0.027,16370,-14790,55,0,STATE
Wisconsin,2016-2017,5772917,5795483,22566,0.391,16581,5985,55,0,STATE
"Adams County, WI",2000-2001,20047,20337,290,1.447,-87,377,55,1,H1
"Adams County, WI",2001-2002,20337,20578,241,1.185,-60,301,55,1,H1
"Adams County, WI",2002-2003,20578,20644,66,0.321,-82,148,55,1,H1
"Adams County, WI",2003-2004,20644,20774,130,0.63,-81,211,55,1,H1
"Adams County, WI",2004-2005,20774,21211,437,2.104,-74,511,55,1,H1
"Adams County, WI",2005-2006,21211,21185,-26,-0.123,-56,30,55,1,H1
"Adams County, WI",2006-2007,21185,21156,-29,-0.137,-59,30,55,1,H1
"Adams County, WI",2007-2008,21156,21101,-55,-0.26,-70,15,55,1,H1
"Adams County, WI",2008-2009,21101,20930,-171,-0.81,-53,-118,55,1,H1
"Adams County, WI",2009-2010,20930,20864,-66,-0.315,-106,40,55,1,H1
"Adams County, WI",2010-2011,20864,20908,44,0.211,-142,186,55,1,H1
"Adams County, WI",2011-2012,20908,20528,-380,-1.817,-107,-273,55,1,H1
"Adams County, WI",2012-2013,20528,20504,-24,-0.117,-81,57,55,1,H1
"Adams County, WI",2013-2014,20504,20215,-289,-1.409,-97,-192,55,1,H1
"Adams County, WI",2014-2015,20194,20148,-46,-0.228,-111,65,55,1,H1
"Adams County, WI",2015-2016,20148,19997,-151,-0.749,-138,-13,55,1,H1
"Adams County, WI",2016-2017,19997,19973,-24,-0.12,-122,98,55,1,H1
"Ashland County, WI",2000-2001,16823,16773,-50,-0.297,-6,-44,55,3,H1
"Ashland County, WI",2001-2002,16773,16747,-26,-0.155,-9,-17,55,3,H1
"Ashland County, WI",2002-2003,16747,16647,-100,-0.597,8,-108,55,3,H1
"Ashland County, WI",2003-2004,16647,16547,-100,-0.601,-15,-85,55,3,H1
"Ashland County, WI",2004-2005,16547,16407,-140,-0.846,-5,-135,55,3,H1
"Ashland County, WI",2005-2006,16407,16408,1,0.006,32,-31,55,3,H1
"Ashland County, WI",2006-2007,16408,16199,-209,-1.274,17,-226,55,3,H1
"Ashland County, WI",2007-2008,16199,16145,-54,-0.333,9,-63,55,3,H1
"Ashland County, WI",2008-2009,16145,16128,-17,-0.105,16,-33,55,3,H1
"Ashland County, WI",2009-2010,16128,16165,37,0.229,5,32,55,3,H1
"Ashland County, WI",2010-2011,16165,16084,-81,-0.501,-15,-66,55,3,H1
"Ashland County, WI",2011-2012,16084,15907,-177,-1.1,15,-192,55,3,H1
"Ashland County, WI",2012-2013,15907,16064,157,0.987,16,141,55,3,H1
"Ashland County, WI",2013-2014,16064,16103,39,0.243,15,24,55,3,H1
"Ashland County, WI",2014-2015,16076,15843,-233,-1.449,0,-233,55,3,H1
"Ashland County, WI",2015-2016,15843,15634,-209,-1.319,4,-213,55,3,H1
"Ashland County, WI",2016-2017,15634,15500,-134,-0.857,4,-138,55,3,H1
"Barron County, WI",2000-2001,45018,45225,207,0.46,4,203,55,5,H1
"Barron County, WI",2001-2002,45225,45515,290,0.641,-2,292,55,5,H1
"Barron County, WI",2002-2003,45515,45601,86,0.189,52,34,55,5,H1
"Barron County, WI",2003-2004,45601,45804,203,0.445,87,116,55,5,H1
"Barron County, WI",2004-2005,45804,45808,4,0.009,39,-35,55,5,H1
"Barron County, WI",2005-2006,45808,45968,160,0.349,53,107,55,5,H1
"Barron County, WI",2006-2007,45968,45874,-94,-0.204,93,-187,55,5,H1
"Barron County, WI",2007-2008,45874,46009,135,0.294,47,88,55,5,H1
"Barron County, WI",2008-2009,46009,45876,-133,-0.289,54,-187,55,5,H1
"Barron County, WI",2009-2010,45876,45842,-34,-0.074,-11,-23,55,5,H1
"Barron County, WI",2010-2011,45842,45911,69,0.151,9,60,55,5,H1
"Barron County, WI",2011-2012,45911,45777,-134,-0.292,68,-202,55,5,H1
"Barron County, WI",2012-2013,45777,45604,-173,-0.378,24,-197,55,5,H1
"Barron County, WI",2013-2014,45604,45455,-149,-0.327,69,-218,55,5,H1
"Barron County, WI",2014-2015,45503,45563,60,0.132,38,22,55,5,H1
"Barron County, WI",2015-2016,45563,45267,-296,-0.65,-10,-286,55,5,H1
"Barron County, WI",2016-2017,45267,45251,-16,-0.035,15,-31,55,5,H1
"Bayfield County, WI",2000-2001,15028,15076,48,0.319,-57,105,55,7,H1
"Bayfield County, WI",2001-2002,15076,15128,52,0.345,9,43,55,7,H1
"Bayfield County, WI",2002-2003,15128,15165,37,0.245,-8,45,55,7,H1
"Bayfield County, WI",2003-2004,15165,15164,-1,-0.007,-17,16,55,7,H1
"Bayfield County, WI",2004-2005,15164,15163,-1,-0.007,-13,12,55,7,H1
"Bayfield County, WI",2005-2006,15163,15172,9,0.059,-21,30,55,7,H1
"Bayfield County, WI",2006-2007,15172,15255,83,0.547,-8,91,55,7,H1
"Bayfield County, WI",2007-2008,15255,15160,-95,-0.623,-21,-74,55,7,H1
"Bayfield County, WI",2008-2009,15160,14981,-179,-1.181,-17,-162,55,7,H1
"Bayfield County, WI",2009-2010,14981,15014,33,0.22,-38,71,55,7,H1
"Bayfield County, WI",2010-2011,15014,15106,92,0.613,-23,115,55,7,H1
"Bayfield County, WI",2011-2012,15106,15090,-16,-0.106,2,-18,55,7,H1
"Bayfield County, WI",2012-2013,15090,15125,35,0.232,-66,101,55,7,H1
"Bayfield County, WI",2013-2014,15125,14985,-140,-0.926,-41,-99,55,7,H1
"Bayfield County, WI",2014-2015,14964,14977,13,0.087,-49,62,55,7,H1
"Bayfield County, WI",2015-2016,14977,14940,-37,-0.247,-61,24,55,7,H1
"Bayfield County, WI",2016-2017,14940,15008,68,0.455,-63,131,55,7,H1
"Brown County, WI",2000-2001,227266,229332,2066,0.909,1626,440,55,9,H1
"Brown County, WI",2001-2002,229332,231821,2489,1.085,1642,847,55,9,H1
"Brown County, WI",2002-2003,231821,233878,2057,0.887,1743,314,55,9,H1
"Brown County, WI",2003-2004,233878,236654,2776,1.187,1771,1005,55,9,H1
"Brown County, WI",2004-2005,236654,238587,1933,0.817,1687,246,55,9,H1
"Brown County, WI",2005-2006,238587,240191,1604,0.672,1767,-163,55,9,H1
"Brown County, WI",2006-2007,240191,242691,2500,1.041,1890,610,55,9,H1
"Brown County, WI",2007-2008,242691,244016,1325,0.546,1761,-436,55,9,H1
"Brown County, WI",2008-2009,244016,246476,2460,1.008,1779,681,55,9,H1
"Brown County, WI",2009-2010,246476,248484,2008,0.815,1746,262,55,9,H1
"Brown County, WI",2010-2011,248484,250556,2072,0.834,1561,511,55,9,H1
"Brown County, WI",2011-2012,250556,253014,2458,0.981,1609,849,55,9,H1
"Brown County, WI",2012-2013,253014,254765,1751,0.692,1737,14,55,9,H1
"Brown County, WI",2013-2014,254765,256670,1905,0.748,1733,172,55,9,H1
"Brown County, WI",2014-2015,256588,258718,2130,0.83,1668,462,55,9,H1
"Brown County, WI",2015-2016,258718,259586,868,0.336,1429,-561,55,9,H1
"Brown County, WI",2016-2017,259586,262052,2466,0.95,1486,980,55,9,H1
"Buffalo County, WI",2000-2001,13799,13855,56,0.406,55,1,55,11,H1
"Buffalo County, WI",2001-2002,13855,13777,-78,-0.563,20,-98,55,11,H1
"Buffalo County, WI",2002-2003,13777,13807,30,0.218,-14,44,55,11,H1
"Buffalo County, WI",2003-2004,13807,13785,-22,-0.159,47,-69,55,11,H1
"Buffalo County, WI",2004-2005,13785,13969,184,1.335,33,151,55,11,H1
"Buffalo County, WI",2005-2006,13969,13908,-61,-0.437,25,-86,55,11,H1
"Buffalo County, WI",2006-2007,13908,13885,-23,-0.165,38,-61,55,11,H1
"Buffalo County, WI",2007-2008,13885,13734,-151,-1.088,8,-159,55,11,H1
"Buffalo County, WI",2008-2009,13734,13618,-116,-0.845,6,-122,55,11,H1
"Buffalo County, WI",2009-2010,13618,13548,-70,-0.514,25,-95,55,11,H1
"Buffalo County, WI",2010-2011,13548,13473,-75,-0.554,-15,-60,55,11,H1
"Buffalo County, WI",2011-2012,13473,13332,-141,-1.047,28,-169,55,11,H1
"Buffalo County, WI",2012-2013,13332,13330,-2,-0.015,25,-27,55,11,H1
"Buffalo County, WI",2013-2014,13330,13188,-142,-1.065,21,-163,55,11,H1
"Buffalo County, WI",2014-2015,13205,13192,-13,-0.098,20,-33,55,11,H1
"Buffalo County, WI",2015-2016,13192,13160,-32,-0.243,28,-60,55,11,H1
"Buffalo County, WI",2016-2017,13160,13167,7,0.053,23,-16,55,11,H1
"Burnett County, WI",2000-2001,15688,15797,109,0.695,-67,176,55,13,H1
"Burnett County, WI",2001-2002,15797,15906,109,0.69,-26,135,55,13,H1
"Burnett County, WI",2002-2003,15906,16063,157,0.987,-39,196,55,13,H1
"Burnett County, WI",2003-2004,16063,16180,117,0.728,-57,174,55,13,H1
"Burnett County, WI",2004-2005,16180,16143,-37,-0.229,-12,-25,55,13,H1
"Burnett County, WI",2005-2006,16143,16056,-87,-0.539,-20,-67,55,13,H1
"Burnett County, WI",2006-2007,16056,15965,-91,-0.567,-41,-50,55,13,H1
"Burnett County, WI",2007-2008,15965,15696,-269,-1.685,-12,-257,55,13,H1
"Burnett County, WI",2008-2009,15696,15609,-87,-0.554,-28,-59,55,13,H1
"Burnett County, WI",2009-2010,15609,15430,-179,-1.147,-75,-104,55,13,H1
"Burnett County, WI",2010-2011,15430,15506,76,0.493,4,72,55,13,H1
"Burnett County, WI",2011-2012,15506,15357,-149,-0.961,-36,-113,55,13,H1
"Burnett County, WI",2012-2013,15357,15316,-41,-0.267,-30,-11,55,13,H1
"Burnett County, WI",2013-2014,15316,15328,12,0.078,-25,37,55,13,H1
"Burnett County, WI",2014-2015,15320,15159,-161,-1.051,-41,-120,55,13,H1
"Burnett County, WI",2015-2016,15159,15229,70,0.462,-28,98,55,13,H1
"Burnett County, WI",2016-2017,15229,15352,123,0.808,-12,135,55,13,H1
"Calumet County, WI",2000-2001,40898,41950,1052,2.572,323,729,55,15,H1
"Calumet County, WI",2001-2002,41950,43411,1461,3.483,324,1137,55,15,H1
"Calumet County, WI",2002-2003,43411,44660,1249,2.877,361,888,55,15,H1
"Calumet County, WI",2003-2004,44660,45456,796,1.782,421,375,55,15,H1
"Calumet County, WI",2004-2005,45456,46185,729,1.604,408,321,55,15,H1
"Calumet County, WI",2005-2006,46185,46809,624,1.351,371,253,55,15,H1
"Calumet County, WI",2006-2007,46809,47188,379,0.81,453,-74,55,15,H1
"Calumet County, WI",2007-2008,47188,48014,826,1.75,342,484,55,15,H1
"Calumet County, WI",2008-2009,48014,48457,443,0.923,399,44,55,15,H1
"Calumet County, WI",2009-2010,48457,48989,532,1.098,369,163,55,15,H1
"Calumet County, WI",2010-2011,48989,49684,695,1.419,310,385,55,15,H1
"Calumet County, WI",2011-2012,49684,49704,20,0.04,302,-282,55,15,H1
"Calumet County, WI",2012-2013,49704,49644,-60,-0.121,180,-240,55,15,H1
"Calumet County, WI",2013-2014,49644,49491,-153,-0.308,220,-373,55,15,H1
"Calumet County, WI",2014-2015,49504,49762,258,0.521,188,70,55,15,H1
"Calumet County, WI",2015-2016,49762,49648,-114,-0.229,150,-264,55,15,H1
"Calumet County, WI",2016-2017,49648,50067,419,0.844,141,278,55,15,H1
"Chippewa County, WI",2000-2001,55346,55820,474,0.856,132,342,55,17,H1
"Chippewa County, WI",2001-2002,55820,56353,533,0.955,174,359,55,17,H1
"Chippewa County, WI",2002-2003,56353,57184,831,1.475,117,714,55,17,H1
"Chippewa County, WI",2003-2004,57184,58801,1617,2.828,249,1368,55,17,H1
"Chippewa County, WI",2004-2005,58801,59802,1001,1.702,218,783,55,17,H1
"Chippewa County, WI",2005-2006,59802,60271,469,0.784,311,158,55,17,H1
"Chippewa County, WI",2006-2007,60271,61022,751,1.246,328,423,55,17,H1
"Chippewa County, WI",2007-2008,61022,61524,502,0.823,254,248,55,17,H1
"Chippewa County, WI",2008-2009,61524,61997,473,0.769,285,188,55,17,H1
"Chippewa County, WI",2009-2010,61997,62615,618,0.997,185,433,55,17,H1
"Chippewa County, WI",2010-2011,62615,62929,314,0.501,253,61,55,17,H1
"Chippewa County, WI",2011-2012,62929,63051,122,0.194,270,-148,55,17,H1
"Chippewa County, WI",2012-2013,63051,63199,148,0.235,164,-16,55,17,H1
"Chippewa County, WI",2013-2014,63199,63460,261,0.413,188,73,55,17,H1
"Chippewa County, WI",2014-2015,63408,63531,123,0.194,128,-5,55,17,H1
"Chippewa County, WI",2015-2016,63531,63567,36,0.057,96,-60,55,17,H1
"Chippewa County, WI",2016-2017,63567,63813,246,0.387,130,116,55,17,H1
"Clark County, WI",2000-2001,33643,33763,120,0.357,189,-69,55,19,H1
"Clark County, WI",2001-2002,33763,33851,88,0.261,161,-73,55,19,H1
"Clark County, WI",2002-2003,33851,34066,215,0.635,200,15,55,19,H1
"Clark County, WI",2003-2004,34066,34234,168,0.493,170,-2,55,19,H1
"Clark County, WI",2004-2005,34234,34334,100,0.292,243,-143,55,19,H1
"Clark County, WI",2005-2006,34334,34399,65,0.189,279,-214,55,19,H1
"Clark County, WI",2006-2007,34399,34435,36,0.105,235,-199,55,19,H1
"Clark County, WI",2007-2008,34435,34644,209,0.607,245,-36,55,19,H1
"Clark County, WI",2008-2009,34644,34589,-55,-0.159,250,-305,55,19,H1
"Clark County, WI",2009-2010,34589,34687,98,0.283,197,-99,55,19,H1
"Clark County, WI",2010-2011,34687,34738,51,0.147,262,-211,55,19,H1
"Clark County, WI",2011-2012,34738,34465,-273,-0.786,242,-515,55,19,H1
"Clark County, WI",2012-2013,34465,34562,97,0.281,264,-167,55,19,H1
"Clark County, WI",2013-2014,34562,34423,-139,-0.402,227,-366,55,19,H1
"Clark County, WI",2014-2015,34393,34445,52,0.151,248,-196,55,19,H1
"Clark County, WI",2015-2016,34445,34558,113,0.328,275,-162,55,19,H1
"Clark County, WI",2016-2017,34558,34679,121,0.35,255,-134,55,19,H1
"Columbia County, WI",2000-2001,52678,53167,489,0.928,49,440,55,21,H1
"Columbia County, WI",2001-2002,53167,53488,321,0.604,123,198,55,21,H1
"Columbia County, WI",2002-2003,53488,54168,680,1.271,129,551,55,21,H1
"Columbia County, WI",2003-2004,54168,55048,880,1.625,170,710,55,21,H1
"Columbia County, WI",2004-2005,55048,55409,361,0.656,156,205,55,21,H1
"Columbia County, WI",2005-2006,55409,55820,411,0.742,161,250,55,21,H1
"Columbia County, WI",2006-2007,55820,56197,377,0.675,162,215,55,21,H1
"Columbia County, WI",2007-2008,56197,56362,165,0.294,182,-17,55,21,H1
"Columbia County, WI",2008-2009,56362,56469,107,0.19,178,-71,55,21,H1
"Columbia County, WI",2009-2010,56469,56888,419,0.742,126,293,55,21,H1
"Columbia County, WI",2010-2011,56888,56716,-172,-0.302,114,-286,55,21,H1
"Columbia County, WI",2011-2012,56716,56461,-255,-0.45,66,-321,55,21,H1
"Columbia County, WI",2012-2013,56461,56613,152,0.269,120,32,55,21,H1
"Columbia County, WI",2013-2014,56613,56615,2,0.004,105,-103,55,21,H1
"Columbia County, WI",2014-2015,56571,56743,172,0.304,74,98,55,21,H1
"Columbia County, WI",2015-2016,56743,56893,150,0.264,98,52,55,21,H1
"Columbia County, WI",2016-2017,56893,57248,355,0.624,100,255,55,21,H1
"Crawford County, WI",2000-2001,17238,17020,-218,-1.265,22,-240,55,23,H1
"Crawford County, WI",2001-2002,17020,16984,-36,-0.212,24,-60,55,23,H1
"Crawford County, WI",2002-2003,16984,16891,-93,-0.548,9,-102,55,23,H1
"Crawford County, WI",2003-2004,16891,17007,116,0.687,49,67,55,23,H1
"Crawford County, WI",2004-2005,17007,16895,-112,-0.659,-4,-108,55,23,H1
"Crawford County, WI",2005-2006,16895,16953,58,0.343,34,24,55,23,H1
"Crawford County, WI",2006-2007,16953,16924,-29,-0.171,-4,-25,55,23,H1
"Crawford County, WI",2007-2008,16924,16808,-116,-0.685,18,-134,55,23,H1
"Crawford County, WI",2008-2009,16808,16692,-116,-0.69,45,-161,55,23,H1
"Crawford County, WI",2009-2010,16692,16615,-77,-0.461,32,-109,55,23,H1
"Crawford County, WI",2010-2011,16615,16664,49,0.295,-33,82,55,23,H1
"Crawford County, WI",2011-2012,16664,16531,-133,-0.798,-22,-111,55,23,H1
"Crawford County, WI",2012-2013,16531,16424,-107,-0.647,1,-108,55,23,H1
"Crawford County, WI",2013-2014,16424,16392,-32,-0.195,-2,-30,55,23,H1
"Crawford County, WI",2014-2015,16386,16391,5,0.031,8,-3,55,23,H1
"Crawford County, WI",2015-2016,16391,16280,-111,-0.677,12,-123,55,23,H1
"Crawford County, WI",2016-2017,16280,16214,-66,-0.405,-8,-58,55,23,H1
"Dane County, WI",2000-2001,428231,434745,6514,1.521,2900,3614,55,25,H1
"Dane County, WI",2001-2002,434745,441623,6878,1.582,2919,3959,55,25,H1
"Dane County, WI",2002-2003,441623,447515,5892,1.334,2932,2960,55,25,H1
"Dane County, WI",2003-2004,447515,453327,5812,1.299,3213,2599,55,25,H1
"Dane County, WI",2004-2005,453327,459048,5721,1.262,3463,2258,55,25,H1
"Dane County, WI",2005-2006,459048,465018,5970,1.301,3478,2492,55,25,H1
"Dane County, WI",2006-2007,465018,471644,6626,1.425,3386,3240,55,25,H1
"Dane County, WI",2007-2008,471644,477791,6147,1.303,3550,2597,55,25,H1
"Dane County, WI",2008-2009,477791,484979,7188,1.504,3491,3697,55,25,H1
"Dane County, WI",2009-2010,484979,489007,4028,0.831,3403,625,55,25,H1
"Dane County, WI",2010-2011,489007,496307,7300,1.493,2998,4302,55,25,H1
"Dane County, WI",2011-2012,496307,503293,6986,1.408,3196,3790,55,25,H1
"Dane County, WI",2012-2013,503293,510027,6734,1.338,3160,3574,55,25,H1
"Dane County, WI",2013-2014,510027,516284,6257,1.227,3160,3097,55,25,H1
"Dane County, WI",2014-2015,516929,523643,6714,1.299,3144,3570,55,25,H1
"Dane County, WI",2015-2016,523643,530257,6614,1.263,3001,3613,55,25,H1
"Dane County, WI",2016-2017,530257,536416,6159,1.162,2947,3212,55,25,H1
"Dodge County, WI",2000-2001,85971,86385,414,0.482,125,289,55,27,H1
"Dodge County, WI",2001-2002,86385,86908,523,0.605,56,467,55,27,H1
"Dodge County, WI",2002-2003,86908,87415,507,0.583,37,470,55,27,H1
"Dodge County, WI",2003-2004,87415,88070,655,0.749,126,529,55,27,H1
"Dodge County, WI",2004-2005,88070,88168,98,0.111,76,22,55,27,H1
"Dodge County, WI",2005-2006,88168,89003,835,0.947,94,741,55,27,H1
"Dodge County, WI",2006-2007,89003,89007,4,0.004,114,-110,55,27,H1
"Dodge County, WI",2007-2008,89007,89239,232,0.261,80,152,55,27,H1
"Dodge County, WI",2008-2009,89239,88677,-562,-0.63,130,-692,55,27,H1
"Dodge County, WI",2009-2010,88677,88659,-18,-0.02,10,-28,55,27,H1
"Dodge County, WI",2010-2011,88659,88737,78,0.088,-43,121,55,27,H1
"Dodge County, WI",2011-2012,88737,88576,-161,-0.181,-2,-159,55,27,H1
"Dodge County, WI",2012-2013,88576,88399,-177,-0.2,-3,-174,55,27,H1
"Dodge County, WI",2013-2014,88399,88574,175,0.198,-39,214,55,27,H1
"Dodge County, WI",2014-2015,88570,88502,-68,-0.077,-1,-67,55,27,H1
"Dodge County, WI",2015-2016,88502,87428,-1074,-1.214,-97,-977,55,27,H1
"Dodge County, WI",2016-2017,87428,87786,358,0.409,-89,447,55,27,H1
"Door County, WI",2000-2001,28019,28159,140,0.5,-80,220,55,29,H1
"Door County, WI",2001-2002,28159,28249,90,0.32,-53,143,55,29,H1
"Door County, WI",2002-2003,28249,28313,64,0.227,-71,135,55,29,H1
"Door County, WI",2003-2004,28313,28213,-100,-0.353,-67,-33,55,29,H1
"Door County, WI",2004-2005,28213,28146,-67,-0.237,-55,-12,55,29,H1
"Door County, WI",2005-2006,28146,28167,21,0.075,-9,30,55,29,H1
"Door County, WI",2006-2007,28167,27957,-210,-0.746,-68,-142,55,29,H1
"Door County, WI",2007-2008,27957,28023,66,0.236,-46,112,55,29,H1
"Door County, WI",2008-2009,28023,27919,-104,-0.371,-54,-50,55,29,H1
"Door County, WI",2009-2010,27919,27712,-207,-0.741,-97,-110,55,29,H1
"Door County, WI",2010-2011,27712,27883,171,0.617,-99,270,55,29,H1
"Door County, WI",2011-2012,27883,27710,-173,-0.62,-108,-65,55,29,H1
"Door County, WI",2012-2013,27710,27873,163,0.588,-151,314,55,29,H1
"Door County, WI",2013-2014,27873,27766,-107,-0.384,-153,46,55,29,H1
"Door County, WI",2014-2015,27713,27554,-159,-0.574,-132,-27,55,29,H1
"Door County, WI",2015-2016,27554,27348,-206,-0.748,-96,-110,55,29,H1
"Door County, WI",2016-2017,27348,27483,135,0.494,-125,260,55,29,H1
"Douglas County, WI",2000-2001,43365,43529,164,0.378,82,82,55,31,H1
"Douglas County, WI",2001-2002,43529,43593,64,0.147,38,26,55,31,H1
"Douglas County, WI",2002-2003,43593,43790,197,0.452,31,166,55,31,H1
"Douglas County, WI",2003-2004,43790,43833,43,0.098,50,-7,55,31,H1
"Douglas County, WI",2004-2005,43833,43872,39,0.089,26,13,55,31,H1
"Douglas County, WI",2005-2006,43872,43815,-57,-0.13,79,-136,55,31,H1
"Douglas County, WI",2006-2007,43815,43710,-105,-0.24,-28,-77,55,31,H1
"Douglas County, WI",2007-2008,43710,43830,120,0.275,101,19,55,31,H1
"Douglas County, WI",2008-2009,43830,43998,168,0.383,69,99,55,31,H1
"Douglas County, WI",2009-2010,43998,44181,183,0.416,13,170,55,31,H1
"Douglas County, WI",2010-2011,44181,44014,-167,-0.378,35,-202,55,31,H1
"Douglas County, WI",2011-2012,44014,43816,-198,-0.45,77,-275,55,31,H1
"Douglas County, WI",2012-2013,43816,43796,-20,-0.046,-4,-16,55,31,H1
"Douglas County, WI",2013-2014,43796,43698,-98,-0.224,9,-107,55,31,H1
"Douglas County, WI",2014-2015,43733,43601,-132,-0.302,28,-160,55,31,H1
"Douglas County, WI",2015-2016,43601,43392,-209,-0.479,17,-226,55,31,H1
"Douglas County, WI",2016-2017,43392,43284,-108,-0.249,-10,-98,55,31,H1
"Dunn County, WI",2000-2001,39952,40599,647,1.619,196,451,55,33,H1
"Dunn County, WI",2001-2002,40599,40947,348,0.857,179,169,55,33,H1
"Dunn County, WI",2002-2003,40947,41222,275,0.672,189,86,55,33,H1
"Dunn County, WI",2003-2004,41222,41690,468,1.135,220,248,55,33,H1
"Dunn County, WI",2004-2005,41690,41988,298,0.715,183,115,55,33,H1
"Dunn County, WI",2005-2006,41988,42828,840,2.001,254,586,55,33,H1
"Dunn County, WI",2006-2007,42828,43148,320,0.747,162,158,55,33,H1
"Dunn County, WI",2007-2008,43148,43382,234,0.542,184,50,55,33,H1
"Dunn County, WI",2008-2009,43382,43570,188,0.433,160,28,55,33,H1
"Dunn County, WI",2009-2010,43570,43886,316,0.725,179,137,55,33,H1
"Dunn County, WI",2010-2011,43886,43885,-1,-0.002,175,-176,55,33,H1
"Dunn County, WI",2011-2012,43885,43930,45,0.103,148,-103,55,33,H1
"Dunn County, WI",2012-2013,43930,44221,291,0.662,167,124,55,33,H1
"Dunn County, WI",2013-2014,44221,44305,84,0.19,144,-60,55,33,H1
"Dunn County, WI",2014-2015,44300,44497,197,0.445,153,44,55,33,H1
"Dunn County, WI",2015-2016,44497,44327,-170,-0.382,136,-306,55,33,H1
"Dunn County, WI",2016-2017,44327,44693,366,0.826,125,241,55,33,H1
"Eau Claire County, WI",2000-2001,93310,93835,525,0.563,408,117,55,35,H1
"Eau Claire County, WI",2001-2002,93835,94493,658,0.701,433,225,55,35,H1
"Eau Claire County, WI",2002-2003,94493,94632,139,0.147,401,-262,55,35,H1
"Eau Claire County, WI",2003-2004,94632,94618,-14,-0.015,375,-389,55,35,H1
"Eau Claire County, WI",2004-2005,94618,95007,389,0.411,461,-72,55,35,H1
"Eau Claire County, WI",2005-2006,95007,95896,889,0.936,443,446,55,35,H1
"Eau Claire County, WI",2006-2007,95896,96632,736,0.767,398,338,55,35,H1
"Eau Claire County, WI",2007-2008,96632,97176,544,0.563,521,23,55,35,H1
"Eau Claire County, WI",2008-2009,97176,98274,1098,1.13,508,590,55,35,H1
"Eau Claire County, WI",2009-2010,98274,99018,744,0.757,479,265,55,35,H1
"Eau Claire County, WI",2010-2011,99018,99909,891,0.9,399,492,55,35,H1
"Eau Claire County, WI",2011-2012,99909,100840,931,0.932,420,511,55,35,H1
"Eau Claire County, WI",2012-2013,100840,101704,864,0.857,424,440,55,35,H1
"Eau Claire County, WI",2013-2014,101704,101564,-140,-0.138,490,-630,55,35,H1
"Eau Claire County, WI",2014-2015,101677,102105,428,0.421,456,-28,55,35,H1
"Eau Claire County, WI",2015-2016,102105,102885,780,0.764,355,425,55,35,H1
"Eau Claire County, WI",2016-2017,102885,103671,786,0.764,434,352,55,35,H1
"Florence County, WI",2000-2001,5076,5036,-40,-0.788,-13,-27,55,37,H1
"Florence County, WI",2001-2002,5036,5068,32,0.635,-11,43,55,37,H1
"Florence County, WI",2002-2003,5068,4960,-108,-2.131,-22,-86,55,37,H1
"Florence County, WI",2003-2004,4960,4890,-70,-1.411,-10,-60,55,37,H1
"Florence County, WI",2004-2005,4890,4825,-65,-1.329,-30,-35,55,37,H1
"Florence County, WI",2005-2006,4825,4794,-31,-0.642,-16,-15,55,37,H1
"Florence County, WI",2006-2007,4794,4682,-112,-2.336,-15,-97,55,37,H1
"Florence County, WI",2007-2008,4682,4564,-118,-2.52,-9,-109,55,37,H1
"Florence County, WI",2008-2009,4564,4494,-70,-1.534,-13,-57,55,37,H1
"Florence County, WI",2009-2010,4494,4404,-90,-2.003,-17,-73,55,37,H1
"Florence County, WI",2010-2011,4404,4498,94,2.134,-31,125,55,37,H1
"Florence County, WI",2011-2012,4498,4472,-26,-0.578,-18,-8,55,37,H1
"Florence County, WI",2012-2013,4472,4517,45,1.006,-11,56,55,37,H1
"Florence County, WI",2013-2014,4517,4481,-36,-0.797,-24,-12,55,37,H1
"Florence County, WI",2014-2015,4461,4464,3,0.067,-12,15,55,37,H1
"Florence County, WI",2015-2016,4464,4334,-130,-2.912,-23,-107,55,37,H1
"Florence County, WI",2016-2017,4334,4371,37,0.854,-18,55,55,37,H1
"Fond du Lac County, WI",2000-2001,97390,97856,466,0.478,233,233,55,39,H1
"Fond du Lac County, WI",2001-2002,97856,98097,241,0.246,184,57,55,39,H1
"Fond du Lac County, WI",2002-2003,98097,98470,373,0.38,286,87,55,39,H1
"Fond du Lac County, WI",2003-2004,98470,98929,459,0.466,263,196,55,39,H1
"Fond du Lac County, WI",2004-2005,98929,99297,368,0.372,202,166,55,39,H1
"Fond du Lac County, WI",2005-2006,99297,99920,623,0.627,238,385,55,39,H1
"Fond du Lac County, WI",2006-2007,99920,100520,600,0.6,295,305,55,39,H1
"Fond du Lac County, WI",2007-2008,100520,101122,602,0.599,279,323,55,39,H1
"Fond du Lac County, WI",2008-2009,101122,101370,248,0.245,295,-47,55,39,H1
"Fond du Lac County, WI",2009-2010,101370,101645,275,0.271,232,43,55,39,H1
"Fond du Lac County, WI",2010-2011,101645,101792,147,0.145,180,-33,55,39,H1
"Fond du Lac County, WI",2011-2012,101792,101702,-90,-0.088,212,-302,55,39,H1
"Fond du Lac County, WI",2012-2013,101702,101648,-54,-0.053,219,-273,55,39,H1
"Fond du Lac County, WI",2013-2014,101648,101759,111,0.109,219,-108,55,39,H1
"Fond du Lac County, WI",2014-2015,102010,101973,-37,-0.036,221,-258,55,39,H1
"Fond du Lac County, WI",2015-2016,101973,102210,237,0.232,182,55,55,39,H1
"Fond du Lac County, WI",2016-2017,102210,102548,338,0.331,159,179,55,39,H1
"Forest County, WI",2000-2001,10034,9916,-118,-1.176,-39,-79,55,41,H1
"Forest County, WI",2001-2002,9916,9879,-37,-0.373,11,-48,55,41,H1
"Forest County, WI",2002-2003,9879,9876,-3,-0.03,16,-19,55,41,H1
"Forest County, WI",2003-2004,9876,9924,48,0.486,-9,57,55,41,H1
"Forest County, WI",2004-2005,9924,9820,-104,-1.048,15,-119,55,41,H1
"Forest County, WI",2005-2006,9820,9737,-83,-0.845,-32,-51,55,41,H1
"Forest County, WI",2006-2007,9737,9639,-98,-1.006,14,-112,55,41,H1
"Forest County, WI",2007-2008,9639,9620,-19,-0.197,-26,7,55,41,H1
"Forest County, WI",2008-2009,9620,9396,-224,-2.328,-1,-223,55,41,H1
"Forest County, WI",2009-2010,9396,9292,-104,-1.107,-13,-91,55,41,H1
"Forest County, WI",2010-2011,9292,9261,-31,-0.334,-18,-13,55,41,H1
"Forest County, WI",2011-2012,9261,9183,-78,-0.842,-10,-68,55,41,H1
"Forest County, WI",2012-2013,9183,9128,-55,-0.599,13,-68,55,41,H1
"Forest County, WI",2013-2014,9128,9127,-1,-0.011,9,-10,55,41,H1
"Forest County, WI",2014-2015,9131,9057,-74,-0.81,16,-90,55,41,H1
"Forest County, WI",2015-2016,9057,9020,-37,-0.409,-9,-28,55,41,H1
"Forest County, WI",2016-2017,9020,8970,-50,-0.554,-7,-43,55,41,H1
"Grant County, WI",2000-2001,49559,49739,180,0.363,39,141,55,43,H1
"Grant County, WI",2001-2002,49739,49667,-72,-0.145,27,-99,55,43,H1
"Grant County, WI",2002-2003,49667,49925,258,0.519,80,178,55,43,H1
"Grant County, WI",2003-2004,49925,50143,218,0.437,77,141,55,43,H1
"Grant County, WI",2004-2005,50143,50244,101,0.201,94,7,55,43,H1
"Grant County, WI",2005-2006,50244,50051,-193,-0.384,94,-287,55,43,H1
"Grant County, WI",2006-2007,50051,50544,493,0.985,31,462,55,43,H1
"Grant County, WI",2007-2008,50544,50834,290,0.574,106,184,55,43,H1
"Grant County, WI",2008-2009,50834,50916,82,0.161,124,-42,55,43,H1
"Grant County, WI",2009-2010,50916,51187,271,0.532,109,162,55,43,H1
"Grant County, WI",2010-2011,51187,51231,44,0.086,38,6,55,43,H1
"Grant County, WI",2011-2012,51231,50991,-240,-0.468,69,-309,55,43,H1
"Grant County, WI",2012-2013,50991,51120,129,0.253,73,56,55,43,H1
"Grant County, WI",2013-2014,51120,51829,709,1.387,61,648,55,43,H1
"Grant County, WI",2014-2015,51824,52250,426,0.822,73,353,55,43,H1
"Grant County, WI",2015-2016,52250,51993,-257,-0.492,106,-363,55,43,H1
"Grant County, WI",2016-2017,51993,51999,6,0.012,99,-93,55,43,H1
"Green County, WI",2000-2001,33770,33929,159,0.471,60,99,55,45,H1
"Green County, WI",2001-2002,33929,34177,248,0.731,86,162,55,45,H1
"Green County, WI",2002-2003,34177,34301,124,0.363,-1,125,55,45,H1
"Green County, WI",2003-2004,34301,34801,500,1.458,105,395,55,45,H1
"Green County, WI",2004-2005,34801,35174,373,1.072,108,265,55,45,H1
"Green County, WI",2005-2006,35174,35869,695,1.976,112,583,55,45,H1
"Green County, WI",2006-2007,35869,36234,365,1.018,157,208,55,45,H1
"Green County, WI",2007-2008,36234,36598,364,1.005,112,252,55,45,H1
"Green County, WI",2008-2009,36598,36672,74,0.202,99,-25,55,45,H1
"Green County, WI",2009-2010,36672,36852,180,0.491,41,139,55,45,H1
"Green County, WI",2010-2011,36852,36972,120,0.326,52,68,55,45,H1
"Green County, WI",2011-2012,36972,36881,-91,-0.246,34,-125,55,45,H1
"Green County, WI",2012-2013,36881,37086,205,0.556,79,126,55,45,H1
"Green County, WI",2013-2014,37086,37063,-23,-0.062,51,-74,55,45,H1
"Green County, WI",2014-2015,37073,37186,113,0.305,41,72,55,45,H1
"Green County, WI",2015-2016,37186,36812,-374,-1.006,15,-389,55,45,H1
"Green County, WI",2016-2017,36812,36851,39,0.106,26,13,55,45,H1
"Green Lake County, WI",2000-2001,19082,19213,131,0.687,14,117,55,47,H1
"Green Lake County, WI",2001-2002,19213,19267,54,0.281,-38,92,55,47,H1
"Green Lake County, WI",2002-2003,19267,19253,-14,-0.073,3,-17,55,47,H1
"Green Lake County, WI",2003-2004,19253,19220,-33,-0.171,-12,-21,55,47,H1
"Green Lake County, WI",2004-2005,19220,19187,-33,-0.172,-27,-6,55,47,H1
"Green Lake County, WI",2005-2006,19187,19195,8,0.042,-41,49,55,47,H1
"Green Lake County, WI",2006-2007,19195,19144,-51,-0.266,9,-60,55,47,H1
"Green Lake County, WI",2007-2008,19144,19102,-42,-0.219,3,-45,55,47,H1
"Green Lake County, WI",2008-2009,19102,19056,-46,-0.241,-12,-34,55,47,H1
"Green Lake County, WI",2009-2010,19056,19032,-24,-0.126,-18,-6,55,47,H1
"Green Lake County, WI",2010-2011,19032,19097,65,0.342,19,46,55,47,H1
"Green Lake County, WI",2011-2012,19097,19075,-22,-0.115,-36,14,55,47,H1
"Green Lake County, WI",2012-2013,19075,18967,-108,-0.566,-10,-98,55,47,H1
"Green Lake County, WI",2013-2014,18967,18836,-131,-0.691,-21,-110,55,47,H1
"Green Lake County, WI",2014-2015,18836,18856,20,0.106,-26,46,55,47,H1
"Green Lake County, WI",2015-2016,18856,18623,-233,-1.236,-4,-229,55,47,H1
"Green Lake County, WI",2016-2017,18623,18760,137,0.736,-25,162,55,47,H1
"Iowa County, WI",2000-2001,22806,22932,126,0.552,95,31,55,49,H1
"Iowa County, WI",2001-2002,22932,23017,85,0.371,119,-34,55,49,H1
"Iowa County, WI",2002-2003,23017,23154,137,0.595,106,31,55,49,H1
"Iowa County, WI",2003-2004,23154,23187,33,0.143,112,-79,55,49,H1
"Iowa County, WI",2004-2005,23187,23405,218,0.94,121,97,55,49,H1
"Iowa County, WI",2005-2006,23405,23589,184,0.786,135,49,55,49,H1
"Iowa County, WI",2006-2007,23589,23636,47,0.199,115,-68,55,49,H1
"Iowa County, WI",2007-2008,23636,23701,65,0.275,129,-64,55,49,H1
"Iowa County, WI",2008-2009,23701,23595,-106,-0.447,124,-230,55,49,H1
"Iowa County, WI",2009-2010,23595,23662,67,0.284,92,-25,55,49,H1
"Iowa County, WI",2010-2011,23662,23778,116,0.49,69,47,55,49,H1
"Iowa County, WI",2011-2012,23778,23766,-12,-0.05,73,-85,55,49,H1
"Iowa County, WI",2012-2013,23766,23740,-26,-0.109,86,-112,55,49,H1
"Iowa County, WI",2013-2014,23740,23825,85,0.358,92,-7,55,49,H1
"Iowa County, WI",2014-2015,23791,23813,22,0.092,70,-48,55,49,H1
"Iowa County, WI",2015-2016,23813,23470,-343,-1.44,78,-421,55,49,H1
"Iowa County, WI",2016-2017,23470,23715,245,1.044,75,170,55,49,H1
"Iron County, WI",2000-2001,6843,6776,-67,-0.979,-40,-27,55,51,H1
"Iron County, WI",2001-2002,6776,6711,-65,-0.959,-44,-21,55,51,H1
"Iron County, WI",2002-2003,6711,6598,-113,-1.684,-53,-60,55,51,H1
"Iron County, WI",2003-2004,6598,6508,-90,-1.364,-45,-45,55,51,H1
"Iron County, WI",2004-2005,6508,6411,-97,-1.49,-64,-33,55,51,H1
"Iron County, WI",2005-2006,6411,6236,-175,-2.73,-49,-126,55,51,H1
"Iron County, WI",2006-2007,6236,6170,-66,-1.058,-42,-24,55,51,H1
"Iron County, WI",2007-2008,6170,6101,-69,-1.118,-34,-35,55,51,H1
"Iron County, WI",2008-2009,6101,5966,-135,-2.213,-45,-90,55,51,H1
"Iron County, WI",2009-2010,5966,5893,-73,-1.224,-64,-9,55,51,H1
"Iron County, WI",2010-2011,5893,5999,106,1.799,-38,144,55,51,H1
"Iron County, WI",2011-2012,5999,5938,-61,-1.017,-57,-4,55,51,H1
"Iron County, WI",2012-2013,5938,5887,-51,-0.859,-43,-8,55,51,H1
"Iron County, WI",2013-2014,5887,5917,30,0.51,-51,81,55,51,H1
"Iron County, WI",2014-2015,5917,5794,-123,-2.079,-36,-87,55,51,H1
"Iron County, WI",2015-2016,5794,5665,-129,-2.226,-43,-86,55,51,H1
"Iron County, WI",2016-2017,5665,5671,6,0.106,-51,57,55,51,H1
"Jackson County, WI",2000-2001,19133,19337,204,1.066,-8,212,55,53,H1
"Jackson County, WI",2001-2002,19337,19374,37,0.191,4,33,55,53,H1
"Jackson County, WI",2002-2003,19374,19641,267,1.378,35,232,55,53,H1
"Jackson County, WI",2003-2004,19641,19633,-8,-0.041,22,-30,55,53,H1
"Jackson County, WI",2004-2005,19633,19885,252,1.284,27,225,55,53,H1
"Jackson County, WI",2005-2006,19885,20016,131,0.659,67,64,55,53,H1
"Jackson County, WI",2006-2007,20016,20227,211,1.054,80,131,55,53,H1
"Jackson County, WI",2007-2008,20227,20348,121,0.598,53,68,55,53,H1
"Jackson County, WI",2008-2009,20348,20372,24,0.118,71,-47,55,53,H1
"Jackson County, WI",2009-2010,20372,20465,93,0.457,23,70,55,53,H1
"Jackson County, WI",2010-2011,20465,20534,69,0.337,40,29,55,53,H1
"Jackson County, WI",2011-2012,20534,20477,-57,-0.278,50,-107,55,53,H1
"Jackson County, WI",2012-2013,20477,20585,108,0.527,59,49,55,53,H1
"Jackson County, WI",2013-2014,20585,20652,67,0.325,77,-10,55,53,H1
"Jackson County, WI",2014-2015,20631,20554,-77,-0.373,73,-150,55,53,H1
"Jackson County, WI",2015-2016,20554,20472,-82,-0.399,49,-131,55,53,H1
"Jackson County, WI",2016-2017,20472,20529,57,0.278,68,-11,55,53,H1
"Jefferson County, WI",2000-2001,76053,76736,683,0.898,347,336,55,55,H1
"Jefferson County, WI",2001-2002,76736,77376,640,0.834,371,269,55,55,H1
"Jefferson County, WI",2002-2003,77376,78148,772,0.998,289,483,55,55,H1
"Jefferson County, WI",2003-2004,78148,79408,1260,1.612,439,821,55,55,H1
"Jefferson County, WI",2004-2005,79408,80392,984,1.239,411,573,55,55,H1
"Jefferson County, WI",2005-2006,80392,81300,908,1.129,463,445,55,55,H1
"Jefferson County, WI",2006-2007,81300,82276,976,1.2,466,510,55,55,H1
"Jefferson County, WI",2007-2008,82276,83140,864,1.05,392,472,55,55,H1
"Jefferson County, WI",2008-2009,83140,83480,340,0.409,416,-76,55,55,H1
"Jefferson County, WI",2009-2010,83480,83686,206,0.247,344,-138,55,55,H1
"Jefferson County, WI",2010-2011,83686,83905,219,0.262,311,-92,55,55,H1
"Jefferson County, WI",2011-2012,83905,84408,503,0.599,293,210,55,55,H1
"Jefferson County, WI",2012-2013,84408,84610,202,0.239,257,-55,55,55,H1
"Jefferson County, WI",2013-2014,84610,84395,-215,-0.254,229,-444,55,55,H1
"Jefferson County, WI",2014-2015,84372,84559,187,0.222,226,-39,55,55,H1
"Jefferson County, WI",2015-2016,84559,84545,-14,-0.017,169,-183,55,55,H1
"Jefferson County, WI",2016-2017,84545,84832,287,0.339,156,131,55,55,H1
"Juneau County, WI",2000-2001,24351,24546,195,0.801,-16,211,55,57,H1
"Juneau County, WI",2001-2002,24546,25050,504,2.053,31,473,55,57,H1
"Juneau County, WI",2002-2003,25050,25186,136,0.543,-22,158,55,57,H1
"Juneau County, WI",2003-2004,25186,25445,259,1.028,7,252,55,57,H1
"Juneau County, WI",2004-2005,25445,26589,1144,4.496,2,1142,55,57,H1
"Juneau County, WI",2005-2006,26589,26695,106,0.399,19,87,55,57,H1
"Juneau County, WI",2006-2007,26695,26755,60,0.225,30,30,55,57,H1
"Juneau County, WI",2007-2008,26755,26825,70,0.262,6,64,55,57,H1
"Juneau County, WI",2008-2009,26825,26728,-97,-0.362,9,-106,55,57,H1
"Juneau County, WI",2009-2010,26728,26667,-61,-0.228,-38,-23,55,57,H1
"Juneau County, WI",2010-2011,26667,26687,20,0.075,-2,22,55,57,H1
"Juneau County, WI",2011-2012,26687,26746,59,0.221,-2,61,55,57,H1
"Juneau County, WI",2012-2013,26746,26540,-206,-0.77,26,-232,55,57,H1
"Juneau County, WI",2013-2014,26540,26395,-145,-0.546,37,-182,55,57,H1
"Juneau County, WI",2014-2015,26313,26224,-89,-0.338,16,-105,55,57,H1
"Juneau County, WI",2015-2016,26224,26359,135,0.515,-23,158,55,57,H1
"Juneau County, WI",2016-2017,26359,26576,217,0.823,16,201,55,57,H1
"Kenosha County, WI",2000-2001,150060,151962,1902,1.267,893,1009,55,59,H1
"Kenosha County, WI",2001-2002,151962,153905,1943,1.279,850,1093,55,59,H1
"Kenosha County, WI",2002-2003,153905,155946,2041,1.326,867,1174,55,59,H1
"Kenosha County, WI",2003-2004,155946,157968,2022,1.297,859,1163,55,59,H1
"Kenosha County, WI",2004-2005,157968,160088,2120,1.342,869,1251,55,59,H1
"Kenosha County, WI",2005-2006,160088,161607,1519,0.949,871,648,55,59,H1
"Kenosha County, WI",2006-2007,161607,163223,1616,1,915,701,55,59,H1
"Kenosha County, WI",2007-2008,163223,164636,1413,0.866,975,438,55,59,H1
"Kenosha County, WI",2008-2009,164636,165502,866,0.526,1027,-161,55,59,H1
"Kenosha County, WI",2009-2010,165502,166577,1075,0.65,899,176,55,59,H1
"Kenosha County, WI",2010-2011,166577,166821,244,0.146,706,-462,55,59,H1
"Kenosha County, WI",2011-2012,166821,167352,531,0.318,554,-23,55,59,H1
"Kenosha County, WI",2012-2013,167352,167521,169,0.101,676,-507,55,59,H1
"Kenosha County, WI",2013-2014,167521,168068,547,0.327,672,-125,55,59,H1
"Kenosha County, WI",2014-2015,168215,168437,222,0.132,661,-439,55,59,H1
"Kenosha County, WI",2015-2016,168437,167869,-568,-0.337,562,-1130,55,59,H1
"Kenosha County, WI",2016-2017,167869,168521,652,0.388,569,83,55,59,H1
"Kewaunee County, WI",2000-2001,20212,20302,90,0.445,44,46,55,61,H1
"Kewaunee County, WI",2001-2002,20302,20434,132,0.65,28,104,55,61,H1
"Kewaunee County, WI",2002-2003,20434,20402,-32,-0.157,70,-102,55,61,H1
"Kewaunee County, WI",2003-2004,20402,20562,160,0.784,80,80,55,61,H1
"Kewaunee County, WI",2004-2005,20562,20650,88,0.428,41,47,55,61,H1
"Kewaunee County, WI",2005-2006,20650,20755,105,0.508,73,32,55,61,H1
"Kewaunee County, WI",2006-2007,20755,20694,-61,-0.294,5,-66,55,61,H1
"Kewaunee County, WI",2007-2008,20694,20636,-58,-0.28,30,-88,55,61,H1
"Kewaunee County, WI",2008-2009,20636,20555,-81,-0.393,57,-138,55,61,H1
"Kewaunee County, WI",2009-2010,20555,20574,19,0.092,25,-6,55,61,H1
"Kewaunee County, WI",2010-2011,20574,20617,43,0.209,41,2,55,61,H1
"Kewaunee County, WI",2011-2012,20617,20618,1,0.005,48,-47,55,61,H1
"Kewaunee County, WI",2012-2013,20618,20474,-144,-0.698,-9,-135,55,61,H1
"Kewaunee County, WI",2013-2014,20474,20444,-30,-0.147,-1,-29,55,61,H1
"Kewaunee County, WI",2014-2015,20412,20366,-46,-0.225,5,-51,55,61,H1
"Kewaunee County, WI",2015-2016,20366,20384,18,0.088,32,-14,55,61,H1
"Kewaunee County, WI",2016-2017,20384,20445,61,0.299,12,49,55,61,H1
"La Crosse County, WI",2000-2001,107291,107761,470,0.438,288,182,55,63,H1
"La Crosse County, WI",2001-2002,107761,108477,716,0.664,313,403,55,63,H1
"La Crosse County, WI",2002-2003,108477,109065,588,0.542,367,221,55,63,H1
"La Crosse County, WI",2003-2004,109065,109410,345,0.316,410,-65,55,63,H1
"La Crosse County, WI",2004-2005,109410,109976,566,0.517,399,167,55,63,H1
"La Crosse County, WI",2005-2006,109976,110641,665,0.605,306,359,55,63,H1
"La Crosse County, WI",2006-2007,110641,111798,1157,1.046,529,628,55,63,H1
"La Crosse County, WI",2007-2008,111798,112761,963,0.861,375,588,55,63,H1
"La Crosse County, WI",2008-2009,112761,114021,1260,1.117,450,810,55,63,H1
"La Crosse County, WI",2009-2010,114021,114859,838,0.735,416,422,55,63,H1
"La Crosse County, WI",2010-2011,114859,115320,461,0.401,308,153,55,63,H1
"La Crosse County, WI",2011-2012,115320,116831,1511,1.31,310,1201,55,63,H1
"La Crosse County, WI",2012-2013,116831,117330,499,0.427,290,209,55,63,H1
"La Crosse County, WI",2013-2014,117330,118011,681,0.58,285,396,55,63,H1
"La Crosse County, WI",2014-2015,117852,118212,360,0.305,302,58,55,63,H1
"La Crosse County, WI",2015-2016,118212,117723,-489,-0.414,269,-758,55,63,H1
"La Crosse County, WI",2016-2017,117723,118274,551,0.468,249,302,55,63,H1
"Lafayette County, WI",2000-2001,16225,16303,78,0.481,49,29,55,65,H1
"Lafayette County, WI",2001-2002,16303,16436,133,0.816,74,59,55,65,H1
"Lafayette County, WI",2002-2003,16436,16516,80,0.487,16,64,55,65,H1
"Lafayette County, WI",2003-2004,16516,16615,99,0.599,48,51,55,65,H1
"Lafayette County, WI",2004-2005,16615,16703,88,0.53,83,5,55,65,H1
"Lafayette County, WI",2005-2006,16703,16785,82,0.491,88,-6,55,65,H1
"Lafayette County, WI",2006-2007,16785,16670,-115,-0.685,58,-173,55,65,H1
"Lafayette County, WI",2007-2008,16670,16768,98,0.588,58,40,55,65,H1
"Lafayette County, WI",2008-2009,16768,16851,83,0.495,70,13,55,65,H1
"Lafayette County, WI",2009-2010,16851,16793,-58,-0.344,62,-120,55,65,H1
"Lafayette County, WI",2010-2011,16793,16953,160,0.953,77,83,55,65,H1
"Lafayette County, WI",2011-2012,16953,16872,-81,-0.478,74,-155,55,65,H1
"Lafayette County, WI",2012-2013,16872,16766,-106,-0.628,69,-175,55,65,H1
"Lafayette County, WI",2013-2014,16766,16853,87,0.519,81,6,55,65,H1
"Lafayette County, WI",2014-2015,16826,16829,3,0.018,92,-89,55,65,H1
"Lafayette County, WI",2015-2016,16829,16776,-53,-0.315,81,-134,55,65,H1
"Lafayette County, WI",2016-2017,16776,16741,-35,-0.209,80,-115,55,65,H1
"Langlade County, WI",2000-2001,20735,20820,85,0.41,-14,99,55,67,H1
"Langlade County, WI",2001-2002,20820,20722,-98,-0.471,-13,-85,55,67,H1
"Langlade County, WI",2002-2003,20722,20668,-54,-0.261,-35,-19,55,67,H1
"Langlade County, WI",2003-2004,20668,20686,18,0.087,-12,30,55,67,H1
"Langlade County, WI",2004-2005,20686,20477,-209,-1.01,-25,-184,55,67,H1
"Langlade County, WI",2005-2006,20477,20440,-37,-0.181,0,-37,55,67,H1
"Langlade County, WI",2006-2007,20440,20379,-61,-0.298,-31,-30,55,67,H1
"Langlade County, WI",2007-2008,20379,20248,-131,-0.643,-29,-102,55,67,H1
"Langlade County, WI",2008-2009,20248,20086,-162,-0.8,-30,-132,55,67,H1
"Langlade County, WI",2009-2010,20086,19936,-150,-0.747,-59,-91,55,67,H1
"Langlade County, WI",2010-2011,19936,19883,-53,-0.266,-24,-29,55,67,H1
"Langlade County, WI",2011-2012,19883,19729,-154,-0.775,-17,-137,55,67,H1
"Langlade County, WI",2012-2013,19729,19572,-157,-0.796,-52,-105,55,67,H1
"Langlade County, WI",2013-2014,19572,19410,-162,-0.828,-42,-120,55,67,H1
"Langlade County, WI",2014-2015,19369,19223,-146,-0.754,-44,-102,55,67,H1
"Langlade County, WI",2015-2016,19223,19086,-137,-0.713,-23,-114,55,67,H1
"Langlade County, WI",2016-2017,19086,19160,74,0.388,-37,111,55,67,H1
"Lincoln County, WI",2000-2001,29670,29548,-122,-0.411,-7,-115,55,69,H1
"Lincoln County, WI",2001-2002,29548,29641,93,0.315,-5,98,55,69,H1
"Lincoln County, WI",2002-2003,29641,29621,-20,-0.067,-37,17,55,69,H1
"Lincoln County, WI",2003-2004,29621,29666,45,0.152,32,13,55,69,H1
"Lincoln County, WI",2004-2005,29666,29602,-64,-0.216,-12,-52,55,69,H1
"Lincoln County, WI",2005-2006,29602,29457,-145,-0.49,6,-151,55,69,H1
"Lincoln County, WI",2006-2007,29457,29272,-185,-0.628,34,-219,55,69,H1
"Lincoln County, WI",2007-2008,29272,29094,-178,-0.608,6,-184,55,69,H1
"Lincoln County, WI",2008-2009,29094,28833,-261,-0.897,-26,-235,55,69,H1
"Lincoln County, WI",2009-2010,28833,28747,-86,-0.298,-85,-1,55,69,H1
"Lincoln County, WI",2010-2011,28747,28440,-307,-1.068,-64,-243,55,69,H1
"Lincoln County, WI",2011-2012,28440,28472,32,0.113,-54,86,55,69,H1
"Lincoln County, WI",2012-2013,28472,28676,204,0.716,-22,226,55,69,H1
"Lincoln County, WI",2013-2014,28676,28493,-183,-0.638,-28,-155,55,69,H1
"Lincoln County, WI",2014-2015,28152,27980,-172,-0.611,-45,-127,55,69,H1
"Lincoln County, WI",2015-2016,27980,27854,-126,-0.45,-50,-76,55,69,H1
"Lincoln County, WI",2016-2017,27854,27838,-16,-0.057,-35,19,55,69,H1
"Manitowoc County, WI",2000-2001,82936,82788,-148,-0.178,64,-212,55,71,H1
"Manitowoc County, WI",2001-2002,82788,82338,-450,-0.544,9,-459,55,71,H1
"Manitowoc County, WI",2002-2003,82338,82010,-328,-0.398,83,-411,55,71,H1
"Manitowoc County, WI",2003-2004,82010,81846,-164,-0.2,167,-331,55,71,H1
"Manitowoc County, WI",2004-2005,81846,81827,-19,-0.023,76,-95,55,71,H1
"Manitowoc County, WI",2005-2006,81827,81869,42,0.051,87,-45,55,71,H1
"Manitowoc County, WI",2006-2007,81869,81872,3,0.004,74,-71,55,71,H1
"Manitowoc County, WI",2007-2008,81872,81698,-174,-0.213,93,-267,55,71,H1
"Manitowoc County, WI",2008-2009,81698,81600,-98,-0.12,151,-249,55,71,H1
"Manitowoc County, WI",2009-2010,81600,81286,-314,-0.385,107,-421,55,71,H1
"Manitowoc County, WI",2010-2011,81286,81139,-147,-0.181,18,-165,55,71,H1
"Manitowoc County, WI",2011-2012,81139,80816,-323,-0.398,83,-406,55,71,H1
"Manitowoc County, WI",2012-2013,80816,80623,-193,-0.239,16,-209,55,71,H1
"Manitowoc County, WI",2013-2014,80623,80160,-463,-0.574,23,-486,55,71,H1
"Manitowoc County, WI",2014-2015,80161,79806,-355,-0.443,-7,-348,55,71,H1
"Manitowoc County, WI",2015-2016,79806,79331,-475,-0.595,-67,-408,55,71,H1
"Manitowoc County, WI",2016-2017,79331,79175,-156,-0.197,-40,-116,55,71,H1
"Marathon County, WI",2000-2001,125995,126459,464,0.368,658,-194,55,73,H1
"Marathon County, WI",2001-2002,126459,126880,421,0.333,519,-98,55,73,H1
"Marathon County, WI",2002-2003,126880,127311,431,0.34,568,-137,55,73,H1
"Marathon County, WI",2003-2004,127311,127855,544,0.427,585,-41,55,73,H1
"Marathon County, WI",2004-2005,127855,128958,1103,0.863,524,579,55,73,H1
"Marathon County, WI",2005-2006,128958,130516,1558,1.208,658,900,55,73,H1
"Marathon County, WI",2006-2007,130516,131773,1257,0.963,763,494,55,73,H1
"Marathon County, WI",2007-2008,131773,133036,1263,0.958,652,611,55,73,H1
"Marathon County, WI",2008-2009,133036,133793,757,0.569,632,125,55,73,H1
"Marathon County, WI",2009-2010,133793,134065,272,0.203,537,-265,55,73,H1
"Marathon County, WI",2010-2011,134065,134531,466,0.348,509,-43,55,73,H1
"Marathon County, WI",2011-2012,134531,134689,158,0.117,486,-328,55,73,H1
"Marathon County, WI",2012-2013,134689,135365,676,0.502,493,183,55,73,H1
"Marathon County, WI",2013-2014,135365,135780,415,0.307,521,-106,55,73,H1
"Marathon County, WI",2014-2015,135619,135868,249,0.184,526,-277,55,73,H1
"Marathon County, WI",2015-2016,135868,135195,-673,-0.495,398,-1071,55,73,H1
"Marathon County, WI",2016-2017,135195,135732,537,0.397,467,70,55,73,H1
"Marinette County, WI",2000-2001,43418,43157,-261,-0.601,-80,-181,55,75,H1
"Marinette County, WI",2001-2002,43157,43122,-35,-0.081,-153,118,55,75,H1
"Marinette County, WI",2002-2003,43122,42946,-176,-0.408,-73,-103,55,75,H1
"Marinette County, WI",2003-2004,42946,42680,-266,-0.619,-60,-206,55,75,H1
"Marinette County, WI",2004-2005,42680,42850,170,0.398,-20,190,55,75,H1
"Marinette County, WI",2005-2006,42850,42389,-461,-1.076,-115,-346,55,75,H1
"Marinette County, WI",2006-2007,42389,42190,-199,-0.469,-101,-98,55,75,H1
"Marinette County, WI",2007-2008,42190,42019,-171,-0.405,-24,-147,55,75,H1
"Marinette County, WI",2008-2009,42019,41792,-227,-0.54,-49,-178,55,75,H1
"Marinette County, WI",2009-2010,41792,41705,-87,-0.208,-89,2,55,75,H1
"Marinette County, WI",2010-2011,41705,41454,-251,-0.602,-115,-136,55,75,H1
"Marinette County, WI",2011-2012,41454,41488,34,0.082,-138,172,55,75,H1
"Marinette County, WI",2012-2013,41488,41497,9,0.022,-70,79,55,75,H1
"Marinette County, WI",2013-2014,41497,41298,-199,-0.48,-58,-141,55,75,H1
"Marinette County, WI",2014-2015,41226,40884,-342,-0.83,-83,-259,55,75,H1
"Marinette County, WI",2015-2016,40884,40289,-595,-1.455,-89,-506,55,75,H1
"Marinette County, WI",2016-2017,40289,40310,21,0.052,-98,119,55,75,H1
"Marquette County, WI",2000-2001,14602,14624,22,0.151,-27,49,55,77,H1
"Marquette County, WI",2001-2002,14624,14798,174,1.19,-4,178,55,77,H1
"Marquette County, WI",2002-2003,14798,14931,133,0.899,-21,154,55,77,H1
"Marquette County, WI",2003-2004,14931,15157,226,1.514,-9,235,55,77,H1
"Marquette County, WI",2004-2005,15157,15390,233,1.537,-5,238,55,77,H1
"Marquette County, WI",2005-2006,15390,15437,47,0.305,-13,60,55,77,H1
"Marquette County, WI",2006-2007,15437,15395,-42,-0.272,-3,-39,55,77,H1
"Marquette County, WI",2007-2008,15395,15485,90,0.585,-10,100,55,77,H1
"Marquette County, WI",2008-2009,15485,15405,-80,-0.517,-6,-74,55,77,H1
"Marquette County, WI",2009-2010,15405,15390,-15,-0.097,-33,18,55,77,H1
"Marquette County, WI",2010-2011,15390,15343,-47,-0.305,-26,-21,55,77,H1
"Marquette County, WI",2011-2012,15343,15186,-157,-1.023,-10,-147,55,77,H1
"Marquette County, WI",2012-2013,15186,15149,-37,-0.244,16,-53,55,77,H1
"Marquette County, WI",2013-2014,15149,15050,-99,-0.654,-18,-81,55,77,H1
"Marquette County, WI",2014-2015,15006,15075,69,0.46,-6,75,55,77,H1
"Marquette County, WI",2015-2016,15075,15137,62,0.411,-51,113,55,77,H1
"Marquette County, WI",2016-2017,15137,15308,171,1.13,-19,190,55,77,H1
"Menominee County, WI",2000-2001,4565,4521,-44,-0.964,51,-95,55,78,H1
"Menominee County, WI",2001-2002,4521,4539,18,0.398,58,-40,55,78,H1
"Menominee County, WI",2002-2003,4539,4478,-61,-1.344,60,-121,55,78,H1
"Menominee County, WI",2003-2004,4478,4406,-72,-1.608,69,-141,55,78,H1
"Menominee County, WI",2004-2005,4406,4353,-53,-1.203,42,-95,55,78,H1
"Menominee County, WI",2005-2006,4353,4312,-41,-0.942,67,-108,55,78,H1
"Menominee County, WI",2006-2007,4312,4293,-19,-0.441,82,-101,55,78,H1
"Menominee County, WI",2007-2008,4293,4214,-79,-1.84,99,-178,55,78,H1
"Menominee County, WI",2008-2009,4214,4191,-23,-0.546,103,-126,55,78,H1
"Menominee County, WI",2009-2010,4191,4257,66,1.575,89,-23,55,78,H1
"Menominee County, WI",2010-2011,4257,4372,115,2.701,62,53,55,78,H1
"Menominee County, WI",2011-2012,4372,4373,1,0.023,65,-64,55,78,H1
"Menominee County, WI",2012-2013,4373,4382,9,0.206,41,-32,55,78,H1
"Menominee County, WI",2013-2014,4382,4522,140,3.195,30,110,55,78,H1
"Menominee County, WI",2014-2015,4532,4573,41,0.905,53,-12,55,78,H1
"Menominee County, WI",2015-2016,4573,4537,-36,-0.787,40,-76,55,78,H1
"Menominee County, WI",2016-2017,4537,4615,78,1.719,32,46,55,78,H1
"Milwaukee County, WI",2000-2001,939769,939305,-464,-0.049,5701,-6165,55,79,H1
"Milwaukee County, WI",2001-2002,939305,939854,549,0.058,5616,-5067,55,79,H1
"Milwaukee County, WI",2002-2003,939854,939513,-341,-0.036,5680,-6021,55,79,H1
"Milwaukee County, WI",2003-2004,939513,936914,-2599,-0.277,6118,-8717,55,79,H1
"Milwaukee County, WI",2004-2005,936914,932540,-4374,-0.467,6120,-10494,55,79,H1
"Milwaukee County, WI",2005-2006,932540,930263,-2277,-0.244,6782,-9059,55,79,H1
"Milwaukee County, WI",2006-2007,930263,931453,1190,0.128,7083,-5893,55,79,H1
"Milwaukee County, WI",2007-2008,931453,934752,3299,0.354,7402,-4103,55,79,H1
"Milwaukee County, WI",2008-2009,934752,942668,7916,0.847,6902,1014,55,79,H1
"Milwaukee County, WI",2009-2010,942668,948210,5542,0.588,7675,-2133,55,79,H1
"Milwaukee County, WI",2010-2011,948210,951481,3271,0.345,5908,-2637,55,79,H1
"Milwaukee County, WI",2011-2012,951481,954521,3040,0.32,6235,-3195,55,79,H1
"Milwaukee County, WI",2012-2013,954521,956386,1865,0.195,5921,-4056,55,79,H1
"Milwaukee County, WI",2013-2014,956386,956406,20,0.002,5892,-5872,55,79,H1
"Milwaukee County, WI",2014-2015,957913,957735,-178,-0.019,5942,-6120,55,79,H1
"Milwaukee County, WI",2015-2016,957735,955369,-2366,-0.247,5479,-7845,55,79,H1
"Milwaukee County, WI",2016-2017,955369,952085,-3284,-0.344,5318,-8602,55,79,H1
"Monroe County, WI",2000-2001,40984,41298,314,0.766,164,150,55,81,H1
"Monroe County, WI",2001-2002,41298,41611,313,0.758,196,117,55,81,H1
"Monroe County, WI",2002-2003,41611,41712,101,0.243,167,-66,55,81,H1
"Monroe County, WI",2003-2004,41712,42229,517,1.239,205,312,55,81,H1
"Monroe County, WI",2004-2005,42229,42604,375,0.888,191,184,55,81,H1
"Monroe County, WI",2005-2006,42604,43208,604,1.418,261,343,55,81,H1
"Monroe County, WI",2006-2007,43208,43729,521,1.206,218,303,55,81,H1
"Monroe County, WI",2007-2008,43729,44157,428,0.979,285,143,55,81,H1
"Monroe County, WI",2008-2009,44157,44437,280,0.634,261,19,55,81,H1
"Monroe County, WI",2009-2010,44437,44755,318,0.716,184,134,55,81,H1
"Monroe County, WI",2010-2011,44755,45109,354,0.791,185,169,55,81,H1
"Monroe County, WI",2011-2012,45109,45087,-22,-0.049,232,-254,55,81,H1
"Monroe County, WI",2012-2013,45087,45249,162,0.359,187,-25,55,81,H1
"Monroe County, WI",2013-2014,45249,45379,130,0.287,206,-76,55,81,H1
"Monroe County, WI",2014-2015,45356,45549,193,0.426,211,-18,55,81,H1
"Monroe County, WI",2015-2016,45549,45356,-193,-0.424,215,-408,55,81,H1
"Monroe County, WI",2016-2017,45356,45625,269,0.593,200,69,55,81,H1
"Oconto County, WI",2000-2001,35804,36149,345,0.964,20,325,55,83,H1
"Oconto County, WI",2001-2002,36149,36458,309,0.855,49,260,55,83,H1
"Oconto County, WI",2002-2003,36458,36889,431,1.182,49,382,55,83,H1
"Oconto County, WI",2003-2004,36889,37354,465,1.261,75,390,55,83,H1
"Oconto County, WI",2004-2005,37354,37563,209,0.56,76,133,55,83,H1
"Oconto County, WI",2005-2006,37563,37756,193,0.514,87,106,55,83,H1
"Oconto County, WI",2006-2007,37756,37805,49,0.13,43,6,55,83,H1
"Oconto County, WI",2007-2008,37805,37816,11,0.029,46,-35,55,83,H1
"Oconto County, WI",2008-2009,37816,37655,-161,-0.426,59,-220,55,83,H1
"Oconto County, WI",2009-2010,37655,37654,-1,-0.003,11,-12,55,83,H1
"Oconto County, WI",2010-2011,37654,37590,-64,-0.17,-16,-48,55,83,H1
"Oconto County, WI",2011-2012,37590,37420,-170,-0.452,21,-191,55,83,H1
"Oconto County, WI",2012-2013,37420,37334,-86,-0.23,8,-94,55,83,H1
"Oconto County, WI",2013-2014,37334,37417,83,0.222,-25,108,55,83,H1
"Oconto County, WI",2014-2015,37498,37435,-63,-0.168,2,-65,55,83,H1
"Oconto County, WI",2015-2016,37435,37471,36,0.096,-13,49,55,83,H1
"Oconto County, WI",2016-2017,37471,37553,82,0.219,-34,116,55,83,H1
"Oneida County, WI",2000-2001,36766,36912,146,0.397,-93,239,55,85,H1
"Oneida County, WI",2001-2002,36912,36875,-37,-0.1,-104,67,55,85,H1
"Oneida County, WI",2002-2003,36875,37223,348,0.944,-34,382,55,85,H1
"Oneida County, WI",2003-2004,37223,37035,-188,-0.505,-84,-104,55,85,H1
"Oneida County, WI",2004-2005,37035,36896,-139,-0.375,-61,-78,55,85,H1
"Oneida County, WI",2005-2006,36896,36746,-150,-0.407,-106,-44,55,85,H1
"Oneida County, WI",2006-2007,36746,36553,-193,-0.525,-138,-55,55,85,H1
"Oneida County, WI",2007-2008,36553,36500,-53,-0.145,-94,41,55,85,H1
"Oneida County, WI",2008-2009,36500,36175,-325,-0.89,-56,-269,55,85,H1
"Oneida County, WI",2009-2010,36175,35938,-237,-0.655,-104,-133,55,85,H1
"Oneida County, WI",2010-2011,35938,35826,-112,-0.312,-135,23,55,85,H1
"Oneida County, WI",2011-2012,35826,35746,-80,-0.223,-101,21,55,85,H1
"Oneida County, WI",2012-2013,35746,35696,-50,-0.14,-150,100,55,85,H1
"Oneida County, WI",2013-2014,35696,35563,-133,-0.373,-133,0,55,85,H1
"Oneida County, WI",2014-2015,35492,35567,75,0.211,-150,225,55,85,H1
"Oneida County, WI",2015-2016,35567,35374,-193,-0.543,-133,-60,55,85,H1
"Oneida County, WI",2016-2017,35374,35254,-120,-0.339,-140,20,55,85,H1
"Outagamie County, WI",2000-2001,161720,163726,2006,1.24,1187,819,55,87,H1
"Outagamie County, WI",2001-2002,163726,165336,1610,0.983,1181,429,55,87,H1
"Outagamie County, WI",2002-2003,165336,166690,1354,0.819,1172,182,55,87,H1
"Outagamie County, WI",2003-2004,166690,168136,1446,0.867,1180,266,55,87,H1
"Outagamie County, WI",2004-2005,168136,169740,1604,0.954,1064,540,55,87,H1
"Outagamie County, WI",2005-2006,169740,171632,1892,1.115,1144,748,55,87,H1
"Outagamie County, WI",2006-2007,171632,173180,1548,0.902,1126,422,55,87,H1
"Outagamie County, WI",2007-2008,173180,174388,1208,0.698,1129,79,55,87,H1
"Outagamie County, WI",2008-2009,174388,176175,1787,1.025,1182,605,55,87,H1
"Outagamie County, WI",2009-2010,176175,176861,686,0.389,1097,-411,55,87,H1
"Outagamie County, WI",2010-2011,176861,177727,866,0.49,1096,-230,55,87,H1
"Outagamie County, WI",2011-2012,177727,178877,1150,0.647,995,155,55,87,H1
"Outagamie County, WI",2012-2013,178877,180225,1348,0.754,1063,285,55,87,H1
"Outagamie County, WI",2013-2014,180225,182006,1781,0.988,1037,744,55,87,H1
"Outagamie County, WI",2014-2015,181979,183245,1266,0.696,1040,226,55,87,H1
"Outagamie County, WI",2015-2016,183245,184654,1409,0.769,926,483,55,87,H1
"Outagamie County, WI",2016-2017,184654,186059,1405,0.761,1011,394,55,87,H1
"Ozaukee County, WI",2000-2001,82515,83001,486,0.589,280,206,55,89,H1
"Ozaukee County, WI",2001-2002,83001,83605,604,0.728,322,282,55,89,H1
"Ozaukee County, WI",2002-2003,83605,84303,698,0.835,268,430,55,89,H1
"Ozaukee County, WI",2003-2004,84303,85069,766,0.909,261,505,55,89,H1
"Ozaukee County, WI",2004-2005,85069,85178,109,0.128,242,-133,55,89,H1
"Ozaukee County, WI",2005-2006,85178,85362,184,0.216,181,3,55,89,H1
"Ozaukee County, WI",2006-2007,85362,85597,235,0.275,148,87,55,89,H1
"Ozaukee County, WI",2007-2008,85597,85994,397,0.464,168,229,55,89,H1
"Ozaukee County, WI",2008-2009,85994,86409,415,0.483,212,203,55,89,H1
"Ozaukee County, WI",2009-2010,86409,86349,-60,-0.069,170,-230,55,89,H1
"Ozaukee County, WI",2010-2011,86349,86707,358,0.415,78,280,55,89,H1
"Ozaukee County, WI",2011-2012,86707,87030,323,0.373,60,263,55,89,H1
"Ozaukee County, WI",2012-2013,87030,87095,65,0.075,96,-31,55,89,H1
"Ozaukee County, WI",2013-2014,87095,87470,375,0.431,59,316,55,89,H1
"Ozaukee County, WI",2014-2015,87566,87850,284,0.324,79,205,55,89,H1
"Ozaukee County, WI",2015-2016,87850,88177,327,0.372,35,292,55,89,H1
"Ozaukee County, WI",2016-2017,88177,88429,252,0.286,58,194,55,89,H1
"Pepin County, WI",2000-2001,7301,7355,54,0.74,0,54,55,91,H1
"Pepin County, WI",2001-2002,7355,7436,81,1.101,37,44,55,91,H1
"Pepin County, WI",2002-2003,7436,7454,18,0.242,-24,42,55,91,H1
"Pepin County, WI",2003-2004,7454,7536,82,1.1,12,70,55,91,H1
"Pepin County, WI",2004-2005,7536,7566,30,0.398,21,9,55,91,H1
"Pepin County, WI",2005-2006,7566,7540,-26,-0.344,28,-54,55,91,H1
"Pepin County, WI",2006-2007,7540,7557,17,0.225,12,5,55,91,H1
"Pepin County, WI",2007-2008,7557,7545,-12,-0.159,33,-45,55,91,H1
"Pepin County, WI",2008-2009,7545,7480,-65,-0.861,22,-87,55,91,H1
"Pepin County, WI",2009-2010,7480,7444,-36,-0.481,4,-40,55,91,H1
"Pepin County, WI",2010-2011,7444,7415,-29,-0.39,-13,-16,55,91,H1
"Pepin County, WI",2011-2012,7415,7387,-28,-0.378,25,-53,55,91,H1
"Pepin County, WI",2012-2013,7387,7368,-19,-0.257,14,-33,55,91,H1
"Pepin County, WI",2013-2014,7368,7335,-33,-0.448,-12,-21,55,91,H1
"Pepin County, WI",2014-2015,7353,7290,-63,-0.857,-14,-49,55,91,H1
"Pepin County, WI",2015-2016,7290,7266,-24,-0.329,16,-40,55,91,H1
"Pepin County, WI",2016-2017,7266,7254,-12,-0.165,-6,-6,55,91,H1
"Pierce County, WI",2000-2001,36844,37204,360,0.977,169,191,55,93,H1
"Pierce County, WI",2001-2002,37204,37547,343,0.922,155,188,55,93,H1
"Pierce County, WI",2002-2003,37547,38090,543,1.446,190,353,55,93,H1
"Pierce County, WI",2003-2004,38090,38789,699,1.835,262,437,55,93,H1
"Pierce County, WI",2004-2005,38789,39318,529,1.364,228,301,55,93,H1
"Pierce County, WI",2005-2006,39318,39915,597,1.518,202,395,55,93,H1
"Pierce County, WI",2006-2007,39915,40238,323,0.809,247,76,55,93,H1
"Pierce County, WI",2007-2008,40238,40758,520,1.292,172,348,55,93,H1
"Pierce County, WI",2008-2009,40758,40613,-145,-0.356,211,-356,55,93,H1
"Pierce County, WI",2009-2010,40613,41110,497,1.224,235,262,55,93,H1
"Pierce County, WI",2010-2011,41110,40822,-288,-0.701,169,-457,55,93,H1
"Pierce County, WI",2011-2012,40822,40674,-148,-0.363,157,-305,55,93,H1
"Pierce County, WI",2012-2013,40674,40733,59,0.145,160,-101,55,93,H1
"Pierce County, WI",2013-2014,40733,40958,225,0.552,130,95,55,93,H1
"Pierce County, WI",2014-2015,40920,40889,-31,-0.076,110,-141,55,93,H1
"Pierce County, WI",2015-2016,40889,41428,539,1.318,112,427,55,93,H1
"Pierce County, WI",2016-2017,41428,41901,473,1.142,115,358,55,93,H1
"Polk County, WI",2000-2001,41454,42212,758,1.829,125,633,55,95,H1
"Polk County, WI",2001-2002,42212,42576,364,0.862,-6,370,55,95,H1
"Polk County, WI",2002-2003,42576,43032,456,1.071,69,387,55,95,H1
"Polk County, WI",2003-2004,43032,43584,552,1.283,76,476,55,95,H1
"Polk County, WI",2004-2005,43584,44014,430,0.987,123,307,55,95,H1
"Polk County, WI",2005-2006,44014,44367,353,0.802,110,243,55,95,H1
"Polk County, WI",2006-2007,44367,44318,-49,-0.11,123,-172,55,95,H1
"Polk County, WI",2007-2008,44318,44331,13,0.029,90,-77,55,95,H1
"Polk County, WI",2008-2009,44331,44376,45,0.102,81,-36,55,95,H1
"Polk County, WI",2009-2010,44376,44154,-222,-0.5,49,-271,55,95,H1
"Polk County, WI",2010-2011,44154,43948,-206,-0.467,30,-236,55,95,H1
"Polk County, WI",2011-2012,43948,43525,-423,-0.963,50,-473,55,95,H1
"Polk County, WI",2012-2013,43525,43424,-101,-0.232,-4,-97,55,95,H1
"Polk County, WI",2013-2014,43424,43437,13,0.03,-18,31,55,95,H1
"Polk County, WI",2014-2015,43475,43441,-34,-0.078,12,-46,55,95,H1
"Polk County, WI",2015-2016,43441,43297,-144,-0.331,-5,-139,55,95,H1
"Polk County, WI",2016-2017,43297,43450,153,0.353,-16,169,55,95,H1
"Portage County, WI",2000-2001,67250,67422,172,0.256,385,-213,55,97,H1
"Portage County, WI",2001-2002,67422,67644,222,0.329,269,-47,55,97,H1
"Portage County, WI",2002-2003,67644,67728,84,0.124,278,-194,55,97,H1
"Portage County, WI",2003-2004,67728,67789,61,0.09,291,-230,55,97,H1
"Portage County, WI",2004-2005,67789,68045,256,0.378,213,43,55,97,H1
"Portage County, WI",2005-2006,68045,68481,436,0.641,270,166,55,97,H1
"Portage County, WI",2006-2007,68481,69133,652,0.952,299,353,55,97,H1
"Portage County, WI",2007-2008,69133,69641,508,0.735,300,208,55,97,H1
"Portage County, WI",2008-2009,69641,69876,235,0.337,301,-66,55,97,H1
"Portage County, WI",2009-2010,69876,69977,101,0.145,255,-154,55,97,H1
"Portage County, WI",2010-2011,69977,70156,179,0.256,210,-31,55,97,H1
"Portage County, WI",2011-2012,70156,70481,325,0.463,231,94,55,97,H1
"Portage County, WI",2012-2013,70481,70587,106,0.15,179,-73,55,97,H1
"Portage County, WI",2013-2014,70587,70482,-105,-0.149,196,-301,55,97,H1
"Portage County, WI",2014-2015,70500,70408,-92,-0.13,174,-266,55,97,H1
"Portage County, WI",2015-2016,70408,70188,-220,-0.312,158,-378,55,97,H1
"Portage County, WI",2016-2017,70188,70474,286,0.407,176,110,55,97,H1
"Price County, WI",2000-2001,15806,15566,-240,-1.518,-55,-185,55,99,H1
"Price County, WI",2001-2002,15566,15411,-155,-0.996,-66,-89,55,99,H1
"Price County, WI",2002-2003,15411,15361,-50,-0.324,-31,-19,55,99,H1
"Price County, WI",2003-2004,15361,15189,-172,-1.12,-106,-66,55,99,H1
"Price County, WI",2004-2005,15189,15046,-143,-0.941,-75,-68,55,99,H1
"Price County, WI",2005-2006,15046,14882,-164,-1.09,-60,-104,55,99,H1
"Price County, WI",2006-2007,14882,14561,-321,-2.157,-90,-231,55,99,H1
"Price County, WI",2007-2008,14561,14411,-150,-1.03,-57,-93,55,99,H1
"Price County, WI",2008-2009,14411,14297,-114,-0.791,-60,-54,55,99,H1
"Price County, WI",2009-2010,14297,14105,-192,-1.343,-74,-118,55,99,H1
"Price County, WI",2010-2011,14105,14018,-87,-0.617,-51,-36,55,99,H1
"Price County, WI",2011-2012,14018,13870,-148,-1.056,-50,-98,55,99,H1
"Price County, WI",2012-2013,13870,13772,-98,-0.707,-71,-27,55,99,H1
"Price County, WI",2013-2014,13772,13675,-97,-0.704,-43,-54,55,99,H1
"Price County, WI",2014-2015,13679,13645,-34,-0.249,-49,15,55,99,H1
"Price County, WI",2015-2016,13645,13424,-221,-1.62,-75,-146,55,99,H1
"Price County, WI",2016-2017,13424,13442,18,0.134,-43,61,55,99,H1
"Racine County, WI",2000-2001,188904,189047,143,0.076,968,-825,55,101,H1
"Racine County, WI",2001-2002,189047,189833,786,0.416,1073,-287,55,101,H1
"Racine County, WI",2002-2003,189833,190845,1012,0.533,1007,5,55,101,H1
"Racine County, WI",2003-2004,190845,191808,963,0.505,1033,-70,55,101,H1
"Racine County, WI",2004-2005,191808,193251,1443,0.752,1046,397,55,101,H1
"Racine County, WI",2005-2006,193251,193915,664,0.344,1050,-386,55,101,H1
"Racine County, WI",2006-2007,193915,194395,480,0.248,1154,-674,55,101,H1
"Racine County, WI",2007-2008,194395,194730,335,0.172,1020,-685,55,101,H1
"Racine County, WI",2008-2009,194730,195130,400,0.205,1115,-715,55,101,H1
"Racine County, WI",2009-2010,195130,195446,316,0.162,961,-645,55,101,H1
"Racine County, WI",2010-2011,195446,194979,-467,-0.239,855,-1322,55,101,H1
"Racine County, WI",2011-2012,194979,194683,-296,-0.152,724,-1020,55,101,H1
"Racine County, WI",2012-2013,194683,194922,239,0.123,702,-463,55,101,H1
"Racine County, WI",2013-2014,194922,195163,241,0.124,802,-561,55,101,H1
"Racine County, WI",2014-2015,194986,195080,94,0.048,762,-668,55,101,H1
"Racine County, WI",2015-2016,195080,195010,-70,-0.036,624,-694,55,101,H1
"Racine County, WI",2016-2017,195010,196071,1061,0.544,701,360,55,101,H1
"Richland County, WI",2000-2001,17979,18061,82,0.456,37,45,55,103,H1
"Richland County, WI",2001-2002,18061,17976,-85,-0.471,-5,-80,55,103,H1
"Richland County, WI",2002-2003,17976,18106,130,0.723,14,116,55,103,H1
"Richland County, WI",2003-2004,18106,18322,216,1.193,76,140,55,103,H1
"Richland County, WI",2004-2005,18322,18256,-66,-0.36,35,-101,55,103,H1
"Richland County, WI",2005-2006,18256,18299,43,0.236,83,-40,55,103,H1
"Richland County, WI",2006-2007,18299,18428,129,0.705,49,80,55,103,H1
"Richland County, WI",2007-2008,18428,18205,-223,-1.21,31,-254,55,103,H1
"Richland County, WI",2008-2009,18205,18112,-93,-0.511,37,-130,55,103,H1
"Richland County, WI",2009-2010,18112,17985,-127,-0.701,6,-133,55,103,H1
"Richland County, WI",2010-2011,17985,17987,2,0.011,4,-2,55,103,H1
"Richland County, WI",2011-2012,17987,17799,-188,-1.045,-8,-180,55,103,H1
"Richland County, WI",2012-2013,17799,17779,-20,-0.112,7,-27,55,103,H1
"Richland County, WI",2013-2014,17779,17662,-117,-0.658,1,-118,55,103,H1
"Richland County, WI",2014-2015,17677,17495,-182,-1.03,15,-197,55,103,H1
"Richland County, WI",2015-2016,17495,17520,25,0.143,1,24,55,103,H1
"Richland County, WI",2016-2017,17520,17516,-4,-0.023,-11,7,55,103,H1
"Rock County, WI",2000-2001,152464,153174,710,0.466,743,-33,55,105,H1
"Rock County, WI",2001-2002,153174,153628,454,0.296,652,-198,55,105,H1
"Rock County, WI",2002-2003,153628,154268,640,0.417,748,-108,55,105,H1
"Rock County, WI",2003-2004,154268,155685,1417,0.919,706,711,55,105,H1
"Rock County, WI",2004-2005,155685,156761,1076,0.691,622,454,55,105,H1
"Rock County, WI",2005-2006,156761,158538,1777,1.134,672,1105,55,105,H1
"Rock County, WI",2006-2007,158538,159912,1374,0.867,839,535,55,105,H1
"Rock County, WI",2007-2008,159912,160647,735,0.46,805,-70,55,105,H1
"Rock County, WI",2008-2009,160647,160411,-236,-0.147,769,-1005,55,105,H1
"Rock County, WI",2009-2010,160411,160230,-181,-0.113,665,-846,55,105,H1
"Rock County, WI",2010-2011,160230,160001,-229,-0.143,561,-790,55,105,H1
"Rock County, WI",2011-2012,160001,160271,270,0.169,519,-249,55,105,H1
"Rock County, WI",2012-2013,160271,160633,362,0.226,446,-84,55,105,H1
"Rock County, WI",2013-2014,160633,161188,555,0.346,530,25,55,105,H1
"Rock County, WI",2014-2015,161267,161448,181,0.112,558,-377,55,105,H1
"Rock County, WI",2015-2016,161448,161421,-27,-0.017,439,-466,55,105,H1
"Rock County, WI",2016-2017,161421,162309,888,0.55,506,382,55,105,H1
"Rusk County, WI",2000-2001,15356,15245,-111,-0.723,-21,-90,55,107,H1
"Rusk County, WI",2001-2002,15245,15257,12,0.079,-41,53,55,107,H1
"Rusk County, WI",2002-2003,15257,15169,-88,-0.577,14,-102,55,107,H1
"Rusk County, WI",2003-2004,15169,15189,20,0.132,-29,49,55,107,H1
"Rusk County, WI",2004-2005,15189,15091,-98,-0.645,-37,-61,55,107,H1
"Rusk County, WI",2005-2006,15091,14945,-146,-0.967,-30,-116,55,107,H1
"Rusk County, WI",2006-2007,14945,14890,-55,-0.368,1,-56,55,107,H1
"Rusk County, WI",2007-2008,14890,14884,-6,-0.04,15,-21,55,107,H1
"Rusk County, WI",2008-2009,14884,14841,-43,-0.289,-4,-39,55,107,H1
"Rusk County, WI",2009-2010,14841,14722,-119,-0.802,-34,-85,55,107,H1
"Rusk County, WI",2010-2011,14722,14611,-111,-0.754,-29,-82,55,107,H1
"Rusk County, WI",2011-2012,14611,14302,-309,-2.115,-8,-301,55,107,H1
"Rusk County, WI",2012-2013,14302,14371,69,0.482,-61,130,55,107,H1
"Rusk County, WI",2013-2014,14371,14333,-38,-0.264,-22,-16,55,107,H1
"Rusk County, WI",2014-2015,14355,14124,-231,-1.609,-27,-204,55,107,H1
"Rusk County, WI",2015-2016,14124,14092,-32,-0.227,-30,-2,55,107,H1
"Rusk County, WI",2016-2017,14092,14151,59,0.419,-18,77,55,107,H1
"St. Croix County, WI",2000-2001,63639,65711,2072,3.256,358,1714,55,109,H1
"St. Croix County, WI",2001-2002,65711,68268,2557,3.891,494,2063,55,109,H1
"St. Croix County, WI",2002-2003,68268,71076,2808,4.113,555,2253,55,109,H1
"St. Croix County, WI",2003-2004,71076,73988,2912,4.097,599,2313,55,109,H1
"St. Croix County, WI",2004-2005,73988,77061,3073,4.153,834,2239,55,109,H1
"St. Croix County, WI",2005-2006,77061,79784,2723,3.534,751,1972,55,109,H1
"St. Croix County, WI",2006-2007,79784,81708,1924,2.412,711,1213,55,109,H1
"St. Croix County, WI",2007-2008,81708,83192,1484,1.816,696,788,55,109,H1
"St. Croix County, WI",2008-2009,83192,84055,863,1.037,674,189,55,109,H1
"St. Croix County, WI",2009-2010,84055,84398,343,0.408,592,-249,55,109,H1
"St. Croix County, WI",2010-2011,84398,84924,526,0.623,553,-27,55,109,H1
"St. Croix County, WI",2011-2012,84924,85220,296,0.349,474,-178,55,109,H1
"St. Croix County, WI",2012-2013,85220,85908,688,0.807,514,174,55,109,H1
"St. Croix County, WI",2013-2014,85908,86759,851,0.991,432,419,55,109,H1
"St. Croix County, WI",2014-2015,86900,87513,613,0.705,510,103,55,109,H1
"St. Croix County, WI",2015-2016,87513,87645,132,0.151,419,-287,55,109,H1
"St. Croix County, WI",2016-2017,87645,88703,1058,1.207,388,670,55,109,H1
"Sauk County, WI",2000-2001,55348,55660,312,0.564,70,242,55,111,H1
"Sauk County, WI",2001-2002,55660,56316,656,1.179,198,458,55,111,H1
"Sauk County, WI",2002-2003,56316,57096,780,1.385,216,564,55,111,H1
"Sauk County, WI",2003-2004,57096,58020,924,1.618,269,655,55,111,H1
"Sauk County, WI",2004-2005,58020,58856,836,1.441,237,599,55,111,H1
"Sauk County, WI",2005-2006,58856,59580,724,1.23,234,490,55,111,H1
"Sauk County, WI",2006-2007,59580,60389,809,1.358,291,518,55,111,H1
"Sauk County, WI",2007-2008,60389,61231,842,1.394,223,619,55,111,H1
"Sauk County, WI",2008-2009,61231,61562,331,0.541,246,85,55,111,H1
"Sauk County, WI",2009-2010,61562,62019,457,0.742,219,238,55,111,H1
"Sauk County, WI",2010-2011,62019,62405,386,0.622,163,223,55,111,H1
"Sauk County, WI",2011-2012,62405,62540,135,0.216,195,-60,55,111,H1
"Sauk County, WI",2012-2013,62540,63063,523,0.836,180,343,55,111,H1
"Sauk County, WI",2013-2014,63063,63379,316,0.501,157,159,55,111,H1
"Sauk County, WI",2014-2015,63360,63642,282,0.445,190,92,55,111,H1
"Sauk County, WI",2015-2016,63642,63604,-38,-0.06,91,-129,55,111,H1
"Sauk County, WI",2016-2017,63604,63981,377,0.593,141,236,55,111,H1
"Sawyer County, WI",2000-2001,16249,16249,0,0,-24,24,55,113,H1
"Sawyer County, WI",2001-2002,16249,16391,142,0.874,-26,168,55,113,H1
"Sawyer County, WI",2002-2003,16391,16510,119,0.726,-37,156,55,113,H1
"Sawyer County, WI",2003-2004,16510,16552,42,0.254,11,31,55,113,H1
"Sawyer County, WI",2004-2005,16552,16652,100,0.604,2,98,55,113,H1
"Sawyer County, WI",2005-2006,16652,16624,-28,-0.168,15,-43,55,113,H1
"Sawyer County, WI",2006-2007,16624,16674,50,0.301,22,28,55,113,H1
"Sawyer County, WI",2007-2008,16674,16650,-24,-0.144,23,-47,55,113,H1
"Sawyer County, WI",2008-2009,16650,16559,-91,-0.547,8,-99,55,113,H1
"Sawyer County, WI",2009-2010,16559,16561,2,0.012,-21,23,55,113,H1
"Sawyer County, WI",2010-2011,16561,16530,-31,-0.187,-22,-9,55,113,H1
"Sawyer County, WI",2011-2012,16530,16540,10,0.06,-26,36,55,113,H1
"Sawyer County, WI",2012-2013,16540,16513,-27,-0.163,-16,-11,55,113,H1
"Sawyer County, WI",2013-2014,16513,16437,-76,-0.46,-20,-56,55,113,H1
"Sawyer County, WI",2014-2015,16435,16376,-59,-0.359,-37,-22,55,113,H1
"Sawyer County, WI",2015-2016,16376,16348,-28,-0.171,-40,12,55,113,H1
"Sawyer County, WI",2016-2017,16348,16418,70,0.428,-29,99,55,113,H1
"Shawano County, WI",2000-2001,40801,40878,77,0.189,16,61,55,115,H1
"Shawano County, WI",2001-2002,40878,40976,98,0.24,4,94,55,115,H1
"Shawano County, WI",2002-2003,40976,41083,107,0.261,26,81,55,115,H1
"Shawano County, WI",2003-2004,41083,41273,190,0.462,14,176,55,115,H1
"Shawano County, WI",2004-2005,41273,41437,164,0.397,33,131,55,115,H1
"Shawano County, WI",2005-2006,41437,41639,202,0.487,73,129,55,115,H1
"Shawano County, WI",2006-2007,41639,41829,190,0.456,90,100,55,115,H1
"Shawano County, WI",2007-2008,41829,41894,65,0.155,48,17,55,115,H1
"Shawano County, WI",2008-2009,41894,41889,-5,-0.012,44,-49,55,115,H1
"Shawano County, WI",2009-2010,41889,41933,44,0.105,19,25,55,115,H1
"Shawano County, WI",2010-2011,41933,41778,-155,-0.37,-30,-125,55,115,H1
"Shawano County, WI",2011-2012,41778,41603,-175,-0.419,21,-196,55,115,H1
"Shawano County, WI",2012-2013,41603,41594,-9,-0.022,53,-62,55,115,H1
"Shawano County, WI",2013-2014,41594,41579,-15,-0.036,43,-58,55,115,H1
"Shawano County, WI",2014-2015,41552,41304,-248,-0.597,23,-271,55,115,H1
"Shawano County, WI",2015-2016,41304,40941,-363,-0.879,-54,-309,55,115,H1
"Shawano County, WI",2016-2017,40941,40935,-6,-0.015,-13,7,55,115,H1
"Sheboygan County, WI",2000-2001,112739,113023,284,0.252,38,246,55,117,H1
"Sheboygan County, WI",2001-2002,113023,113251,228,0.202,336,-108,55,117,H1
"Sheboygan County, WI",2002-2003,113251,113433,182,0.161,331,-149,55,117,H1
"Sheboygan County, WI",2003-2004,113433,113832,399,0.352,315,84,55,117,H1
"Sheboygan County, WI",2004-2005,113832,114454,622,0.546,401,221,55,117,H1
"Sheboygan County, WI",2005-2006,114454,114775,321,0.28,349,-28,55,117,H1
"Sheboygan County, WI",2006-2007,114775,115178,403,0.351,309,94,55,117,H1
"Sheboygan County, WI",2007-2008,115178,115652,474,0.412,422,52,55,117,H1
"Sheboygan County, WI",2008-2009,115652,115562,-90,-0.078,433,-523,55,117,H1
"Sheboygan County, WI",2009-2010,115562,115418,-144,-0.125,306,-450,55,117,H1
"Sheboygan County, WI",2010-2011,115418,115312,-106,-0.092,303,-409,55,117,H1
"Sheboygan County, WI",2011-2012,115312,114952,-360,-0.312,189,-549,55,117,H1
"Sheboygan County, WI",2012-2013,114952,114868,-84,-0.073,175,-259,55,117,H1
"Sheboygan County, WI",2013-2014,114868,115290,422,0.367,212,210,55,117,H1
"Sheboygan County, WI",2014-2015,115262,115569,307,0.266,192,115,55,117,H1
"Sheboygan County, WI",2015-2016,115569,115127,-442,-0.382,135,-577,55,117,H1
"Sheboygan County, WI",2016-2017,115127,115344,217,0.188,177,40,55,117,H1
"Taylor County, WI",2000-2001,19752,19813,61,0.309,51,10,55,119,H1
"Taylor County, WI",2001-2002,19813,19933,120,0.606,42,78,55,119,H1
"Taylor County, WI",2002-2003,19933,19933,0,0,38,-38,55,119,H1
"Taylor County, WI",2003-2004,19933,20186,253,1.269,77,176,55,119,H1
"Taylor County, WI",2004-2005,20186,20330,144,0.713,76,68,55,119,H1
"Taylor County, WI",2005-2006,20330,20394,64,0.315,71,-7,55,119,H1
"Taylor County, WI",2006-2007,20394,20473,79,0.387,86,-7,55,119,H1
"Taylor County, WI",2007-2008,20473,20577,104,0.508,60,44,55,119,H1
"Taylor County, WI",2008-2009,20577,20697,120,0.583,54,66,55,119,H1
"Taylor County, WI",2009-2010,20697,20630,-67,-0.324,31,-98,55,119,H1
"Taylor County, WI",2010-2011,20630,20760,130,0.63,44,86,55,119,H1
"Taylor County, WI",2011-2012,20760,20474,-286,-1.378,65,-351,55,119,H1
"Taylor County, WI",2012-2013,20474,20577,103,0.503,40,63,55,119,H1
"Taylor County, WI",2013-2014,20577,20540,-37,-0.18,13,-50,55,119,H1
"Taylor County, WI",2014-2015,20561,20455,-106,-0.516,48,-154,55,119,H1
"Taylor County, WI",2015-2016,20455,20275,-180,-0.88,53,-233,55,119,H1
"Taylor County, WI",2016-2017,20275,20321,46,0.227,51,-5,55,119,H1
"Trempealeau County, WI",2000-2001,27080,27118,38,0.14,29,9,55,121,H1
"Trempealeau County, WI",2001-2002,27118,27249,131,0.483,-14,145,55,121,H1
"Trempealeau County, WI",2002-2003,27249,27413,164,0.602,-3,167,55,121,H1
"Trempealeau County, WI",2003-2004,27413,27676,263,0.959,73,190,55,121,H1
"Trempealeau County, WI",2004-2005,27676,28065,389,1.406,106,283,55,121,H1
"Trempealeau County, WI",2005-2006,28065,28286,221,0.787,-11,232,55,121,H1
"Trempealeau County, WI",2006-2007,28286,28396,110,0.389,57,53,55,121,H1
"Trempealeau County, WI",2007-2008,28396,28452,56,0.197,114,-58,55,121,H1
"Trempealeau County, WI",2008-2009,28452,28627,175,0.615,101,74,55,121,H1
"Trempealeau County, WI",2009-2010,28627,28853,226,0.789,51,175,55,121,H1
"Trempealeau County, WI",2010-2011,28853,29056,203,0.704,128,75,55,121,H1
"Trempealeau County, WI",2011-2012,29056,29371,315,1.084,122,193,55,121,H1
"Trempealeau County, WI",2012-2013,29371,29579,208,0.708,116,92,55,121,H1
"Trempealeau County, WI",2013-2014,29579,29509,-70,-0.237,142,-212,55,121,H1
"Trempealeau County, WI",2014-2015,29515,29550,35,0.119,135,-100,55,121,H1
"Trempealeau County, WI",2015-2016,29550,29624,74,0.25,112,-38,55,121,H1
"Trempealeau County, WI",2016-2017,29624,29472,-152,-0.513,146,-298,55,121,H1
"Vernon County, WI",2000-2001,28050,28157,107,0.381,41,66,55,123,H1
"Vernon County, WI",2001-2002,28157,28288,131,0.465,42,89,55,123,H1
"Vernon County, WI",2002-2003,28288,28395,107,0.378,88,19,55,123,H1
"Vernon County, WI",2003-2004,28395,28652,257,0.905,161,96,55,123,H1
"Vernon County, WI",2004-2005,28652,28959,307,1.071,125,182,55,123,H1
"Vernon County, WI",2005-2006,28959,29123,164,0.566,117,47,55,123,H1
"Vernon County, WI",2006-2007,29123,29313,190,0.652,157,33,55,123,H1
"Vernon County, WI",2007-2008,29313,29431,118,0.403,109,9,55,123,H1
"Vernon County, WI",2008-2009,29431,29659,228,0.775,159,69,55,123,H1
"Vernon County, WI",2009-2010,29659,29735,76,0.256,81,-5,55,123,H1
"Vernon County, WI",2010-2011,29735,30033,298,1.002,103,195,55,123,H1
"Vernon County, WI",2011-2012,30033,30203,170,0.566,131,39,55,123,H1
"Vernon County, WI",2012-2013,30203,30285,82,0.271,141,-59,55,123,H1
"Vernon County, WI",2013-2014,30285,30362,77,0.254,117,-40,55,123,H1
"Vernon County, WI",2014-2015,30360,30506,146,0.481,113,33,55,123,H1
"Vernon County, WI",2015-2016,30506,30543,37,0.121,117,-80,55,123,H1
"Vernon County, WI",2016-2017,30543,30759,216,0.707,93,123,55,123,H1
"Vilas County, WI",2000-2001,21162,21464,302,1.427,-106,408,55,125,H1
"Vilas County, WI",2001-2002,21464,21766,302,1.407,-49,351,55,125,H1
"Vilas County, WI",2002-2003,21766,21997,231,1.061,-73,304,55,125,H1
"Vilas County, WI",2003-2004,21997,22069,72,0.327,-36,108,55,125,H1
"Vilas County, WI",2004-2005,22069,22116,47,0.213,-56,103,55,125,H1
"Vilas County, WI",2005-2006,22116,22064,-52,-0.235,-76,24,55,125,H1
"Vilas County, WI",2006-2007,22064,21997,-67,-0.304,-79,12,55,125,H1
"Vilas County, WI",2007-2008,21997,21767,-230,-1.046,-107,-123,55,125,H1
"Vilas County, WI",2008-2009,21767,21524,-243,-1.116,-95,-148,55,125,H1
"Vilas County, WI",2009-2010,21524,21439,-85,-0.395,-114,29,55,125,H1
"Vilas County, WI",2010-2011,21439,21366,-73,-0.341,-110,37,55,125,H1
"Vilas County, WI",2011-2012,21366,21281,-85,-0.398,-123,38,55,125,H1
"Vilas County, WI",2012-2013,21281,21355,74,0.348,-85,159,55,125,H1
"Vilas County, WI",2013-2014,21355,21398,43,0.201,-99,142,55,125,H1
"Vilas County, WI",2014-2015,21398,21387,-11,-0.051,-99,88,55,125,H1
"Vilas County, WI",2015-2016,21387,21464,77,0.36,-120,197,55,125,H1
"Vilas County, WI",2016-2017,21464,21683,219,1.02,-130,349,55,125,H1
"Walworth County, WI",2000-2001,92328,93462,1134,1.228,226,908,55,127,H1
"Walworth County, WI",2001-2002,93462,95370,1908,2.041,365,1543,55,127,H1
"Walworth County, WI",2002-2003,95370,97087,1717,1.8,420,1297,55,127,H1
"Walworth County, WI",2003-2004,97087,98128,1041,1.072,251,790,55,127,H1
"Walworth County, WI",2004-2005,98128,99848,1720,1.753,334,1386,55,127,H1
"Walworth County, WI",2005-2006,99848,101026,1178,1.18,365,813,55,127,H1
"Walworth County, WI",2006-2007,101026,101449,423,0.419,381,42,55,127,H1
"Walworth County, WI",2007-2008,101449,101916,467,0.46,427,40,55,127,H1
"Walworth County, WI",2008-2009,101916,102077,161,0.158,402,-241,55,127,H1
"Walworth County, WI",2009-2010,102077,102161,84,0.082,281,-197,55,127,H1
"Walworth County, WI",2010-2011,102161,102783,622,0.609,161,461,55,127,H1
"Walworth County, WI",2011-2012,102783,103052,269,0.262,186,83,55,127,H1
"Walworth County, WI",2012-2013,103052,103079,27,0.026,160,-133,55,127,H1
"Walworth County, WI",2013-2014,103079,103527,448,0.435,142,306,55,127,H1
"Walworth County, WI",2014-2015,103499,102804,-695,-0.672,117,-812,55,127,H1
"Walworth County, WI",2015-2016,102804,102775,-29,-0.028,126,-155,55,127,H1
"Walworth County, WI",2016-2017,102775,103082,307,0.299,108,199,55,127,H1
"Washburn County, WI",2000-2001,16034,16070,36,0.225,-39,75,55,129,H1
"Washburn County, WI",2001-2002,16070,16174,104,0.647,-32,136,55,129,H1
"Washburn County, WI",2002-2003,16174,16138,-36,-0.223,-9,-27,55,129,H1
"Washburn County, WI",2003-2004,16138,16126,-12,-0.074,-1,-11,55,129,H1
"Washburn County, WI",2004-2005,16126,16097,-29,-0.18,6,-35,55,129,H1
"Washburn County, WI",2005-2006,16097,16098,1,0.006,8,-7,55,129,H1
"Washburn County, WI",2006-2007,16098,16038,-60,-0.373,6,-66,55,129,H1
"Washburn County, WI",2007-2008,16038,16003,-35,-0.218,8,-43,55,129,H1
"Washburn County, WI",2008-2009,16003,15947,-56,-0.35,10,-66,55,129,H1
"Washburn County, WI",2009-2010,15947,15934,-13,-0.082,-18,5,55,129,H1
"Washburn County, WI",2010-2011,15934,15787,-147,-0.923,-55,-92,55,129,H1
"Washburn County, WI",2011-2012,15787,15835,48,0.304,-65,113,55,129,H1
"Washburn County, WI",2012-2013,15835,15673,-162,-1.023,-48,-114,55,129,H1
"Washburn County, WI",2013-2014,15673,15694,21,0.134,-48,69,55,129,H1
"Washburn County, WI",2014-2015,15678,15552,-126,-0.804,-41,-85,55,129,H1
"Washburn County, WI",2015-2016,15552,15610,58,0.373,-70,128,55,129,H1
"Washburn County, WI",2016-2017,15610,15758,148,0.948,-65,213,55,129,H1
"Washington County, WI",2000-2001,117967,119387,1420,1.204,680,740,55,131,H1
"Washington County, WI",2001-2002,119387,120741,1354,1.134,690,664,55,131,H1
"Washington County, WI",2002-2003,120741,122143,1402,1.161,624,778,55,131,H1
"Washington County, WI",2003-2004,122143,124076,1933,1.583,582,1351,55,131,H1
"Washington County, WI",2004-2005,124076,125788,1712,1.38,590,1122,55,131,H1
"Washington County, WI",2005-2006,125788,127483,1695,1.348,576,1119,55,131,H1
"Washington County, WI",2006-2007,127483,129203,1720,1.349,650,1070,55,131,H1
"Washington County, WI",2007-2008,129203,130795,1592,1.232,638,954,55,131,H1
"Washington County, WI",2008-2009,130795,131579,784,0.599,639,145,55,131,H1
"Washington County, WI",2009-2010,131579,131897,318,0.242,407,-89,55,131,H1
"Washington County, WI",2010-2011,131897,132157,260,0.197,330,-70,55,131,H1
"Washington County, WI",2011-2012,132157,132581,424,0.321,286,138,55,131,H1
"Washington County, WI",2012-2013,132581,132746,165,0.124,316,-151,55,131,H1
"Washington County, WI",2013-2014,132746,133251,505,0.38,255,250,55,131,H1
"Washington County, WI",2014-2015,133301,133674,373,0.28,270,103,55,131,H1
"Washington County, WI",2015-2016,133674,134372,698,0.522,288,410,55,131,H1
"Washington County, WI",2016-2017,134372,135101,729,0.543,244,485,55,131,H1
"Waukesha County, WI",2000-2001,362169,365564,3395,0.937,1654,1741,55,133,H1
"Waukesha County, WI",2001-2002,365564,370051,4487,1.227,1522,2965,55,133,H1
"Waukesha County, WI",2002-2003,370051,373787,3736,1.01,1585,2151,55,133,H1
"Waukesha County, WI",2003-2004,373787,376243,2456,0.657,1505,951,55,133,H1
"Waukesha County, WI",2004-2005,376243,378885,2642,0.702,1404,1238,55,133,H1
"Waukesha County, WI",2005-2006,378885,380799,1914,0.505,1146,768,55,133,H1
"Waukesha County, WI",2006-2007,380799,384239,3440,0.903,1308,2132,55,133,H1
"Waukesha County, WI",2007-2008,384239,386691,2452,0.638,1126,1326,55,133,H1
"Waukesha County, WI",2008-2009,386691,388957,2266,0.586,1189,1077,55,133,H1
"Waukesha County, WI",2009-2010,388957,390079,1122,0.288,770,352,55,133,H1
"Waukesha County, WI",2010-2011,390079,390796,717,0.184,747,-30,55,133,H1
"Waukesha County, WI",2011-2012,390796,392623,1827,0.468,705,1122,55,133,H1
"Waukesha County, WI",2012-2013,392623,393940,1317,0.335,601,716,55,133,H1
"Waukesha County, WI",2013-2014,393940,395118,1178,0.299,617,561,55,133,H1
"Waukesha County, WI",2014-2015,395335,396488,1153,0.292,538,615,55,133,H1
"Waukesha County, WI",2015-2016,396488,398225,1737,0.438,556,1181,55,133,H1
"Waukesha County, WI",2016-2017,398225,400621,2396,0.602,455,1941,55,133,H1
"Waupaca County, WI",2000-2001,51976,52092,116,0.223,-71,187,55,135,H1
"Waupaca County, WI",2001-2002,52092,52380,288,0.553,-74,362,55,135,H1
"Waupaca County, WI",2002-2003,52380,52579,199,0.38,-54,253,55,135,H1
"Waupaca County, WI",2003-2004,52579,52605,26,0.049,-131,157,55,135,H1
"Waupaca County, WI",2004-2005,52605,52508,-97,-0.184,-124,27,55,135,H1
"Waupaca County, WI",2005-2006,52508,52634,126,0.24,-211,337,55,135,H1
"Waupaca County, WI",2006-2007,52634,52677,43,0.082,-74,117,55,135,H1
"Waupaca County, WI",2007-2008,52677,52593,-84,-0.159,-122,38,55,135,H1
"Waupaca County, WI",2008-2009,52593,52392,-201,-0.382,-96,-105,55,135,H1
"Waupaca County, WI",2009-2010,52392,52417,25,0.048,-157,182,55,135,H1
"Waupaca County, WI",2010-2011,52417,52337,-80,-0.153,-268,188,55,135,H1
"Waupaca County, WI",2011-2012,52337,52028,-309,-0.59,-194,-115,55,135,H1
"Waupaca County, WI",2012-2013,52028,52212,184,0.354,-143,327,55,135,H1
"Waupaca County, WI",2013-2014,52212,52066,-146,-0.28,-171,25,55,135,H1
"Waupaca County, WI",2014-2015,52088,51945,-143,-0.275,-167,24,55,135,H1
"Waupaca County, WI",2015-2016,51945,51354,-591,-1.138,-230,-361,55,135,H1
"Waupaca County, WI",2016-2017,51354,51225,-129,-0.251,-189,60,55,135,H1
"Waushara County, WI",2000-2001,23074,23343,269,1.166,-8,277,55,137,H1
"Waushara County, WI",2001-2002,23343,24257,914,3.916,-57,971,55,137,H1
"Waushara County, WI",2002-2003,24257,24464,207,0.853,-27,234,55,137,H1
"Waushara County, WI",2003-2004,24464,24534,70,0.286,-17,87,55,137,H1
"Waushara County, WI",2004-2005,24534,24564,30,0.122,-19,49,55,137,H1
"Waushara County, WI",2005-2006,24564,24690,126,0.513,2,124,55,137,H1
"Waushara County, WI",2006-2007,24690,24686,-4,-0.016,-40,36,55,137,H1
"Waushara County, WI",2007-2008,24686,24760,74,0.3,3,71,55,137,H1
"Waushara County, WI",2008-2009,24760,24554,-206,-0.832,-1,-205,55,137,H1
"Waushara County, WI",2009-2010,24554,24492,-62,-0.253,-34,-28,55,137,H1
"Waushara County, WI",2010-2011,24492,24570,78,0.318,-49,127,55,137,H1
"Waushara County, WI",2011-2012,24570,24477,-93,-0.379,-44,-49,55,137,H1
"Waushara County, WI",2012-2013,24477,24330,-147,-0.601,-22,-125,55,137,H1
"Waushara County, WI",2013-2014,24330,24178,-152,-0.625,-10,-142,55,137,H1
"Waushara County, WI",2014-2015,24173,24033,-140,-0.579,-11,-129,55,137,H1
"Waushara County, WI",2015-2016,24033,24132,99,0.412,-61,160,55,137,H1
"Waushara County, WI",2016-2017,24132,24369,237,0.982,-19,256,55,137,H1
"Winnebago County, WI",2000-2001,157103,158163,1060,0.675,709,351,55,139,H1
"Winnebago County, WI",2001-2002,158163,159134,971,0.614,569,402,55,139,H1
"Winnebago County, WI",2002-2003,159134,159440,306,0.192,502,-196,55,139,H1
"Winnebago County, WI",2003-2004,159440,160130,690,0.433,460,230,55,139,H1
"Winnebago County, WI",2004-2005,160130,161451,1321,0.825,556,765,55,139,H1
"Winnebago County, WI",2005-2006,161451,162727,1276,0.79,598,678,55,139,H1
"Winnebago County, WI",2006-2007,162727,164037,1310,0.805,598,712,55,139,H1
"Winnebago County, WI",2007-2008,164037,164910,873,0.532,632,241,55,139,H1
"Winnebago County, WI",2008-2009,164910,166429,1519,0.921,632,887,55,139,H1
"Winnebago County, WI",2009-2010,166429,167004,575,0.345,512,63,55,139,H1
"Winnebago County, WI",2010-2011,167004,167558,554,0.332,432,122,55,139,H1
"Winnebago County, WI",2011-2012,167558,168634,1076,0.642,500,576,55,139,H1
"Winnebago County, WI",2012-2013,168634,169360,726,0.431,489,237,55,139,H1
"Winnebago County, WI",2013-2014,169360,169511,151,0.089,477,-326,55,139,H1
"Winnebago County, WI",2014-2015,169639,169546,-93,-0.055,437,-530,55,139,H1
"Winnebago County, WI",2015-2016,169546,169555,9,0.005,488,-479,55,139,H1
"Winnebago County, WI",2016-2017,169555,170414,859,0.507,432,427,55,139,H1
"Wood County, WI",2000-2001,75486,75376,-110,-0.146,162,-272,55,141,H1
"Wood County, WI",2001-2002,75376,75223,-153,-0.203,207,-360,55,141,H1
"Wood County, WI",2002-2003,75223,75179,-44,-0.058,120,-164,55,141,H1
"Wood County, WI",2003-2004,75179,75164,-15,-0.02,215,-230,55,141,H1
"Wood County, WI",2004-2005,75164,74981,-183,-0.243,108,-291,55,141,H1
"Wood County, WI",2005-2006,74981,74603,-378,-0.504,143,-521,55,141,H1
"Wood County, WI",2006-2007,74603,74465,-138,-0.185,135,-273,55,141,H1
"Wood County, WI",2007-2008,74465,74519,54,0.073,210,-156,55,141,H1
"Wood County, WI",2008-2009,74519,74627,108,0.145,196,-88,55,141,H1
"Wood County, WI",2009-2010,74627,74780,153,0.205,76,77,55,141,H1
"Wood County, WI",2010-2011,74780,74619,-161,-0.215,156,-317,55,141,H1
"Wood County, WI",2011-2012,74619,74354,-265,-0.355,73,-338,55,141,H1
"Wood County, WI",2012-2013,74354,73944,-410,-0.551,110,-520,55,141,H1
"Wood County, WI",2013-2014,73944,73608,-336,-0.454,106,-442,55,141,H1
"Wood County, WI",2014-2015,73597,73435,-162,-0.22,57,-219,55,141,H1
"Wood County, WI",2015-2016,73435,73196,-239,-0.325,41,-280,55,141,H1
"Wood County, WI",2016-2017,73196,73126,-70,-0.096,65,-135,55,141,H1
Wyoming,2000-2001,494300,494657,357,0.072,2195,-1838,56,0,STATE
Wyoming,2001-2002,494657,500017,5360,1.084,2129,3231,56,0,STATE
Wyoming,2002-2003,500017,503453,3436,0.687,2621,815,56,0,STATE
Wyoming,2003-2004,503453,509106,5653,1.123,2597,3056,56,0,STATE
Wyoming,2004-2005,509106,514157,5051,0.992,3033,2018,56,0,STATE
Wyoming,2005-2006,514157,522667,8510,1.655,3172,5338,56,0,STATE
Wyoming,2006-2007,522667,534876,12209,2.336,3506,8703,56,0,STATE
Wyoming,2007-2008,534876,546043,11167,2.088,3836,7331,56,0,STATE
Wyoming,2008-2009,546043,559851,13808,2.529,3715,10093,56,0,STATE
Wyoming,2009-2010,559851,564516,4665,0.833,3616,1049,56,0,STATE
Wyoming,2010-2011,564516,567768,3252,0.576,3024,228,56,0,STATE
Wyoming,2011-2012,567768,577080,9312,1.64,3051,6261,56,0,STATE
Wyoming,2012-2013,577080,583131,6051,1.049,2894,3157,56,0,STATE
Wyoming,2013-2014,583131,584304,1173,0.201,3350,-2177,56,0,STATE
Wyoming,2014-2015,584304,586107,1803,0.309,3089,-1286,56,0,STATE
Wyoming,2015-2016,586107,584910,-1197,-0.204,2980,-4177,56,0,STATE
Wyoming,2016-2017,584910,579315,-5595,-0.957,2666,-8261,56,0,STATE
"Albany County, WY",2000-2001,31966,32419,453,1.417,207,246,56,1,H1
"Albany County, WY",2001-2002,32419,32675,256,0.79,168,88,56,1,H1
"Albany County, WY",2002-2003,32675,33098,423,1.295,199,224,56,1,H1
"Albany County, WY",2003-2004,33098,33580,482,1.456,221,261,56,1,H1
"Albany County, WY",2004-2005,33580,33631,51,0.152,225,-174,56,1,H1
"Albany County, WY",2005-2006,33631,33950,319,0.949,233,86,56,1,H1
"Albany County, WY",2006-2007,33950,33858,-92,-0.271,208,-300,56,1,H1
"Albany County, WY",2007-2008,33858,34643,785,2.319,278,507,56,1,H1
"Albany County, WY",2008-2009,34643,35743,1100,3.175,266,834,56,1,H1
"Albany County, WY",2009-2010,35743,36440,697,1.95,268,429,56,1,H1
"Albany County, WY",2010-2011,36440,36913,473,1.298,223,250,56,1,H1
"Albany County, WY",2011-2012,36913,37363,450,1.219,251,199,56,1,H1
"Albany County, WY",2012-2013,37363,37574,211,0.565,206,5,56,1,H1
"Albany County, WY",2013-2014,37574,37811,237,0.631,233,4,56,1,H1
"Albany County, WY",2014-2015,37918,37956,38,0.1,254,-216,56,1,H1
"Albany County, WY",2015-2016,37956,37987,31,0.082,212,-181,56,1,H1
"Albany County, WY",2016-2017,37987,38332,345,0.908,195,150,56,1,H1
"Big Horn County, WY",2000-2001,11398,11209,-189,-1.658,-1,-188,56,3,H1
"Big Horn County, WY",2001-2002,11209,11157,-52,-0.464,-13,-39,56,3,H1
"Big Horn County, WY",2002-2003,11157,11073,-84,-0.753,15,-99,56,3,H1
"Big Horn County, WY",2003-2004,11073,11231,158,1.427,21,137,56,3,H1
"Big Horn County, WY",2004-2005,11231,11193,-38,-0.338,30,-68,56,3,H1
"Big Horn County, WY",2005-2006,11193,11222,29,0.259,10,19,56,3,H1
"Big Horn County, WY",2006-2007,11222,11350,128,1.141,5,123,56,3,H1
"Big Horn County, WY",2007-2008,11350,11419,69,0.608,-25,94,56,3,H1
"Big Horn County, WY",2008-2009,11419,11541,122,1.068,24,98,56,3,H1
"Big Horn County, WY",2009-2010,11541,11674,133,1.152,37,96,56,3,H1
"Big Horn County, WY",2010-2011,11674,11745,71,0.608,19,52,56,3,H1
"Big Horn County, WY",2011-2012,11745,11778,33,0.281,5,28,56,3,H1
"Big Horn County, WY",2012-2013,11778,12006,228,1.936,6,222,56,3,H1
"Big Horn County, WY",2013-2014,12006,11930,-76,-0.633,34,-110,56,3,H1
"Big Horn County, WY",2014-2015,11919,12022,103,0.864,22,81,56,3,H1
"Big Horn County, WY",2015-2016,12022,11941,-81,-0.674,0,-81,56,3,H1
"Big Horn County, WY",2016-2017,11941,11906,-35,-0.293,24,-59,56,3,H1
"Campbell County, WY",2000-2001,33979,34699,720,2.119,371,349,56,5,H1
"Campbell County, WY",2001-2002,34699,36193,1494,4.306,313,1181,56,5,H1
"Campbell County, WY",2002-2003,36193,36586,393,1.086,376,17,56,5,H1
"Campbell County, WY",2003-2004,36586,36907,321,0.877,391,-70,56,5,H1
"Campbell County, WY",2004-2005,36907,37888,981,2.658,466,515,56,5,H1
"Campbell County, WY",2005-2006,37888,39497,1609,4.247,458,1151,56,5,H1
"Campbell County, WY",2006-2007,39497,41651,2154,5.454,535,1619,56,5,H1
"Campbell County, WY",2007-2008,41651,42846,1195,2.869,502,693,56,5,H1
"Campbell County, WY",2008-2009,42846,45650,2804,6.544,516,2288,56,5,H1
"Campbell County, WY",2009-2010,45650,46223,573,1.255,576,-3,56,5,H1
"Campbell County, WY",2010-2011,46223,46590,367,0.794,482,-115,56,5,H1
"Campbell County, WY",2011-2012,46590,47897,1307,2.805,528,779,56,5,H1
"Campbell County, WY",2012-2013,47897,48210,313,0.653,541,-228,56,5,H1
"Campbell County, WY",2013-2014,48210,48320,110,0.228,466,-356,56,5,H1
"Campbell County, WY",2014-2015,48243,49220,977,2.025,451,526,56,5,H1
"Campbell County, WY",2015-2016,49220,48800,-420,-0.853,592,-1012,56,5,H1
"Campbell County, WY",2016-2017,48800,46242,-2558,-5.242,455,-3013,56,5,H1
"Carbon County, WY",2000-2001,15582,15217,-365,-2.342,32,-397,56,7,H1
"Carbon County, WY",2001-2002,15217,15256,39,0.256,30,9,56,7,H1
"Carbon County, WY",2002-2003,15256,15240,-16,-0.105,39,-55,56,7,H1
"Carbon County, WY",2003-2004,15240,15236,-4,-0.026,73,-77,56,7,H1
"Carbon County, WY",2004-2005,15236,15077,-159,-1.044,47,-206,56,7,H1
"Carbon County, WY",2005-2006,15077,15136,59,0.391,65,-6,56,7,H1
"Carbon County, WY",2006-2007,15136,15494,358,2.365,75,283,56,7,H1
"Carbon County, WY",2007-2008,15494,15658,164,1.058,82,82,56,7,H1
"Carbon County, WY",2008-2009,15658,15977,319,2.037,106,213,56,7,H1
"Carbon County, WY",2009-2010,15977,15835,-142,-0.889,119,-261,56,7,H1
"Carbon County, WY",2010-2011,15835,15818,-17,-0.107,86,-103,56,7,H1
"Carbon County, WY",2011-2012,15818,15679,-139,-0.879,64,-203,56,7,H1
"Carbon County, WY",2012-2013,15679,15791,112,0.714,83,29,56,7,H1
"Carbon County, WY",2013-2014,15791,15854,63,0.399,70,-7,56,7,H1
"Carbon County, WY",2014-2015,15856,15559,-297,-1.873,91,-388,56,7,H1
"Carbon County, WY",2015-2016,15559,15727,168,1.08,103,65,56,7,H1
"Carbon County, WY",2016-2017,15727,15303,-424,-2.696,79,-503,56,7,H1
"Converse County, WY",2000-2001,12083,11996,-87,-0.72,52,-139,56,9,H1
"Converse County, WY",2001-2002,11996,12196,200,1.667,32,168,56,9,H1
"Converse County, WY",2002-2003,12196,12232,36,0.295,73,-37,56,9,H1
"Converse County, WY",2003-2004,12232,12350,118,0.965,36,82,56,9,H1
"Converse County, WY",2004-2005,12350,12595,245,1.984,83,162,56,9,H1
"Converse County, WY",2005-2006,12595,12801,206,1.636,83,123,56,9,H1
"Converse County, WY",2006-2007,12801,13071,270,2.109,69,201,56,9,H1
"Converse County, WY",2007-2008,13071,13486,415,3.175,86,329,56,9,H1
"Converse County, WY",2008-2009,13486,13839,353,2.618,87,266,56,9,H1
"Converse County, WY",2009-2010,13839,13817,-22,-0.159,87,-109,56,9,H1
"Converse County, WY",2010-2011,13817,13720,-97,-0.702,66,-163,56,9,H1
"Converse County, WY",2011-2012,13720,14005,285,2.077,62,223,56,9,H1
"Converse County, WY",2012-2013,14005,14316,311,2.221,57,254,56,9,H1
"Converse County, WY",2013-2014,14316,14097,-219,-1.53,61,-280,56,9,H1
"Converse County, WY",2014-2015,14172,14236,64,0.452,89,-25,56,9,H1
"Converse County, WY",2015-2016,14236,14127,-109,-0.766,63,-172,56,9,H1
"Converse County, WY",2016-2017,14127,13809,-318,-2.251,72,-390,56,9,H1
"Crook County, WY",2000-2001,5902,5778,-124,-2.101,-11,-113,56,11,H1
"Crook County, WY",2001-2002,5778,5926,148,2.561,13,135,56,11,H1
"Crook County, WY",2002-2003,5926,5981,55,0.928,12,43,56,11,H1
"Crook County, WY",2003-2004,5981,6052,71,1.187,13,58,56,11,H1
"Crook County, WY",2004-2005,6052,6176,124,2.049,22,102,56,11,H1
"Crook County, WY",2005-2006,6176,6286,110,1.781,31,79,56,11,H1
"Crook County, WY",2006-2007,6286,6617,331,5.266,47,284,56,11,H1
"Crook County, WY",2007-2008,6617,6823,206,3.113,67,139,56,11,H1
"Crook County, WY",2008-2009,6823,6965,142,2.081,31,111,56,11,H1
"Crook County, WY",2009-2010,6965,7108,143,2.053,20,123,56,11,H1
"Crook County, WY",2010-2011,7108,7121,13,0.183,17,-4,56,11,H1
"Crook County, WY",2011-2012,7121,7139,18,0.253,47,-29,56,11,H1
"Crook County, WY",2012-2013,7139,7158,19,0.266,29,-10,56,11,H1
"Crook County, WY",2013-2014,7158,7248,90,1.257,33,57,56,11,H1
"Crook County, WY",2014-2015,7264,7444,180,2.478,49,131,56,11,H1
"Crook County, WY",2015-2016,7444,7497,53,0.712,60,-7,56,11,H1
"Crook County, WY",2016-2017,7497,7410,-87,-1.16,54,-141,56,11,H1
"Fremont County, WY",2000-2001,35840,35718,-122,-0.34,102,-224,56,13,H1
"Fremont County, WY",2001-2002,35718,36015,297,0.832,91,206,56,13,H1
"Fremont County, WY",2002-2003,36015,36130,115,0.319,141,-26,56,13,H1
"Fremont County, WY",2003-2004,36130,36383,253,0.7,146,107,56,13,H1
"Fremont County, WY",2004-2005,36383,36838,455,1.251,245,210,56,13,H1
"Fremont County, WY",2005-2006,36838,37408,570,1.547,233,337,56,13,H1
"Fremont County, WY",2006-2007,37408,38132,724,1.935,200,524,56,13,H1
"Fremont County, WY",2007-2008,38132,38907,775,2.032,292,483,56,13,H1
"Fremont County, WY",2008-2009,38907,39685,778,2,266,512,56,13,H1
"Fremont County, WY",2009-2010,39685,40224,539,1.358,249,290,56,13,H1
"Fremont County, WY",2010-2011,40224,40589,365,0.907,235,130,56,13,H1
"Fremont County, WY",2011-2012,40589,41125,536,1.321,201,335,56,13,H1
"Fremont County, WY",2012-2013,41125,41052,-73,-0.178,109,-182,56,13,H1
"Fremont County, WY",2013-2014,41052,40703,-349,-0.85,129,-478,56,13,H1
"Fremont County, WY",2014-2015,40717,40315,-402,-0.987,117,-519,56,13,H1
"Fremont County, WY",2015-2016,40315,40245,-70,-0.174,126,-196,56,13,H1
"Fremont County, WY",2016-2017,40245,39803,-442,-1.098,70,-512,56,13,H1
"Goshen County, WY",2000-2001,12561,12475,-86,-0.685,15,-101,56,15,H1
"Goshen County, WY",2001-2002,12475,12381,-94,-0.754,-16,-78,56,15,H1
"Goshen County, WY",2002-2003,12381,12374,-7,-0.057,23,-30,56,15,H1
"Goshen County, WY",2003-2004,12374,12473,99,0.8,-13,112,56,15,H1
"Goshen County, WY",2004-2005,12473,12460,-13,-0.104,-8,-5,56,15,H1
"Goshen County, WY",2005-2006,12460,12538,78,0.626,-12,90,56,15,H1
"Goshen County, WY",2006-2007,12538,12620,82,0.654,20,62,56,15,H1
"Goshen County, WY",2007-2008,12620,12772,152,1.204,10,142,56,15,H1
"Goshen County, WY",2008-2009,12772,12967,195,1.527,23,172,56,15,H1
"Goshen County, WY",2009-2010,12967,13411,444,3.424,26,418,56,15,H1
"Goshen County, WY",2010-2011,13411,13604,193,1.439,-25,218,56,15,H1
"Goshen County, WY",2011-2012,13604,13670,66,0.485,3,63,56,15,H1
"Goshen County, WY",2012-2013,13670,13578,-92,-0.673,21,-113,56,15,H1
"Goshen County, WY",2013-2014,13578,13514,-64,-0.471,15,-79,56,15,H1
"Goshen County, WY",2014-2015,13509,13383,-126,-0.933,12,-138,56,15,H1
"Goshen County, WY",2015-2016,13383,13355,-28,-0.209,-3,-25,56,15,H1
"Goshen County, WY",2016-2017,13355,13378,23,0.172,-7,30,56,15,H1
"Hot Springs County, WY",2000-2001,4851,4763,-88,-1.814,-32,-56,56,17,H1
"Hot Springs County, WY",2001-2002,4763,4743,-20,-0.42,-2,-18,56,17,H1
"Hot Springs County, WY",2002-2003,4743,4632,-111,-2.34,-37,-74,56,17,H1
"Hot Springs County, WY",2003-2004,4632,4629,-3,-0.065,-33,30,56,17,H1
"Hot Springs County, WY",2004-2005,4629,4604,-25,-0.54,-18,-7,56,17,H1
"Hot Springs County, WY",2005-2006,4604,4632,28,0.608,-10,38,56,17,H1
"Hot Springs County, WY",2006-2007,4632,4647,15,0.324,-4,19,56,17,H1
"Hot Springs County, WY",2007-2008,4647,4698,51,1.097,-21,72,56,17,H1
"Hot Springs County, WY",2008-2009,4698,4819,121,2.576,-23,144,56,17,H1
"Hot Springs County, WY",2009-2010,4819,4804,-15,-0.311,-21,6,56,17,H1
"Hot Springs County, WY",2010-2011,4804,4809,5,0.104,-17,22,56,17,H1
"Hot Springs County, WY",2011-2012,4809,4845,36,0.749,-2,38,56,17,H1
"Hot Springs County, WY",2012-2013,4845,4856,11,0.227,-8,19,56,17,H1
"Hot Springs County, WY",2013-2014,4856,4816,-40,-0.824,-21,-19,56,17,H1
"Hot Springs County, WY",2014-2015,4793,4741,-52,-1.085,-24,-28,56,17,H1
"Hot Springs County, WY",2015-2016,4741,4669,-72,-1.519,-11,-61,56,17,H1
"Hot Springs County, WY",2016-2017,4669,4696,27,0.578,-24,51,56,17,H1
"Johnson County, WY",2000-2001,7108,7167,59,0.83,-14,73,56,19,H1
"Johnson County, WY",2001-2002,7167,7371,204,2.846,1,203,56,19,H1
"Johnson County, WY",2002-2003,7371,7496,125,1.696,-12,137,56,19,H1
"Johnson County, WY",2003-2004,7496,7554,58,0.774,-13,71,56,19,H1
"Johnson County, WY",2004-2005,7554,7685,131,1.734,10,121,56,19,H1
"Johnson County, WY",2005-2006,7685,7796,111,1.444,0,111,56,19,H1
"Johnson County, WY",2006-2007,7796,8146,350,4.489,31,319,56,19,H1
"Johnson County, WY",2007-2008,8146,8460,314,3.855,18,296,56,19,H1
"Johnson County, WY",2008-2009,8460,8565,105,1.241,26,79,56,19,H1
"Johnson County, WY",2009-2010,8565,8568,3,0.035,12,-9,56,19,H1
"Johnson County, WY",2010-2011,8568,8627,59,0.689,16,43,56,19,H1
"Johnson County, WY",2011-2012,8627,8606,-21,-0.243,11,-32,56,19,H1
"Johnson County, WY",2012-2013,8606,8622,16,0.186,14,2,56,19,H1
"Johnson County, WY",2013-2014,8622,8573,-49,-0.568,14,-63,56,19,H1
"Johnson County, WY",2014-2015,8552,8585,33,0.386,15,18,56,19,H1
"Johnson County, WY",2015-2016,8585,8496,-89,-1.037,-9,-80,56,19,H1
"Johnson County, WY",2016-2017,8496,8476,-20,-0.235,-6,-14,56,19,H1
"Laramie County, WY",2000-2001,81825,82554,729,0.891,487,242,56,21,H1
"Laramie County, WY",2001-2002,82554,83226,672,0.814,469,203,56,21,H1
"Laramie County, WY",2002-2003,83226,84084,858,1.031,554,304,56,21,H1
"Laramie County, WY",2003-2004,84084,85427,1343,1.597,558,785,56,21,H1
"Laramie County, WY",2004-2005,85427,85732,305,0.357,564,-259,56,21,H1
"Laramie County, WY",2005-2006,85732,86819,1087,1.268,648,439,56,21,H1
"Laramie County, WY",2006-2007,86819,87654,835,0.962,569,266,56,21,H1
"Laramie County, WY",2007-2008,87654,89077,1423,1.623,674,749,56,21,H1
"Laramie County, WY",2008-2009,89077,90430,1353,1.519,626,727,56,21,H1
"Laramie County, WY",2009-2010,90430,92199,1769,1.956,621,1148,56,21,H1
"Laramie County, WY",2010-2011,92199,92607,408,0.443,520,-112,56,21,H1
"Laramie County, WY",2011-2012,92607,94849,2242,2.421,502,1740,56,21,H1
"Laramie County, WY",2012-2013,94849,96015,1166,1.229,539,627,56,21,H1
"Laramie County, WY",2013-2014,96015,96389,374,0.39,504,-130,56,21,H1
"Laramie County, WY",2014-2015,96469,97121,652,0.676,487,165,56,21,H1
"Laramie County, WY",2015-2016,97121,97968,847,0.872,525,322,56,21,H1
"Laramie County, WY",2016-2017,97968,98327,359,0.366,472,-113,56,21,H1
"Lincoln County, WY",2000-2001,14621,14697,76,0.52,69,7,56,23,H1
"Lincoln County, WY",2001-2002,14697,14858,161,1.095,84,77,56,23,H1
"Lincoln County, WY",2002-2003,14858,15117,259,1.743,100,159,56,23,H1
"Lincoln County, WY",2003-2004,15117,15539,422,2.792,99,323,56,23,H1
"Lincoln County, WY",2004-2005,15539,15917,378,2.433,113,265,56,23,H1
"Lincoln County, WY",2005-2006,15917,16429,512,3.217,165,347,56,23,H1
"Lincoln County, WY",2006-2007,16429,17013,584,3.555,170,414,56,23,H1
"Lincoln County, WY",2007-2008,17013,17629,616,3.621,184,432,56,23,H1
"Lincoln County, WY",2008-2009,17629,18082,453,2.57,181,272,56,23,H1
"Lincoln County, WY",2009-2010,18082,18075,-7,-0.039,121,-128,56,23,H1
"Lincoln County, WY",2010-2011,18075,18004,-71,-0.393,111,-182,56,23,H1
"Lincoln County, WY",2011-2012,18004,17926,-78,-0.433,130,-208,56,23,H1
"Lincoln County, WY",2012-2013,17926,18326,400,2.231,138,262,56,23,H1
"Lincoln County, WY",2013-2014,18326,18567,241,1.315,134,107,56,23,H1
"Lincoln County, WY",2014-2015,18564,18722,158,0.851,132,26,56,23,H1
"Lincoln County, WY",2015-2016,18722,19076,354,1.891,130,224,56,23,H1
"Lincoln County, WY",2016-2017,19076,19265,189,0.991,126,63,56,23,H1
"Natrona County, WY",2000-2001,66603,66978,375,0.563,301,74,56,25,H1
"Natrona County, WY",2001-2002,66978,67554,576,0.86,327,249,56,25,H1
"Natrona County, WY",2002-2003,67554,68246,692,1.024,317,375,56,25,H1
"Natrona County, WY",2003-2004,68246,69035,789,1.156,451,338,56,25,H1
"Natrona County, WY",2004-2005,69035,69922,887,1.285,409,478,56,25,H1
"Natrona County, WY",2005-2006,69922,70806,884,1.264,352,532,56,25,H1
"Natrona County, WY",2006-2007,70806,72365,1559,2.202,492,1067,56,25,H1
"Natrona County, WY",2007-2008,72365,73682,1317,1.82,467,850,56,25,H1
"Natrona County, WY",2008-2009,73682,75238,1556,2.112,461,1095,56,25,H1
"Natrona County, WY",2009-2010,75238,75466,228,0.303,431,-203,56,25,H1
"Natrona County, WY",2010-2011,75466,76416,950,1.259,365,585,56,25,H1
"Natrona County, WY",2011-2012,76416,78686,2270,2.971,387,1883,56,25,H1
"Natrona County, WY",2012-2013,78686,81143,2457,3.123,450,2007,56,25,H1
"Natrona County, WY",2013-2014,81143,81624,481,0.593,470,11,56,25,H1
"Natrona County, WY",2014-2015,81603,82178,575,0.705,488,87,56,25,H1
"Natrona County, WY",2015-2016,82178,80892,-1286,-1.565,414,-1700,56,25,H1
"Natrona County, WY",2016-2017,80892,79547,-1345,-1.663,373,-1718,56,25,H1
"Niobrara County, WY",2000-2001,2396,2357,-39,-1.628,-3,-36,56,27,H1
"Niobrara County, WY",2001-2002,2357,2293,-64,-2.715,-7,-57,56,27,H1
"Niobrara County, WY",2002-2003,2293,2280,-13,-0.567,-16,3,56,27,H1
"Niobrara County, WY",2003-2004,2280,2319,39,1.711,-10,49,56,27,H1
"Niobrara County, WY",2004-2005,2319,2315,-4,-0.172,-10,6,56,27,H1
"Niobrara County, WY",2005-2006,2315,2321,6,0.259,-8,14,56,27,H1
"Niobrara County, WY",2006-2007,2321,2407,86,3.705,-11,97,56,27,H1
"Niobrara County, WY",2007-2008,2407,2467,60,2.493,-4,64,56,27,H1
"Niobrara County, WY",2008-2009,2467,2475,8,0.324,9,-1,56,27,H1
"Niobrara County, WY",2009-2010,2475,2491,16,0.646,-5,21,56,27,H1
"Niobrara County, WY",2010-2011,2491,2484,-7,-0.281,-3,-4,56,27,H1
"Niobrara County, WY",2011-2012,2484,2475,-9,-0.362,-11,2,56,27,H1
"Niobrara County, WY",2012-2013,2475,2549,74,2.99,7,67,56,27,H1
"Niobrara County, WY",2013-2014,2549,2463,-86,-3.374,9,-95,56,27,H1
"Niobrara County, WY",2014-2015,2530,2542,12,0.474,7,5,56,27,H1
"Niobrara County, WY",2015-2016,2542,2470,-72,-2.832,5,-77,56,27,H1
"Niobrara County, WY",2016-2017,2470,2397,-73,-2.955,15,-88,56,27,H1
"Park County, WY",2000-2001,25821,25696,-125,-0.484,31,-156,56,29,H1
"Park County, WY",2001-2002,25696,25761,65,0.253,35,30,56,29,H1
"Park County, WY",2002-2003,25761,25988,227,0.881,24,203,56,29,H1
"Park County, WY",2003-2004,25988,26078,90,0.346,-1,91,56,29,H1
"Park County, WY",2004-2005,26078,26372,294,1.127,61,233,56,29,H1
"Park County, WY",2005-2006,26372,26789,417,1.581,94,323,56,29,H1
"Park County, WY",2006-2007,26789,27209,420,1.568,53,367,56,29,H1
"Park County, WY",2007-2008,27209,27594,385,1.415,88,297,56,29,H1
"Park County, WY",2008-2009,27594,28008,414,1.5,71,343,56,29,H1
"Park County, WY",2009-2010,28008,28262,254,0.907,43,211,56,29,H1
"Park County, WY",2010-2011,28262,28467,205,0.725,37,168,56,29,H1
"Park County, WY",2011-2012,28467,28805,338,1.187,65,273,56,29,H1
"Park County, WY",2012-2013,28805,29154,349,1.212,61,288,56,29,H1
"Park County, WY",2013-2014,29154,28989,-165,-0.566,85,-250,56,29,H1
"Park County, WY",2014-2015,29126,29228,102,0.35,60,42,56,29,H1
"Park County, WY",2015-2016,29228,29412,184,0.63,34,150,56,29,H1
"Park County, WY",2016-2017,29412,29568,156,0.53,63,93,56,29,H1
"Platte County, WY",2000-2001,8739,8765,26,0.298,-7,33,56,31,H1
"Platte County, WY",2001-2002,8765,8766,1,0.011,-13,14,56,31,H1
"Platte County, WY",2002-2003,8766,8689,-77,-0.878,-4,-73,56,31,H1
"Platte County, WY",2003-2004,8689,8730,41,0.472,-15,56,56,31,H1
"Platte County, WY",2004-2005,8730,8681,-49,-0.561,2,-51,56,31,H1
"Platte County, WY",2005-2006,8681,8690,9,0.104,-27,36,56,31,H1
"Platte County, WY",2006-2007,8690,8682,-8,-0.092,6,-14,56,31,H1
"Platte County, WY",2007-2008,8682,8622,-60,-0.691,-19,-41,56,31,H1
"Platte County, WY",2008-2009,8622,8608,-14,-0.162,-17,3,56,31,H1
"Platte County, WY",2009-2010,8608,8680,72,0.836,-30,102,56,31,H1
"Platte County, WY",2010-2011,8680,8700,20,0.23,-22,42,56,31,H1
"Platte County, WY",2011-2012,8700,8735,35,0.402,-12,47,56,31,H1
"Platte County, WY",2012-2013,8735,8735,0,0,7,-7,56,31,H1
"Platte County, WY",2013-2014,8735,8799,64,0.733,8,56,56,31,H1
"Platte County, WY",2014-2015,8776,8812,36,0.41,-1,37,56,31,H1
"Platte County, WY",2015-2016,8812,8675,-137,-1.555,-5,-132,56,31,H1
"Platte County, WY",2016-2017,8675,8562,-113,-1.303,0,-113,56,31,H1
"Sheridan County, WY",2000-2001,26584,26623,39,0.147,6,33,56,33,H1
"Sheridan County, WY",2001-2002,26623,26839,216,0.811,-36,252,56,33,H1
"Sheridan County, WY",2002-2003,26839,26938,99,0.369,54,45,56,33,H1
"Sheridan County, WY",2003-2004,26938,26942,4,0.015,31,-27,56,33,H1
"Sheridan County, WY",2004-2005,26942,27075,133,0.494,72,61,56,33,H1
"Sheridan County, WY",2005-2006,27075,27422,347,1.282,-1,348,56,33,H1
"Sheridan County, WY",2006-2007,27422,27845,423,1.543,72,351,56,33,H1
"Sheridan County, WY",2007-2008,27845,28465,620,2.227,85,535,56,33,H1
"Sheridan County, WY",2008-2009,28465,29017,552,1.939,79,473,56,33,H1
"Sheridan County, WY",2009-2010,29017,29148,131,0.451,93,38,56,33,H1
"Sheridan County, WY",2010-2011,29148,29275,127,0.436,44,83,56,33,H1
"Sheridan County, WY",2011-2012,29275,29598,323,1.103,46,277,56,33,H1
"Sheridan County, WY",2012-2013,29598,29836,238,0.804,48,190,56,33,H1
"Sheridan County, WY",2013-2014,29836,30032,196,0.657,23,173,56,33,H1
"Sheridan County, WY",2014-2015,30020,30009,-11,-0.037,20,-31,56,33,H1
"Sheridan County, WY",2015-2016,30009,30049,40,0.133,-6,46,56,33,H1
"Sheridan County, WY",2016-2017,30049,30210,161,0.536,-12,173,56,33,H1
"Sublette County, WY",2000-2001,5963,6026,63,1.057,-7,70,56,35,H1
"Sublette County, WY",2001-2002,6026,6389,363,6.024,35,328,56,35,H1
"Sublette County, WY",2002-2003,6389,6687,298,4.664,35,263,56,35,H1
"Sublette County, WY",2003-2004,6687,7072,385,5.757,25,360,56,35,H1
"Sublette County, WY",2004-2005,7072,7515,443,6.264,28,415,56,35,H1
"Sublette County, WY",2005-2006,7515,7957,442,5.882,23,419,56,35,H1
"Sublette County, WY",2006-2007,7957,8800,843,10.594,75,768,56,35,H1
"Sublette County, WY",2007-2008,8800,9474,674,7.659,92,582,56,35,H1
"Sublette County, WY",2008-2009,9474,10134,660,6.966,85,575,56,35,H1
"Sublette County, WY",2009-2010,10134,10231,97,0.957,65,32,56,35,H1
"Sublette County, WY",2010-2011,10231,10127,-104,-1.017,81,-185,56,35,H1
"Sublette County, WY",2011-2012,10127,10412,285,2.814,100,185,56,35,H1
"Sublette County, WY",2012-2013,10412,10087,-325,-3.121,82,-407,56,35,H1
"Sublette County, WY",2013-2014,10087,10057,-30,-0.297,85,-115,56,35,H1
"Sublette County, WY",2014-2015,10039,9899,-140,-1.395,77,-217,56,35,H1
"Sublette County, WY",2015-2016,9899,10002,103,1.041,60,43,56,35,H1
"Sublette County, WY",2016-2017,10002,9799,-203,-2.03,68,-271,56,35,H1
"Sweetwater County, WY",2000-2001,37552,36899,-653,-1.739,265,-918,56,37,H1
"Sweetwater County, WY",2001-2002,36899,37428,529,1.434,320,209,56,37,H1
"Sweetwater County, WY",2002-2003,37428,37450,22,0.059,352,-330,56,37,H1
"Sweetwater County, WY",2003-2004,37450,38026,576,1.538,271,305,56,37,H1
"Sweetwater County, WY",2004-2005,38026,38739,713,1.875,348,365,56,37,H1
"Sweetwater County, WY",2005-2006,38739,39749,1010,2.607,404,606,56,37,H1
"Sweetwater County, WY",2006-2007,39749,41470,1721,4.33,446,1275,56,37,H1
"Sweetwater County, WY",2007-2008,41470,42358,888,2.141,504,384,56,37,H1
"Sweetwater County, WY",2008-2009,42358,44133,1775,4.19,453,1322,56,37,H1
"Sweetwater County, WY",2009-2010,44133,43599,-534,-1.21,449,-983,56,37,H1
"Sweetwater County, WY",2010-2011,43599,44048,449,1.03,389,60,56,37,H1
"Sweetwater County, WY",2011-2012,44048,45115,1067,2.422,322,745,56,37,H1
"Sweetwater County, WY",2012-2013,45115,45205,90,0.199,393,-303,56,37,H1
"Sweetwater County, WY",2013-2014,45205,45010,-195,-0.431,364,-559,56,37,H1
"Sweetwater County, WY",2014-2015,44925,44626,-299,-0.666,358,-657,56,37,H1
"Sweetwater County, WY",2015-2016,44626,44245,-381,-0.854,324,-705,56,37,H1
"Sweetwater County, WY",2016-2017,44245,43534,-711,-1.607,308,-1019,56,37,H1
"Teton County, WY",2000-2001,18381,18653,272,1.48,112,160,56,39,H1
"Teton County, WY",2001-2002,18653,18837,184,0.986,138,46,56,39,H1
"Teton County, WY",2002-2003,18837,19066,229,1.216,145,84,56,39,H1
"Teton County, WY",2003-2004,19066,19467,401,2.103,146,255,56,39,H1
"Teton County, WY",2004-2005,19467,19632,165,0.848,196,-31,56,39,H1
"Teton County, WY",2005-2006,19632,20014,382,1.946,219,163,56,39,H1
"Teton County, WY",2006-2007,20014,20472,458,2.288,223,235,56,39,H1
"Teton County, WY",2007-2008,20472,20988,516,2.521,239,277,56,39,H1
"Teton County, WY",2008-2009,20988,21232,244,1.163,219,25,56,39,H1
"Teton County, WY",2009-2010,21232,21290,58,0.273,185,-127,56,39,H1
"Teton County, WY",2010-2011,21290,21482,192,0.902,173,19,56,39,H1
"Teton County, WY",2011-2012,21482,21704,222,1.033,170,52,56,39,H1
"Teton County, WY",2012-2013,21704,22375,671,3.092,178,493,56,39,H1
"Teton County, WY",2013-2014,22375,22930,555,2.48,183,372,56,39,H1
"Teton County, WY",2014-2015,22905,23125,220,0.96,193,27,56,39,H1
"Teton County, WY",2015-2016,23125,23180,55,0.238,173,-118,56,39,H1
"Teton County, WY",2016-2017,23180,23265,85,0.367,180,-95,56,39,H1
"Uinta County, WY",2000-2001,19666,19413,-253,-1.286,184,-437,56,41,H1
"Uinta County, WY",2001-2002,19413,19587,174,0.896,188,-14,56,41,H1
"Uinta County, WY",2002-2003,19587,19480,-107,-0.546,200,-307,56,41,H1
"Uinta County, WY",2003-2004,19480,19470,-10,-0.051,192,-202,56,41,H1
"Uinta County, WY",2004-2005,19470,19494,24,0.123,161,-137,56,41,H1
"Uinta County, WY",2005-2006,19494,19709,215,1.103,182,33,56,41,H1
"Uinta County, WY",2006-2007,19709,20171,462,2.344,194,268,56,41,H1
"Uinta County, WY",2007-2008,20171,20613,442,2.191,221,221,56,41,H1
"Uinta County, WY",2008-2009,20613,21054,441,2.139,199,242,56,41,H1
"Uinta County, WY",2009-2010,21054,21103,49,0.233,215,-166,56,41,H1
"Uinta County, WY",2010-2011,21103,20917,-186,-0.881,186,-372,56,41,H1
"Uinta County, WY",2011-2012,20917,20989,72,0.344,196,-124,56,41,H1
"Uinta County, WY",2012-2013,20989,21031,42,0.2,189,-147,56,41,H1
"Uinta County, WY",2013-2014,21031,20904,-127,-0.604,182,-309,56,41,H1
"Uinta County, WY",2014-2015,20903,20822,-81,-0.388,179,-260,56,41,H1
"Uinta County, WY",2015-2016,20822,20711,-111,-0.533,164,-275,56,41,H1
"Uinta County, WY",2016-2017,20711,20495,-216,-1.043,155,-371,56,41,H1
"Washakie County, WY",2000-2001,8252,8068,-184,-2.23,21,-205,56,43,H1
"Washakie County, WY",2001-2002,8068,7988,-80,-0.992,-8,-72,56,43,H1
"Washakie County, WY",2002-2003,7988,7976,-12,-0.15,29,-41,56,43,H1
"Washakie County, WY",2003-2004,7976,7960,-16,-0.201,-10,-6,56,43,H1
"Washakie County, WY",2004-2005,7960,8022,62,0.779,-1,63,56,43,H1
"Washakie County, WY",2005-2006,8022,7979,-43,-0.536,27,-70,56,43,H1
"Washakie County, WY",2006-2007,7979,8169,190,2.381,36,154,56,43,H1
"Washakie County, WY",2007-2008,8169,8229,60,0.734,9,51,56,43,H1
"Washakie County, WY",2008-2009,8229,8423,194,2.358,16,178,56,43,H1
"Washakie County, WY",2009-2010,8423,8541,118,1.401,38,80,56,43,H1
"Washakie County, WY",2010-2011,8541,8466,-75,-0.878,29,-104,56,43,H1
"Washakie County, WY",2011-2012,8466,8441,-25,-0.295,-15,-10,56,43,H1
"Washakie County, WY",2012-2013,8441,8450,9,0.107,19,-10,56,43,H1
"Washakie County, WY",2013-2014,8450,8322,-128,-1.515,9,-137,56,43,H1
"Washakie County, WY",2014-2015,8316,8328,12,0.144,11,1,56,43,H1
"Washakie County, WY",2015-2016,8328,8188,-140,-1.681,11,-151,56,43,H1
"Washakie County, WY",2016-2017,8188,8064,-124,-1.514,1,-125,56,43,H1
"Weston County, WY",2000-2001,6627,6487,-140,-2.113,15,-155,56,45,H1
"Weston County, WY",2001-2002,6487,6578,91,1.403,-20,111,56,45,H1
"Weston County, WY",2002-2003,6578,6610,32,0.486,2,30,56,45,H1
"Weston County, WY",2003-2004,6610,6646,36,0.545,18,18,56,45,H1
"Weston County, WY",2004-2005,6646,6594,-52,-0.782,-12,-40,56,45,H1
"Weston County, WY",2005-2006,6594,6717,123,1.865,3,120,56,45,H1
"Weston County, WY",2006-2007,6717,7033,316,4.704,-5,321,56,45,H1
"Weston County, WY",2007-2008,7033,7133,100,1.422,7,93,56,45,H1
"Weston County, WY",2008-2009,7133,7266,133,1.865,11,122,56,45,H1
"Weston County, WY",2009-2010,7266,7169,-97,-1.335,17,-114,56,45,H1
"Weston County, WY",2010-2011,7169,7102,-67,-0.935,10,-77,56,45,H1
"Weston County, WY",2011-2012,7102,7051,-51,-0.718,7,-58,56,45,H1
"Weston County, WY",2012-2013,7051,7154,103,1.461,22,81,56,45,H1
"Weston County, WY",2013-2014,7154,7201,47,0.657,25,22,56,45,H1
"Weston County, WY",2014-2015,7185,7234,49,0.682,2,47,56,45,H1
"Weston County, WY",2015-2016,7234,7198,-36,-0.498,18,-54,56,45,H1
"Weston County, WY",2016-2017,7198,6927,-271,-3.765,5,-276,56,45,H1
Alaska,2000-2001,627963,633714,5751,0.916,6987,-1236,2,0,STATE
Alaska,2001-2002,633714,642337,8623,1.361,6765,1858,2,0,STATE
Alaska,2002-2003,642337,648414,6077,0.946,6885,-808,2,0,STATE
Alaska,2003-2004,648414,659286,10872,1.677,7247,3625,2,0,STATE
Alaska,2004-2005,659286,666946,7660,1.162,7228,432,2,0,STATE
Alaska,2005-2006,666946,675302,8356,1.253,7560,796,2,0,STATE
Alaska,2006-2007,675302,680300,4998,0.74,7638,-2640,2,0,STATE
Alaska,2007-2008,680300,687455,7155,1.052,8204,-1049,2,0,STATE
Alaska,2008-2009,687455,698895,11440,1.664,8167,3273,2,0,STATE
Alaska,2009-2010,698895,714021,15126,2.164,8077,7049,2,0,STATE
Alaska,2010-2011,714021,722720,8699,1.218,7783,916,2,0,STATE
Alaska,2011-2012,722720,731228,8508,1.177,7192,1316,2,0,STATE
Alaska,2012-2013,731228,737442,6214,0.85,7308,-1094,2,0,STATE
Alaska,2013-2014,737442,737046,-396,-0.054,7290,-7686,2,0,STATE
Alaska,2014-2015,737046,738432,1386,0.188,7216,-5830,2,0,STATE
Alaska,2015-2016,738432,741522,3090,0.418,6761,-3671,2,0,STATE
Alaska,2016-2017,741522,739795,-1727,-0.233,6620,-8347,2,0,STATE
"Aleutians East Borough, AK",2000-2001,2693,2590,-103,-3.825,6,-109,2,13,H1
"Aleutians East Borough, AK",2001-2002,2590,2734,144,5.56,18,126,2,13,H1
"Aleutians East Borough, AK",2002-2003,2734,2732,-2,-0.073,12,-14,2,13,H1
"Aleutians East Borough, AK",2003-2004,2732,2727,-5,-0.183,8,-13,2,13,H1
"Aleutians East Borough, AK",2004-2005,2727,2787,60,2.2,13,47,2,13,H1
"Aleutians East Borough, AK",2005-2006,2787,2794,7,0.251,20,-13,2,13,H1
"Aleutians East Borough, AK",2006-2007,2794,3012,218,7.802,12,206,2,13,H1
"Aleutians East Borough, AK",2007-2008,3012,2991,-21,-0.697,10,-31,2,13,H1
"Aleutians East Borough, AK",2008-2009,2991,3084,93,3.109,19,74,2,13,H1
"Aleutians East Borough, AK",2009-2010,3084,3178,94,3.048,16,78,2,13,H1
"Aleutians East Borough, AK",2010-2011,3178,3267,89,2.801,16,73,2,13,H1
"Aleutians East Borough, AK",2011-2012,3267,3320,53,1.622,11,42,2,13,H1
"Aleutians East Borough, AK",2012-2013,3320,3351,31,0.934,8,23,2,13,H1
"Aleutians East Borough, AK",2013-2014,3351,3360,9,0.269,7,2,2,13,H1
"Aleutians East Borough, AK",2014-2015,3317,3341,24,0.724,7,17,2,13,H1
"Aleutians East Borough, AK",2015-2016,3341,3324,-17,-0.509,8,-25,2,13,H1
"Aleutians East Borough, AK",2016-2017,3324,3370,46,1.384,6,40,2,13,H1
"Aleutians West Census Area, AK",2000-2001,5470,5501,31,0.567,22,9,2,16,H5
"Aleutians West Census Area, AK",2001-2002,5501,5472,-29,-0.527,26,-55,2,16,H5
"Aleutians West Census Area, AK",2002-2003,5472,5709,237,4.331,12,225,2,16,H5
"Aleutians West Census Area, AK",2003-2004,5709,5798,89,1.559,17,72,2,16,H5
"Aleutians West Census Area, AK",2004-2005,5798,5913,115,1.983,39,76,2,16,H5
"Aleutians West Census Area, AK",2005-2006,5913,5658,-255,-4.313,26,-281,2,16,H5
"Aleutians West Census Area, AK",2006-2007,5658,5466,-192,-3.393,26,-218,2,16,H5
"Aleutians West Census Area, AK",2007-2008,5466,5393,-73,-1.336,24,-97,2,16,H5
"Aleutians West Census Area, AK",2008-2009,5393,5537,144,2.67,34,110,2,16,H5
"Aleutians West Census Area, AK",2009-2010,5537,5551,14,0.253,27,-13,2,16,H5
"Aleutians West Census Area, AK",2010-2011,5551,5587,36,0.649,23,13,2,16,H5
"Aleutians West Census Area, AK",2011-2012,5587,5671,84,1.503,16,68,2,16,H5
"Aleutians West Census Area, AK",2012-2013,5671,5692,21,0.37,25,-4,2,16,H5
"Aleutians West Census Area, AK",2013-2014,5692,5750,58,1.019,33,25,2,16,H5
"Aleutians West Census Area, AK",2014-2015,5751,5702,-49,-0.852,22,-71,2,16,H5
"Aleutians West Census Area, AK",2015-2016,5702,5747,45,0.789,20,25,2,16,H5
"Aleutians West Census Area, AK",2016-2017,5747,5763,16,0.278,26,-10,2,16,H5
"Anchorage Municipality, AK",2000-2001,260816,264274,3458,1.326,3031,427,2,20,H6
"Anchorage Municipality, AK",2001-2002,264274,268229,3955,1.497,2807,1148,2,20,H6
"Anchorage Municipality, AK",2002-2003,268229,270568,2339,0.872,2967,-628,2,20,H6
"Anchorage Municipality, AK",2003-2004,270568,274484,3916,1.447,3265,651,2,20,H6
"Anchorage Municipality, AK",2004-2005,274484,276494,2010,0.732,3089,-1079,2,20,H6
"Anchorage Municipality, AK",2005-2006,276494,280085,3591,1.299,3204,387,2,20,H6
"Anchorage Municipality, AK",2006-2007,280085,278792,-1293,-0.462,3302,-4595,2,20,H6
"Anchorage Municipality, AK",2007-2008,278792,281554,2762,0.991,3256,-494,2,20,H6
"Anchorage Municipality, AK",2008-2009,281554,287677,6123,2.175,3140,2983,2,20,H6
"Anchorage Municipality, AK",2009-2010,287677,293337,5660,1.967,3308,2352,2,20,H6
"Anchorage Municipality, AK",2010-2011,293337,296282,2945,1.004,3286,-341,2,20,H6
"Anchorage Municipality, AK",2011-2012,296282,298633,2351,0.794,3080,-729,2,20,H6
"Anchorage Municipality, AK",2012-2013,298633,301629,2996,1.003,3.00E+03,-4,2,20,H6
"Anchorage Municipality, AK",2013-2014,301629,301010,-619,-0.205,2988,-3607,2,20,H6
"Anchorage Municipality, AK",2014-2015,300357,298695,-1662,-0.553,3096,-4758,2,20,H6
"Anchorage Municipality, AK",2015-2016,298695,297376,-1319,-0.442,2737,-4056,2,20,H6
"Anchorage Municipality, AK",2016-2017,297376,294356,-3020,-1.016,2706,-5726,2,20,H6
"Bethel Census Area, AK",2000-2001,16080,16171,91,0.566,339,-248,2,50,H5
"Bethel Census Area, AK",2001-2002,16171,16414,243,1.503,331,-88,2,50,H5
"Bethel Census Area, AK",2002-2003,16414,16517,103,0.628,316,-213,2,50,H5
"Bethel Census Area, AK",2003-2004,16517,16603,86,0.521,329,-243,2,50,H5
"Bethel Census Area, AK",2004-2005,16603,16728,125,0.753,326,-201,2,50,H5
"Bethel Census Area, AK",2005-2006,16728,16755,27,0.161,347,-320,2,50,H5
"Bethel Census Area, AK",2006-2007,16755,16723,-32,-0.191,316,-348,2,50,H5
"Bethel Census Area, AK",2007-2008,16723,16762,39,0.233,352,-313,2,50,H5
"Bethel Census Area, AK",2008-2009,16762,16860,98,0.585,356,-258,2,50,H5
"Bethel Census Area, AK",2009-2010,16860,17068,208,1.234,343,-135,2,50,H5
"Bethel Census Area, AK",2010-2011,17068,17453,385,2.256,364,21,2,50,H5
"Bethel Census Area, AK",2011-2012,17453,17687,234,1.341,302,-68,2,50,H5
"Bethel Census Area, AK",2012-2013,17687,17806,119,0.673,303,-184,2,50,H5
"Bethel Census Area, AK",2013-2014,17806,17868,62,0.348,296,-234,2,50,H5
"Bethel Census Area, AK",2014-2015,17923,17946,23,0.128,288,-265,2,50,H5
"Bethel Census Area, AK",2015-2016,17946,17980,34,0.189,283,-249,2,50,H5
"Bethel Census Area, AK",2016-2017,17980,18076,96,0.534,278,-182,2,50,H5
"Bristol Bay Borough, AK",2000-2001,1232,1196,-36,-2.922,12,-48,2,60,H1
"Bristol Bay Borough, AK",2001-2002,1196,1166,-30,-2.508,10,-40,2,60,H1
"Bristol Bay Borough, AK",2002-2003,1166,1140,-26,-2.23,5,-31,2,60,H1
"Bristol Bay Borough, AK",2003-2004,1140,1144,4,0.351,8,-4,2,60,H1
"Bristol Bay Borough, AK",2004-2005,1144,1171,27,2.36,10,17,2,60,H1
"Bristol Bay Borough, AK",2005-2006,1171,1111,-60,-5.124,2,-62,2,60,H1
"Bristol Bay Borough, AK",2006-2007,1111,1076,-35,-3.15,5,-40,2,60,H1
"Bristol Bay Borough, AK",2007-2008,1076,1040,-36,-3.346,4,-40,2,60,H1
"Bristol Bay Borough, AK",2008-2009,1040,976,-64,-6.154,4,-68,2,60,H1
"Bristol Bay Borough, AK",2009-2010,976,1002,26,2.664,11,15,2,60,H1
"Bristol Bay Borough, AK",2010-2011,1002,1038,36,3.593,9,27,2,60,H1
"Bristol Bay Borough, AK",2011-2012,1038,984,-54,-5.202,-2,-52,2,60,H1
"Bristol Bay Borough, AK",2012-2013,984,955,-29,-2.947,8,-37,2,60,H1
"Bristol Bay Borough, AK",2013-2014,955,957,2,0.209,4,-2,2,60,H1
"Bristol Bay Borough, AK",2014-2015,946,892,-54,-5.708,3,-57,2,60,H1
"Bristol Bay Borough, AK",2015-2016,892,905,13,1.457,6,7,2,60,H1
"Bristol Bay Borough, AK",2016-2017,905,867,-38,-4.199,2,-40,2,60,H1
"Denali Borough, AK",2000-2001,1890,1850,-40,-2.116,18,-58,2,68,H1
"Denali Borough, AK",2001-2002,1850,1862,12,0.649,24,-12,2,68,H1
"Denali Borough, AK",2002-2003,1862,1825,-37,-1.987,23,-60,2,68,H1
"Denali Borough, AK",2003-2004,1825,1877,52,2.849,16,36,2,68,H1
"Denali Borough, AK",2004-2005,1877,1834,-43,-2.291,15,-58,2,68,H1
"Denali Borough, AK",2005-2006,1834,1837,3,0.164,10,-7,2,68,H1
"Denali Borough, AK",2006-2007,1837,1803,-34,-1.851,17,-51,2,68,H1
"Denali Borough, AK",2007-2008,1803,1803,0,0,22,-22,2,68,H1
"Denali Borough, AK",2008-2009,1803,1817,14,0.776,22,-8,2,68,H1
"Denali Borough, AK",2009-2010,1817,1832,15,0.826,19,-4,2,68,H1
"Denali Borough, AK",2010-2011,1832,1869,37,2.02,14,23,2,68,H1
"Denali Borough, AK",2011-2012,1869,1906,37,1.98,13,24,2,68,H1
"Denali Borough, AK",2012-2013,1906,1933,27,1.417,7,20,2,68,H1
"Denali Borough, AK",2013-2014,1933,1921,-12,-0.621,14,-26,2,68,H1
"Denali Borough, AK",2014-2015,1903,1919,16,0.841,19,-3,2,68,H1
"Denali Borough, AK",2015-2016,1919,2045,126,6.566,13,113,2,68,H1
"Denali Borough, AK",2016-2017,2045,2074,29,1.418,22,7,2,68,H1
"Dillingham Census Area, AK",2000-2001,4916,4840,-76,-1.546,54,-130,2,70,H5
"Dillingham Census Area, AK",2001-2002,4840,4900,60,1.24,52,8,2,70,H5
"Dillingham Census Area, AK",2002-2003,4900,4828,-72,-1.469,67,-139,2,70,H5
"Dillingham Census Area, AK",2003-2004,4828,4850,22,0.456,56,-34,2,70,H5
"Dillingham Census Area, AK",2004-2005,4850,4841,-9,-0.186,68,-77,2,70,H5
"Dillingham Census Area, AK",2005-2006,4841,4833,-8,-0.165,57,-65,2,70,H5
"Dillingham Census Area, AK",2006-2007,4833,4832,-1,-0.021,63,-64,2,70,H5
"Dillingham Census Area, AK",2007-2008,4832,4769,-63,-1.304,84,-147,2,70,H5
"Dillingham Census Area, AK",2008-2009,4769,4776,7,0.147,86,-79,2,70,H5
"Dillingham Census Area, AK",2009-2010,4776,4869,93,1.947,95,-2,2,70,H5
"Dillingham Census Area, AK",2010-2011,4869,4969,100,2.054,73,27,2,70,H5
"Dillingham Census Area, AK",2011-2012,4969,4968,-1,-0.02,62,-63,2,70,H5
"Dillingham Census Area, AK",2012-2013,4968,4988,20,0.403,58,-38,2,70,H5
"Dillingham Census Area, AK",2013-2014,4988,4988,0,0,52,-52,2,70,H5
"Dillingham Census Area, AK",2014-2015,4994,4997,3,0.06,65,-62,2,70,H5
"Dillingham Census Area, AK",2015-2016,4997,4976,-21,-0.42,78,-99,2,70,H5
"Dillingham Census Area, AK",2016-2017,4976,4932,-44,-0.884,66,-110,2,70,H5
"Fairbanks North Star Borough, AK",2000-2001,83005,84814,1809,2.179,1197,612,2,90,H1
"Fairbanks North Star Borough, AK",2001-2002,84814,86095,1281,1.51,1182,99,2,90,H1
"Fairbanks North Star Borough, AK",2002-2003,86095,86885,790,0.918,1249,-459,2,90,H1
"Fairbanks North Star Borough, AK",2003-2004,86885,89043,2158,2.484,1221,937,2,90,H1
"Fairbanks North Star Borough, AK",2004-2005,89043,90431,1388,1.559,1209,179,2,90,H1
"Fairbanks North Star Borough, AK",2005-2006,90431,90545,114,0.126,1184,-1070,2,90,H1
"Fairbanks North Star Borough, AK",2006-2007,90545,93545,3.00E+03,3.313,1244,1756,2,90,H1
"Fairbanks North Star Borough, AK",2007-2008,93545,94552,1007,1.076,1557,-550,2,90,H1
"Fairbanks North Star Borough, AK",2008-2009,94552,95238,686,0.726,1489,-803,2,90,H1
"Fairbanks North Star Borough, AK",2009-2010,95238,98174,2936,3.083,1290,1646,2,90,H1
"Fairbanks North Star Borough, AK",2010-2011,98174,98029,-145,-0.148,1328,-1473,2,90,H1
"Fairbanks North Star Borough, AK",2011-2012,98029,100227,2198,2.242,1144,1054,2,90,H1
"Fairbanks North Star Borough, AK",2012-2013,100227,100807,580,0.579,1196,-616,2,90,H1
"Fairbanks North Star Borough, AK",2013-2014,100807,99357,-1450,-1.438,1166,-2616,2,90,H1
"Fairbanks North Star Borough, AK",2014-2015,99371,99631,260,0.262,1244,-984,2,90,H1
"Fairbanks North Star Borough, AK",2015-2016,99631,100602,971,0.975,1191,-220,2,90,H1
"Fairbanks North Star Borough, AK",2016-2017,100602,99703,-899,-0.894,1206,-2105,2,90,H1
"Haines Borough, AK",2000-2001,2399,2334,-65,-2.709,3,-68,2,100,H1
"Haines Borough, AK",2001-2002,2334,2325,-9,-0.386,1,-10,2,100,H1
"Haines Borough, AK",2002-2003,2325,2337,12,0.516,0,12,2,100,H1
"Haines Borough, AK",2003-2004,2337,2281,-56,-2.396,2,-58,2,100,H1
"Haines Borough, AK",2004-2005,2281,2280,-1,-0.044,7,-8,2,100,H1
"Haines Borough, AK",2005-2006,2280,2300,20,0.877,-7,27,2,100,H1
"Haines Borough, AK",2006-2007,2300,2379,79,3.435,9,70,2,100,H1
"Haines Borough, AK",2007-2008,2379,2404,25,1.051,8,17,2,100,H1
"Haines Borough, AK",2008-2009,2404,2486,82,3.411,16,66,2,100,H1
"Haines Borough, AK",2009-2010,2486,2504,18,0.724,18,0,2,100,H1
"Haines Borough, AK",2010-2011,2504,2572,68,2.716,14,54,2,100,H1
"Haines Borough, AK",2011-2012,2572,2572,0,0,-1,1,2,100,H1
"Haines Borough, AK",2012-2013,2572,2569,-3,-0.117,2,-5,2,100,H1
"Haines Borough, AK",2013-2014,2569,2566,-3,-0.117,9,-12,2,100,H1
"Haines Borough, AK",2014-2015,2566,2534,-32,-1.247,5,-37,2,100,H1
"Haines Borough, AK",2015-2016,2534,2531,-3,-0.118,5,-8,2,100,H1
"Haines Borough, AK",2016-2017,2531,2526,-5,-0.198,11,-16,2,100,H1
"Hoonah-Angoon Census Area, AK",2000-2001,2562,2538,-24,-0.937,-6,-18,2,105,H5
"Hoonah-Angoon Census Area, AK",2001-2002,2538,2479,-59,-2.325,6,-65,2,105,H5
"Hoonah-Angoon Census Area, AK",2002-2003,2479,2378,-101,-4.074,5,-106,2,105,H5
"Hoonah-Angoon Census Area, AK",2003-2004,2378,2331,-47,-1.976,13,-60,2,105,H5
"Hoonah-Angoon Census Area, AK",2004-2005,2331,2316,-15,-0.644,5,-20,2,105,H5
"Hoonah-Angoon Census Area, AK",2005-2006,2316,2271,-45,-1.943,10,-55,2,105,H5
"Hoonah-Angoon Census Area, AK",2006-2007,2271,2242,-29,-1.277,7,-36,2,105,H5
"Hoonah-Angoon Census Area, AK",2007-2008,2242,2225,-17,-0.758,16,-33,2,105,H5
"Hoonah-Angoon Census Area, AK",2008-2009,2225,2144,-81,-3.64,20,-101,2,105,H5
"Hoonah-Angoon Census Area, AK",2009-2010,2144,2149,5,0.233,19,-14,2,105,H5
"Hoonah-Angoon Census Area, AK",2010-2011,2149,2124,-25,-1.163,16,-41,2,105,H5
"Hoonah-Angoon Census Area, AK",2011-2012,2124,2140,16,0.753,6,10,2,105,H5
"Hoonah-Angoon Census Area, AK",2012-2013,2140,2134,-6,-0.28,10,-16,2,105,H5
"Hoonah-Angoon Census Area, AK",2013-2014,2134,2082,-52,-2.437,9,-61,2,105,H5
"Hoonah-Angoon Census Area, AK",2014-2015,2091,2133,42,2.009,3,39,2,105,H5
"Hoonah-Angoon Census Area, AK",2015-2016,2133,2145,12,0.563,10,2,2,105,H5
"Hoonah-Angoon Census Area, AK",2016-2017,2145,2145,0,0,4,-4,2,105,H5
"Juneau City and Borough, AK",2000-2001,30668,30502,-166,-0.541,266,-432,2,110,H6
"Juneau City and Borough, AK",2001-2002,30502,30712,210,0.688,261,-51,2,110,H6
"Juneau City and Borough, AK",2002-2003,30712,30993,281,0.915,256,25,2,110,H6
"Juneau City and Borough, AK",2003-2004,30993,31103,110,0.355,249,-139,2,110,H6
"Juneau City and Borough, AK",2004-2005,31103,31003,-100,-0.322,244,-344,2,110,H6
"Juneau City and Borough, AK",2005-2006,31003,30808,-195,-0.629,252,-447,2,110,H6
"Juneau City and Borough, AK",2006-2007,30808,30682,-126,-0.409,259,-385,2,110,H6
"Juneau City and Borough, AK",2007-2008,30682,31110,428,1.395,219,209,2,110,H6
"Juneau City and Borough, AK",2008-2009,31110,30857,-253,-0.813,273,-526,2,110,H6
"Juneau City and Borough, AK",2009-2010,30857,31386,529,1.714,272,257,2,110,H6
"Juneau City and Borough, AK",2010-2011,31386,32170,784,2.498,255,529,2,110,H6
"Juneau City and Borough, AK",2011-2012,32170,32411,241,0.749,186,55,2,110,H6
"Juneau City and Borough, AK",2012-2013,32411,32626,215,0.663,244,-29,2,110,H6
"Juneau City and Borough, AK",2013-2014,32626,32406,-220,-0.674,228,-448,2,110,H6
"Juneau City and Borough, AK",2014-2015,32625,32756,131,0.402,264,-133,2,110,H6
"Juneau City and Borough, AK",2015-2016,32756,32405,-351,-1.072,184,-535,2,110,H6
"Juneau City and Borough, AK",2016-2017,32405,32094,-311,-0.96,182,-493,2,110,H6
"Kenai Peninsula Borough, AK",2000-2001,49618,49986,368,0.742,344,24,2,122,H1
"Kenai Peninsula Borough, AK",2001-2002,49986,50804,818,1.636,322,496,2,122,H1
"Kenai Peninsula Borough, AK",2002-2003,50804,50963,159,0.313,326,-167,2,122,H1
"Kenai Peninsula Borough, AK",2003-2004,50963,51404,441,0.865,308,133,2,122,H1
"Kenai Peninsula Borough, AK",2004-2005,51404,51590,186,0.362,322,-136,2,122,H1
"Kenai Peninsula Borough, AK",2005-2006,51590,52253,663,1.285,354,309,2,122,H1
"Kenai Peninsula Borough, AK",2006-2007,52253,53272,1019,1.95,356,663,2,122,H1
"Kenai Peninsula Borough, AK",2007-2008,53272,53655,383,0.719,326,57,2,122,H1
"Kenai Peninsula Borough, AK",2008-2009,53655,54796,1141,2.127,336,805,2,122,H1
"Kenai Peninsula Borough, AK",2009-2010,54796,55566,770,1.405,339,431,2,122,H1
"Kenai Peninsula Borough, AK",2010-2011,55566,56369,803,1.445,325,478,2,122,H1
"Kenai Peninsula Borough, AK",2011-2012,56369,56958,589,1.045,371,218,2,122,H1
"Kenai Peninsula Borough, AK",2012-2013,56958,57067,109,0.191,322,-213,2,122,H1
"Kenai Peninsula Borough, AK",2013-2014,57067,57477,410,0.718,293,117,2,122,H1
"Kenai Peninsula Borough, AK",2014-2015,57638,58059,421,0.73,266,155,2,122,H1
"Kenai Peninsula Borough, AK",2015-2016,58059,58543,484,0.834,299,185,2,122,H1
"Kenai Peninsula Borough, AK",2016-2017,58543,58617,74,0.126,246,-172,2,122,H1
"Ketchikan Gateway Borough, AK",2000-2001,1.40E+04,13796,-204,-1.457,64,-268,2,130,H1
"Ketchikan Gateway Borough, AK",2001-2002,13796,13599,-197,-1.428,97,-294,2,130,H1
"Ketchikan Gateway Borough, AK",2002-2003,13599,13335,-264,-1.941,97,-361,2,130,H1
"Ketchikan Gateway Borough, AK",2003-2004,13335,13244,-91,-0.682,77,-168,2,130,H1
"Ketchikan Gateway Borough, AK",2004-2005,13244,13305,61,0.461,118,-57,2,130,H1
"Ketchikan Gateway Borough, AK",2005-2006,13305,13492,187,1.405,108,79,2,130,H1
"Ketchikan Gateway Borough, AK",2006-2007,13492,13341,-151,-1.119,113,-264,2,130,H1
"Ketchikan Gateway Borough, AK",2007-2008,13341,13326,-15,-0.112,100,-115,2,130,H1
"Ketchikan Gateway Borough, AK",2008-2009,13326,13294,-32,-0.24,97,-129,2,130,H1
"Ketchikan Gateway Borough, AK",2009-2010,13294,13536,242,1.82,112,130,2,130,H1
"Ketchikan Gateway Borough, AK",2010-2011,13536,13654,118,0.872,84,34,2,130,H1
"Ketchikan Gateway Borough, AK",2011-2012,13654,13709,55,0.403,80,-25,2,130,H1
"Ketchikan Gateway Borough, AK",2012-2013,13709,13695,-14,-0.102,109,-123,2,130,H1
"Ketchikan Gateway Borough, AK",2013-2014,13695,13787,92,0.672,104,-12,2,130,H1
"Ketchikan Gateway Borough, AK",2014-2015,13781,13709,-72,-0.522,79,-151,2,130,H1
"Ketchikan Gateway Borough, AK",2015-2016,13709,13727,18,0.131,107,-89,2,130,H1
"Ketchikan Gateway Borough, AK",2016-2017,13727,13856,129,0.94,66,63,2,130,H1
"Kodiak Island Borough, AK",2000-2001,13983,13748,-235,-1.681,182,-417,2,150,H1
"Kodiak Island Borough, AK",2001-2002,13748,13651,-97,-0.706,171,-268,2,150,H1
"Kodiak Island Borough, AK",2002-2003,13651,13239,-412,-3.018,179,-591,2,150,H1
"Kodiak Island Borough, AK",2003-2004,13239,13206,-33,-0.249,137,-170,2,150,H1
"Kodiak Island Borough, AK",2004-2005,13206,13105,-101,-0.765,165,-266,2,150,H1
"Kodiak Island Borough, AK",2005-2006,13105,13184,79,0.603,150,-71,2,150,H1
"Kodiak Island Borough, AK",2006-2007,13184,13159,-25,-0.19,155,-180,2,150,H1
"Kodiak Island Borough, AK",2007-2008,13159,13262,103,0.783,182,-79,2,150,H1
"Kodiak Island Borough, AK",2008-2009,13262,13505,243,1.832,196,47,2,150,H1
"Kodiak Island Borough, AK",2009-2010,13505,13637,132,0.977,218,-86,2,150,H1
"Kodiak Island Borough, AK",2010-2011,13637,13807,170,1.247,159,11,2,150,H1
"Kodiak Island Borough, AK",2011-2012,13807,14075,268,1.941,155,113,2,150,H1
"Kodiak Island Borough, AK",2012-2013,14075,14115,40,0.284,176,-136,2,150,H1
"Kodiak Island Borough, AK",2013-2014,14115,13986,-129,-0.914,172,-301,2,150,H1
"Kodiak Island Borough, AK",2014-2015,14007,13889,-118,-0.842,181,-299,2,150,H1
"Kodiak Island Borough, AK",2015-2016,13889,13679,-210,-1.512,168,-378,2,150,H1
"Kodiak Island Borough, AK",2016-2017,13679,13448,-231,-1.689,165,-396,2,150,H1
"Kusilvak Census Area, AK",2014-2015,8053,8119,66,0.82,146,-80,2,158,H1
"Kusilvak Census Area, AK",2015-2016,8119,8161,42,0.517,146,-104,2,158,H1
"Kusilvak Census Area, AK",2016-2017,8161,8202,41,0.502,143,-102,2,158,H1
"Lake and Peninsula Borough, AK",2000-2001,1814,1715,-99,-5.458,6,-105,2,164,H1
"Lake and Peninsula Borough, AK",2001-2002,1715,1621,-94,-5.481,3,-97,2,164,H1
"Lake and Peninsula Borough, AK",2002-2003,1621,1626,5,0.308,8,-3,2,164,H1
"Lake and Peninsula Borough, AK",2003-2004,1626,1644,18,1.107,18,0,2,164,H1
"Lake and Peninsula Borough, AK",2004-2005,1644,1639,-5,-0.304,17,-22,2,164,H1
"Lake and Peninsula Borough, AK",2005-2006,1639,1624,-15,-0.915,13,-28,2,164,H1
"Lake and Peninsula Borough, AK",2006-2007,1624,1629,5,0.308,6,-1,2,164,H1
"Lake and Peninsula Borough, AK",2007-2008,1629,1606,-23,-1.412,16,-39,2,164,H1
"Lake and Peninsula Borough, AK",2008-2009,1606,1612,6,0.374,29,-23,2,164,H1
"Lake and Peninsula Borough, AK",2009-2010,1612,1638,26,1.613,33,-7,2,164,H1
"Lake and Peninsula Borough, AK",2010-2011,1638,1656,18,1.099,9,9,2,164,H1
"Lake and Peninsula Borough, AK",2011-2012,1656,1643,-13,-0.785,22,-35,2,164,H1
"Lake and Peninsula Borough, AK",2012-2013,1643,1662,19,1.156,19,0,2,164,H1
"Lake and Peninsula Borough, AK",2013-2014,1662,1631,-31,-1.865,17,-48,2,164,H1
"Lake and Peninsula Borough, AK",2014-2015,1629,1563,-66,-4.052,12,-78,2,164,H1
"Lake and Peninsula Borough, AK",2015-2016,1563,1602,39,2.495,23,16,2,164,H1
"Lake and Peninsula Borough, AK",2016-2017,1602,1620,18,1.124,24,-6,2,164,H1
"Matanuska-Susitna Borough, AK",2000-2001,59802,61807,2005,3.353,547,1458,2,170,H1
"Matanuska-Susitna Borough, AK",2001-2002,61807,64353,2546,4.119,558,1988,2,170,H1
"Matanuska-Susitna Borough, AK",2002-2003,64353,67162,2809,4.365,506,2303,2,170,H1
"Matanuska-Susitna Borough, AK",2003-2004,67162,70761,3599,5.359,710,2889,2,170,H1
"Matanuska-Susitna Borough, AK",2004-2005,70761,74409,3648,5.155,673,2975,2,170,H1
"Matanuska-Susitna Borough, AK",2005-2006,74409,78633,4224,5.677,826,3398,2,170,H1
"Matanuska-Susitna Borough, AK",2006-2007,78633,81402,2769,3.521,837,1932,2,170,H1
"Matanuska-Susitna Borough, AK",2007-2008,81402,84079,2677,3.289,875,1802,2,170,H1
"Matanuska-Susitna Borough, AK",2008-2009,84079,86885,2806,3.337,913,1893,2,170,H1
"Matanuska-Susitna Borough, AK",2009-2010,86885,89783,2898,3.335,823,2075,2,170,H1
"Matanuska-Susitna Borough, AK",2010-2011,89783,91858,2075,2.311,820,1255,2,170,H1
"Matanuska-Susitna Borough, AK",2011-2012,91858,93798,1940,2.112,791,1149,2,170,H1
"Matanuska-Susitna Borough, AK",2012-2013,93798,95892,2094,2.232,813,1281,2,170,H1
"Matanuska-Susitna Borough, AK",2013-2014,95892,97882,1990,2.075,845,1145,2,170,H1
"Matanuska-Susitna Borough, AK",2014-2015,98285,101095,2810,2.859,887,1923,2,170,H1
"Matanuska-Susitna Borough, AK",2015-2016,101095,104123,3028,2.995,924,2104,2,170,H1
"Matanuska-Susitna Borough, AK",2016-2017,104123,106532,2409,2.314,979,1430,2,170,H1
"Nome Census Area, AK",2000-2001,9152,9167,15,0.164,148,-133,2,180,H5
"Nome Census Area, AK",2001-2002,9167,9161,-6,-0.065,134,-140,2,180,H5
"Nome Census Area, AK",2002-2003,9161,9210,49,0.535,143,-94,2,180,H5
"Nome Census Area, AK",2003-2004,9210,9351,141,1.531,134,7,2,180,H5
"Nome Census Area, AK",2004-2005,9351,9338,-13,-0.139,172,-185,2,180,H5
"Nome Census Area, AK",2005-2006,9338,9235,-103,-1.103,177,-280,2,180,H5
"Nome Census Area, AK",2006-2007,9235,9246,11,0.119,144,-133,2,180,H5
"Nome Census Area, AK",2007-2008,9246,9231,-15,-0.162,210,-225,2,180,H5
"Nome Census Area, AK",2008-2009,9231,9313,82,0.888,187,-105,2,180,H5
"Nome Census Area, AK",2009-2010,9313,9543,230,2.47,184,46,2,180,H5
"Nome Census Area, AK",2010-2011,9543,9844,301,3.154,174,127,2,180,H5
"Nome Census Area, AK",2011-2012,9844,9873,29,0.295,175,-146,2,180,H5
"Nome Census Area, AK",2012-2013,9873,9884,11,0.111,123,-112,2,180,H5
"Nome Census Area, AK",2013-2014,9884,9817,-67,-0.678,115,-182,2,180,H5
"Nome Census Area, AK",2014-2015,9833,9846,13,0.132,121,-108,2,180,H5
"Nome Census Area, AK",2015-2016,9846,9915,69,0.701,118,-49,2,180,H5
"Nome Census Area, AK",2016-2017,9915,9921,6,0.061,92,-86,2,180,H5
"North Slope Borough, AK",2000-2001,7420,7530,110,1.482,110,0,2,185,H1
"North Slope Borough, AK",2001-2002,7530,7728,198,2.629,153,45,2,185,H1
"North Slope Borough, AK",2002-2003,7728,7968,240,3.106,122,118,2,185,H1
"North Slope Borough, AK",2003-2004,7968,8046,78,0.979,131,-53,2,185,H1
"North Slope Borough, AK",2004-2005,8046,8190,144,1.79,136,8,2,185,H1
"North Slope Borough, AK",2005-2006,8190,8315,125,1.526,157,-32,2,185,H1
"North Slope Borough, AK",2006-2007,8315,8519,204,2.453,128,76,2,185,H1
"North Slope Borough, AK",2007-2008,8519,8841,322,3.78,154,168,2,185,H1
"North Slope Borough, AK",2008-2009,8841,9105,264,2.986,152,112,2,185,H1
"North Slope Borough, AK",2009-2010,9105,9467,362,3.976,156,206,2,185,H1
"North Slope Borough, AK",2010-2011,9467,9534,67,0.708,129,-62,2,185,H1
"North Slope Borough, AK",2011-2012,9534,9655,121,1.269,145,-24,2,185,H1
"North Slope Borough, AK",2012-2013,9655,9733,78,0.808,129,-51,2,185,H1
"North Slope Borough, AK",2013-2014,9733,9703,-30,-0.308,121,-151,2,185,H1
"North Slope Borough, AK",2014-2015,9713,9687,-26,-0.268,123,-149,2,185,H1
"North Slope Borough, AK",2015-2016,9687,9685,-2,-0.021,92,-94,2,185,H1
"North Slope Borough, AK",2016-2017,9685,9782,97,1.002,94,3,2,185,H1
"Northwest Arctic Borough, AK",2000-2001,7226,7251,25,0.346,125,-100,2,188,H1
"Northwest Arctic Borough, AK",2001-2002,7251,7252,1,0.014,125,-124,2,188,H1
"Northwest Arctic Borough, AK",2002-2003,7252,7310,58,0.8,119,-61,2,188,H1
"Northwest Arctic Borough, AK",2003-2004,7310,7397,87,1.19,128,-41,2,188,H1
"Northwest Arctic Borough, AK",2004-2005,7397,7416,19,0.257,135,-116,2,188,H1
"Northwest Arctic Borough, AK",2005-2006,7416,7467,51,0.688,149,-98,2,188,H1
"Northwest Arctic Borough, AK",2006-2007,7467,7440,-27,-0.362,154,-181,2,188,H1
"Northwest Arctic Borough, AK",2007-2008,7440,7466,26,0.349,181,-155,2,188,H1
"Northwest Arctic Borough, AK",2008-2009,7466,7467,1,0.013,141,-140,2,188,H1
"Northwest Arctic Borough, AK",2009-2010,7467,7531,64,0.857,157,-93,2,188,H1
"Northwest Arctic Borough, AK",2010-2011,7531,7708,177,2.35,170,7,2,188,H1
"Northwest Arctic Borough, AK",2011-2012,7708,7709,1,0.013,123,-122,2,188,H1
"Northwest Arctic Borough, AK",2012-2013,7709,7697,-12,-0.156,150,-162,2,188,H1
"Northwest Arctic Borough, AK",2013-2014,7697,7717,20,0.26,107,-87,2,188,H1
"Northwest Arctic Borough, AK",2014-2015,7748,7752,4,0.052,99,-95,2,188,H1
"Northwest Arctic Borough, AK",2015-2016,7752,7662,-90,-1.161,116,-206,2,188,H1
"Northwest Arctic Borough, AK",2016-2017,7662,7684,22,0.287,82,-60,2,188,H1
"Petersburg Census Area, AK",2000-2001,4249,4198,-51,-1.2,28,-79,2,195,H5
"Petersburg Census Area, AK",2001-2002,4198,4112,-86,-2.049,1,-87,2,195,H5
"Petersburg Census Area, AK",2002-2003,4112,4022,-90,-2.189,-11,-79,2,195,H5
"Petersburg Census Area, AK",2003-2004,4022,4059,37,0.92,17,20,2,195,H5
"Petersburg Census Area, AK",2004-2005,4059,3959,-100,-2.464,6,-106,2,195,H5
"Petersburg Census Area, AK",2005-2006,3959,3886,-73,-1.844,22,-95,2,195,H5
"Petersburg Census Area, AK",2006-2007,3886,3898,12,0.309,9,3,2,195,H5
"Petersburg Census Area, AK",2007-2008,3898,3817,-81,-2.078,13,-94,2,195,H5
"Petersburg Census Area, AK",2008-2009,3817,3775,-42,-1.1,27,-69,2,195,H5
"Petersburg Census Area, AK",2009-2010,3775,3209,-566,-14.993,24,-590,2,195,H5
"Petersburg Census Area, AK",2010-2011,3209,3235,26,0.81,26,0,2,195,H5
"Petersburg Census Area, AK",2011-2012,3235,3241,6,0.185,21,-15,2,195,H5
"Petersburg Census Area, AK",2012-2013,3241,3213,-28,-0.864,26,-54,2,195,H5
"Petersburg Census Area, AK",2013-2014,3213,3160,-53,-1.65,19,-72,2,195,H5
"Petersburg Census Area, AK",2014-2015,3184,3177,-7,-0.22,24,-31,2,195,H5
"Petersburg Census Area, AK",2015-2016,3177,3278,101,3.179,10,91,2,195,H5
"Petersburg Census Area, AK",2016-2017,3278,3281,3,0.092,8,-5,2,195,H5
"Prince of Wales-Hyder Census Area, AK",2000-2001,6098,5887,-211,-3.46,62,-273,2,198,H5
"Prince of Wales-Hyder Census Area, AK",2001-2002,5887,5675,-212,-3.601,39,-251,2,198,H5
"Prince of Wales-Hyder Census Area, AK",2002-2003,5675,5650,-25,-0.441,30,-55,2,198,H5
"Prince of Wales-Hyder Census Area, AK",2003-2004,5650,5614,-36,-0.637,24,-60,2,198,H5
"Prince of Wales-Hyder Census Area, AK",2004-2005,5614,5534,-80,-1.425,23,-103,2,198,H5
"Prince of Wales-Hyder Census Area, AK",2005-2006,5534,5574,40,0.723,52,-12,2,198,H5
"Prince of Wales-Hyder Census Area, AK",2006-2007,5574,5457,-117,-2.099,32,-149,2,198,H5
"Prince of Wales-Hyder Census Area, AK",2007-2008,5457,5448,-9,-0.165,56,-65,2,198,H5
"Prince of Wales-Hyder Census Area, AK",2008-2009,5448,5465,17,0.312,56,-39,2,198,H5
"Prince of Wales-Hyder Census Area, AK",2009-2010,5465,6214,749,13.705,53,696,2,198,H5
"Prince of Wales-Hyder Census Area, AK",2010-2011,6214,6379,165,2.655,35,130,2,198,H5
"Prince of Wales-Hyder Census Area, AK",2011-2012,6379,6387,8,0.125,54,-46,2,198,H5
"Prince of Wales-Hyder Census Area, AK",2012-2013,6387,6402,15,0.235,34,-19,2,198,H5
"Prince of Wales-Hyder Census Area, AK",2013-2014,6402,6396,-6,-0.094,32,-38,2,198,H5
"Prince of Wales-Hyder Census Area, AK",2014-2015,6384,6341,-43,-0.674,30,-73,2,198,H5
"Prince of Wales-Hyder Census Area, AK",2015-2016,6341,6507,166,2.618,11,155,2,198,H5
"Prince of Wales-Hyder Census Area, AK",2016-2017,6507,6443,-64,-0.984,21,-85,2,198,H5
"Sitka City and Borough, AK",2000-2001,8845,8727,-118,-1.334,64,-182,2,220,H6
"Sitka City and Borough, AK",2001-2002,8727,8874,147,1.684,93,54,2,220,H6
"Sitka City and Borough, AK",2002-2003,8874,8881,7,0.079,66,-59,2,220,H6
"Sitka City and Borough, AK",2003-2004,8881,8890,9,0.101,65,-56,2,220,H6
"Sitka City and Borough, AK",2004-2005,8890,8994,104,1.17,65,39,2,220,H6
"Sitka City and Borough, AK",2005-2006,8994,9046,52,0.578,54,-2,2,220,H6
"Sitka City and Borough, AK",2006-2007,9046,8851,-195,-2.156,70,-265,2,220,H6
"Sitka City and Borough, AK",2007-2008,8851,8835,-16,-0.181,81,-97,2,220,H6
"Sitka City and Borough, AK",2008-2009,8835,8844,9,0.102,86,-77,2,220,H6
"Sitka City and Borough, AK",2009-2010,8844,8897,53,0.599,77,-24,2,220,H6
"Sitka City and Borough, AK",2010-2011,8897,8913,16,0.18,49,-33,2,220,H6
"Sitka City and Borough, AK",2011-2012,8913,9060,147,1.649,55,92,2,220,H6
"Sitka City and Borough, AK",2012-2013,9060,9014,-46,-0.508,38,-84,2,220,H6
"Sitka City and Borough, AK",2013-2014,9014,8900,-114,-1.265,54,-168,2,220,H6
"Sitka City and Borough, AK",2014-2015,8881,8863,-18,-0.203,41,-59,2,220,H6
"Sitka City and Borough, AK",2015-2016,8863,8768,-95,-1.072,41,-136,2,220,H6
"Sitka City and Borough, AK",2016-2017,8768,8689,-79,-0.901,42,-121,2,220,H6
"Skagway Municipality, AK",2000-2001,868,868,0,0,3,-3,2,230,H1
"Skagway Municipality, AK",2001-2002,868,865,-3,-0.346,5,-8,2,230,H1
"Skagway Municipality, AK",2002-2003,865,895,30,3.468,5,25,2,230,H1
"Skagway Municipality, AK",2003-2004,895,934,39,4.358,6,33,2,230,H1
"Skagway Municipality, AK",2004-2005,934,949,15,1.606,7,8,2,230,H1
"Skagway Municipality, AK",2005-2006,949,946,-3,-0.316,6,-9,2,230,H1
"Skagway Municipality, AK",2006-2007,946,955,9,0.951,-3,12,2,230,H1
"Skagway Municipality, AK",2007-2008,955,967,12,1.257,3,9,2,230,H1
"Skagway Municipality, AK",2008-2009,967,975,8,0.827,10,-2,2,230,H1
"Skagway Municipality, AK",2009-2010,975,965,-10,-1.026,7,-17,2,230,H1
"Skagway Municipality, AK",2010-2011,965,960,-5,-0.518,15,-20,2,230,H1
"Skagway Municipality, AK",2011-2012,960,994,34,3.542,7,27,2,230,H1
"Skagway Municipality, AK",2012-2013,994,1012,18,1.811,5,13,2,230,H1
"Skagway Municipality, AK",2013-2014,1012,1036,24,2.372,-9,33,2,230,H1
"Skagway Municipality, AK",2014-2015,1038,1057,19,1.83,-6,25,2,230,H1
"Skagway Municipality, AK",2015-2016,1057,1130,73,6.906,9,64,2,230,H1
"Skagway Municipality, AK",2016-2017,1130,1157,27,2.389,-1,28,2,230,H1
"Southeast Fairbanks Census Area, AK",2000-2001,6177,5705,-472,-7.641,67,-539,2,240,H5
"Southeast Fairbanks Census Area, AK",2001-2002,5705,5672,-33,-0.578,52,-85,2,240,H5
"Southeast Fairbanks Census Area, AK",2002-2003,5672,5772,100,1.763,51,49,2,240,H5
"Southeast Fairbanks Census Area, AK",2003-2004,5772,6022,250,4.331,27,223,2,240,H5
"Southeast Fairbanks Census Area, AK",2004-2005,6022,6530,508,8.436,73,435,2,240,H5
"Southeast Fairbanks Census Area, AK",2005-2006,6530,6817,287,4.395,84,203,2,240,H5
"Southeast Fairbanks Census Area, AK",2006-2007,6817,6945,128,1.878,90,38,2,240,H5
"Southeast Fairbanks Census Area, AK",2007-2008,6945,6904,-41,-0.59,92,-133,2,240,H5
"Southeast Fairbanks Census Area, AK",2008-2009,6904,6955,51,0.739,87,-36,2,240,H5
"Southeast Fairbanks Census Area, AK",2009-2010,6955,7053,98,1.409,68,30,2,240,H5
"Southeast Fairbanks Census Area, AK",2010-2011,7053,7120,67,0.95,83,-16,2,240,H5
"Southeast Fairbanks Census Area, AK",2011-2012,7120,7149,29,0.407,88,-59,2,240,H5
"Southeast Fairbanks Census Area, AK",2012-2013,7149,6969,-180,-2.518,54,-234,2,240,H5
"Southeast Fairbanks Census Area, AK",2013-2014,6969,6931,-38,-0.545,72,-110,2,240,H5
"Southeast Fairbanks Census Area, AK",2014-2015,6978,6839,-139,-1.992,82,-221,2,240,H5
"Southeast Fairbanks Census Area, AK",2015-2016,6839,6840,1,0.015,53,-52,2,240,H5
"Southeast Fairbanks Census Area, AK",2016-2017,6840,6888,48,0.702,68,-20,2,240,H5
"Valdez-Cordova Census Area, AK",2000-2001,10210,10114,-96,-0.94,75,-171,2,261,H5
"Valdez-Cordova Census Area, AK",2001-2002,10114,10061,-53,-0.524,81,-134,2,261,H5
"Valdez-Cordova Census Area, AK",2002-2003,10061,9996,-65,-0.646,71,-136,2,261,H5
"Valdez-Cordova Census Area, AK",2003-2004,9996,9990,-6,-0.06,70,-76,2,261,H5
"Valdez-Cordova Census Area, AK",2004-2005,9990,9914,-76,-0.761,69,-145,2,261,H5
"Valdez-Cordova Census Area, AK",2005-2006,9914,9828,-86,-0.867,72,-158,2,261,H5
"Valdez-Cordova Census Area, AK",2006-2007,9828,9572,-256,-2.605,71,-327,2,261,H5
"Valdez-Cordova Census Area, AK",2007-2008,9572,9458,-114,-1.191,89,-203,2,261,H5
"Valdez-Cordova Census Area, AK",2008-2009,9458,9492,34,0.359,80,-46,2,261,H5
"Valdez-Cordova Census Area, AK",2009-2010,9492,9678,186,1.96,90,96,2,261,H5
"Valdez-Cordova Census Area, AK",2010-2011,9678,9752,74,0.765,73,1,2,261,H5
"Valdez-Cordova Census Area, AK",2011-2012,9752,9736,-16,-0.164,54,-70,2,261,H5
"Valdez-Cordova Census Area, AK",2012-2013,9736,9770,34,0.349,105,-71,2,261,H5
"Valdez-Cordova Census Area, AK",2013-2014,9770,9488,-282,-2.886,90,-372,2,261,H5
"Valdez-Cordova Census Area, AK",2014-2015,9493,9362,-131,-1.38,96,-227,2,261,H5
"Valdez-Cordova Census Area, AK",2015-2016,9362,9340,-22,-0.235,80,-102,2,261,H5
"Valdez-Cordova Census Area, AK",2016-2017,9340,9278,-62,-0.664,91,-153,2,261,H5
"Wade Hampton Census Area, AK",2000-2001,7033,7051,18,0.256,173,-155,2,270,H5
"Wade Hampton Census Area, AK",2001-2002,7051,7103,52,0.737,164,-112,2,270,H5
"Wade Hampton Census Area, AK",2002-2003,7103,7201,98,1.38,191,-93,2,270,H5
"Wade Hampton Census Area, AK",2003-2004,7201,7330,129,1.791,171,-42,2,270,H5
"Wade Hampton Census Area, AK",2004-2005,7330,7313,-17,-0.232,196,-213,2,270,H5
"Wade Hampton Census Area, AK",2005-2006,7313,7292,-21,-0.287,185,-206,2,270,H5
"Wade Hampton Census Area, AK",2006-2007,7292,7372,80,1.097,181,-101,2,270,H5
"Wade Hampton Census Area, AK",2007-2008,7372,7392,20,0.271,187,-167,2,270,H5
"Wade Hampton Census Area, AK",2008-2009,7392,7469,77,1.042,213,-136,2,270,H5
"Wade Hampton Census Area, AK",2009-2010,7469,7473,4,0.054,209,-205,2,270,H5
"Wade Hampton Census Area, AK",2010-2011,7473,7662,189,2.529,180,9,2,270,H5
"Wade Hampton Census Area, AK",2011-2012,7662,7795,133,1.736,183,-50,2,270,H5
"Wade Hampton Census Area, AK",2012-2013,7795,7952,157,2.014,142,15,2,270,H5
"Wade Hampton Census Area, AK",2013-2014,7952,8010,58,0.729,126,-68,2,270,H5
"Wrangell City and Borough, AK",2000-2001,2452,2426,-26,-1.06,15,-41,2,275,H1
"Wrangell City and Borough, AK",2001-2002,2426,2382,-44,-1.814,-3,-41,2,275,H1
"Wrangell City and Borough, AK",2002-2003,2382,2347,-35,-1.469,12,-47,2,275,H1
"Wrangell City and Borough, AK",2003-2004,2347,2288,-59,-2.514,-2,-57,2,275,H1
"Wrangell City and Borough, AK",2004-2005,2288,2298,10,0.437,-2,12,2,275,H1
"Wrangell City and Borough, AK",2005-2006,2298,2309,11,0.479,8,3,2,275,H1
"Wrangell City and Borough, AK",2006-2007,2309,2322,13,0.563,3,10,2,275,H1
"Wrangell City and Borough, AK",2007-2008,2322,2353,31,1.335,17,14,2,275,H1
"Wrangell City and Borough, AK",2008-2009,2353,2331,-22,-0.935,17,-39,2,275,H1
"Wrangell City and Borough, AK",2009-2010,2331,2366,35,1.502,17,18,2,275,H1
"Wrangell City and Borough, AK",2010-2011,2366,2381,15,0.634,14,1,2,275,H1
"Wrangell City and Borough, AK",2011-2012,2381,2398,17,0.714,5,12,2,275,H1
"Wrangell City and Borough, AK",2012-2013,2398,2404,6,0.25,7,-1,2,275,H1
"Wrangell City and Borough, AK",2013-2014,2404,2364,-40,-1.664,-2,-38,2,275,H1
"Wrangell City and Borough, AK",2014-2015,2360,2382,22,0.932,2,20,2,275,H1
"Wrangell City and Borough, AK",2015-2016,2382,2502,120,5.038,9,111,2,275,H1
"Wrangell City and Borough, AK",2016-2017,2502,2521,19,0.759,-4,23,2,275,H1
"Yakutat City and Borough, AK",2000-2001,796,764,-32,-4.02,-1,-31,2,282,H1
"Yakutat City and Borough, AK",2001-2002,764,702,-62,-8.115,2,-64,2,282,H1
"Yakutat City and Borough, AK",2002-2003,702,673,-29,-4.131,2,-31,2,282,H1
"Yakutat City and Borough, AK",2003-2004,673,647,-26,-3.863,2,-28,2,282,H1
"Yakutat City and Borough, AK",2004-2005,647,665,18,2.782,3,15,2,282,H1
"Yakutat City and Borough, AK",2005-2006,665,642,-23,-3.459,3,-26,2,282,H1
"Yakutat City and Borough, AK",2006-2007,642,656,14,2.181,5,9,2,282,H1
"Yakutat City and Borough, AK",2007-2008,656,627,-29,-4.421,6,-35,2,282,H1
"Yakutat City and Borough, AK",2008-2009,627,665,38,6.061,6,32,2,282,H1
"Yakutat City and Borough, AK",2009-2010,665,661,-4,-0.602,6,-10,2,282,H1
"Yakutat City and Borough, AK",2010-2011,661,647,-14,-2.118,3,-17,2,282,H1
"Yakutat City and Borough, AK",2011-2012,647,651,4,0.618,6,-2,2,282,H1
"Yakutat City and Borough, AK",2012-2013,651,634,-17,-2.611,4,-21,2,282,H1
"Yakutat City and Borough, AK",2013-2014,634,635,1,0.158,7,-6,2,282,H1
"Yakutat City and Borough, AK",2014-2015,634,613,-21,-3.312,9,-30,2,282,H1
"Yakutat City and Borough, AK",2015-2016,613,612,-1,-0.163,5,-6,2,282,H1
"Yakutat City and Borough, AK",2016-2017,612,605,-7,-1.144,6,-13,2,282,H1
"Yukon-Koyukuk Census Area, AK",2000-2001,6489,6364,-125,-1.926,33,-158,2,290,H5
"Yukon-Koyukuk Census Area, AK",2001-2002,6364,6334,-30,-0.471,50,-80,2,290,H5
"Yukon-Koyukuk Census Area, AK",2002-2003,6334,6252,-82,-1.295,56,-138,2,290,H5
"Yukon-Koyukuk Census Area, AK",2003-2004,6252,6218,-34,-0.544,40,-74,2,290,H5
"Yukon-Koyukuk Census Area, AK",2004-2005,6218,6.00E+03,-218,-3.506,25,-243,2,290,H5
"Yukon-Koyukuk Census Area, AK",2005-2006,6.00E+03,5762,-238,-3.967,35,-273,2,290,H5
"Yukon-Koyukuk Census Area, AK",2006-2007,5762,5712,-50,-0.868,27,-77,2,290,H5
"Yukon-Koyukuk Census Area, AK",2007-2008,5712,5585,-127,-2.223,64,-191,2,290,H5
"Yukon-Koyukuk Census Area, AK",2008-2009,5585,5495,-90,-1.611,75,-165,2,290,H5
"Yukon-Koyukuk Census Area, AK",2009-2010,5495,5589,94,1.711,86,8,2,290,H5
"Yukon-Koyukuk Census Area, AK",2010-2011,5589,5733,144,2.576,43,101,2,290,H5
"Yukon-Koyukuk Census Area, AK",2011-2012,5733,5731,-2,-0.035,27,-29,2,290,H5
"Yukon-Koyukuk Census Area, AK",2012-2013,5731,5654,-77,-1.344,20,-97,2,290,H5
"Yukon-Koyukuk Census Area, AK",2013-2014,5654,5547,-107,-1.892,7,-114,2,290,H5
"Yukon-Koyukuk Census Area, AK",2014-2015,5563,5533,-30,-0.539,8,-38,2,290,H5
"Yukon-Koyukuk Census Area, AK",2015-2016,5533,5412,-121,-2.187,15,-136,2,290,H5
"Yukon-Koyukuk Census Area, AK",2016-2017,5412,5365,-47,-0.868,-11,-36,2,290,H5
South Dakota,2000-2001,755844,757972,2128,0.282,3489,-1361,46,0,STATE
South Dakota,2001-2002,757972,760020,2048,0.27,3491,-1443,46,0,STATE
South Dakota,2002-2003,760020,763729,3709,0.488,3899,-190,46,0,STATE
South Dakota,2003-2004,763729,770396,6667,0.873,4195,2472,46,0,STATE
South Dakota,2004-2005,770396,775493,5097,0.662,4506,591,46,0,STATE
South Dakota,2005-2006,775493,783033,7540,0.972,4624,2916,46,0,STATE
South Dakota,2006-2007,783033,791623,8590,1.097,5148,3442,46,0,STATE
South Dakota,2007-2008,791623,799124,7501,0.948,5257,2244,46,0,STATE
South Dakota,2008-2009,799124,807067,7943,0.994,5261,2682,46,0,STATE
South Dakota,2009-2010,807067,816299,9232,1.144,5278,3954,46,0,STATE
South Dakota,2010-2011,816299,824289,7990,0.979,4494,3496,46,0,STATE
South Dakota,2011-2012,824289,834631,10342,1.255,4457,5885,46,0,STATE
South Dakota,2012-2013,834631,845270,10639,1.275,4760,5879,46,0,STATE
South Dakota,2013-2014,845270,853304,8034,0.95,5574,2460,46,0,STATE
South Dakota,2014-2015,853304,858469,5165,0.605,5372,-207,46,0,STATE
South Dakota,2015-2016,858469,861542,3073,0.358,4926,-1853,46,0,STATE
South Dakota,2016-2017,861542,869666,8124,0.943,4879,3245,46,0,STATE
"Aurora County, SD",2000-2001,3045,2946,-99,-3.251,-14,-85,46,3,H1
"Aurora County, SD",2001-2002,2946,2869,-77,-2.614,-33,-44,46,3,H1
"Aurora County, SD",2002-2003,2869,2862,-7,-0.244,-5,-2,46,3,H1
"Aurora County, SD",2003-2004,2862,2860,-2,-0.07,-6,4,46,3,H1
"Aurora County, SD",2004-2005,2860,2789,-71,-2.483,-1,-70,46,3,H1
"Aurora County, SD",2005-2006,2789,2775,-14,-0.502,7,-21,46,3,H1
"Aurora County, SD",2006-2007,2775,2745,-30,-1.081,-6,-24,46,3,H1
"Aurora County, SD",2007-2008,2745,2750,5,0.182,3,2,46,3,H1
"Aurora County, SD",2008-2009,2750,2712,-38,-1.382,4,-42,46,3,H1
"Aurora County, SD",2009-2010,2712,2709,-3,-0.111,5,-8,46,3,H1
"Aurora County, SD",2010-2011,2709,2722,13,0.48,11,2,46,3,H1
"Aurora County, SD",2011-2012,2722,2751,29,1.065,6,23,46,3,H1
"Aurora County, SD",2012-2013,2751,2718,-33,-1.2,5,-38,46,3,H1
"Aurora County, SD",2013-2014,2718,2745,27,0.993,12,15,46,3,H1
"Aurora County, SD",2014-2015,2743,2733,-10,-0.365,22,-32,46,3,H1
"Aurora County, SD",2015-2016,2733,2750,17,0.622,19,-2,46,3,H1
"Aurora County, SD",2016-2017,2750,2738,-12,-0.436,19,-31,46,3,H1
"Beadle County, SD",2000-2001,17030,16952,-78,-0.458,-51,-27,46,5,H1
"Beadle County, SD",2001-2002,16952,16767,-185,-1.091,22,-207,46,5,H1
"Beadle County, SD",2002-2003,16767,16504,-263,-1.569,-5,-258,46,5,H1
"Beadle County, SD",2003-2004,16504,16370,-134,-0.812,11,-145,46,5,H1
"Beadle County, SD",2004-2005,16370,16304,-66,-0.403,-38,-28,46,5,H1
"Beadle County, SD",2005-2006,16304,16149,-155,-0.951,-21,-134,46,5,H1
"Beadle County, SD",2006-2007,16149,16489,340,2.105,42,298,46,5,H1
"Beadle County, SD",2007-2008,16489,16810,321,1.947,36,285,46,5,H1
"Beadle County, SD",2008-2009,16810,17288,478,2.844,17,461,46,5,H1
"Beadle County, SD",2009-2010,17288,17412,124,0.717,24,100,46,5,H1
"Beadle County, SD",2010-2011,17412,17732,320,1.838,98,222,46,5,H1
"Beadle County, SD",2011-2012,17732,1.80E+04,268,1.511,92,176,46,5,H1
"Beadle County, SD",2012-2013,1.80E+04,18299,299,1.661,172,127,46,5,H1
"Beadle County, SD",2013-2014,18299,18169,-130,-0.71,151,-281,46,5,H1
"Beadle County, SD",2014-2015,18304,18372,68,0.372,153,-85,46,5,H1
"Beadle County, SD",2015-2016,18372,18087,-285,-1.551,141,-426,46,5,H1
"Beadle County, SD",2016-2017,18087,18157,70,0.387,122,-52,46,5,H1
"Bennett County, SD",2000-2001,3572,3518,-54,-1.512,30,-84,46,7,H1
"Bennett County, SD",2001-2002,3518,3519,1,0.028,32,-31,46,7,H1
"Bennett County, SD",2002-2003,3519,3513,-6,-0.171,46,-52,46,7,H1
"Bennett County, SD",2003-2004,3513,3519,6,0.171,45,-39,46,7,H1
"Bennett County, SD",2004-2005,3519,3547,28,0.796,36,-8,46,7,H1
"Bennett County, SD",2005-2006,3547,3475,-72,-2.03,32,-104,46,7,H1
"Bennett County, SD",2006-2007,3475,3466,-9,-0.259,35,-44,46,7,H1
"Bennett County, SD",2007-2008,3466,3429,-37,-1.068,37,-74,46,7,H1
"Bennett County, SD",2008-2009,3429,3397,-32,-0.933,57,-89,46,7,H1
"Bennett County, SD",2009-2010,3397,3442,45,1.325,45,0,46,7,H1
"Bennett County, SD",2010-2011,3442,3437,-5,-0.145,29,-34,46,7,H1
"Bennett County, SD",2011-2012,3437,3438,1,0.029,48,-47,46,7,H1
"Bennett County, SD",2012-2013,3438,3451,13,0.378,44,-31,46,7,H1
"Bennett County, SD",2013-2014,3451,3430,-21,-0.609,42,-63,46,7,H1
"Bennett County, SD",2014-2015,3432,3423,-9,-0.262,34,-43,46,7,H1
"Bennett County, SD",2015-2016,3423,3447,24,0.701,49,-25,46,7,H1
"Bennett County, SD",2016-2017,3447,3454,7,0.203,30,-23,46,7,H1
"Bon Homme County, SD",2000-2001,7243,7169,-74,-1.022,-22,-52,46,9,H1
"Bon Homme County, SD",2001-2002,7169,7091,-78,-1.088,-35,-43,46,9,H1
"Bon Homme County, SD",2002-2003,7091,7074,-17,-0.24,-25,8,46,9,H1
"Bon Homme County, SD",2003-2004,7074,7014,-60,-0.848,-26,-34,46,9,H1
"Bon Homme County, SD",2004-2005,7014,6985,-29,-0.413,-2,-27,46,9,H1
"Bon Homme County, SD",2005-2006,6985,7174,189,2.706,-3,192,46,9,H1
"Bon Homme County, SD",2006-2007,7174,7060,-114,-1.589,-38,-76,46,9,H1
"Bon Homme County, SD",2007-2008,7060,7040,-20,-0.283,-18,-2,46,9,H1
"Bon Homme County, SD",2008-2009,7040,7049,9,0.128,-5,14,46,9,H1
"Bon Homme County, SD",2009-2010,7049,7059,10,0.142,-1,11,46,9,H1
"Bon Homme County, SD",2010-2011,7059,7029,-30,-0.425,-2,-28,46,9,H1
"Bon Homme County, SD",2011-2012,7029,7038,9,0.128,-5,14,46,9,H1
"Bon Homme County, SD",2012-2013,7038,7010,-28,-0.398,-11,-17,46,9,H1
"Bon Homme County, SD",2013-2014,7010,7023,13,0.185,0,13,46,9,H1
"Bon Homme County, SD",2014-2015,7008,6985,-23,-0.328,-10,-13,46,9,H1
"Bon Homme County, SD",2015-2016,6985,6968,-17,-0.243,-2,-15,46,9,H1
"Bon Homme County, SD",2016-2017,6968,6984,16,0.23,8,8,46,9,H1
"Brookings County, SD",2000-2001,28342,28565,223,0.787,97,126,46,11,H1
"Brookings County, SD",2001-2002,28565,28913,348,1.218,174,174,46,11,H1
"Brookings County, SD",2002-2003,28913,29171,258,0.892,113,145,46,11,H1
"Brookings County, SD",2003-2004,29171,29393,222,0.761,132,90,46,11,H1
"Brookings County, SD",2004-2005,29393,29485,92,0.313,183,-91,46,11,H1
"Brookings County, SD",2005-2006,29485,30323,838,2.842,172,666,46,11,H1
"Brookings County, SD",2006-2007,30323,30831,508,1.675,155,353,46,11,H1
"Brookings County, SD",2007-2008,30831,31363,532,1.726,190,342,46,11,H1
"Brookings County, SD",2008-2009,31363,31729,366,1.167,183,183,46,11,H1
"Brookings County, SD",2009-2010,31729,32020,291,0.917,201,90,46,11,H1
"Brookings County, SD",2010-2011,32020,32130,110,0.344,182,-72,46,11,H1
"Brookings County, SD",2011-2012,32130,32686,556,1.73,187,369,46,11,H1
"Brookings County, SD",2012-2013,32686,33087,401,1.227,224,177,46,11,H1
"Brookings County, SD",2013-2014,33087,33314,227,0.686,221,6,46,11,H1
"Brookings County, SD",2014-2015,33394,33897,503,1.506,232,271,46,11,H1
"Brookings County, SD",2015-2016,33897,34057,160,0.472,256,-96,46,11,H1
"Brookings County, SD",2016-2017,34057,34255,198,0.581,242,-44,46,11,H1
"Brown County, SD",2000-2001,35472,35303,-169,-0.476,75,-244,46,13,H1
"Brown County, SD",2001-2002,35303,35187,-116,-0.329,66,-182,46,13,H1
"Brown County, SD",2002-2003,35187,35223,36,0.102,158,-122,46,13,H1
"Brown County, SD",2003-2004,35223,35329,106,0.301,122,-16,46,13,H1
"Brown County, SD",2004-2005,35329,35441,112,0.317,78,34,46,13,H1
"Brown County, SD",2005-2006,35441,35561,120,0.339,120,0,46,13,H1
"Brown County, SD",2006-2007,35561,35821,260,0.731,132,128,46,13,H1
"Brown County, SD",2007-2008,35821,35865,44,0.123,156,-112,46,13,H1
"Brown County, SD",2008-2009,35865,36181,316,0.881,106,210,46,13,H1
"Brown County, SD",2009-2010,36181,36626,445,1.23,135,310,46,13,H1
"Brown County, SD",2010-2011,36626,36931,305,0.833,128,177,46,13,H1
"Brown County, SD",2011-2012,36931,37514,583,1.579,67,516,46,13,H1
"Brown County, SD",2012-2013,37514,38162,648,1.727,127,521,46,13,H1
"Brown County, SD",2013-2014,38162,38408,246,0.645,140,106,46,13,H1
"Brown County, SD",2014-2015,38602,38785,183,0.474,152,31,46,13,H1
"Brown County, SD",2015-2016,38785,38918,133,0.343,185,-52,46,13,H1
"Brown County, SD",2016-2017,38918,39178,260,0.668,167,93,46,13,H1
"Brule County, SD",2000-2001,5334,5179,-155,-2.906,13,-168,46,15,H1
"Brule County, SD",2001-2002,5179,5067,-112,-2.163,3,-115,46,15,H1
"Brule County, SD",2002-2003,5067,5058,-9,-0.178,7,-16,46,15,H1
"Brule County, SD",2003-2004,5058,5030,-28,-0.554,-4,-24,46,15,H1
"Brule County, SD",2004-2005,5030,5010,-20,-0.398,24,-44,46,15,H1
"Brule County, SD",2005-2006,5010,4991,-19,-0.379,11,-30,46,15,H1
"Brule County, SD",2006-2007,4991,5079,88,1.763,1,87,46,15,H1
"Brule County, SD",2007-2008,5079,5112,33,0.65,42,-9,46,15,H1
"Brule County, SD",2008-2009,5112,5184,72,1.408,26,46,46,15,H1
"Brule County, SD",2009-2010,5184,5266,82,1.582,13,69,46,15,H1
"Brule County, SD",2010-2011,5266,5306,40,0.76,8,32,46,15,H1
"Brule County, SD",2011-2012,5306,5304,-2,-0.038,11,-13,46,15,H1
"Brule County, SD",2012-2013,5304,5372,68,1.282,31,37,46,15,H1
"Brule County, SD",2013-2014,5372,5309,-63,-1.173,33,-96,46,15,H1
"Brule County, SD",2014-2015,5329,5281,-48,-0.901,20,-68,46,15,H1
"Brule County, SD",2015-2016,5281,5213,-68,-1.288,21,-89,46,15,H1
"Brule County, SD",2016-2017,5213,5312,99,1.899,15,84,46,15,H1
"Buffalo County, SD",2000-2001,1991,2004,13,0.653,23,-10,46,17,H1
"Buffalo County, SD",2001-2002,2004,1977,-27,-1.347,23,-50,46,17,H1
"Buffalo County, SD",2002-2003,1977,1978,1,0.051,46,-45,46,17,H1
"Buffalo County, SD",2003-2004,1978,1977,-1,-0.051,51,-52,46,17,H1
"Buffalo County, SD",2004-2005,1977,1959,-18,-0.91,37,-55,46,17,H1
"Buffalo County, SD",2005-2006,1959,1973,14,0.715,48,-34,46,17,H1
"Buffalo County, SD",2006-2007,1973,1937,-36,-1.825,37,-73,46,17,H1
"Buffalo County, SD",2007-2008,1937,1956,19,0.981,57,-38,46,17,H1
"Buffalo County, SD",2008-2009,1956,1858,-98,-5.01,60,-158,46,17,H1
"Buffalo County, SD",2009-2010,1858,1942,84,4.521,43,41,46,17,H1
"Buffalo County, SD",2010-2011,1942,1986,44,2.266,34,10,46,17,H1
"Buffalo County, SD",2011-2012,1986,2026,40,2.014,43,-3,46,17,H1
"Buffalo County, SD",2012-2013,2026,2033,7,0.346,34,-27,46,17,H1
"Buffalo County, SD",2013-2014,2033,2077,44,2.164,22,22,46,17,H1
"Buffalo County, SD",2014-2015,2084,2095,11,0.528,26,-15,46,17,H1
"Buffalo County, SD",2015-2016,2095,2032,-63,-3.007,14,-77,46,17,H1
"Buffalo County, SD",2016-2017,2032,1999,-33,-1.624,8,-41,46,17,H1
"Butte County, SD",2000-2001,9093,9120,27,0.297,45,-18,46,19,H1
"Butte County, SD",2001-2002,9120,9046,-74,-0.811,9,-83,46,19,H1
"Butte County, SD",2002-2003,9046,9199,153,1.691,12,141,46,19,H1
"Butte County, SD",2003-2004,9199,9284,85,0.924,39,46,46,19,H1
"Butte County, SD",2004-2005,9284,9422,138,1.486,33,105,46,19,H1
"Butte County, SD",2005-2006,9422,9517,95,1.008,32,63,46,19,H1
"Butte County, SD",2006-2007,9517,9817,300,3.152,45,255,46,19,H1
"Butte County, SD",2007-2008,9817,9977,160,1.63,33,127,46,19,H1
"Butte County, SD",2008-2009,9977,9989,12,0.12,50,-38,46,19,H1
"Butte County, SD",2009-2010,9989,10126,137,1.372,25,112,46,19,H1
"Butte County, SD",2010-2011,10126,10307,181,1.787,27,154,46,19,H1
"Butte County, SD",2011-2012,10307,10238,-69,-0.669,-4,-65,46,19,H1
"Butte County, SD",2012-2013,10238,10325,87,0.85,32,55,46,19,H1
"Butte County, SD",2013-2014,10325,10298,-27,-0.262,31,-58,46,19,H1
"Butte County, SD",2014-2015,10307,10283,-24,-0.233,40,-64,46,19,H1
"Butte County, SD",2015-2016,10283,10127,-156,-1.517,13,-169,46,19,H1
"Butte County, SD",2016-2017,10127,10107,-20,-0.197,14,-34,46,19,H1
"Campbell County, SD",2000-2001,1781,1766,-15,-0.842,-5,-10,46,21,H1
"Campbell County, SD",2001-2002,1766,1738,-28,-1.586,1,-29,46,21,H1
"Campbell County, SD",2002-2003,1738,1691,-47,-2.704,-6,-41,46,21,H1
"Campbell County, SD",2003-2004,1691,1647,-44,-2.602,-1,-43,46,21,H1
"Campbell County, SD",2004-2005,1647,1591,-56,-3.4,-13,-43,46,21,H1
"Campbell County, SD",2005-2006,1591,1533,-58,-3.646,-14,-44,46,21,H1
"Campbell County, SD",2006-2007,1533,1474,-59,-3.849,3,-62,46,21,H1
"Campbell County, SD",2007-2008,1474,1456,-18,-1.221,-2,-16,46,21,H1
"Campbell County, SD",2008-2009,1456,1454,-2,-0.137,-2,0,46,21,H1
"Campbell County, SD",2009-2010,1454,1474,20,1.376,2,18,46,21,H1
"Campbell County, SD",2010-2011,1474,1416,-58,-3.935,-5,-53,46,21,H1
"Campbell County, SD",2011-2012,1416,1389,-27,-1.907,-13,-14,46,21,H1
"Campbell County, SD",2012-2013,1389,1347,-42,-3.024,3,-45,46,21,H1
"Campbell County, SD",2013-2014,1347,1386,39,2.895,7,32,46,21,H1
"Campbell County, SD",2014-2015,1375,1397,22,1.6,10,12,46,21,H1
"Campbell County, SD",2015-2016,1397,1388,-9,-0.644,-2,-7,46,21,H1
"Campbell County, SD",2016-2017,1388,1379,-9,-0.648,3,-12,46,21,H1
"Charles Mix County, SD",2000-2001,9340,9207,-133,-1.424,35,-168,46,23,H1
"Charles Mix County, SD",2001-2002,9207,9164,-43,-0.467,66,-109,46,23,H1
"Charles Mix County, SD",2002-2003,9164,9075,-89,-0.971,33,-122,46,23,H1
"Charles Mix County, SD",2003-2004,9075,9055,-20,-0.22,50,-70,46,23,H1
"Charles Mix County, SD",2004-2005,9055,9134,79,0.872,70,9,46,23,H1
"Charles Mix County, SD",2005-2006,9134,9110,-24,-0.263,64,-88,46,23,H1
"Charles Mix County, SD",2006-2007,9110,9034,-76,-0.834,42,-118,46,23,H1
"Charles Mix County, SD",2007-2008,9034,9009,-25,-0.277,63,-88,46,23,H1
"Charles Mix County, SD",2008-2009,9009,9079,70,0.777,54,16,46,23,H1
"Charles Mix County, SD",2009-2010,9079,9145,66,0.727,60,6,46,23,H1
"Charles Mix County, SD",2010-2011,9145,9192,47,0.514,40,7,46,23,H1
"Charles Mix County, SD",2011-2012,9192,9210,18,0.196,74,-56,46,23,H1
"Charles Mix County, SD",2012-2013,9210,9211,1,0.011,89,-88,46,23,H1
"Charles Mix County, SD",2013-2014,9211,9287,76,0.825,66,10,46,23,H1
"Charles Mix County, SD",2014-2015,9248,9383,135,1.46,66,69,46,23,H1
"Charles Mix County, SD",2015-2016,9383,9382,-1,-0.011,47,-48,46,23,H1
"Charles Mix County, SD",2016-2017,9382,9428,46,0.49,52,-6,46,23,H1
"Clark County, SD",2000-2001,4129,4144,15,0.363,-6,21,46,25,H1
"Clark County, SD",2001-2002,4144,4003,-141,-3.403,-16,-125,46,25,H1
"Clark County, SD",2002-2003,4003,3958,-45,-1.124,-3,-42,46,25,H1
"Clark County, SD",2003-2004,3958,3897,-61,-1.541,2,-63,46,25,H1
"Clark County, SD",2004-2005,3897,3827,-70,-1.796,-16,-54,46,25,H1
"Clark County, SD",2005-2006,3827,3713,-114,-2.979,-13,-101,46,25,H1
"Clark County, SD",2006-2007,3713,3711,-2,-0.054,-1,-1,46,25,H1
"Clark County, SD",2007-2008,3711,3714,3,0.081,-3,6,46,25,H1
"Clark County, SD",2008-2009,3714,3688,-26,-0.7,-9,-17,46,25,H1
"Clark County, SD",2009-2010,3688,3701,13,0.352,-7,20,46,25,H1
"Clark County, SD",2010-2011,3701,3596,-105,-2.837,-20,-85,46,25,H1
"Clark County, SD",2011-2012,3596,3583,-13,-0.362,-16,3,46,25,H1
"Clark County, SD",2012-2013,3583,3628,45,1.256,18,27,46,25,H1
"Clark County, SD",2013-2014,3628,3645,17,0.469,6,11,46,25,H1
"Clark County, SD",2014-2015,3662,3659,-3,-0.082,19,-22,46,25,H1
"Clark County, SD",2015-2016,3659,3640,-19,-0.519,25,-44,46,25,H1
"Clark County, SD",2016-2017,3640,3668,28,0.769,20,8,46,25,H1
"Clay County, SD",2000-2001,13510,13627,117,0.866,78,39,46,27,H1
"Clay County, SD",2001-2002,13627,13505,-122,-0.895,43,-165,46,27,H1
"Clay County, SD",2002-2003,13505,13536,31,0.23,73,-42,46,27,H1
"Clay County, SD",2003-2004,13536,13449,-87,-0.643,57,-144,46,27,H1
"Clay County, SD",2004-2005,13449,13517,68,0.506,43,25,46,27,H1
"Clay County, SD",2005-2006,13517,13627,110,0.814,70,40,46,27,H1
"Clay County, SD",2006-2007,13627,13785,158,1.159,68,90,46,27,H1
"Clay County, SD",2007-2008,13785,13959,174,1.262,81,93,46,27,H1
"Clay County, SD",2008-2009,13959,13846,-113,-0.81,84,-197,46,27,H1
"Clay County, SD",2009-2010,13846,13846,0,0,58,-58,46,27,H1
"Clay County, SD",2010-2011,13846,14035,189,1.365,68,121,46,27,H1
"Clay County, SD",2011-2012,14035,14091,56,0.399,44,12,46,27,H1
"Clay County, SD",2012-2013,14091,13937,-154,-1.093,66,-220,46,27,H1
"Clay County, SD",2013-2014,13937,13932,-5,-0.036,69,-74,46,27,H1
"Clay County, SD",2014-2015,13991,13964,-27,-0.193,72,-99,46,27,H1
"Clay County, SD",2015-2016,13964,13938,-26,-0.186,60,-86,46,27,H1
"Clay County, SD",2016-2017,13938,13990,52,0.373,55,-3,46,27,H1
"Codington County, SD",2000-2001,25950,26033,83,0.32,103,-20,46,29,H1
"Codington County, SD",2001-2002,26033,26100,67,0.257,109,-42,46,29,H1
"Codington County, SD",2002-2003,26100,26184,84,0.322,141,-57,46,29,H1
"Codington County, SD",2003-2004,26184,26254,70,0.267,132,-62,46,29,H1
"Codington County, SD",2004-2005,26254,26364,110,0.419,178,-68,46,29,H1
"Codington County, SD",2005-2006,26364,26754,390,1.479,138,252,46,29,H1
"Codington County, SD",2006-2007,26754,27036,282,1.054,184,98,46,29,H1
"Codington County, SD",2007-2008,27036,27043,7,0.026,163,-156,46,29,H1
"Codington County, SD",2008-2009,27043,27137,94,0.348,137,-43,46,29,H1
"Codington County, SD",2009-2010,27137,27218,81,0.298,152,-71,46,29,H1
"Codington County, SD",2010-2011,27218,27399,181,0.665,130,51,46,29,H1
"Codington County, SD",2011-2012,27399,27581,182,0.664,122,60,46,29,H1
"Codington County, SD",2012-2013,27581,27855,274,0.993,189,85,46,29,H1
"Codington County, SD",2013-2014,27855,27938,83,0.298,160,-77,46,29,H1
"Codington County, SD",2014-2015,27960,27939,-21,-0.075,170,-191,46,29,H1
"Codington County, SD",2015-2016,27939,28033,94,0.336,138,-44,46,29,H1
"Codington County, SD",2016-2017,28033,28099,66,0.235,139,-73,46,29,H1
"Corson County, SD",2000-2001,4194,4162,-32,-0.763,45,-77,46,31,H1
"Corson County, SD",2001-2002,4162,4208,46,1.105,45,1,46,31,H1
"Corson County, SD",2002-2003,4208,4236,28,0.665,56,-28,46,31,H1
"Corson County, SD",2003-2004,4236,4256,20,0.472,36,-16,46,31,H1
"Corson County, SD",2004-2005,4256,4213,-43,-1.01,61,-104,46,31,H1
"Corson County, SD",2005-2006,4213,4041,-172,-4.083,41,-213,46,31,H1
"Corson County, SD",2006-2007,4041,4118,77,1.905,47,30,46,31,H1
"Corson County, SD",2007-2008,4118,4051,-67,-1.627,74,-141,46,31,H1
"Corson County, SD",2008-2009,4051,3983,-68,-1.679,74,-142,46,31,H1
"Corson County, SD",2009-2010,3983,4067,84,2.109,57,27,46,31,H1
"Corson County, SD",2010-2011,4067,4047,-20,-0.492,31,-51,46,31,H1
"Corson County, SD",2011-2012,4047,4082,35,0.865,43,-8,46,31,H1
"Corson County, SD",2012-2013,4082,4230,148,3.626,52,96,46,31,H1
"Corson County, SD",2013-2014,4230,4182,-48,-1.135,40,-88,46,31,H1
"Corson County, SD",2014-2015,4195,4197,2,0.048,41,-39,46,31,H1
"Corson County, SD",2015-2016,4197,4125,-72,-1.716,47,-119,46,31,H1
"Corson County, SD",2016-2017,4125,4203,78,1.891,42,36,46,31,H1
"Custer County, SD",2000-2001,7345,7368,23,0.313,-4,27,46,33,H1
"Custer County, SD",2001-2002,7368,7499,131,1.778,-31,162,46,33,H1
"Custer County, SD",2002-2003,7499,7588,89,1.187,4,85,46,33,H1
"Custer County, SD",2003-2004,7588,7795,207,2.728,4,203,46,33,H1
"Custer County, SD",2004-2005,7795,7810,15,0.192,15,0,46,33,H1
"Custer County, SD",2005-2006,7810,7992,182,2.33,6,176,46,33,H1
"Custer County, SD",2006-2007,7992,8028,36,0.45,-11,47,46,33,H1
"Custer County, SD",2007-2008,8028,8060,32,0.399,11,21,46,33,H1
"Custer County, SD",2008-2009,8060,8095,35,0.434,-8,43,46,33,H1
"Custer County, SD",2009-2010,8095,8269,174,2.149,-27,201,46,33,H1
"Custer County, SD",2010-2011,8269,8335,66,0.798,-6,72,46,33,H1
"Custer County, SD",2011-2012,8335,8315,-20,-0.24,-22,2,46,33,H1
"Custer County, SD",2012-2013,8315,8424,109,1.311,-4,113,46,33,H1
"Custer County, SD",2013-2014,8424,8445,21,0.249,-3,24,46,33,H1
"Custer County, SD",2014-2015,8445,8446,1,0.012,-8,9,46,33,H1
"Custer County, SD",2015-2016,8446,8616,170,2.013,-26,196,46,33,H1
"Custer County, SD",2016-2017,8616,8691,75,0.87,-8,83,46,33,H1
"Davison County, SD",2000-2001,18763,18868,105,0.56,91,14,46,35,H1
"Davison County, SD",2001-2002,18868,18862,-6,-0.032,43,-49,46,35,H1
"Davison County, SD",2002-2003,18862,18907,45,0.239,51,-6,46,35,H1
"Davison County, SD",2003-2004,18907,19104,197,1.042,78,119,46,35,H1
"Davison County, SD",2004-2005,19104,19126,22,0.115,96,-74,46,35,H1
"Davison County, SD",2005-2006,19126,19404,278,1.454,111,167,46,35,H1
"Davison County, SD",2006-2007,19404,19351,-53,-0.273,96,-149,46,35,H1
"Davison County, SD",2007-2008,19351,19318,-33,-0.171,101,-134,46,35,H1
"Davison County, SD",2008-2009,19318,19377,59,0.305,120,-61,46,35,H1
"Davison County, SD",2009-2010,19377,19515,138,0.712,113,25,46,35,H1
"Davison County, SD",2010-2011,19515,19615,100,0.512,69,31,46,35,H1
"Davison County, SD",2011-2012,19615,19798,183,0.933,43,140,46,35,H1
"Davison County, SD",2012-2013,19798,19839,41,0.207,77,-36,46,35,H1
"Davison County, SD",2013-2014,19839,19885,46,0.232,92,-46,46,35,H1
"Davison County, SD",2014-2015,19861,19858,-3,-0.015,75,-78,46,35,H1
"Davison County, SD",2015-2016,19858,19831,-27,-0.136,51,-78,46,35,H1
"Davison County, SD",2016-2017,19831,19704,-127,-0.64,60,-187,46,35,H1
"Day County, SD",2000-2001,6226,6090,-136,-2.184,-25,-111,46,37,H1
"Day County, SD",2001-2002,6090,6040,-50,-0.821,-39,-11,46,37,H1
"Day County, SD",2002-2003,6040,5929,-111,-1.838,-20,-91,46,37,H1
"Day County, SD",2003-2004,5929,5879,-50,-0.843,-38,-12,46,37,H1
"Day County, SD",2004-2005,5879,5872,-7,-0.119,-14,7,46,37,H1
"Day County, SD",2005-2006,5872,5805,-67,-1.141,-34,-33,46,37,H1
"Day County, SD",2006-2007,5805,5752,-53,-0.913,-3,-50,46,37,H1
"Day County, SD",2007-2008,5752,5638,-114,-1.982,-6,-108,46,37,H1
"Day County, SD",2008-2009,5638,5653,15,0.266,-10,25,46,37,H1
"Day County, SD",2009-2010,5653,5715,62,1.097,-4,66,46,37,H1
"Day County, SD",2010-2011,5715,5763,48,0.84,9,39,46,37,H1
"Day County, SD",2011-2012,5763,5636,-127,-2.204,-19,-108,46,37,H1
"Day County, SD",2012-2013,5636,5617,-19,-0.337,-13,-6,46,37,H1
"Day County, SD",2013-2014,5617,5588,-29,-0.516,-17,-12,46,37,H1
"Day County, SD",2014-2015,5558,5539,-19,-0.342,-25,6,46,37,H1
"Day County, SD",2015-2016,5539,5514,-25,-0.451,-2,-23,46,37,H1
"Day County, SD",2016-2017,5514,5521,7,0.127,-19,26,46,37,H1
"Deuel County, SD",2000-2001,4495,4482,-13,-0.289,3,-16,46,39,H1
"Deuel County, SD",2001-2002,4482,4473,-9,-0.201,-1,-8,46,39,H1
"Deuel County, SD",2002-2003,4473,4402,-71,-1.587,-1,-70,46,39,H1
"Deuel County, SD",2003-2004,4402,4345,-57,-1.295,-5,-52,46,39,H1
"Deuel County, SD",2004-2005,4345,4389,44,1.013,-2,46,46,39,H1
"Deuel County, SD",2005-2006,4389,4394,5,0.114,9,-4,46,39,H1
"Deuel County, SD",2006-2007,4394,4344,-50,-1.138,-12,-38,46,39,H1
"Deuel County, SD",2007-2008,4344,4394,50,1.151,18,32,46,39,H1
"Deuel County, SD",2008-2009,4394,4379,-15,-0.341,32,-47,46,39,H1
"Deuel County, SD",2009-2010,4379,4348,-31,-0.708,22,-53,46,39,H1
"Deuel County, SD",2010-2011,4348,4368,20,0.46,11,9,46,39,H1
"Deuel County, SD",2011-2012,4368,4368,0,0,-10,10,46,39,H1
"Deuel County, SD",2012-2013,4368,4303,-65,-1.488,24,-89,46,39,H1
"Deuel County, SD",2013-2014,4303,4312,9,0.209,13,-4,46,39,H1
"Deuel County, SD",2014-2015,4320,4333,13,0.301,12,1,46,39,H1
"Deuel County, SD",2015-2016,4333,4238,-95,-2.192,15,-110,46,39,H1
"Deuel County, SD",2016-2017,4238,4281,43,1.015,15,28,46,39,H1
"Dewey County, SD",2000-2001,5948,5907,-41,-0.689,94,-135,46,41,H1
"Dewey County, SD",2001-2002,5907,5825,-82,-1.388,98,-180,46,41,H1
"Dewey County, SD",2002-2003,5825,5839,14,0.24,108,-94,46,41,H1
"Dewey County, SD",2003-2004,5839,5722,-117,-2.004,84,-201,46,41,H1
"Dewey County, SD",2004-2005,5722,5667,-55,-0.961,103,-158,46,41,H1
"Dewey County, SD",2005-2006,5667,5537,-130,-2.294,95,-225,46,41,H1
"Dewey County, SD",2006-2007,5537,5402,-135,-2.438,102,-237,46,41,H1
"Dewey County, SD",2007-2008,5402,5245,-157,-2.906,129,-286,46,41,H1
"Dewey County, SD",2008-2009,5245,5252,7,0.133,129,-122,46,41,H1
"Dewey County, SD",2009-2010,5252,5329,77,1.466,123,-46,46,41,H1
"Dewey County, SD",2010-2011,5329,5407,78,1.464,62,16,46,41,H1
"Dewey County, SD",2011-2012,5407,5544,137,2.534,102,35,46,41,H1
"Dewey County, SD",2012-2013,5544,5606,62,1.118,69,-7,46,41,H1
"Dewey County, SD",2013-2014,5606,5662,56,0.999,61,-5,46,41,H1
"Dewey County, SD",2014-2015,5677,5685,8,0.141,59,-51,46,41,H1
"Dewey County, SD",2015-2016,5685,5774,89,1.566,92,-3,46,41,H1
"Dewey County, SD",2016-2017,5774,5835,61,1.056,78,-17,46,41,H1
"Douglas County, SD",2000-2001,3439,3419,-20,-0.582,-9,-11,46,43,H1
"Douglas County, SD",2001-2002,3419,3351,-68,-1.989,-21,-47,46,43,H1
"Douglas County, SD",2002-2003,3351,3295,-56,-1.671,6,-62,46,43,H1
"Douglas County, SD",2003-2004,3295,3280,-15,-0.455,-5,-10,46,43,H1
"Douglas County, SD",2004-2005,3280,3242,-38,-1.159,-15,-23,46,43,H1
"Douglas County, SD",2005-2006,3242,3131,-111,-3.424,-20,-91,46,43,H1
"Douglas County, SD",2006-2007,3131,3080,-51,-1.629,-8,-43,46,43,H1
"Douglas County, SD",2007-2008,3080,3006,-74,-2.403,-5,-69,46,43,H1
"Douglas County, SD",2008-2009,3006,3017,11,0.366,-11,22,46,43,H1
"Douglas County, SD",2009-2010,3017,2993,-24,-0.795,-9,-15,46,43,H1
"Douglas County, SD",2010-2011,2993,2993,0,0,-17,17,46,43,H1
"Douglas County, SD",2011-2012,2993,2972,-21,-0.702,-19,-2,46,43,H1
"Douglas County, SD",2012-2013,2972,3017,45,1.514,6,39,46,43,H1
"Douglas County, SD",2013-2014,3017,2973,-44,-1.458,4,-48,46,43,H1
"Douglas County, SD",2014-2015,2948,2977,29,0.984,-5,34,46,43,H1
"Douglas County, SD",2015-2016,2977,2910,-67,-2.251,7,-74,46,43,H1
"Douglas County, SD",2016-2017,2910,2931,21,0.722,17,4,46,43,H1
"Edmunds County, SD",2000-2001,4353,4299,-54,-1.241,-24,-30,46,45,H1
"Edmunds County, SD",2001-2002,4299,4230,-69,-1.605,-11,-58,46,45,H1
"Edmunds County, SD",2002-2003,4230,4196,-34,-0.804,-8,-26,46,45,H1
"Edmunds County, SD",2003-2004,4196,4111,-85,-2.026,-11,-74,46,45,H1
"Edmunds County, SD",2004-2005,4111,4128,17,0.414,-2,19,46,45,H1
"Edmunds County, SD",2005-2006,4128,4043,-85,-2.059,-2,-83,46,45,H1
"Edmunds County, SD",2006-2007,4043,4026,-17,-0.42,-25,8,46,45,H1
"Edmunds County, SD",2007-2008,4026,4050,24,0.596,2,22,46,45,H1
"Edmunds County, SD",2008-2009,4050,4038,-12,-0.296,18,-30,46,45,H1
"Edmunds County, SD",2009-2010,4038,4075,37,0.916,9,28,46,45,H1
"Edmunds County, SD",2010-2011,4075,4061,-14,-0.344,-13,-1,46,45,H1
"Edmunds County, SD",2011-2012,4061,4028,-33,-0.813,-10,-23,46,45,H1
"Edmunds County, SD",2012-2013,4028,4035,7,0.174,9,-2,46,45,H1
"Edmunds County, SD",2013-2014,4035,3983,-52,-1.289,9,-61,46,45,H1
"Edmunds County, SD",2014-2015,3979,3999,20,0.503,12,8,46,45,H1
"Edmunds County, SD",2015-2016,3999,3938,-61,-1.525,9,-70,46,45,H1
"Edmunds County, SD",2016-2017,3938,3919,-19,-0.482,5,-24,46,45,H1
"Fall River County, SD",2000-2001,7375,7339,-36,-0.488,-43,7,46,47,H1
"Fall River County, SD",2001-2002,7339,7238,-101,-1.376,-60,-41,46,47,H1
"Fall River County, SD",2002-2003,7238,7212,-26,-0.359,-45,19,46,47,H1
"Fall River County, SD",2003-2004,7212,7178,-34,-0.471,-46,12,46,47,H1
"Fall River County, SD",2004-2005,7178,7181,3,0.042,-36,39,46,47,H1
"Fall River County, SD",2005-2006,7181,7108,-73,-1.017,-46,-27,46,47,H1
"Fall River County, SD",2006-2007,7108,7083,-25,-0.352,-36,11,46,47,H1
"Fall River County, SD",2007-2008,7083,7032,-51,-0.72,-51,0,46,47,H1
"Fall River County, SD",2008-2009,7032,7056,24,0.341,-35,59,46,47,H1
"Fall River County, SD",2009-2010,7056,7121,65,0.921,-47,112,46,47,H1
"Fall River County, SD",2010-2011,7121,6984,-137,-1.924,-65,-72,46,47,H1
"Fall River County, SD",2011-2012,6984,6999,15,0.215,-62,77,46,47,H1
"Fall River County, SD",2012-2013,6999,6837,-162,-2.315,-44,-118,46,47,H1
"Fall River County, SD",2013-2014,6837,6845,8,0.117,-42,50,46,47,H1
"Fall River County, SD",2014-2015,6864,6867,3,0.044,-35,38,46,47,H1
"Fall River County, SD",2015-2016,6867,6769,-98,-1.427,-48,-50,46,47,H1
"Fall River County, SD",2016-2017,6769,6687,-82,-1.211,-32,-50,46,47,H1
"Faulk County, SD",2000-2001,2617,2547,-70,-2.675,-1,-69,46,49,H1
"Faulk County, SD",2001-2002,2547,2514,-33,-1.296,-8,-25,46,49,H1
"Faulk County, SD",2002-2003,2514,2493,-21,-0.835,-2,-19,46,49,H1
"Faulk County, SD",2003-2004,2493,2440,-53,-2.126,-8,-45,46,49,H1
"Faulk County, SD",2004-2005,2440,2411,-29,-1.189,2,-31,46,49,H1
"Faulk County, SD",2005-2006,2411,2398,-13,-0.539,-4,-9,46,49,H1
"Faulk County, SD",2006-2007,2398,2406,8,0.334,-14,22,46,49,H1
"Faulk County, SD",2007-2008,2406,2415,9,0.374,3,6,46,49,H1
"Faulk County, SD",2008-2009,2415,2349,-66,-2.733,6,-72,46,49,H1
"Faulk County, SD",2009-2010,2349,2367,18,0.766,2,16,46,49,H1
"Faulk County, SD",2010-2011,2367,2374,7,0.296,3,4,46,49,H1
"Faulk County, SD",2011-2012,2374,2379,5,0.211,-3,8,46,49,H1
"Faulk County, SD",2012-2013,2379,2380,1,0.042,5,-4,46,49,H1
"Faulk County, SD",2013-2014,2380,2357,-23,-0.966,9,-32,46,49,H1
"Faulk County, SD",2014-2015,2345,2337,-8,-0.341,15,-23,46,49,H1
"Faulk County, SD",2015-2016,2337,2325,-12,-0.513,5,-17,46,49,H1
"Faulk County, SD",2016-2017,2325,2329,4,0.172,12,-8,46,49,H1
"Grant County, SD",2000-2001,7835,7699,-136,-1.736,-33,-103,46,51,H1
"Grant County, SD",2001-2002,7699,7672,-27,-0.351,-6,-21,46,51,H1
"Grant County, SD",2002-2003,7672,7703,31,0.404,-14,45,46,51,H1
"Grant County, SD",2003-2004,7703,7582,-121,-1.571,-18,-103,46,51,H1
"Grant County, SD",2004-2005,7582,7454,-128,-1.688,-47,-81,46,51,H1
"Grant County, SD",2005-2006,7454,7410,-44,-0.59,-5,-39,46,51,H1
"Grant County, SD",2006-2007,7410,7401,-9,-0.121,-15,6,46,51,H1
"Grant County, SD",2007-2008,7401,7389,-12,-0.162,-5,-7,46,51,H1
"Grant County, SD",2008-2009,7389,7369,-20,-0.271,-24,4,46,51,H1
"Grant County, SD",2009-2010,7369,7346,-23,-0.312,-24,1,46,51,H1
"Grant County, SD",2010-2011,7346,7259,-87,-1.184,0,-87,46,51,H1
"Grant County, SD",2011-2012,7259,7268,9,0.124,0,9,46,51,H1
"Grant County, SD",2012-2013,7268,7289,21,0.289,5,16,46,51,H1
"Grant County, SD",2013-2014,7289,7241,-48,-0.659,-5,-43,46,51,H1
"Grant County, SD",2014-2015,7221,7142,-79,-1.094,8,-87,46,51,H1
"Grant County, SD",2015-2016,7142,7095,-47,-0.658,-11,-36,46,51,H1
"Grant County, SD",2016-2017,7095,7061,-34,-0.479,6,-40,46,51,H1
"Gregory County, SD",2000-2001,4766,4632,-134,-2.812,-31,-103,46,53,H1
"Gregory County, SD",2001-2002,4632,4550,-82,-1.77,-24,-58,46,53,H1
"Gregory County, SD",2002-2003,4550,4494,-56,-1.231,-44,-12,46,53,H1
"Gregory County, SD",2003-2004,4494,4431,-63,-1.402,-38,-25,46,53,H1
"Gregory County, SD",2004-2005,4431,4378,-53,-1.196,-14,-39,46,53,H1
"Gregory County, SD",2005-2006,4378,4311,-67,-1.53,-30,-37,46,53,H1
"Gregory County, SD",2006-2007,4311,4267,-44,-1.021,-30,-14,46,53,H1
"Gregory County, SD",2007-2008,4267,4254,-13,-0.305,3,-16,46,53,H1
"Gregory County, SD",2008-2009,4254,4260,6,0.141,-12,18,46,53,H1
"Gregory County, SD",2009-2010,4260,4258,-2,-0.047,-11,9,46,53,H1
"Gregory County, SD",2010-2011,4258,4220,-38,-0.892,-18,-20,46,53,H1
"Gregory County, SD",2011-2012,4220,4248,28,0.664,-27,55,46,53,H1
"Gregory County, SD",2012-2013,4248,4231,-17,-0.4,-13,-4,46,53,H1
"Gregory County, SD",2013-2014,4231,4217,-14,-0.331,-12,-2,46,53,H1
"Gregory County, SD",2014-2015,4221,4201,-20,-0.474,1,-21,46,53,H1
"Gregory County, SD",2015-2016,4201,4171,-30,-0.714,8,-38,46,53,H1
"Gregory County, SD",2016-2017,4171,4226,55,1.319,10,45,46,53,H1
"Haakon County, SD",2000-2001,2201,2174,-27,-1.227,-2,-25,46,55,H1
"Haakon County, SD",2001-2002,2174,2134,-40,-1.84,-8,-32,46,55,H1
"Haakon County, SD",2002-2003,2134,2112,-22,-1.031,-1,-21,46,55,H1
"Haakon County, SD",2003-2004,2112,2080,-32,-1.515,-17,-15,46,55,H1
"Haakon County, SD",2004-2005,2080,2030,-50,-2.404,0,-50,46,55,H1
"Haakon County, SD",2005-2006,2030,1984,-46,-2.266,-15,-31,46,55,H1
"Haakon County, SD",2006-2007,1984,1957,-27,-1.361,-11,-16,46,55,H1
"Haakon County, SD",2007-2008,1957,1945,-12,-0.613,0,-12,46,55,H1
"Haakon County, SD",2008-2009,1945,1953,8,0.411,1,7,46,55,H1
"Haakon County, SD",2009-2010,1953,1923,-30,-1.536,4,-34,46,55,H1
"Haakon County, SD",2010-2011,1923,1910,-13,-0.676,-4,-9,46,55,H1
"Haakon County, SD",2011-2012,1910,1909,-1,-0.052,-2,1,46,55,H1
"Haakon County, SD",2012-2013,1909,1888,-21,-1.1,-8,-13,46,55,H1
"Haakon County, SD",2013-2014,1888,1847,-41,-2.172,3,-44,46,55,H1
"Haakon County, SD",2014-2015,1847,1861,14,0.758,11,3,46,55,H1
"Haakon County, SD",2015-2016,1861,1883,22,1.182,3,19,46,55,H1
"Haakon County, SD",2016-2017,1883,1943,60,3.186,14,46,46,55,H1
"Hamlin County, SD",2000-2001,5546,5551,5,0.09,25,-20,46,57,H1
"Hamlin County, SD",2001-2002,5551,5566,15,0.27,15,0,46,57,H1
"Hamlin County, SD",2002-2003,5566,5558,-8,-0.144,28,-36,46,57,H1
"Hamlin County, SD",2003-2004,5558,5559,1,0.018,23,-22,46,57,H1
"Hamlin County, SD",2004-2005,5559,5625,66,1.187,25,41,46,57,H1
"Hamlin County, SD",2005-2006,5625,5595,-30,-0.533,25,-55,46,57,H1
"Hamlin County, SD",2006-2007,5595,5696,101,1.805,15,86,46,57,H1
"Hamlin County, SD",2007-2008,5696,5753,57,1.001,41,16,46,57,H1
"Hamlin County, SD",2008-2009,5753,5843,90,1.564,46,44,46,57,H1
"Hamlin County, SD",2009-2010,5843,5915,72,1.232,48,24,46,57,H1
"Hamlin County, SD",2010-2011,5915,5950,35,0.592,34,1,46,57,H1
"Hamlin County, SD",2011-2012,5950,5941,-9,-0.151,39,-48,46,57,H1
"Hamlin County, SD",2012-2013,5941,5952,11,0.185,60,-49,46,57,H1
"Hamlin County, SD",2013-2014,5952,5989,37,0.622,54,-17,46,57,H1
"Hamlin County, SD",2014-2015,5998,6047,49,0.817,57,-8,46,57,H1
"Hamlin County, SD",2015-2016,6047,5878,-169,-2.795,54,-223,46,57,H1
"Hamlin County, SD",2016-2017,5878,5948,70,1.191,45,25,46,57,H1
"Hand County, SD",2000-2001,3716,3650,-66,-1.776,-13,-53,46,59,H1
"Hand County, SD",2001-2002,3650,3589,-61,-1.671,-14,-47,46,59,H1
"Hand County, SD",2002-2003,3589,3547,-42,-1.17,-15,-27,46,59,H1
"Hand County, SD",2003-2004,3547,3415,-132,-3.721,-34,-98,46,59,H1
"Hand County, SD",2004-2005,3415,3396,-19,-0.556,2,-21,46,59,H1
"Hand County, SD",2005-2006,3396,3390,-6,-0.177,-16,10,46,59,H1
"Hand County, SD",2006-2007,3390,3389,-1,-0.029,-7,6,46,59,H1
"Hand County, SD",2007-2008,3389,3396,7,0.207,12,-5,46,59,H1
"Hand County, SD",2008-2009,3396,3399,3,0.088,-9,12,46,59,H1
"Hand County, SD",2009-2010,3399,3429,30,0.883,-8,38,46,59,H1
"Hand County, SD",2010-2011,3429,3441,12,0.35,-3,15,46,59,H1
"Hand County, SD",2011-2012,3441,3385,-56,-1.627,-7,-49,46,59,H1
"Hand County, SD",2012-2013,3385,3396,11,0.325,-6,17,46,59,H1
"Hand County, SD",2013-2014,3396,3345,-51,-1.502,-1,-50,46,59,H1
"Hand County, SD",2014-2015,3354,3348,-6,-0.179,18,-24,46,59,H1
"Hand County, SD",2015-2016,3348,3282,-66,-1.971,-12,-54,46,59,H1
"Hand County, SD",2016-2017,3282,3277,-5,-0.152,0,-5,46,59,H1
"Hanson County, SD",2000-2001,3152,3263,111,3.522,55,56,46,61,H1
"Hanson County, SD",2001-2002,3263,3287,24,0.736,17,7,46,61,H1
"Hanson County, SD",2002-2003,3287,3335,48,1.46,37,11,46,61,H1
"Hanson County, SD",2003-2004,3335,3503,168,5.037,33,135,46,61,H1
"Hanson County, SD",2004-2005,3503,3511,8,0.228,38,-30,46,61,H1
"Hanson County, SD",2005-2006,3511,3414,-97,-2.763,32,-129,46,61,H1
"Hanson County, SD",2006-2007,3414,3417,3,0.088,26,-23,46,61,H1
"Hanson County, SD",2007-2008,3417,3399,-18,-0.527,37,-55,46,61,H1
"Hanson County, SD",2008-2009,3399,3345,-54,-1.589,44,-98,46,61,H1
"Hanson County, SD",2009-2010,3345,3348,3,0.09,26,-23,46,61,H1
"Hanson County, SD",2010-2011,3348,3390,42,1.254,31,11,46,61,H1
"Hanson County, SD",2011-2012,3390,3394,4,0.118,26,-22,46,61,H1
"Hanson County, SD",2012-2013,3394,3407,13,0.383,39,-26,46,61,H1
"Hanson County, SD",2013-2014,3407,3419,12,0.352,40,-28,46,61,H1
"Hanson County, SD",2014-2015,3399,3385,-14,-0.412,36,-50,46,61,H1
"Hanson County, SD",2015-2016,3385,3390,5,0.148,27,-22,46,61,H1
"Hanson County, SD",2016-2017,3390,3423,33,0.973,27,6,46,61,H1
"Harding County, SD",2000-2001,1345,1337,-8,-0.595,15,-23,46,63,H1
"Harding County, SD",2001-2002,1337,1317,-20,-1.496,4,-24,46,63,H1
"Harding County, SD",2002-2003,1317,1332,15,1.139,7,8,46,63,H1
"Harding County, SD",2003-2004,1332,1278,-54,-4.054,-1,-53,46,63,H1
"Harding County, SD",2004-2005,1278,1257,-21,-1.643,0,-21,46,63,H1
"Harding County, SD",2005-2006,1257,1278,21,1.671,5,16,46,63,H1
"Harding County, SD",2006-2007,1278,1274,-4,-0.313,0,-4,46,63,H1
"Harding County, SD",2007-2008,1274,1252,-22,-1.727,8,-30,46,63,H1
"Harding County, SD",2008-2009,1252,1263,11,0.879,11,0,46,63,H1
"Harding County, SD",2009-2010,1263,1245,-18,-1.425,12,-30,46,63,H1
"Harding County, SD",2010-2011,1245,1294,49,3.936,-2,51,46,63,H1
"Harding County, SD",2011-2012,1294,1315,21,1.623,2,19,46,63,H1
"Harding County, SD",2012-2013,1315,1264,-51,-3.878,12,-63,46,63,H1
"Harding County, SD",2013-2014,1264,1250,-14,-1.108,10,-24,46,63,H1
"Harding County, SD",2014-2015,1254,1267,13,1.037,11,2,46,63,H1
"Harding County, SD",2015-2016,1267,1265,-2,-0.158,13,-15,46,63,H1
"Harding County, SD",2016-2017,1265,1242,-23,-1.818,9,-32,46,63,H1
"Hughes County, SD",2000-2001,16505,16351,-154,-0.933,36,-190,46,65,H1
"Hughes County, SD",2001-2002,16351,16479,128,0.783,50,78,46,65,H1
"Hughes County, SD",2002-2003,16479,16514,35,0.212,36,-1,46,65,H1
"Hughes County, SD",2003-2004,16514,16573,59,0.357,59,0,46,65,H1
"Hughes County, SD",2004-2005,16573,16682,109,0.658,86,23,46,65,H1
"Hughes County, SD",2005-2006,16682,16717,35,0.21,57,-22,46,65,H1
"Hughes County, SD",2006-2007,16717,16788,71,0.425,105,-34,46,65,H1
"Hughes County, SD",2007-2008,16788,16690,-98,-0.584,68,-166,46,65,H1
"Hughes County, SD",2008-2009,16690,16867,177,1.061,53,124,46,65,H1
"Hughes County, SD",2009-2010,16867,17062,195,1.156,73,122,46,65,H1
"Hughes County, SD",2010-2011,17062,17283,221,1.295,112,109,46,65,H1
"Hughes County, SD",2011-2012,17283,17441,158,0.914,82,76,46,65,H1
"Hughes County, SD",2012-2013,17441,17466,25,0.143,117,-92,46,65,H1
"Hughes County, SD",2013-2014,17466,17642,176,1.008,90,86,46,65,H1
"Hughes County, SD",2014-2015,17617,17555,-62,-0.352,97,-159,46,65,H1
"Hughes County, SD",2015-2016,17555,17577,22,0.125,81,-59,46,65,H1
"Hughes County, SD",2016-2017,17577,17666,89,0.506,78,11,46,65,H1
"Hutchinson County, SD",2000-2001,8060,7925,-135,-1.675,-25,-110,46,67,H1
"Hutchinson County, SD",2001-2002,7925,7803,-122,-1.539,-83,-39,46,67,H1
"Hutchinson County, SD",2002-2003,7803,7769,-34,-0.436,-31,-3,46,67,H1
"Hutchinson County, SD",2003-2004,7769,7660,-109,-1.403,-48,-61,46,67,H1
"Hutchinson County, SD",2004-2005,7660,7594,-66,-0.862,-42,-24,46,67,H1
"Hutchinson County, SD",2005-2006,7594,7471,-123,-1.62,-31,-92,46,67,H1
"Hutchinson County, SD",2006-2007,7471,7436,-35,-0.468,-30,-5,46,67,H1
"Hutchinson County, SD",2007-2008,7436,7363,-73,-0.982,-44,-29,46,67,H1
"Hutchinson County, SD",2008-2009,7363,7325,-38,-0.516,-33,-5,46,67,H1
"Hutchinson County, SD",2009-2010,7325,7333,8,0.109,-37,45,46,67,H1
"Hutchinson County, SD",2010-2011,7333,7195,-138,-1.882,-45,-93,46,67,H1
"Hutchinson County, SD",2011-2012,7195,7206,11,0.153,-6,17,46,67,H1
"Hutchinson County, SD",2012-2013,7206,7170,-36,-0.5,-16,-20,46,67,H1
"Hutchinson County, SD",2013-2014,7170,7200,30,0.418,-8,38,46,67,H1
"Hutchinson County, SD",2014-2015,7228,7301,73,1.01,4,69,46,67,H1
"Hutchinson County, SD",2015-2016,7301,7338,37,0.507,12,25,46,67,H1
"Hutchinson County, SD",2016-2017,7338,7358,20,0.273,22,-2,46,67,H1
"Hyde County, SD",2000-2001,1655,1607,-48,-2.9,0,-48,46,69,H1
"Hyde County, SD",2001-2002,1607,1552,-55,-3.423,-10,-45,46,69,H1
"Hyde County, SD",2002-2003,1552,1587,35,2.255,-6,41,46,69,H1
"Hyde County, SD",2003-2004,1587,1616,29,1.827,-5,34,46,69,H1
"Hyde County, SD",2004-2005,1616,1601,-15,-0.928,-8,-7,46,69,H1
"Hyde County, SD",2005-2006,1601,1531,-70,-4.372,-15,-55,46,69,H1
"Hyde County, SD",2006-2007,1531,1467,-64,-4.18,-3,-61,46,69,H1
"Hyde County, SD",2007-2008,1467,1430,-37,-2.522,-11,-26,46,69,H1
"Hyde County, SD",2008-2009,1430,1420,-10,-0.699,-1,-9,46,69,H1
"Hyde County, SD",2009-2010,1420,1416,-4,-0.282,-1,-3,46,69,H1
"Hyde County, SD",2010-2011,1416,1395,-21,-1.483,-6,-15,46,69,H1
"Hyde County, SD",2011-2012,1395,1431,36,2.581,-1,37,46,69,H1
"Hyde County, SD",2012-2013,1431,1387,-44,-3.075,-5,-39,46,69,H1
"Hyde County, SD",2013-2014,1387,1396,9,0.649,2,7,46,69,H1
"Hyde County, SD",2014-2015,1396,1397,1,0.072,10,-9,46,69,H1
"Hyde County, SD",2015-2016,1397,1339,-58,-4.152,-2,-56,46,69,H1
"Hyde County, SD",2016-2017,1339,1318,-21,-1.568,3,-24,46,69,H1
"Jackson County, SD",2000-2001,2940,2846,-94,-3.197,27,-121,46,71,H1
"Jackson County, SD",2001-2002,2846,2876,30,1.054,14,16,46,71,H1
"Jackson County, SD",2002-2003,2876,2927,51,1.773,39,12,46,71,H1
"Jackson County, SD",2003-2004,2927,2939,12,0.41,31,-19,46,71,H1
"Jackson County, SD",2004-2005,2939,2982,43,1.463,36,7,46,71,H1
"Jackson County, SD",2005-2006,2982,2976,-6,-0.201,31,-37,46,71,H1
"Jackson County, SD",2006-2007,2976,3008,32,1.075,24,8,46,71,H1
"Jackson County, SD",2007-2008,3008,2950,-58,-1.928,46,-104,46,71,H1
"Jackson County, SD",2008-2009,2950,2982,32,1.085,44,-12,46,71,H1
"Jackson County, SD",2009-2010,2982,3047,65,2.18,35,30,46,71,H1
"Jackson County, SD",2010-2011,3047,3172,125,4.102,39,86,46,71,H1
"Jackson County, SD",2011-2012,3172,3177,5,0.158,32,-27,46,71,H1
"Jackson County, SD",2012-2013,3177,3231,54,1.7,41,13,46,71,H1
"Jackson County, SD",2013-2014,3231,3274,43,1.331,43,0,46,71,H1
"Jackson County, SD",2014-2015,3278,3321,43,1.312,52,-9,46,71,H1
"Jackson County, SD",2015-2016,3321,3297,-24,-0.723,47,-71,46,71,H1
"Jackson County, SD",2016-2017,3297,3289,-8,-0.243,42,-50,46,71,H1
"Jerauld County, SD",2000-2001,2259,2225,-34,-1.505,-16,-18,46,73,H1
"Jerauld County, SD",2001-2002,2225,2197,-28,-1.258,-8,-20,46,73,H1
"Jerauld County, SD",2002-2003,2197,2155,-42,-1.912,-6,-36,46,73,H1
"Jerauld County, SD",2003-2004,2155,2102,-53,-2.459,-6,-47,46,73,H1
"Jerauld County, SD",2004-2005,2102,2105,3,0.143,-8,11,46,73,H1
"Jerauld County, SD",2005-2006,2105,2059,-46,-2.185,-1,-45,46,73,H1
"Jerauld County, SD",2006-2007,2059,2006,-53,-2.574,0,-53,46,73,H1
"Jerauld County, SD",2007-2008,2006,2023,17,0.847,0,17,46,73,H1
"Jerauld County, SD",2008-2009,2023,2019,-4,-0.198,6,-10,46,73,H1
"Jerauld County, SD",2009-2010,2019,2084,65,3.219,6,59,46,73,H1
"Jerauld County, SD",2010-2011,2084,2067,-17,-0.816,-5,-12,46,73,H1
"Jerauld County, SD",2011-2012,2067,2040,-27,-1.306,-3,-24,46,73,H1
"Jerauld County, SD",2012-2013,2040,2058,18,0.882,-7,25,46,73,H1
"Jerauld County, SD",2013-2014,2058,2007,-51,-2.478,7,-58,46,73,H1
"Jerauld County, SD",2014-2015,2005,1997,-8,-0.399,5,-13,46,73,H1
"Jerauld County, SD",2015-2016,1997,2005,8,0.401,1,7,46,73,H1
"Jerauld County, SD",2016-2017,2005,2028,23,1.147,-2,25,46,73,H1
"Jones County, SD",2000-2001,1182,1136,-46,-3.892,8,-54,46,75,H1
"Jones County, SD",2001-2002,1136,1113,-23,-2.025,2,-25,46,75,H1
"Jones County, SD",2002-2003,1113,1074,-39,-3.504,7,-46,46,75,H1
"Jones County, SD",2003-2004,1074,1068,-6,-0.559,-5,-1,46,75,H1
"Jones County, SD",2004-2005,1068,1033,-35,-3.277,2,-37,46,75,H1
"Jones County, SD",2005-2006,1033,1046,13,1.258,12,1,46,75,H1
"Jones County, SD",2006-2007,1046,1014,-32,-3.059,-2,-30,46,75,H1
"Jones County, SD",2007-2008,1014,976,-38,-3.748,13,-51,46,75,H1
"Jones County, SD",2008-2009,976,990,14,1.434,17,-3,46,75,H1
"Jones County, SD",2009-2010,990,1007,17,1.717,19,-2,46,75,H1
"Jones County, SD",2010-2011,1007,1020,13,1.291,6,7,46,75,H1
"Jones County, SD",2011-2012,1020,1010,-10,-0.98,-1,-9,46,75,H1
"Jones County, SD",2012-2013,1010,996,-14,-1.386,-2,-12,46,75,H1
"Jones County, SD",2013-2014,996,975,-21,-2.108,4,-25,46,75,H1
"Jones County, SD",2014-2015,965,924,-41,-4.249,4,-45,46,75,H1
"Jones County, SD",2015-2016,924,935,11,1.19,4,7,46,75,H1
"Jones County, SD",2016-2017,935,936,1,0.107,9,-8,46,75,H1
"Kingsbury County, SD",2000-2001,5803,5635,-168,-2.895,-34,-134,46,77,H1
"Kingsbury County, SD",2001-2002,5635,5524,-111,-1.97,-49,-62,46,77,H1
"Kingsbury County, SD",2002-2003,5524,5435,-89,-1.611,-37,-52,46,77,H1
"Kingsbury County, SD",2003-2004,5435,5311,-124,-2.282,-56,-68,46,77,H1
"Kingsbury County, SD",2004-2005,5311,5318,7,0.132,-21,28,46,77,H1
"Kingsbury County, SD",2005-2006,5318,5228,-90,-1.692,-27,-63,46,77,H1
"Kingsbury County, SD",2006-2007,5228,5177,-51,-0.976,-36,-15,46,77,H1
"Kingsbury County, SD",2007-2008,5177,5142,-35,-0.676,-14,-21,46,77,H1
"Kingsbury County, SD",2008-2009,5142,5146,4,0.078,-30,34,46,77,H1
"Kingsbury County, SD",2009-2010,5146,5136,-10,-0.194,-18,8,46,77,H1
"Kingsbury County, SD",2010-2011,5136,5176,40,0.779,-7,47,46,77,H1
"Kingsbury County, SD",2011-2012,5176,5240,64,1.236,-5,69,46,77,H1
"Kingsbury County, SD",2012-2013,5240,5080,-160,-3.053,-3,-157,46,77,H1
"Kingsbury County, SD",2013-2014,5080,5075,-5,-0.098,-13,8,46,77,H1
"Kingsbury County, SD",2014-2015,5076,4990,-86,-1.694,3,-89,46,77,H1
"Kingsbury County, SD",2015-2016,4990,4977,-13,-0.261,5,-18,46,77,H1
"Kingsbury County, SD",2016-2017,4977,4952,-25,-0.502,7,-32,46,77,H1
"Lake County, SD",2000-2001,11217,11143,-74,-0.66,-20,-54,46,79,H1
"Lake County, SD",2001-2002,11143,10922,-221,-1.983,23,-244,46,79,H1
"Lake County, SD",2002-2003,10922,10767,-155,-1.419,12,-167,46,79,H1
"Lake County, SD",2003-2004,10767,10612,-155,-1.44,4,-159,46,79,H1
"Lake County, SD",2004-2005,10612,10624,12,0.113,39,-27,46,79,H1
"Lake County, SD",2005-2006,10624,10659,35,0.329,41,-6,46,79,H1
"Lake County, SD",2006-2007,10659,10920,261,2.449,4,257,46,79,H1
"Lake County, SD",2007-2008,10920,11119,199,1.822,66,133,46,79,H1
"Lake County, SD",2008-2009,11119,11084,-35,-0.315,56,-91,46,79,H1
"Lake County, SD",2009-2010,11084,11275,191,1.723,17,174,46,79,H1
"Lake County, SD",2010-2011,11275,11601,326,2.891,7,319,46,79,H1
"Lake County, SD",2011-2012,11601,11832,231,1.991,29,202,46,79,H1
"Lake County, SD",2012-2013,11832,12078,246,2.079,37,209,46,79,H1
"Lake County, SD",2013-2014,12078,12368,290,2.401,23,267,46,79,H1
"Lake County, SD",2014-2015,12327,12622,295,2.393,23,272,46,79,H1
"Lake County, SD",2015-2016,12622,12605,-17,-0.135,19,-36,46,79,H1
"Lake County, SD",2016-2017,12605,12809,204,1.618,11,193,46,79,H1
"Lawrence County, SD",2000-2001,21763,21738,-25,-0.115,53,-78,46,81,H1
"Lawrence County, SD",2001-2002,21738,21763,25,0.115,38,-13,46,81,H1
"Lawrence County, SD",2002-2003,21763,22135,372,1.709,44,328,46,81,H1
"Lawrence County, SD",2003-2004,22135,22610,475,2.146,59,416,46,81,H1
"Lawrence County, SD",2004-2005,22610,22889,279,1.234,48,231,46,81,H1
"Lawrence County, SD",2005-2006,22889,23172,283,1.236,44,239,46,81,H1
"Lawrence County, SD",2006-2007,23172,23543,371,1.601,79,292,46,81,H1
"Lawrence County, SD",2007-2008,23543,23659,116,0.493,76,40,46,81,H1
"Lawrence County, SD",2008-2009,23659,23781,122,0.516,74,48,46,81,H1
"Lawrence County, SD",2009-2010,23781,24170,389,1.636,65,324,46,81,H1
"Lawrence County, SD",2010-2011,24170,24303,133,0.55,33,100,46,81,H1
"Lawrence County, SD",2011-2012,24303,24360,57,0.235,-10,67,46,81,H1
"Lawrence County, SD",2012-2013,24360,24899,539,2.213,9,530,46,81,H1
"Lawrence County, SD",2013-2014,24899,24657,-242,-0.972,43,-285,46,81,H1
"Lawrence County, SD",2014-2015,24717,24827,110,0.445,23,87,46,81,H1
"Lawrence County, SD",2015-2016,24827,25183,356,1.434,19,337,46,81,H1
"Lawrence County, SD",2016-2017,25183,25429,246,0.977,17,229,46,81,H1
"Lincoln County, SD",2000-2001,24557,26322,1765,7.187,269,1496,46,83,H1
"Lincoln County, SD",2001-2002,26322,28032,1710,6.496,280,1430,46,83,H1
"Lincoln County, SD",2002-2003,28032,29720,1688,6.022,268,1420,46,83,H1
"Lincoln County, SD",2003-2004,29720,32343,2623,8.826,352,2271,46,83,H1
"Lincoln County, SD",2004-2005,32343,34598,2255,6.972,427,1828,46,83,H1
"Lincoln County, SD",2005-2006,34598,36885,2287,6.61,479,1808,46,83,H1
"Lincoln County, SD",2006-2007,36885,39260,2375,6.439,569,1806,46,83,H1
"Lincoln County, SD",2007-2008,39260,41590,2330,5.935,587,1743,46,83,H1
"Lincoln County, SD",2008-2009,41590,43522,1932,4.645,615,1317,46,83,H1
"Lincoln County, SD",2009-2010,43522,45150,1628,3.741,551,1077,46,83,H1
"Lincoln County, SD",2010-2011,45150,46744,1594,3.53,538,1056,46,83,H1
"Lincoln County, SD",2011-2012,46744,48302,1558,3.333,625,933,46,83,H1
"Lincoln County, SD",2012-2013,48302,49886,1584,3.279,626,958,46,83,H1
"Lincoln County, SD",2013-2014,49886,51548,1662,3.332,625,1037,46,83,H1
"Lincoln County, SD",2014-2015,51517,52849,1332,2.586,568,764,46,83,H1
"Lincoln County, SD",2015-2016,52849,54572,1723,3.26,518,1205,46,83,H1
"Lincoln County, SD",2016-2017,54572,56664,2092,3.833,538,1554,46,83,H1
"Lyman County, SD",2000-2001,3908,3879,-29,-0.742,33,-62,46,85,H1
"Lyman County, SD",2001-2002,3879,3863,-16,-0.412,30,-46,46,85,H1
"Lyman County, SD",2002-2003,3863,3860,-3,-0.078,46,-49,46,85,H1
"Lyman County, SD",2003-2004,3860,3827,-33,-0.855,54,-87,46,85,H1
"Lyman County, SD",2004-2005,3827,3756,-71,-1.855,32,-103,46,85,H1
"Lyman County, SD",2005-2006,3756,3754,-2,-0.053,42,-44,46,85,H1
"Lyman County, SD",2006-2007,3754,3765,11,0.293,27,-16,46,85,H1
"Lyman County, SD",2007-2008,3765,3669,-96,-2.55,46,-142,46,85,H1
"Lyman County, SD",2008-2009,3669,3723,54,1.472,53,1,46,85,H1
"Lyman County, SD",2009-2010,3723,3770,47,1.262,60,-13,46,85,H1
"Lyman County, SD",2010-2011,3770,3833,63,1.671,34,29,46,85,H1
"Lyman County, SD",2011-2012,3833,3793,-40,-1.044,24,-64,46,85,H1
"Lyman County, SD",2012-2013,3793,3881,88,2.32,43,45,46,85,H1
"Lyman County, SD",2013-2014,3881,3877,-4,-0.103,52,-56,46,85,H1
"Lyman County, SD",2014-2015,3859,3876,17,0.441,49,-32,46,85,H1
"Lyman County, SD",2015-2016,3876,3920,44,1.135,54,-10,46,85,H1
"Lyman County, SD",2016-2017,3920,3904,-16,-0.408,55,-71,46,85,H1
"McCook County, SD",2000-2001,5840,5854,14,0.24,6,8,46,87,H1
"McCook County, SD",2001-2002,5854,5772,-82,-1.401,16,-98,46,87,H1
"McCook County, SD",2002-2003,5772,5776,4,0.069,1,3,46,87,H1
"McCook County, SD",2003-2004,5776,5805,29,0.502,9,20,46,87,H1
"McCook County, SD",2004-2005,5805,5793,-12,-0.207,16,-28,46,87,H1
"McCook County, SD",2005-2006,5793,5679,-114,-1.968,-10,-104,46,87,H1
"McCook County, SD",2006-2007,5679,5699,20,0.352,4,16,46,87,H1
"McCook County, SD",2007-2008,5699,5598,-101,-1.772,12,-113,46,87,H1
"McCook County, SD",2008-2009,5598,5592,-6,-0.107,17,-23,46,87,H1
"McCook County, SD",2009-2010,5592,5608,16,0.286,29,-13,46,87,H1
"McCook County, SD",2010-2011,5608,5568,-40,-0.713,16,-56,46,87,H1
"McCook County, SD",2011-2012,5568,5603,35,0.629,-23,58,46,87,H1
"McCook County, SD",2012-2013,5603,5647,44,0.785,3,41,46,87,H1
"McCook County, SD",2013-2014,5647,5649,2,0.035,5,-3,46,87,H1
"McCook County, SD",2014-2015,5643,5599,-44,-0.78,6,-50,46,87,H1
"McCook County, SD",2015-2016,5599,5481,-118,-2.108,4,-122,46,87,H1
"McCook County, SD",2016-2017,5481,5499,18,0.328,4,14,46,87,H1
"McPherson County, SD",2000-2001,2889,2826,-63,-2.181,-26,-37,46,89,H1
"McPherson County, SD",2001-2002,2826,2770,-56,-1.982,-16,-40,46,89,H1
"McPherson County, SD",2002-2003,2770,2728,-42,-1.516,2,-44,46,89,H1
"McPherson County, SD",2003-2004,2728,2663,-65,-2.383,-15,-50,46,89,H1
"McPherson County, SD",2004-2005,2663,2627,-36,-1.352,-24,-12,46,89,H1
"McPherson County, SD",2005-2006,2627,2571,-56,-2.132,-17,-39,46,89,H1
"McPherson County, SD",2006-2007,2571,2518,-53,-2.061,-23,-30,46,89,H1
"McPherson County, SD",2007-2008,2518,2517,-1,-0.04,-8,7,46,89,H1
"McPherson County, SD",2008-2009,2517,2469,-48,-1.907,-16,-32,46,89,H1
"McPherson County, SD",2009-2010,2469,2454,-15,-0.608,-19,4,46,89,H1
"McPherson County, SD",2010-2011,2454,2445,-9,-0.367,-10,1,46,89,H1
"McPherson County, SD",2011-2012,2445,2429,-16,-0.654,-12,-4,46,89,H1
"McPherson County, SD",2012-2013,2429,2439,10,0.412,-11,21,46,89,H1
"McPherson County, SD",2013-2014,2439,2429,-10,-0.41,-1,-9,46,89,H1
"McPherson County, SD",2014-2015,2426,2415,-11,-0.453,1,-12,46,89,H1
"McPherson County, SD",2015-2016,2415,2422,7,0.29,-5,12,46,89,H1
"McPherson County, SD",2016-2017,2422,2426,4,0.165,-1,5,46,89,H1
"Marshall County, SD",2000-2001,4593,4515,-78,-1.698,-27,-51,46,91,H1
"Marshall County, SD",2001-2002,4515,4446,-69,-1.528,-37,-32,46,91,H1
"Marshall County, SD",2002-2003,4446,4420,-26,-0.585,-15,-11,46,91,H1
"Marshall County, SD",2003-2004,4420,4542,122,2.76,-7,129,46,91,H1
"Marshall County, SD",2004-2005,4542,4625,83,1.827,6,77,46,91,H1
"Marshall County, SD",2005-2006,4625,4616,-9,-0.195,-6,-3,46,91,H1
"Marshall County, SD",2006-2007,4616,4591,-25,-0.542,2,-27,46,91,H1
"Marshall County, SD",2007-2008,4591,4618,27,0.588,10,17,46,91,H1
"Marshall County, SD",2008-2009,4618,4608,-10,-0.217,14,-24,46,91,H1
"Marshall County, SD",2009-2010,4608,4642,34,0.738,8,26,46,91,H1
"Marshall County, SD",2010-2011,4642,4615,-27,-0.582,4,-31,46,91,H1
"Marshall County, SD",2011-2012,4615,4656,41,0.888,-16,57,46,91,H1
"Marshall County, SD",2012-2013,4656,4745,89,1.912,22,67,46,91,H1
"Marshall County, SD",2013-2014,4745,4683,-62,-1.307,13,-75,46,91,H1
"Marshall County, SD",2014-2015,4698,4769,71,1.511,18,53,46,91,H1
"Marshall County, SD",2015-2016,4769,4790,21,0.44,36,-15,46,91,H1
"Marshall County, SD",2016-2017,4790,4804,14,0.292,12,2,46,91,H1
"Meade County, SD",2000-2001,24252,24371,119,0.491,210,-91,46,93,H1
"Meade County, SD",2001-2002,24371,24646,275,1.128,239,36,46,93,H1
"Meade County, SD",2002-2003,24646,24573,-73,-0.296,187,-260,46,93,H1
"Meade County, SD",2003-2004,24573,25064,491,1.998,153,338,46,93,H1
"Meade County, SD",2004-2005,25064,25089,25,0.1,115,-90,46,93,H1
"Meade County, SD",2005-2006,25089,25085,-4,-0.016,137,-141,46,93,H1
"Meade County, SD",2006-2007,25085,24995,-90,-0.359,188,-278,46,93,H1
"Meade County, SD",2007-2008,24995,24931,-64,-0.256,116,-180,46,93,H1
"Meade County, SD",2008-2009,24931,25314,383,1.536,135,248,46,93,H1
"Meade County, SD",2009-2010,25314,25504,190,0.751,201,-11,46,93,H1
"Meade County, SD",2010-2011,25504,25593,89,0.349,131,-42,46,93,H1
"Meade County, SD",2011-2012,25593,25924,331,1.293,155,176,46,93,H1
"Meade County, SD",2012-2013,25924,26567,643,2.48,152,491,46,93,H1
"Meade County, SD",2013-2014,26567,26951,384,1.445,158,226,46,93,H1
"Meade County, SD",2014-2015,26903,26986,83,0.309,134,-51,46,93,H1
"Meade County, SD",2015-2016,26986,27360,374,1.386,109,265,46,93,H1
"Meade County, SD",2016-2017,27360,28018,658,2.405,95,563,46,93,H1
"Mellette County, SD",2000-2001,2084,2070,-14,-0.672,9,-23,46,95,H1
"Mellette County, SD",2001-2002,2070,2042,-28,-1.353,18,-46,46,95,H1
"Mellette County, SD",2002-2003,2042,2070,28,1.371,15,13,46,95,H1
"Mellette County, SD",2003-2004,2070,2014,-56,-2.705,8,-64,46,95,H1
"Mellette County, SD",2004-2005,2014,2027,13,0.645,17,-4,46,95,H1
"Mellette County, SD",2005-2006,2027,2030,3,0.148,16,-13,46,95,H1
"Mellette County, SD",2006-2007,2030,2040,10,0.493,38,-28,46,95,H1
"Mellette County, SD",2007-2008,2040,2.00E+03,-40,-1.961,24,-64,46,95,H1
"Mellette County, SD",2008-2009,2.00E+03,2041,41,2.05,27,14,46,95,H1
"Mellette County, SD",2009-2010,2041,2037,-4,-0.196,27,-31,46,95,H1
"Mellette County, SD",2010-2011,2037,2111,74,3.633,24,50,46,95,H1
"Mellette County, SD",2011-2012,2111,2092,-19,-0.9,-3,-16,46,95,H1
"Mellette County, SD",2012-2013,2092,2081,-11,-0.526,14,-25,46,95,H1
"Mellette County, SD",2013-2014,2081,2100,19,0.913,20,-1,46,95,H1
"Mellette County, SD",2014-2015,2101,2050,-51,-2.427,23,-74,46,95,H1
"Mellette County, SD",2015-2016,2050,2081,31,1.512,17,14,46,95,H1
"Mellette County, SD",2016-2017,2081,2088,7,0.336,27,-20,46,95,H1
"Miner County, SD",2000-2001,2835,2769,-66,-2.328,-8,-58,46,97,H1
"Miner County, SD",2001-2002,2769,2711,-58,-2.095,-27,-31,46,97,H1
"Miner County, SD",2002-2003,2711,2592,-119,-4.39,-9,-110,46,97,H1
"Miner County, SD",2003-2004,2592,2551,-41,-1.582,-4,-37,46,97,H1
"Miner County, SD",2004-2005,2551,2508,-43,-1.686,2,-45,46,97,H1
"Miner County, SD",2005-2006,2508,2474,-34,-1.356,-5,-29,46,97,H1
"Miner County, SD",2006-2007,2474,2420,-54,-2.183,-19,-35,46,97,H1
"Miner County, SD",2007-2008,2420,2372,-48,-1.983,5,-53,46,97,H1
"Miner County, SD",2008-2009,2372,2407,35,1.476,2,33,46,97,H1
"Miner County, SD",2009-2010,2407,2382,-25,-1.039,-2,-23,46,97,H1
"Miner County, SD",2010-2011,2382,2343,-39,-1.637,-17,-22,46,97,H1
"Miner County, SD",2011-2012,2343,2323,-20,-0.854,-17,-3,46,97,H1
"Miner County, SD",2012-2013,2323,2335,12,0.517,6,6,46,97,H1
"Miner County, SD",2013-2014,2335,2316,-19,-0.814,-4,-15,46,97,H1
"Miner County, SD",2014-2015,2309,2236,-73,-3.162,3,-76,46,97,H1
"Miner County, SD",2015-2016,2236,2241,5,0.224,0,5,46,97,H1
"Miner County, SD",2016-2017,2241,2228,-13,-0.58,2,-15,46,97,H1
"Minnehaha County, SD",2000-2001,149068,150775,1707,1.145,1235,472,46,99,H1
"Minnehaha County, SD",2001-2002,150775,152062,1287,0.854,1263,24,46,99,H1
"Minnehaha County, SD",2002-2003,152062,153740,1678,1.103,1350,328,46,99,H1
"Minnehaha County, SD",2003-2004,153740,155648,1908,1.241,1517,391,46,99,H1
"Minnehaha County, SD",2004-2005,155648,157778,2130,1.368,1455,675,46,99,H1
"Minnehaha County, SD",2005-2006,157778,160630,2852,1.808,1450,1402,46,99,H1
"Minnehaha County, SD",2006-2007,160630,163577,2947,1.835,1582,1365,46,99,H1
"Minnehaha County, SD",2007-2008,163577,166320,2743,1.677,1450,1293,46,99,H1
"Minnehaha County, SD",2008-2009,166320,168482,2162,1.3,1462,700,46,99,H1
"Minnehaha County, SD",2009-2010,168482,169992,1510,0.896,1648,-138,46,99,H1
"Minnehaha County, SD",2010-2011,169992,171963,1971,1.159,1448,523,46,99,H1
"Minnehaha County, SD",2011-2012,171963,175511,3548,2.063,1509,2039,46,99,H1
"Minnehaha County, SD",2012-2013,175511,179724,4213,2.4,1591,2622,46,99,H1
"Minnehaha County, SD",2013-2014,179724,182882,3158,1.757,1608,1550,46,99,H1
"Minnehaha County, SD",2014-2015,182649,185197,2548,1.395,1662,886,46,99,H1
"Minnehaha County, SD",2015-2016,185197,186051,854,0.461,1681,-827,46,99,H1
"Minnehaha County, SD",2016-2017,186051,188616,2565,1.379,1594,971,46,99,H1
"Moody County, SD",2000-2001,6571,6581,10,0.152,12,-2,46,101,H1
"Moody County, SD",2001-2002,6581,6515,-66,-1.003,29,-95,46,101,H1
"Moody County, SD",2002-2003,6515,6472,-43,-0.66,23,-66,46,101,H1
"Moody County, SD",2003-2004,6472,6514,42,0.649,19,23,46,101,H1
"Moody County, SD",2004-2005,6514,6542,28,0.43,25,3,46,101,H1
"Moody County, SD",2005-2006,6542,6537,-5,-0.076,30,-35,46,101,H1
"Moody County, SD",2006-2007,6537,6570,33,0.505,35,-2,46,101,H1
"Moody County, SD",2007-2008,6570,6501,-69,-1.05,39,-108,46,101,H1
"Moody County, SD",2008-2009,6501,6449,-52,-0.8,46,-98,46,101,H1
"Moody County, SD",2009-2010,6449,6495,46,0.713,40,6,46,101,H1
"Moody County, SD",2010-2011,6495,6498,3,0.046,44,-41,46,101,H1
"Moody County, SD",2011-2012,6498,6447,-51,-0.785,40,-91,46,101,H1
"Moody County, SD",2012-2013,6447,6416,-31,-0.481,41,-72,46,101,H1
"Moody County, SD",2013-2014,6416,6367,-49,-0.764,43,-92,46,101,H1
"Moody County, SD",2014-2015,6399,6430,31,0.484,43,-12,46,101,H1
"Moody County, SD",2015-2016,6430,6556,126,1.96,48,78,46,101,H1
"Moody County, SD",2016-2017,6556,6579,23,0.351,50,-27,46,101,H1
"Oglala Lakota County, SD",2014-2015,14234,14373,139,0.977,192,-53,46,113,H1
"Oglala Lakota County, SD",2015-2016,14373,14392,19,0.132,120,-101,46,113,H1
"Oglala Lakota County, SD",2016-2017,14392,14354,-38,-0.264,131,-169,46,113,H1
"Pennington County, SD",2000-2001,88872,89953,1081,1.216,738,343,46,103,H1
"Pennington County, SD",2001-2002,89953,90677,724,0.805,679,45,46,103,H1
"Pennington County, SD",2002-2003,90677,91117,440,0.485,691,-251,46,103,H1
"Pennington County, SD",2003-2004,91117,92560,1443,1.584,895,548,46,103,H1
"Pennington County, SD",2004-2005,92560,93099,539,0.582,874,-335,46,103,H1
"Pennington County, SD",2005-2006,93099,94394,1295,1.391,888,407,46,103,H1
"Pennington County, SD",2006-2007,94394,95895,1501,1.59,1041,460,46,103,H1
"Pennington County, SD",2007-2008,95895,98128,2233,2.329,840,1393,46,103,H1
"Pennington County, SD",2008-2009,98128,99845,1717,1.75,850,867,46,103,H1
"Pennington County, SD",2009-2010,99845,101279,1434,1.436,821,613,46,103,H1
"Pennington County, SD",2010-2011,101279,102426,1147,1.133,711,436,46,103,H1
"Pennington County, SD",2011-2012,102426,104552,2126,2.076,767,1359,46,103,H1
"Pennington County, SD",2012-2013,104552,106372,1820,1.741,771,1049,46,103,H1
"Pennington County, SD",2013-2014,106372,108242,1870,1.758,760,1110,46,103,H1
"Pennington County, SD",2014-2015,108277,108702,425,0.393,743,-318,46,103,H1
"Pennington County, SD",2015-2016,108702,108903,201,0.185,551,-350,46,103,H1
"Pennington County, SD",2016-2017,108903,110141,1238,1.137,576,662,46,103,H1
"Perkins County, SD",2000-2001,3333,3269,-64,-1.92,-15,-49,46,105,H1
"Perkins County, SD",2001-2002,3269,3243,-26,-0.795,-12,-14,46,105,H1
"Perkins County, SD",2002-2003,3243,3141,-102,-3.145,5,-107,46,105,H1
"Perkins County, SD",2003-2004,3141,3046,-95,-3.025,-22,-73,46,105,H1
"Perkins County, SD",2004-2005,3046,2984,-62,-2.035,-2,-60,46,105,H1
"Perkins County, SD",2005-2006,2984,2977,-7,-0.235,-10,3,46,105,H1
"Perkins County, SD",2006-2007,2977,2963,-14,-0.47,-27,13,46,105,H1
"Perkins County, SD",2007-2008,2963,2936,-27,-0.911,-9,-18,46,105,H1
"Perkins County, SD",2008-2009,2936,2943,7,0.238,-2,9,46,105,H1
"Perkins County, SD",2009-2010,2943,2974,31,1.053,9,22,46,105,H1
"Perkins County, SD",2010-2011,2974,3005,31,1.042,-22,53,46,105,H1
"Perkins County, SD",2011-2012,3005,3020,15,0.499,-15,30,46,105,H1
"Perkins County, SD",2012-2013,3020,3035,15,0.497,5,10,46,105,H1
"Perkins County, SD",2013-2014,3035,3033,-2,-0.066,6,-8,46,105,H1
"Perkins County, SD",2014-2015,3045,3019,-26,-0.854,11,-37,46,105,H1
"Perkins County, SD",2015-2016,3019,2966,-53,-1.756,7,-60,46,105,H1
"Perkins County, SD",2016-2017,2966,2974,8,0.27,12,-4,46,105,H1
"Potter County, SD",2000-2001,2679,2592,-87,-3.247,-7,-80,46,107,H1
"Potter County, SD",2001-2002,2592,2555,-37,-1.427,-22,-15,46,107,H1
"Potter County, SD",2002-2003,2555,2554,-1,-0.039,-14,13,46,107,H1
"Potter County, SD",2003-2004,2554,2516,-38,-1.488,-20,-18,46,107,H1
"Potter County, SD",2004-2005,2516,2444,-72,-2.862,-15,-57,46,107,H1
"Potter County, SD",2005-2006,2444,2413,-31,-1.268,-19,-12,46,107,H1
"Potter County, SD",2006-2007,2413,2351,-62,-2.569,-14,-48,46,107,H1
"Potter County, SD",2007-2008,2351,2285,-66,-2.807,-7,-59,46,107,H1
"Potter County, SD",2008-2009,2285,2283,-2,-0.088,-18,16,46,107,H1
"Potter County, SD",2009-2010,2283,2338,55,2.409,-10,65,46,107,H1
"Potter County, SD",2010-2011,2338,2361,23,0.984,-10,33,46,107,H1
"Potter County, SD",2011-2012,2361,2349,-12,-0.508,-26,14,46,107,H1
"Potter County, SD",2012-2013,2349,2369,20,0.851,-7,27,46,107,H1
"Potter County, SD",2013-2014,2369,2340,-29,-1.224,-6,-23,46,107,H1
"Potter County, SD",2014-2015,2334,2320,-14,-0.6,-12,-2,46,107,H1
"Potter County, SD",2015-2016,2320,2270,-50,-2.155,-3,-47,46,107,H1
"Potter County, SD",2016-2017,2270,2231,-39,-1.718,-8,-31,46,107,H1
"Roberts County, SD",2000-2001,10004,10023,19,0.19,4,15,46,109,H1
"Roberts County, SD",2001-2002,10023,9855,-168,-1.676,15,-183,46,109,H1
"Roberts County, SD",2002-2003,9855,9986,131,1.329,58,73,46,109,H1
"Roberts County, SD",2003-2004,9986,10033,47,0.471,25,22,46,109,H1
"Roberts County, SD",2004-2005,10033,9939,-94,-0.937,22,-116,46,109,H1
"Roberts County, SD",2005-2006,9939,9977,38,0.382,71,-33,46,109,H1
"Roberts County, SD",2006-2007,9977,9986,9,0.09,71,-62,46,109,H1
"Roberts County, SD",2007-2008,9986,9997,11,0.11,63,-52,46,109,H1
"Roberts County, SD",2008-2009,9997,10013,16,0.16,68,-52,46,109,H1
"Roberts County, SD",2009-2010,10013,10182,169,1.688,69,100,46,109,H1
"Roberts County, SD",2010-2011,10182,10307,125,1.228,55,70,46,109,H1
"Roberts County, SD",2011-2012,10307,10348,41,0.398,75,-34,46,109,H1
"Roberts County, SD",2012-2013,10348,10305,-43,-0.416,78,-121,46,109,H1
"Roberts County, SD",2013-2014,10305,10374,69,0.67,89,-20,46,109,H1
"Roberts County, SD",2014-2015,10344,10311,-33,-0.319,90,-123,46,109,H1
"Roberts County, SD",2015-2016,10311,10222,-89,-0.863,90,-179,46,109,H1
"Roberts County, SD",2016-2017,10222,10278,56,0.548,65,-9,46,109,H1
"Sanborn County, SD",2000-2001,2658,2553,-105,-3.95,-7,-98,46,111,H1
"Sanborn County, SD",2001-2002,2553,2538,-15,-0.588,1,-16,46,111,H1
"Sanborn County, SD",2002-2003,2538,2567,29,1.143,0,29,46,111,H1
"Sanborn County, SD",2003-2004,2567,2541,-26,-1.013,-4,-22,46,111,H1
"Sanborn County, SD",2004-2005,2541,2457,-84,-3.306,-4,-80,46,111,H1
"Sanborn County, SD",2005-2006,2457,2410,-47,-1.913,-14,-33,46,111,H1
"Sanborn County, SD",2006-2007,2410,2395,-15,-0.622,4,-19,46,111,H1
"Sanborn County, SD",2007-2008,2395,2374,-21,-0.877,13,-34,46,111,H1
"Sanborn County, SD",2008-2009,2374,2367,-7,-0.295,3,-10,46,111,H1
"Sanborn County, SD",2009-2010,2367,2358,-9,-0.38,-1,-8,46,111,H1
"Sanborn County, SD",2010-2011,2358,2363,5,0.212,3,2,46,111,H1
"Sanborn County, SD",2011-2012,2363,2325,-38,-1.608,-7,-31,46,111,H1
"Sanborn County, SD",2012-2013,2325,2324,-1,-0.043,7,-8,46,111,H1
"Sanborn County, SD",2013-2014,2324,2336,12,0.516,10,2,46,111,H1
"Sanborn County, SD",2014-2015,2333,2355,22,0.943,17,5,46,111,H1
"Sanborn County, SD",2015-2016,2355,2378,23,0.977,17,6,46,111,H1
"Sanborn County, SD",2016-2017,2378,2450,72,3.028,20,52,46,111,H1
"Shannon County, SD",2000-2001,12542,12602,60,0.478,221,-161,46,113,H1
"Shannon County, SD",2001-2002,12602,12872,270,2.143,249,21,46,113,H1
"Shannon County, SD",2002-2003,12872,12993,121,0.94,228,-107,46,113,H1
"Shannon County, SD",2003-2004,12993,12983,-10,-0.077,241,-251,46,113,H1
"Shannon County, SD",2004-2005,12983,13150,167,1.286,234,-67,46,113,H1
"Shannon County, SD",2005-2006,13150,13404,254,1.932,311,-57,46,113,H1
"Shannon County, SD",2006-2007,13404,13345,-59,-0.44,280,-339,46,113,H1
"Shannon County, SD",2007-2008,13345,13368,23,0.172,254,-231,46,113,H1
"Shannon County, SD",2008-2009,13368,13425,57,0.426,263,-206,46,113,H1
"Shannon County, SD",2009-2010,13425,13649,224,1.669,237,-13,46,113,H1
"Shannon County, SD",2010-2011,13649,13917,268,1.964,236,32,46,113,H1
"Shannon County, SD",2011-2012,13917,14076,159,1.142,219,-60,46,113,H1
"Shannon County, SD",2012-2013,14076,14166,90,0.639,182,-92,46,113,H1
"Shannon County, SD",2013-2014,14166,14218,52,0.367,183,-131,46,113,H1
"Spink County, SD",2000-2001,7413,7204,-209,-2.819,-6,-203,46,115,H1
"Spink County, SD",2001-2002,7204,7071,-133,-1.846,1,-134,46,115,H1
"Spink County, SD",2002-2003,7071,6937,-134,-1.895,-5,-129,46,115,H1
"Spink County, SD",2003-2004,6937,6886,-51,-0.735,0,-51,46,115,H1
"Spink County, SD",2004-2005,6886,6814,-72,-1.046,9,-81,46,115,H1
"Spink County, SD",2005-2006,6814,6714,-100,-1.468,-1,-99,46,115,H1
"Spink County, SD",2006-2007,6714,6562,-152,-2.264,-4,-148,46,115,H1
"Spink County, SD",2007-2008,6562,6472,-90,-1.372,10,-100,46,115,H1
"Spink County, SD",2008-2009,6472,6435,-37,-0.572,19,-56,46,115,H1
"Spink County, SD",2009-2010,6435,6410,-25,-0.389,12,-37,46,115,H1
"Spink County, SD",2010-2011,6410,6503,93,1.451,-3,96,46,115,H1
"Spink County, SD",2011-2012,6503,6652,149,2.291,3,146,46,115,H1
"Spink County, SD",2012-2013,6652,6599,-53,-0.797,8,-61,46,115,H1
"Spink County, SD",2013-2014,6599,6598,-1,-0.015,12,-13,46,115,H1
"Spink County, SD",2014-2015,6580,6524,-56,-0.851,14,-70,46,115,H1
"Spink County, SD",2015-2016,6524,6404,-120,-1.839,-2,-118,46,115,H1
"Spink County, SD",2016-2017,6404,6410,6,0.094,2,4,46,115,H1
"Stanley County, SD",2000-2001,2777,2745,-32,-1.152,6,-38,46,117,H1
"Stanley County, SD",2001-2002,2745,2725,-20,-0.729,26,-46,46,117,H1
"Stanley County, SD",2002-2003,2725,2764,39,1.431,17,22,46,117,H1
"Stanley County, SD",2003-2004,2764,2843,79,2.858,31,48,46,117,H1
"Stanley County, SD",2004-2005,2843,2822,-21,-0.739,23,-44,46,117,H1
"Stanley County, SD",2005-2006,2822,2845,23,0.815,13,10,46,117,H1
"Stanley County, SD",2006-2007,2845,2886,41,1.441,23,18,46,117,H1
"Stanley County, SD",2007-2008,2886,2864,-22,-0.762,32,-54,46,117,H1
"Stanley County, SD",2008-2009,2864,2906,42,1.466,25,17,46,117,H1
"Stanley County, SD",2009-2010,2906,2989,83,2.856,26,57,46,117,H1
"Stanley County, SD",2010-2011,2989,2989,0,0,17,-17,46,117,H1
"Stanley County, SD",2011-2012,2989,2977,-12,-0.401,22,-34,46,117,H1
"Stanley County, SD",2012-2013,2977,2984,7,0.235,24,-17,46,117,H1
"Stanley County, SD",2013-2014,2984,2983,-1,-0.034,28,-29,46,117,H1
"Stanley County, SD",2014-2015,2965,2954,-11,-0.371,22,-33,46,117,H1
"Stanley County, SD",2015-2016,2954,3024,70,2.37,39,31,46,117,H1
"Stanley County, SD",2016-2017,3024,3011,-13,-0.43,27,-40,46,117,H1
"Sully County, SD",2000-2001,1545,1533,-12,-0.777,11,-23,46,119,H1
"Sully County, SD",2001-2002,1533,1487,-46,-3.001,10,-56,46,119,H1
"Sully County, SD",2002-2003,1487,1436,-51,-3.43,12,-63,46,119,H1
"Sully County, SD",2003-2004,1436,1410,-26,-1.811,9,-35,46,119,H1
"Sully County, SD",2004-2005,1410,1407,-3,-0.213,4,-7,46,119,H1
"Sully County, SD",2005-2006,1407,1422,15,1.066,14,1,46,119,H1
"Sully County, SD",2006-2007,1422,1436,14,0.985,15,-1,46,119,H1
"Sully County, SD",2007-2008,1436,1375,-61,-4.248,17,-78,46,119,H1
"Sully County, SD",2008-2009,1375,1367,-8,-0.582,23,-31,46,119,H1
"Sully County, SD",2009-2010,1367,1374,7,0.512,21,-14,46,119,H1
"Sully County, SD",2010-2011,1374,1387,13,0.946,2,11,46,119,H1
"Sully County, SD",2011-2012,1387,1445,58,4.182,9,49,46,119,H1
"Sully County, SD",2012-2013,1445,1464,19,1.315,7,12,46,119,H1
"Sully County, SD",2013-2014,1464,1438,-26,-1.776,7,-33,46,119,H1
"Sully County, SD",2014-2015,1426,1426,0,0,13,-13,46,119,H1
"Sully County, SD",2015-2016,1426,1419,-7,-0.491,7,-14,46,119,H1
"Sully County, SD",2016-2017,1419,1407,-12,-0.846,10,-22,46,119,H1
"Todd County, SD",2000-2001,9065,9157,92,1.015,175,-83,46,121,H1
"Todd County, SD",2001-2002,9157,9233,76,0.83,232,-156,46,121,H1
"Todd County, SD",2002-2003,9233,9260,27,0.292,176,-149,46,121,H1
"Todd County, SD",2003-2004,9260,9452,192,2.073,176,16,46,121,H1
"Todd County, SD",2004-2005,9452,9484,32,0.339,189,-157,46,121,H1
"Todd County, SD",2005-2006,9484,9505,21,0.221,183,-162,46,121,H1
"Todd County, SD",2006-2007,9505,9631,126,1.326,222,-96,46,121,H1
"Todd County, SD",2007-2008,9631,9559,-72,-0.748,219,-291,46,121,H1
"Todd County, SD",2008-2009,9559,9521,-38,-0.398,216,-254,46,121,H1
"Todd County, SD",2009-2010,9521,9637,116,1.218,201,-85,46,121,H1
"Todd County, SD",2010-2011,9637,9865,228,2.366,213,15,46,121,H1
"Todd County, SD",2011-2012,9865,9935,70,0.71,181,-111,46,121,H1
"Todd County, SD",2012-2013,9935,9977,42,0.423,135,-93,46,121,H1
"Todd County, SD",2013-2014,9977,9882,-95,-0.952,138,-233,46,121,H1
"Todd County, SD",2014-2015,9930,9959,29,0.292,142,-113,46,121,H1
"Todd County, SD",2015-2016,9959,10099,140,1.406,145,-5,46,121,H1
"Todd County, SD",2016-2017,10099,10065,-34,-0.337,144,-178,46,121,H1
"Tripp County, SD",2000-2001,6391,6281,-110,-1.721,-2,-108,46,123,H1
"Tripp County, SD",2001-2002,6281,6254,-27,-0.43,-17,-10,46,123,H1
"Tripp County, SD",2002-2003,6254,6184,-70,-1.119,-14,-56,46,123,H1
"Tripp County, SD",2003-2004,6184,6069,-115,-1.86,-19,-96,46,123,H1
"Tripp County, SD",2004-2005,6069,6061,-8,-0.132,19,-27,46,123,H1
"Tripp County, SD",2005-2006,6061,5964,-97,-1.6,-3,-94,46,123,H1
"Tripp County, SD",2006-2007,5964,5800,-164,-2.75,-15,-149,46,123,H1
"Tripp County, SD",2007-2008,5800,5671,-129,-2.224,-2,-127,46,123,H1
"Tripp County, SD",2008-2009,5671,5636,-35,-0.617,-7,-28,46,123,H1
"Tripp County, SD",2009-2010,5636,5639,3,0.053,-4,7,46,123,H1
"Tripp County, SD",2010-2011,5639,5605,-34,-0.603,-14,-20,46,123,H1
"Tripp County, SD",2011-2012,5605,5485,-120,-2.141,-2,-118,46,123,H1
"Tripp County, SD",2012-2013,5485,5506,21,0.383,12,9,46,123,H1
"Tripp County, SD",2013-2014,5506,5512,6,0.109,4,2,46,123,H1
"Tripp County, SD",2014-2015,5499,5434,-65,-1.182,6,-71,46,123,H1
"Tripp County, SD",2015-2016,5434,5490,56,1.031,3,53,46,123,H1
"Tripp County, SD",2016-2017,5490,5460,-30,-0.546,11,-41,46,123,H1
"Turner County, SD",2000-2001,8845,8742,-103,-1.164,-37,-66,46,125,H1
"Turner County, SD",2001-2002,8742,8576,-166,-1.899,-33,-133,46,125,H1
"Turner County, SD",2002-2003,8576,8577,1,0.012,-28,29,46,125,H1
"Turner County, SD",2003-2004,8577,8532,-45,-0.525,-19,-26,46,125,H1
"Turner County, SD",2004-2005,8532,8436,-96,-1.125,-27,-69,46,125,H1
"Turner County, SD",2005-2006,8436,8382,-54,-0.64,-6,-48,46,125,H1
"Turner County, SD",2006-2007,8382,8407,25,0.298,5,20,46,125,H1
"Turner County, SD",2007-2008,8407,8379,-28,-0.333,-27,-1,46,125,H1
"Turner County, SD",2008-2009,8379,8317,-62,-0.74,-18,-44,46,125,H1
"Turner County, SD",2009-2010,8317,8349,32,0.385,-8,40,46,125,H1
"Turner County, SD",2010-2011,8349,8375,26,0.311,-11,37,46,125,H1
"Turner County, SD",2011-2012,8375,8332,-43,-0.513,-10,-33,46,125,H1
"Turner County, SD",2012-2013,8332,8365,33,0.396,-1,34,46,125,H1
"Turner County, SD",2013-2014,8365,8272,-93,-1.112,-2,-91,46,125,H1
"Turner County, SD",2014-2015,8253,8209,-44,-0.533,-17,-27,46,125,H1
"Turner County, SD",2015-2016,8209,8268,59,0.719,-3,62,46,125,H1
"Turner County, SD",2016-2017,8268,8315,47,0.568,-4,51,46,125,H1
"Union County, SD",2000-2001,12564,12577,13,0.103,51,-38,46,127,H1
"Union County, SD",2001-2002,12577,12711,134,1.065,73,61,46,127,H1
"Union County, SD",2002-2003,12711,12863,152,1.196,70,82,46,127,H1
"Union County, SD",2003-2004,12863,13002,139,1.081,72,67,46,127,H1
"Union County, SD",2004-2005,13002,13119,117,0.9,78,39,46,127,H1
"Union County, SD",2005-2006,13119,13388,269,2.05,92,177,46,127,H1
"Union County, SD",2006-2007,13388,13672,284,2.121,76,208,46,127,H1
"Union County, SD",2007-2008,13672,13825,153,1.119,84,69,46,127,H1
"Union County, SD",2008-2009,13825,14127,302,2.184,84,218,46,127,H1
"Union County, SD",2009-2010,14127,14480,353,2.499,79,274,46,127,H1
"Union County, SD",2010-2011,14480,14601,121,0.836,58,63,46,127,H1
"Union County, SD",2011-2012,14601,14841,240,1.644,63,177,46,127,H1
"Union County, SD",2012-2013,14841,14804,-37,-0.249,57,-94,46,127,H1
"Union County, SD",2013-2014,14804,15029,225,1.52,77,148,46,127,H1
"Union County, SD",2014-2015,15020,14909,-111,-0.739,38,-149,46,127,H1
"Union County, SD",2015-2016,14909,14992,83,0.557,66,17,46,127,H1
"Union County, SD",2016-2017,14992,15029,37,0.247,56,-19,46,127,H1
"Walworth County, SD",2000-2001,5932,5812,-120,-2.023,-22,-98,46,129,H1
"Walworth County, SD",2001-2002,5812,5698,-114,-1.961,-22,-92,46,129,H1
"Walworth County, SD",2002-2003,5698,5551,-147,-2.58,-24,-123,46,129,H1
"Walworth County, SD",2003-2004,5551,5525,-26,-0.468,-8,-18,46,129,H1
"Walworth County, SD",2004-2005,5525,5507,-18,-0.326,-16,-2,46,129,H1
"Walworth County, SD",2005-2006,5507,5469,-38,-0.69,-28,-10,46,129,H1
"Walworth County, SD",2006-2007,5469,5379,-90,-1.646,-3,-87,46,129,H1
"Walworth County, SD",2007-2008,5379,5368,-11,-0.204,-19,8,46,129,H1
"Walworth County, SD",2008-2009,5368,5371,3,0.056,-15,18,46,129,H1
"Walworth County, SD",2009-2010,5371,5446,75,1.396,-3,78,46,129,H1
"Walworth County, SD",2010-2011,5446,5569,123,2.259,-9,132,46,129,H1
"Walworth County, SD",2011-2012,5569,5460,-109,-1.957,-15,-94,46,129,H1
"Walworth County, SD",2012-2013,5460,5505,45,0.824,-3,48,46,129,H1
"Walworth County, SD",2013-2014,5505,5511,6,0.109,-3,9,46,129,H1
"Walworth County, SD",2014-2015,5508,5443,-65,-1.18,4,-69,46,129,H1
"Walworth County, SD",2015-2016,5443,5501,58,1.066,6,52,46,129,H1
"Walworth County, SD",2016-2017,5501,5543,42,0.763,11,31,46,129,H1
"Yankton County, SD",2000-2001,21616,21527,-89,-0.412,60,-149,46,135,H1
"Yankton County, SD",2001-2002,21527,21576,49,0.228,41,8,46,135,H1
"Yankton County, SD",2002-2003,21576,21687,111,0.514,42,69,46,135,H1
"Yankton County, SD",2003-2004,21687,21869,182,0.839,49,133,46,135,H1
"Yankton County, SD",2004-2005,21869,21871,2,0.009,61,-59,46,135,H1
"Yankton County, SD",2005-2006,21871,21957,86,0.393,72,14,46,135,H1
"Yankton County, SD",2006-2007,21957,22064,107,0.487,98,9,46,135,H1
"Yankton County, SD",2007-2008,22064,22267,203,0.92,65,138,46,135,H1
"Yankton County, SD",2008-2009,22267,22331,64,0.287,53,11,46,135,H1
"Yankton County, SD",2009-2010,22331,22455,124,0.555,58,66,46,135,H1
"Yankton County, SD",2010-2011,22455,22507,52,0.232,39,13,46,135,H1
"Yankton County, SD",2011-2012,22507,22591,84,0.373,43,41,46,135,H1
"Yankton County, SD",2012-2013,22591,22664,73,0.323,65,8,46,135,H1
"Yankton County, SD",2013-2014,22664,22684,20,0.088,73,-53,46,135,H1
"Yankton County, SD",2014-2015,22695,22702,7,0.031,79,-72,46,135,H1
"Yankton County, SD",2015-2016,22702,22626,-76,-0.335,25,-101,46,135,H1
"Yankton County, SD",2016-2017,22626,22662,36,0.159,84,-48,46,135,H1
"Ziebach County, SD",2000-2001,2479,2514,35,1.412,33,2,46,137,H1
"Ziebach County, SD",2001-2002,2514,2560,46,1.83,35,11,46,137,H1
"Ziebach County, SD",2002-2003,2560,2594,34,1.328,27,7,46,137,H1
"Ziebach County, SD",2003-2004,2594,2631,37,1.426,29,8,46,137,H1
"Ziebach County, SD",2004-2005,2631,2663,32,1.216,30,2,46,137,H1
"Ziebach County, SD",2005-2006,2663,2782,119,4.469,39,80,46,137,H1
"Ziebach County, SD",2006-2007,2782,2781,-1,-0.036,19,-20,46,137,H1
"Ziebach County, SD",2007-2008,2781,2708,-73,-2.625,33,-106,46,137,H1
"Ziebach County, SD",2008-2009,2708,2737,29,1.071,42,-13,46,137,H1
"Ziebach County, SD",2009-2010,2737,2820,83,3.033,28,55,46,137,H1
"Ziebach County, SD",2010-2011,2820,2837,17,0.603,30,-13,46,137,H1
"Ziebach County, SD",2011-2012,2837,2869,32,1.128,35,-3,46,137,H1
"Ziebach County, SD",2012-2013,2869,2835,-34,-1.185,28,-62,46,137,H1
"Ziebach County, SD",2013-2014,2835,2826,-9,-0.317,23,-32,46,137,H1
"Ziebach County, SD",2014-2015,2823,2803,-20,-0.708,13,-33,46,137,H1
"Ziebach County, SD",2015-2016,2803,2874,71,2.533,14,57,46,137,H1
"Ziebach County, SD",2016-2017,2874,2756,-118,-4.106,4,-122,46,137,H1
Virginia,2000-2001,7105817,7198362,92545,1.302,42505,50040,51,0,STATE
Virginia,2001-2002,7198362,7286873,88511,1.23,42120,46391,51,0,STATE
Virginia,2002-2003,7286873,7366977,80104,1.099,43101,37003,51,0,STATE
Virginia,2003-2004,7366977,7475575,108598,1.474,44960,63638,51,0,STATE
Virginia,2004-2005,7475575,7577105,101530,1.358,45850,55680,51,0,STATE
Virginia,2005-2006,7577105,7673725,96620,1.275,48734,47886,51,0,STATE
Virginia,2006-2007,7673725,7.75E+06,77275,1.007,50830,26445,51,0,STATE
Virginia,2007-2008,7.75E+06,7833496,82496,1.064,49180,33316,51,0,STATE
Virginia,2008-2009,7833496,7925937,92441,1.18,47534,44907,51,0,STATE
Virginia,2009-2010,7925937,8025787,99850,1.26,46555,53295,51,0,STATE
Virginia,2010-2011,8025787,8110783,84996,1.059,41887,43109,51,0,STATE
Virginia,2011-2012,8110783,8193374,82591,1.018,42555,40036,51,0,STATE
Virginia,2012-2013,8193374,8267875,74501,0.909,39077,35424,51,0,STATE
Virginia,2013-2014,8267875,8328098,60223,0.728,40043,20180,51,0,STATE
Virginia,2014-2015,8328098,8382993,54895,0.659,40010,14885,51,0,STATE
Virginia,2015-2016,8382993,8414380,31387,0.374,37294,-5907,51,0,STATE
Virginia,2016-2017,8414380,8470020,55640,0.661,34729,20911,51,0,STATE
"Accomack County, VA",2000-2001,38215,37742,-473,-1.238,24,-497,51,1,H1
"Accomack County, VA",2001-2002,37742,37308,-434,-1.15,-19,-415,51,1,H1
"Accomack County, VA",2002-2003,37308,36742,-566,-1.517,36,-602,51,1,H1
"Accomack County, VA",2003-2004,36742,36310,-432,-1.176,-2,-430,51,1,H1
"Accomack County, VA",2004-2005,36310,35835,-475,-1.308,9,-484,51,1,H1
"Accomack County, VA",2005-2006,35835,35192,-643,-1.794,60,-703,51,1,H1
"Accomack County, VA",2006-2007,35192,34553,-639,-1.816,22,-661,51,1,H1
"Accomack County, VA",2007-2008,34553,33970,-583,-1.687,93,-676,51,1,H1
"Accomack County, VA",2008-2009,33970,33415,-555,-1.634,72,-627,51,1,H1
"Accomack County, VA",2009-2010,33415,33176,-239,-0.715,-10,-229,51,1,H1
"Accomack County, VA",2010-2011,33176,33294,118,0.356,6,112,51,1,H1
"Accomack County, VA",2011-2012,33294,33313,19,0.057,33,-14,51,1,H1
"Accomack County, VA",2012-2013,33313,33021,-292,-0.877,-51,-241,51,1,H1
"Accomack County, VA",2013-2014,33021,33021,0,0,-47,47,51,1,H1
"Accomack County, VA",2014-2015,32998,32973,-25,-0.076,-83,58,51,1,H1
"Accomack County, VA",2015-2016,32973,32818,-155,-0.47,-80,-75,51,1,H1
"Accomack County, VA",2016-2017,32818,32545,-273,-0.832,-102,-171,51,1,H1
"Albemarle County, VA",2000-2001,83532,85002,1470,1.76,446,1024,51,3,H1
"Albemarle County, VA",2001-2002,85002,86150,1148,1.351,403,745,51,3,H1
"Albemarle County, VA",2002-2003,86150,87620,1470,1.706,412,1058,51,3,H1
"Albemarle County, VA",2003-2004,87620,89491,1871,2.135,388,1483,51,3,H1
"Albemarle County, VA",2004-2005,89491,91676,2185,2.442,294,1891,51,3,H1
"Albemarle County, VA",2005-2006,91676,93852,2176,2.374,412,1764,51,3,H1
"Albemarle County, VA",2006-2007,93852,95009,1157,1.233,512,645,51,3,H1
"Albemarle County, VA",2007-2008,95009,97081,2072,2.181,416,1656,51,3,H1
"Albemarle County, VA",2008-2009,97081,98071,990,1.02,487,503,51,3,H1
"Albemarle County, VA",2009-2010,98071,99214,1143,1.165,366,777,51,3,H1
"Albemarle County, VA",2010-2011,99214,100667,1453,1.465,387,1066,51,3,H1
"Albemarle County, VA",2011-2012,100667,102030,1363,1.354,317,1046,51,3,H1
"Albemarle County, VA",2012-2013,102030,103014,984,0.964,288,696,51,3,H1
"Albemarle County, VA",2013-2014,103014,104489,1475,1.432,280,1195,51,3,H1
"Albemarle County, VA",2014-2015,104351,105703,1352,1.296,269,1083,51,3,H1
"Albemarle County, VA",2015-2016,105703,106419,716,0.677,176,540,51,3,H1
"Albemarle County, VA",2016-2017,106419,107702,1283,1.206,166,1117,51,3,H1
"Alleghany County, VA",2000-2001,17213,17082,-131,-0.761,-6,-125,51,5,H1
"Alleghany County, VA",2001-2002,17082,16953,-129,-0.755,-62,-67,51,5,H1
"Alleghany County, VA",2002-2003,16953,16687,-266,-1.569,-87,-179,51,5,H1
"Alleghany County, VA",2003-2004,16687,16645,-42,-0.252,-61,19,51,5,H1
"Alleghany County, VA",2004-2005,16645,16580,-65,-0.391,-90,25,51,5,H1
"Alleghany County, VA",2005-2006,16580,16564,-16,-0.097,-24,8,51,5,H1
"Alleghany County, VA",2006-2007,16564,16530,-34,-0.205,-57,23,51,5,H1
"Alleghany County, VA",2007-2008,16530,16404,-126,-0.762,-70,-56,51,5,H1
"Alleghany County, VA",2008-2009,16404,16306,-98,-0.597,-49,-49,51,5,H1
"Alleghany County, VA",2009-2010,16306,16223,-83,-0.509,-48,-35,51,5,H1
"Alleghany County, VA",2010-2011,16223,16320,97,0.598,-85,182,51,5,H1
"Alleghany County, VA",2011-2012,16320,16183,-137,-0.839,-97,-40,51,5,H1
"Alleghany County, VA",2012-2013,16183,16121,-62,-0.383,-119,57,51,5,H1
"Alleghany County, VA",2013-2014,16121,15820,-301,-1.867,-136,-165,51,5,H1
"Alleghany County, VA",2014-2015,15884,15677,-207,-1.303,-141,-66,51,5,H1
"Alleghany County, VA",2015-2016,15677,15372,-305,-1.946,-89,-216,51,5,H1
"Alleghany County, VA",2016-2017,15372,15122,-250,-1.626,-123,-127,51,5,H1
"Amelia County, VA",2000-2001,11446,11481,35,0.306,40,-5,51,7,H1
"Amelia County, VA",2001-2002,11481,11540,59,0.514,36,23,51,7,H1
"Amelia County, VA",2002-2003,11540,11544,4,0.035,-12,16,51,7,H1
"Amelia County, VA",2003-2004,11544,11712,168,1.455,35,133,51,7,H1
"Amelia County, VA",2004-2005,11712,11943,231,1.972,-5,236,51,7,H1
"Amelia County, VA",2005-2006,11943,12250,307,2.571,33,274,51,7,H1
"Amelia County, VA",2006-2007,12250,12447,197,1.608,3,194,51,7,H1
"Amelia County, VA",2007-2008,12447,12563,116,0.932,28,88,51,7,H1
"Amelia County, VA",2008-2009,12563,12594,31,0.247,34,-3,51,7,H1
"Amelia County, VA",2009-2010,12594,12740,146,1.159,25,121,51,7,H1
"Amelia County, VA",2010-2011,12740,12752,12,0.094,19,-7,51,7,H1
"Amelia County, VA",2011-2012,12752,12745,-7,-0.055,-11,4,51,7,H1
"Amelia County, VA",2012-2013,12745,12727,-18,-0.141,2,-20,51,7,H1
"Amelia County, VA",2013-2014,12727,12855,128,1.006,25,103,51,7,H1
"Amelia County, VA",2014-2015,12785,12903,118,0.923,3,115,51,7,H1
"Amelia County, VA",2015-2016,12903,12830,-73,-0.566,13,-86,51,7,H1
"Amelia County, VA",2016-2017,12830,13020,190,1.481,4,186,51,7,H1
"Amherst County, VA",2000-2001,31854,31953,99,0.311,47,52,51,9,H1
"Amherst County, VA",2001-2002,31953,31775,-178,-0.557,-22,-156,51,9,H1
"Amherst County, VA",2002-2003,31775,31810,35,0.11,5,30,51,9,H1
"Amherst County, VA",2003-2004,31810,31783,-27,-0.085,7,-34,51,9,H1
"Amherst County, VA",2004-2005,31783,31955,172,0.541,26,146,51,9,H1
"Amherst County, VA",2005-2006,31955,32094,139,0.435,-6,145,51,9,H1
"Amherst County, VA",2006-2007,32094,32203,109,0.34,29,80,51,9,H1
"Amherst County, VA",2007-2008,32203,32510,307,0.953,22,285,51,9,H1
"Amherst County, VA",2008-2009,32510,32447,-63,-0.194,13,-76,51,9,H1
"Amherst County, VA",2009-2010,32447,32388,-59,-0.182,-3,-56,51,9,H1
"Amherst County, VA",2010-2011,32388,32120,-268,-0.827,-21,-247,51,9,H1
"Amherst County, VA",2011-2012,32120,32445,325,1.012,-23,348,51,9,H1
"Amherst County, VA",2012-2013,32445,32193,-252,-0.777,-13,-239,51,9,H1
"Amherst County, VA",2013-2014,32193,32041,-152,-0.472,-46,-106,51,9,H1
"Amherst County, VA",2014-2015,32062,31914,-148,-0.462,-53,-95,51,9,H1
"Amherst County, VA",2015-2016,31914,31667,-247,-0.774,20,-267,51,9,H1
"Amherst County, VA",2016-2017,31667,31594,-73,-0.231,-14,-59,51,9,H1
"Appomattox County, VA",2000-2001,13692,13809,117,0.855,13,104,51,11,H1
"Appomattox County, VA",2001-2002,13809,13733,-76,-0.55,27,-103,51,11,H1
"Appomattox County, VA",2002-2003,13733,13765,32,0.233,3,29,51,11,H1
"Appomattox County, VA",2003-2004,13765,13916,151,1.097,21,130,51,11,H1
"Appomattox County, VA",2004-2005,13916,13981,65,0.467,3,62,51,11,H1
"Appomattox County, VA",2005-2006,13981,14215,234,1.674,-11,245,51,11,H1
"Appomattox County, VA",2006-2007,14215,14425,210,1.477,16,194,51,11,H1
"Appomattox County, VA",2007-2008,14425,14795,370,2.565,17,353,51,11,H1
"Appomattox County, VA",2008-2009,14795,14812,17,0.115,45,-28,51,11,H1
"Appomattox County, VA",2009-2010,14812,15031,219,1.479,33,186,51,11,H1
"Appomattox County, VA",2010-2011,15031,15003,-28,-0.186,-19,-9,51,11,H1
"Appomattox County, VA",2011-2012,15003,15144,141,0.94,45,96,51,11,H1
"Appomattox County, VA",2012-2013,15144,15230,86,0.568,42,44,51,11,H1
"Appomattox County, VA",2013-2014,15230,15279,49,0.322,32,17,51,11,H1
"Appomattox County, VA",2014-2015,15266,15414,148,0.969,25,123,51,11,H1
"Appomattox County, VA",2015-2016,15414,15505,91,0.59,3,88,51,11,H1
"Appomattox County, VA",2016-2017,15505,15681,176,1.135,-2,178,51,11,H1
"Arlington County, VA",2000-2001,189198,190386,1188,0.628,1705,-517,51,13,H1
"Arlington County, VA",2001-2002,190386,190137,-249,-0.131,1715,-1964,51,13,H1
"Arlington County, VA",2002-2003,190137,188735,-1402,-0.737,1702,-3104,51,13,H1
"Arlington County, VA",2003-2004,188735,187901,-834,-0.442,1677,-2511,51,13,H1
"Arlington County, VA",2004-2005,187901,187760,-141,-0.075,1837,-1978,51,13,H1
"Arlington County, VA",2005-2006,187760,188176,416,0.222,1734,-1318,51,13,H1
"Arlington County, VA",2006-2007,188176,190759,2583,1.373,1847,736,51,13,H1
"Arlington County, VA",2007-2008,190759,196305,5546,2.907,1863,3683,51,13,H1
"Arlington County, VA",2008-2009,196305,202637,6332,3.226,1864,4468,51,13,H1
"Arlington County, VA",2009-2010,202637,209395,6758,3.335,2134,4624,51,13,H1
"Arlington County, VA",2010-2011,209395,216603,7208,3.442,2074,5134,51,13,H1
"Arlington County, VA",2011-2012,216603,221947,5344,2.467,2231,3113,51,13,H1
"Arlington County, VA",2012-2013,221947,226012,4065,1.832,2305,1760,51,13,H1
"Arlington County, VA",2013-2014,226012,226908,896,0.396,2247,-1351,51,13,H1
"Arlington County, VA",2014-2015,226624,229164,2540,1.121,2164,376,51,13,H1
"Arlington County, VA",2015-2016,229164,231610,2446,1.067,2213,233,51,13,H1
"Arlington County, VA",2016-2017,231610,234965,3355,1.449,2011,1344,51,13,H1
"Augusta County, VA",2000-2001,65572,66124,552,0.842,138,414,51,15,H1
"Augusta County, VA",2001-2002,66124,66735,611,0.924,128,483,51,15,H1
"Augusta County, VA",2002-2003,66735,67660,925,1.386,213,712,51,15,H1
"Augusta County, VA",2003-2004,67660,68899,1239,1.831,119,1120,51,15,H1
"Augusta County, VA",2004-2005,68899,69949,1050,1.524,146,904,51,15,H1
"Augusta County, VA",2005-2006,69949,71896,1947,2.783,139,1808,51,15,H1
"Augusta County, VA",2006-2007,71896,73041,1145,1.593,245,900,51,15,H1
"Augusta County, VA",2007-2008,73041,73555,514,0.704,163,351,51,15,H1
"Augusta County, VA",2008-2009,73555,73844,289,0.393,164,125,51,15,H1
"Augusta County, VA",2009-2010,73844,73485,-359,-0.486,122,-481,51,15,H1
"Augusta County, VA",2010-2011,73485,73752,267,0.363,-57,324,51,15,H1
"Augusta County, VA",2011-2012,73752,73603,-149,-0.202,-43,-106,51,15,H1
"Augusta County, VA",2012-2013,73603,73835,232,0.315,-111,343,51,15,H1
"Augusta County, VA",2013-2014,73835,73862,27,0.037,-93,120,51,15,H1
"Augusta County, VA",2014-2015,74159,74314,155,0.209,-139,294,51,15,H1
"Augusta County, VA",2015-2016,74314,74774,460,0.619,-38,498,51,15,H1
"Augusta County, VA",2016-2017,74774,75144,370,0.495,-66,436,51,15,H1
"Bath County, VA",2000-2001,5020,4997,-23,-0.458,-22,-1,51,17,H1
"Bath County, VA",2001-2002,4997,5012,15,0.3,-27,42,51,17,H1
"Bath County, VA",2002-2003,5012,4974,-38,-0.758,-28,-10,51,17,H1
"Bath County, VA",2003-2004,4974,4934,-40,-0.804,-23,-17,51,17,H1
"Bath County, VA",2004-2005,4934,4891,-43,-0.872,-35,-8,51,17,H1
"Bath County, VA",2005-2006,4891,4823,-68,-1.39,-29,-39,51,17,H1
"Bath County, VA",2006-2007,4823,4835,12,0.249,-13,25,51,17,H1
"Bath County, VA",2007-2008,4835,4778,-57,-1.179,-21,-36,51,17,H1
"Bath County, VA",2008-2009,4778,4743,-35,-0.733,-34,-1,51,17,H1
"Bath County, VA",2009-2010,4743,4717,-26,-0.548,-35,9,51,17,H1
"Bath County, VA",2010-2011,4717,4676,-41,-0.869,-26,-15,51,17,H1
"Bath County, VA",2011-2012,4676,4655,-21,-0.449,-39,18,51,17,H1
"Bath County, VA",2012-2013,4655,4607,-48,-1.031,-12,-36,51,17,H1
"Bath County, VA",2013-2014,4607,4563,-44,-0.955,-15,-29,51,17,H1
"Bath County, VA",2014-2015,4549,4470,-79,-1.737,-4,-75,51,17,H1
"Bath County, VA",2015-2016,4470,4413,-57,-1.275,-11,-46,51,17,H1
"Bath County, VA",2016-2017,4413,4297,-116,-2.629,-13,-103,51,17,H1
"Bedford County, VA",2000-2001,60472,60985,513,0.848,170,343,51,19,H1
"Bedford County, VA",2001-2002,60985,61580,595,0.976,86,509,51,19,H1
"Bedford County, VA",2002-2003,61580,62441,861,1.398,133,728,51,19,H1
"Bedford County, VA",2003-2004,62441,63563,1122,1.797,97,1025,51,19,H1
"Bedford County, VA",2004-2005,63563,64825,1262,1.985,148,1114,51,19,H1
"Bedford County, VA",2005-2006,64825,66363,1538,2.373,156,1382,51,19,H1
"Bedford County, VA",2006-2007,66363,67392,1029,1.551,41,988,51,19,H1
"Bedford County, VA",2007-2008,67392,67594,202,0.3,122,80,51,19,H1
"Bedford County, VA",2008-2009,67594,68399,805,1.191,138,667,51,19,H1
"Bedford County, VA",2009-2010,68399,74941,6542,9.564,122,6420,51,19,H1
"Bedford County, VA",2010-2011,74941,75338,397,0.53,-38,435,51,19,H1
"Bedford County, VA",2011-2012,75338,75431,93,0.123,-101,194,51,19,H1
"Bedford County, VA",2012-2013,75431,75740,309,0.41,-86,395,51,19,H1
"Bedford County, VA",2013-2014,75740,76583,843,1.113,-118,961,51,19,H1
"Bedford County, VA",2014-2015,77095,77724,629,0.816,-85,714,51,19,H1
"Bedford County, VA",2015-2016,77724,77828,104,0.134,-188,292,51,19,H1
"Bedford County, VA",2016-2017,77828,77974,146,0.188,-206,352,51,19,H1
"Bland County, VA",2000-2001,6833,6876,43,0.629,-20,63,51,21,H1
"Bland County, VA",2001-2002,6876,6836,-40,-0.582,-5,-35,51,21,H1
"Bland County, VA",2002-2003,6836,6913,77,1.126,-5,82,51,21,H1
"Bland County, VA",2003-2004,6913,6913,0,0,-33,33,51,21,H1
"Bland County, VA",2004-2005,6913,6873,-40,-0.579,-16,-24,51,21,H1
"Bland County, VA",2005-2006,6873,6840,-33,-0.48,-38,5,51,21,H1
"Bland County, VA",2006-2007,6840,6930,90,1.316,-47,137,51,21,H1
"Bland County, VA",2007-2008,6930,6921,-9,-0.13,-19,10,51,21,H1
"Bland County, VA",2008-2009,6921,6868,-53,-0.766,-8,-45,51,21,H1
"Bland County, VA",2009-2010,6868,6823,-45,-0.655,-20,-25,51,21,H1
"Bland County, VA",2010-2011,6823,6780,-43,-0.63,-42,-1,51,21,H1
"Bland County, VA",2011-2012,6780,6710,-70,-1.032,-45,-25,51,21,H1
"Bland County, VA",2012-2013,6710,6695,-15,-0.224,-25,10,51,21,H1
"Bland County, VA",2013-2014,6695,6625,-70,-1.046,-39,-31,51,21,H1
"Bland County, VA",2014-2015,6606,6561,-45,-0.681,-44,-1,51,21,H1
"Bland County, VA",2015-2016,6561,6475,-86,-1.311,-34,-52,51,21,H1
"Bland County, VA",2016-2017,6475,6350,-125,-1.931,-38,-87,51,21,H1
"Botetourt County, VA",2000-2001,30648,30748,100,0.326,26,74,51,23,H1
"Botetourt County, VA",2001-2002,30748,31155,407,1.324,28,379,51,23,H1
"Botetourt County, VA",2002-2003,31155,31454,299,0.96,68,231,51,23,H1
"Botetourt County, VA",2003-2004,31454,31715,261,0.83,44,217,51,23,H1
"Botetourt County, VA",2004-2005,31715,31803,88,0.277,-21,109,51,23,H1
"Botetourt County, VA",2005-2006,31803,32491,688,2.163,15,673,51,23,H1
"Botetourt County, VA",2006-2007,32491,32681,190,0.585,-10,200,51,23,H1
"Botetourt County, VA",2007-2008,32681,32955,274,0.838,-16,290,51,23,H1
"Botetourt County, VA",2008-2009,32955,33042,87,0.264,6,81,51,23,H1
"Botetourt County, VA",2009-2010,33042,33188,146,0.442,-14,160,51,23,H1
"Botetourt County, VA",2010-2011,33188,33052,-136,-0.41,-76,-60,51,23,H1
"Botetourt County, VA",2011-2012,33052,33157,105,0.318,-88,193,51,23,H1
"Botetourt County, VA",2012-2013,33157,33029,-128,-0.386,-79,-49,51,23,H1
"Botetourt County, VA",2013-2014,33029,33100,71,0.215,-89,160,51,23,H1
"Botetourt County, VA",2014-2015,33115,33347,232,0.701,-98,330,51,23,H1
"Botetourt County, VA",2015-2016,33347,33150,-197,-0.591,-117,-80,51,23,H1
"Botetourt County, VA",2016-2017,33150,33192,42,0.127,-117,159,51,23,H1
"Brunswick County, VA",2000-2001,18387,18331,-56,-0.305,3,-59,51,25,H1
"Brunswick County, VA",2001-2002,18331,18236,-95,-0.518,-36,-59,51,25,H1
"Brunswick County, VA",2002-2003,18236,18072,-164,-0.899,-51,-113,51,25,H1
"Brunswick County, VA",2003-2004,18072,17981,-91,-0.504,-40,-51,51,25,H1
"Brunswick County, VA",2004-2005,17981,17981,0,0,-9,9,51,25,H1
"Brunswick County, VA",2005-2006,17981,18011,30,0.167,-7,37,51,25,H1
"Brunswick County, VA",2006-2007,18011,17823,-188,-1.044,-18,-170,51,25,H1
"Brunswick County, VA",2007-2008,17823,17791,-32,-0.18,-36,4,51,25,H1
"Brunswick County, VA",2008-2009,17791,17507,-284,-1.596,-23,-261,51,25,H1
"Brunswick County, VA",2009-2010,17507,17424,-83,-0.474,-39,-44,51,25,H1
"Brunswick County, VA",2010-2011,17424,17161,-263,-1.509,-42,-221,51,25,H1
"Brunswick County, VA",2011-2012,17161,17063,-98,-0.571,-27,-71,51,25,H1
"Brunswick County, VA",2012-2013,17063,16659,-404,-2.368,-49,-355,51,25,H1
"Brunswick County, VA",2013-2014,16659,16498,-161,-0.966,-73,-88,51,25,H1
"Brunswick County, VA",2014-2015,16787,16698,-89,-0.53,-79,-10,51,25,H1
"Brunswick County, VA",2015-2016,16698,16275,-423,-2.533,-84,-339,51,25,H1
"Brunswick County, VA",2016-2017,16275,16244,-31,-0.19,-88,57,51,25,H1
"Buchanan County, VA",2000-2001,26838,26501,-337,-1.256,-25,-312,51,27,H1
"Buchanan County, VA",2001-2002,26501,26299,-202,-0.762,-88,-114,51,27,H1
"Buchanan County, VA",2002-2003,26299,25941,-358,-1.361,-75,-283,51,27,H1
"Buchanan County, VA",2003-2004,25941,25647,-294,-1.133,-70,-224,51,27,H1
"Buchanan County, VA",2004-2005,25647,25315,-332,-1.294,-85,-247,51,27,H1
"Buchanan County, VA",2005-2006,25315,25009,-306,-1.209,-51,-255,51,27,H1
"Buchanan County, VA",2006-2007,25009,24670,-339,-1.356,-74,-265,51,27,H1
"Buchanan County, VA",2007-2008,24670,24371,-299,-1.212,-70,-229,51,27,H1
"Buchanan County, VA",2008-2009,24371,24234,-137,-0.562,-53,-84,51,27,H1
"Buchanan County, VA",2009-2010,24234,24028,-206,-0.85,-45,-161,51,27,H1
"Buchanan County, VA",2010-2011,24028,23888,-140,-0.583,-79,-61,51,27,H1
"Buchanan County, VA",2011-2012,23888,23837,-51,-0.213,-81,30,51,27,H1
"Buchanan County, VA",2012-2013,23837,23555,-282,-1.183,-67,-215,51,27,H1
"Buchanan County, VA",2013-2014,23555,23106,-449,-1.906,-73,-376,51,27,H1
"Buchanan County, VA",2014-2015,23177,22776,-401,-1.73,-120,-281,51,27,H1
"Buchanan County, VA",2015-2016,22776,22102,-674,-2.959,-136,-538,51,27,H1
"Buchanan County, VA",2016-2017,22102,21514,-588,-2.66,-130,-458,51,27,H1
"Buckingham County, VA",2000-2001,15634,15857,223,1.426,-55,278,51,29,H1
"Buckingham County, VA",2001-2002,15857,15908,51,0.322,-6,57,51,29,H1
"Buckingham County, VA",2002-2003,15908,16057,149,0.937,-17,166,51,29,H1
"Buckingham County, VA",2003-2004,16057,16168,111,0.691,-25,136,51,29,H1
"Buckingham County, VA",2004-2005,16168,16401,233,1.441,-49,282,51,29,H1
"Buckingham County, VA",2005-2006,16401,16547,146,0.89,-27,173,51,29,H1
"Buckingham County, VA",2006-2007,16547,16737,190,1.148,25,165,51,29,H1
"Buckingham County, VA",2007-2008,16737,16819,82,0.49,23,59,51,29,H1
"Buckingham County, VA",2008-2009,16819,17148,329,1.956,-5,334,51,29,H1
"Buckingham County, VA",2009-2010,17148,17107,-41,-0.239,4,-45,51,29,H1
"Buckingham County, VA",2010-2011,17107,17170,63,0.368,-2,65,51,29,H1
"Buckingham County, VA",2011-2012,17170,17043,-127,-0.74,8,-135,51,29,H1
"Buckingham County, VA",2012-2013,17043,17127,84,0.493,37,47,51,29,H1
"Buckingham County, VA",2013-2014,17127,16913,-214,-1.249,24,-238,51,29,H1
"Buckingham County, VA",2014-2015,16927,17032,105,0.62,17,88,51,29,H1
"Buckingham County, VA",2015-2016,17032,17060,28,0.164,-19,47,51,29,H1
"Buckingham County, VA",2016-2017,17060,17065,5,0.029,-27,32,51,29,H1
"Campbell County, VA",2000-2001,51082,51349,267,0.523,248,19,51,31,H1
"Campbell County, VA",2001-2002,51349,51685,336,0.654,120,216,51,31,H1
"Campbell County, VA",2002-2003,51685,51885,200,0.387,153,47,51,31,H1
"Campbell County, VA",2003-2004,51885,52093,208,0.401,72,136,51,31,H1
"Campbell County, VA",2004-2005,52093,52795,702,1.348,137,565,51,31,H1
"Campbell County, VA",2005-2006,52795,53475,680,1.288,96,584,51,31,H1
"Campbell County, VA",2006-2007,53475,53769,294,0.55,49,245,51,31,H1
"Campbell County, VA",2007-2008,53769,54232,463,0.861,107,356,51,31,H1
"Campbell County, VA",2008-2009,54232,54472,240,0.443,108,132,51,31,H1
"Campbell County, VA",2009-2010,54472,54891,419,0.769,86,333,51,31,H1
"Campbell County, VA",2010-2011,54891,54812,-79,-0.144,7,-86,51,31,H1
"Campbell County, VA",2011-2012,54812,54726,-86,-0.157,35,-121,51,31,H1
"Campbell County, VA",2012-2013,54726,54851,125,0.228,-30,155,51,31,H1
"Campbell County, VA",2013-2014,54851,54885,34,0.062,-24,58,51,31,H1
"Campbell County, VA",2014-2015,55101,55086,-15,-0.027,-30,15,51,31,H1
"Campbell County, VA",2015-2016,55086,55180,94,0.171,-42,136,51,31,H1
"Campbell County, VA",2016-2017,55180,55010,-170,-0.308,-15,-155,51,31,H1
"Caroline County, VA",2000-2001,22136,22168,32,0.145,29,3,51,33,H1
"Caroline County, VA",2001-2002,22168,22566,398,1.795,36,362,51,33,H1
"Caroline County, VA",2002-2003,22566,23135,569,2.521,70,499,51,33,H1
"Caroline County, VA",2003-2004,23135,23920,785,3.393,83,702,51,33,H1
"Caroline County, VA",2004-2005,23920,25475,1555,6.501,147,1408,51,33,H1
"Caroline County, VA",2005-2006,25475,26722,1247,4.895,149,1098,51,33,H1
"Caroline County, VA",2006-2007,26722,27592,870,3.256,131,739,51,33,H1
"Caroline County, VA",2007-2008,27592,28011,419,1.519,164,255,51,33,H1
"Caroline County, VA",2008-2009,28011,28263,252,0.9,147,105,51,33,H1
"Caroline County, VA",2009-2010,28263,28615,352,1.245,126,226,51,33,H1
"Caroline County, VA",2010-2011,28615,28667,52,0.182,146,-94,51,33,H1
"Caroline County, VA",2011-2012,28667,28939,272,0.949,167,105,51,33,H1
"Caroline County, VA",2012-2013,28939,29285,346,1.196,141,205,51,33,H1
"Caroline County, VA",2013-2014,29285,29778,493,1.683,141,352,51,33,H1
"Caroline County, VA",2014-2015,29795,29984,189,0.634,168,21,51,33,H1
"Caroline County, VA",2015-2016,29984,30071,87,0.29,78,9,51,33,H1
"Caroline County, VA",2016-2017,30071,30461,390,1.297,111,279,51,33,H1
"Carroll County, VA",2000-2001,29264,29448,184,0.629,-53,237,51,35,H1
"Carroll County, VA",2001-2002,29448,29415,-33,-0.112,-8,-25,51,35,H1
"Carroll County, VA",2002-2003,29415,29472,57,0.194,-24,81,51,35,H1
"Carroll County, VA",2003-2004,29472,29670,198,0.672,-69,267,51,35,H1
"Carroll County, VA",2004-2005,29670,29660,-10,-0.034,-62,52,51,35,H1
"Carroll County, VA",2005-2006,29660,29894,234,0.789,-41,275,51,35,H1
"Carroll County, VA",2006-2007,29894,29933,39,0.13,-40,79,51,35,H1
"Carroll County, VA",2007-2008,29933,30067,134,0.448,-63,197,51,35,H1
"Carroll County, VA",2008-2009,30067,30002,-65,-0.216,-59,-6,51,35,H1
"Carroll County, VA",2009-2010,30002,30042,40,0.133,-48,88,51,35,H1
"Carroll County, VA",2010-2011,30042,30031,-11,-0.037,-103,92,51,35,H1
"Carroll County, VA",2011-2012,30031,29873,-158,-0.526,-94,-64,51,35,H1
"Carroll County, VA",2012-2013,29873,29837,-36,-0.121,-124,88,51,35,H1
"Carroll County, VA",2013-2014,29837,29621,-216,-0.724,-127,-89,51,35,H1
"Carroll County, VA",2014-2015,29641,29724,83,0.28,-137,220,51,35,H1
"Carroll County, VA",2015-2016,29724,29699,-25,-0.084,-108,83,51,35,H1
"Carroll County, VA",2016-2017,29699,29708,9,0.03,-126,135,51,35,H1
"Charles City County, VA",2000-2001,6930,6952,22,0.317,8,14,51,36,H1
"Charles City County, VA",2001-2002,6952,7030,78,1.122,12,66,51,36,H1
"Charles City County, VA",2002-2003,7030,7091,61,0.868,4,57,51,36,H1
"Charles City County, VA",2003-2004,7091,7050,-41,-0.578,-9,-32,51,36,H1
"Charles City County, VA",2004-2005,7050,7060,10,0.142,-2,12,51,36,H1
"Charles City County, VA",2005-2006,7060,7156,96,1.36,5,91,51,36,H1
"Charles City County, VA",2006-2007,7156,7148,-8,-0.112,-1,-7,51,36,H1
"Charles City County, VA",2007-2008,7148,7232,84,1.175,23,61,51,36,H1
"Charles City County, VA",2008-2009,7232,7216,-16,-0.221,4,-20,51,36,H1
"Charles City County, VA",2009-2010,7216,7260,44,0.61,-19,63,51,36,H1
"Charles City County, VA",2010-2011,7260,7231,-29,-0.399,-44,15,51,36,H1
"Charles City County, VA",2011-2012,7231,7148,-83,-1.148,-20,-63,51,36,H1
"Charles City County, VA",2012-2013,7148,7106,-42,-0.588,-13,-29,51,36,H1
"Charles City County, VA",2013-2014,7106,7023,-83,-1.168,-23,-60,51,36,H1
"Charles City County, VA",2014-2015,7024,7040,16,0.228,-46,62,51,36,H1
"Charles City County, VA",2015-2016,7040,7023,-17,-0.241,-29,12,51,36,H1
"Charles City County, VA",2016-2017,7023,7004,-19,-0.271,-49,30,51,36,H1
"Charlotte County, VA",2000-2001,12476,12481,5,0.04,-14,19,51,37,H1
"Charlotte County, VA",2001-2002,12481,12590,109,0.873,-23,132,51,37,H1
"Charlotte County, VA",2002-2003,12590,12465,-125,-0.993,-14,-111,51,37,H1
"Charlotte County, VA",2003-2004,12465,12524,59,0.473,-7,66,51,37,H1
"Charlotte County, VA",2004-2005,12524,12631,107,0.854,-16,123,51,37,H1
"Charlotte County, VA",2005-2006,12631,12731,100,0.792,-15,115,51,37,H1
"Charlotte County, VA",2006-2007,12731,12680,-51,-0.401,-35,-16,51,37,H1
"Charlotte County, VA",2007-2008,12680,12654,-26,-0.205,0,-26,51,37,H1
"Charlotte County, VA",2008-2009,12654,12588,-66,-0.522,-3,-63,51,37,H1
"Charlotte County, VA",2009-2010,12588,12547,-41,-0.326,-21,-20,51,37,H1
"Charlotte County, VA",2010-2011,12547,12501,-46,-0.367,-13,-33,51,37,H1
"Charlotte County, VA",2011-2012,12501,12411,-90,-0.72,-17,-73,51,37,H1
"Charlotte County, VA",2012-2013,12411,12312,-99,-0.798,6,-105,51,37,H1
"Charlotte County, VA",2013-2014,12312,12225,-87,-0.707,-18,-69,51,37,H1
"Charlotte County, VA",2014-2015,12186,12201,15,0.123,-19,34,51,37,H1
"Charlotte County, VA",2015-2016,12201,12130,-71,-0.582,-7,-64,51,37,H1
"Charlotte County, VA",2016-2017,12130,12119,-11,-0.091,-6,-5,51,37,H1
"Chesterfield County, VA",2000-2001,261047,265544,4497,1.723,1842,2655,51,41,H1
"Chesterfield County, VA",2001-2002,265544,270741,5197,1.957,1870,3327,51,41,H1
"Chesterfield County, VA",2002-2003,270741,276300,5559,2.053,1898,3661,51,41,H1
"Chesterfield County, VA",2003-2004,276300,283030,6730,2.436,1890,4840,51,41,H1
"Chesterfield County, VA",2004-2005,283030,289998,6968,2.462,1951,5017,51,41,H1
"Chesterfield County, VA",2005-2006,289998,298496,8498,2.93,2122,6376,51,41,H1
"Chesterfield County, VA",2006-2007,298496,304636,6140,2.057,2107,4033,51,41,H1
"Chesterfield County, VA",2007-2008,304636,309837,5201,1.707,2091,3110,51,41,H1
"Chesterfield County, VA",2008-2009,309837,313096,3259,1.052,2279,980,51,41,H1
"Chesterfield County, VA",2009-2010,313096,317151,4055,1.295,2110,1945,51,41,H1
"Chesterfield County, VA",2010-2011,317151,320292,3141,0.99,1684,1457,51,41,H1
"Chesterfield County, VA",2011-2012,320292,323850,3558,1.111,1581,1977,51,41,H1
"Chesterfield County, VA",2012-2013,323850,327892,4042,1.248,1613,2429,51,41,H1
"Chesterfield County, VA",2013-2014,327892,332499,4607,1.405,1608,2999,51,41,H1
"Chesterfield County, VA",2014-2015,332593,335687,3094,0.93,1671,1423,51,41,H1
"Chesterfield County, VA",2015-2016,335687,338815,3128,0.932,1454,1674,51,41,H1
"Chesterfield County, VA",2016-2017,338815,343599,4784,1.412,1390,3394,51,41,H1
"Clarke County, VA",2000-2001,12672,12862,190,1.499,1,189,51,43,H1
"Clarke County, VA",2001-2002,12862,12950,88,0.684,-7,95,51,43,H1
"Clarke County, VA",2002-2003,12950,13110,160,1.236,-12,172,51,43,H1
"Clarke County, VA",2003-2004,13110,13413,303,2.311,-17,320,51,43,H1
"Clarke County, VA",2004-2005,13413,13710,297,2.214,3,294,51,43,H1
"Clarke County, VA",2005-2006,13710,13939,229,1.67,11,218,51,43,H1
"Clarke County, VA",2006-2007,13939,13969,30,0.215,3,27,51,43,H1
"Clarke County, VA",2007-2008,13969,14092,123,0.881,-1,124,51,43,H1
"Clarke County, VA",2008-2009,14092,14015,-77,-0.546,7,-84,51,43,H1
"Clarke County, VA",2009-2010,14015,14049,34,0.243,-27,61,51,43,H1
"Clarke County, VA",2010-2011,14049,14229,180,1.281,-9,189,51,43,H1
"Clarke County, VA",2011-2012,14229,14316,87,0.611,-18,105,51,43,H1
"Clarke County, VA",2012-2013,14316,14348,32,0.224,11,21,51,43,H1
"Clarke County, VA",2013-2014,14348,14423,75,0.523,11,64,51,43,H1
"Clarke County, VA",2014-2015,14365,14363,-2,-0.014,23,-25,51,43,H1
"Clarke County, VA",2015-2016,14363,14322,-41,-0.285,-14,-27,51,43,H1
"Clarke County, VA",2016-2017,14322,14508,186,1.299,-15,201,51,43,H1
"Craig County, VA",2000-2001,5073,5056,-17,-0.335,21,-38,51,45,H1
"Craig County, VA",2001-2002,5056,5065,9,0.178,-9,18,51,45,H1
"Craig County, VA",2002-2003,5065,5097,32,0.632,-6,38,51,45,H1
"Craig County, VA",2003-2004,5097,5142,45,0.883,6,39,51,45,H1
"Craig County, VA",2004-2005,5142,5139,-3,-0.058,-5,2,51,45,H1
"Craig County, VA",2005-2006,5139,5158,19,0.37,-12,31,51,45,H1
"Craig County, VA",2006-2007,5158,5212,54,1.047,1,53,51,45,H1
"Craig County, VA",2007-2008,5212,5167,-45,-0.863,-3,-42,51,45,H1
"Craig County, VA",2008-2009,5167,5120,-47,-0.91,-15,-32,51,45,H1
"Craig County, VA",2009-2010,5120,5176,56,1.094,-15,71,51,45,H1
"Craig County, VA",2010-2011,5176,5228,52,1.005,-22,74,51,45,H1
"Craig County, VA",2011-2012,5228,5198,-30,-0.574,-10,-20,51,45,H1
"Craig County, VA",2012-2013,5198,5196,-2,-0.038,7,-9,51,45,H1
"Craig County, VA",2013-2014,5196,5234,38,0.731,-15,53,51,45,H1
"Craig County, VA",2014-2015,5240,5211,-29,-0.553,-12,-17,51,45,H1
"Craig County, VA",2015-2016,5211,5140,-71,-1.363,-3,-68,51,45,H1
"Craig County, VA",2016-2017,5140,5062,-78,-1.518,-27,-51,51,45,H1
"Culpeper County, VA",2000-2001,34442,35299,857,2.488,145,712,51,47,H1
"Culpeper County, VA",2001-2002,35299,36612,1313,3.72,174,1139,51,47,H1
"Culpeper County, VA",2002-2003,36612,38121,1509,4.122,201,1308,51,47,H1
"Culpeper County, VA",2003-2004,38121,39670,1549,4.063,259,1290,51,47,H1
"Culpeper County, VA",2004-2005,39670,41894,2224,5.606,212,2012,51,47,H1
"Culpeper County, VA",2005-2006,41894,44076,2182,5.208,277,1905,51,47,H1
"Culpeper County, VA",2006-2007,44076,45527,1451,3.292,405,1046,51,47,H1
"Culpeper County, VA",2007-2008,45527,46056,529,1.162,289,240,51,47,H1
"Culpeper County, VA",2008-2009,46056,46236,180,0.391,298,-118,51,47,H1
"Culpeper County, VA",2009-2010,46236,46816,580,1.254,268,312,51,47,H1
"Culpeper County, VA",2010-2011,46816,47311,495,1.057,236,259,51,47,H1
"Culpeper County, VA",2011-2012,47311,47767,456,0.964,289,167,51,47,H1
"Culpeper County, VA",2012-2013,47767,48488,721,1.509,285,436,51,47,H1
"Culpeper County, VA",2013-2014,48488,49166,678,1.398,277,401,51,47,H1
"Culpeper County, VA",2014-2015,49117,49432,315,0.641,266,49,51,47,H1
"Culpeper County, VA",2015-2016,49432,50333,901,1.823,299,602,51,47,H1
"Culpeper County, VA",2016-2017,50333,51282,949,1.885,265,684,51,47,H1
"Cumberland County, VA",2000-2001,8987,9002,15,0.167,11,4,51,49,H1
"Cumberland County, VA",2001-2002,9002,9093,91,1.011,42,49,51,49,H1
"Cumberland County, VA",2002-2003,9093,9216,123,1.353,8,115,51,49,H1
"Cumberland County, VA",2003-2004,9216,9223,7,0.076,15,-8,51,49,H1
"Cumberland County, VA",2004-2005,9223,9465,242,2.624,21,221,51,49,H1
"Cumberland County, VA",2005-2006,9465,9596,131,1.384,24,107,51,49,H1
"Cumberland County, VA",2006-2007,9596,9762,166,1.73,31,135,51,49,H1
"Cumberland County, VA",2007-2008,9762,9849,87,0.891,35,52,51,49,H1
"Cumberland County, VA",2008-2009,9849,10013,164,1.665,33,131,51,49,H1
"Cumberland County, VA",2009-2010,10013,10043,30,0.3,35,-5,51,49,H1
"Cumberland County, VA",2010-2011,10043,10019,-24,-0.239,19,-43,51,49,H1
"Cumberland County, VA",2011-2012,10019,9851,-168,-1.677,28,-196,51,49,H1
"Cumberland County, VA",2012-2013,9851,9838,-13,-0.132,14,-27,51,49,H1
"Cumberland County, VA",2013-2014,9838,9827,-11,-0.112,0,-11,51,49,H1
"Cumberland County, VA",2014-2015,9839,9719,-120,-1.22,5,-125,51,49,H1
"Cumberland County, VA",2015-2016,9719,9742,23,0.237,0,23,51,49,H1
"Cumberland County, VA",2016-2017,9742,9811,69,0.708,-20,89,51,49,H1
"Dickenson County, VA",2000-2001,16322,16237,-85,-0.521,-26,-59,51,51,H1
"Dickenson County, VA",2001-2002,16237,16074,-163,-1.004,-64,-99,51,51,H1
"Dickenson County, VA",2002-2003,16074,16018,-56,-0.348,-33,-23,51,51,H1
"Dickenson County, VA",2003-2004,16018,16003,-15,-0.094,-20,5,51,51,H1
"Dickenson County, VA",2004-2005,16003,16111,108,0.675,-41,149,51,51,H1
"Dickenson County, VA",2005-2006,16111,15958,-153,-0.95,4,-157,51,51,H1
"Dickenson County, VA",2006-2007,15958,15971,13,0.081,2,11,51,51,H1
"Dickenson County, VA",2007-2008,15971,16078,107,0.67,11,96,51,51,H1
"Dickenson County, VA",2008-2009,16078,15925,-153,-0.952,-28,-125,51,51,H1
"Dickenson County, VA",2009-2010,15925,15870,-55,-0.345,-57,2,51,51,H1
"Dickenson County, VA",2010-2011,15870,15765,-105,-0.662,-13,-92,51,51,H1
"Dickenson County, VA",2011-2012,15765,15668,-97,-0.615,-35,-62,51,51,H1
"Dickenson County, VA",2012-2013,15668,15449,-219,-1.398,-43,-176,51,51,H1
"Dickenson County, VA",2013-2014,15449,15308,-141,-0.913,-30,-111,51,51,H1
"Dickenson County, VA",2014-2015,15306,15115,-191,-1.248,-22,-169,51,51,H1
"Dickenson County, VA",2015-2016,15115,15040,-75,-0.496,-56,-19,51,51,H1
"Dickenson County, VA",2016-2017,15040,14782,-258,-1.715,-44,-214,51,51,H1
"Dinwiddie County, VA",2000-2001,24674,24666,-8,-0.032,50,-58,51,53,H1
"Dinwiddie County, VA",2001-2002,24666,25038,372,1.508,8,364,51,53,H1
"Dinwiddie County, VA",2002-2003,25038,25415,377,1.506,25,352,51,53,H1
"Dinwiddie County, VA",2003-2004,25415,25770,355,1.397,9,346,51,53,H1
"Dinwiddie County, VA",2004-2005,25770,26149,379,1.471,25,354,51,53,H1
"Dinwiddie County, VA",2005-2006,26149,26590,441,1.686,34,407,51,53,H1
"Dinwiddie County, VA",2006-2007,26590,27078,488,1.835,20,468,51,53,H1
"Dinwiddie County, VA",2007-2008,27078,27694,616,2.275,23,593,51,53,H1
"Dinwiddie County, VA",2008-2009,27694,27888,194,0.701,53,141,51,53,H1
"Dinwiddie County, VA",2009-2010,27888,27998,110,0.394,29,81,51,53,H1
"Dinwiddie County, VA",2010-2011,27998,28084,86,0.307,-4,90,51,53,H1
"Dinwiddie County, VA",2011-2012,28084,28100,16,0.057,42,-26,51,53,H1
"Dinwiddie County, VA",2012-2013,28100,27926,-174,-0.619,-54,-120,51,53,H1
"Dinwiddie County, VA",2013-2014,27926,27859,-67,-0.24,-19,-48,51,53,H1
"Dinwiddie County, VA",2014-2015,28068,27852,-216,-0.77,-45,-171,51,53,H1
"Dinwiddie County, VA",2015-2016,27852,28025,173,0.621,-71,244,51,53,H1
"Dinwiddie County, VA",2016-2017,28025,28208,183,0.653,-70,253,51,53,H1
"Essex County, VA",2000-2001,9984,9994,10,0.1,-9,19,51,57,H1
"Essex County, VA",2001-2002,9994,10074,80,0.8,-15,95,51,57,H1
"Essex County, VA",2002-2003,10074,10201,127,1.261,-32,159,51,57,H1
"Essex County, VA",2003-2004,10201,10238,37,0.363,5,32,51,57,H1
"Essex County, VA",2004-2005,10238,10445,207,2.022,-8,215,51,57,H1
"Essex County, VA",2005-2006,10445,10576,131,1.254,7,124,51,57,H1
"Essex County, VA",2006-2007,10576,10739,163,1.541,-2,165,51,57,H1
"Essex County, VA",2007-2008,10739,10920,181,1.685,20,161,51,57,H1
"Essex County, VA",2008-2009,10920,11104,184,1.685,7,177,51,57,H1
"Essex County, VA",2009-2010,11104,11154,50,0.45,14,36,51,57,H1
"Essex County, VA",2010-2011,11154,11204,50,0.448,15,35,51,57,H1
"Essex County, VA",2011-2012,11204,11167,-37,-0.33,-20,-17,51,57,H1
"Essex County, VA",2012-2013,11167,11200,33,0.296,19,14,51,57,H1
"Essex County, VA",2013-2014,11200,11103,-97,-0.866,15,-112,51,57,H1
"Essex County, VA",2014-2015,11084,11130,46,0.415,8,38,51,57,H1
"Essex County, VA",2015-2016,11130,11096,-34,-0.305,6,-40,51,57,H1
"Essex County, VA",2016-2017,11096,11028,-68,-0.613,8,-76,51,57,H1
"Fairfax County, VA",2000-2001,975476,991564,16088,1.649,10524,5564,51,59,H1
"Fairfax County, VA",2001-2002,991564,998613,7049,0.711,10270,-3221,51,59,H1
"Fairfax County, VA",2002-2003,998613,1003070,4457,0.446,10293,-5836,51,59,H1
"Fairfax County, VA",2003-2004,1003070,1010938,7868,0.784,10538,-2670,51,59,H1
"Fairfax County, VA",2004-2005,1010938,1019490,8552,0.846,10903,-2351,51,59,H1
"Fairfax County, VA",2005-2006,1019490,1018981,-509,-0.05,10621,-11130,51,59,H1
"Fairfax County, VA",2006-2007,1018981,1027727,8746,0.858,10629,-1883,51,59,H1
"Fairfax County, VA",2007-2008,1027727,1044178,16451,1.601,10770,5681,51,59,H1
"Fairfax County, VA",2008-2009,1044178,1065142,20964,2.008,10077,10887,51,59,H1
"Fairfax County, VA",2009-2010,1065142,1086723,21581,2.026,10659,10922,51,59,H1
"Fairfax County, VA",2010-2011,1086723,1105624,18901,1.739,10603,8298,51,59,H1
"Fairfax County, VA",2011-2012,1105624,1121050,15426,1.395,10327,5099,51,59,H1
"Fairfax County, VA",2012-2013,1121050,1134423,13373,1.193,9983,3390,51,59,H1
"Fairfax County, VA",2013-2014,1134423,1137538,3115,0.275,9819,-6704,51,59,H1
"Fairfax County, VA",2014-2015,1139045,1142234,3189,0.28,9156,-5967,51,59,H1
"Fairfax County, VA",2015-2016,1142234,1144636,2402,0.21,8875,-6473,51,59,H1
"Fairfax County, VA",2016-2017,1144636,1148433,3797,0.332,8278,-4481,51,59,H1
"Fauquier County, VA",2000-2001,55470,56878,1408,2.538,269,1139,51,61,H1
"Fauquier County, VA",2001-2002,56878,58522,1644,2.89,319,1325,51,61,H1
"Fauquier County, VA",2002-2003,58522,59863,1341,2.291,286,1055,51,61,H1
"Fauquier County, VA",2003-2004,59863,61319,1456,2.432,248,1208,51,61,H1
"Fauquier County, VA",2004-2005,61319,62686,1367,2.229,296,1071,51,61,H1
"Fauquier County, VA",2005-2006,62686,63761,1075,1.715,366,709,51,61,H1
"Fauquier County, VA",2006-2007,63761,64122,361,0.566,315,46,51,61,H1
"Fauquier County, VA",2007-2008,64122,64558,436,0.68,371,65,51,61,H1
"Fauquier County, VA",2008-2009,64558,64907,349,0.541,375,-26,51,61,H1
"Fauquier County, VA",2009-2010,64907,65443,536,0.826,252,284,51,61,H1
"Fauquier County, VA",2010-2011,65443,66105,662,1.012,210,452,51,61,H1
"Fauquier County, VA",2011-2012,66105,66603,498,0.753,279,219,51,61,H1
"Fauquier County, VA",2012-2013,66603,67233,630,0.946,215,415,51,61,H1
"Fauquier County, VA",2013-2014,67233,68248,1015,1.51,172,843,51,61,H1
"Fauquier County, VA",2014-2015,68382,68782,400,0.585,232,168,51,61,H1
"Fauquier County, VA",2015-2016,68782,68784,2,0.003,199,-197,51,61,H1
"Fauquier County, VA",2016-2017,68784,69465,681,0.99,160,521,51,61,H1
"Floyd County, VA",2000-2001,13909,14086,177,1.273,28,149,51,63,H1
"Floyd County, VA",2001-2002,14086,14172,86,0.611,-12,98,51,63,H1
"Floyd County, VA",2002-2003,14172,14261,89,0.628,-20,109,51,63,H1
"Floyd County, VA",2003-2004,14261,14371,110,0.771,37,73,51,63,H1
"Floyd County, VA",2004-2005,14371,14588,217,1.51,-9,226,51,63,H1
"Floyd County, VA",2005-2006,14588,14762,174,1.193,18,156,51,63,H1
"Floyd County, VA",2006-2007,14762,14823,61,0.413,33,28,51,63,H1
"Floyd County, VA",2007-2008,14823,15101,278,1.875,-14,292,51,63,H1
"Floyd County, VA",2008-2009,15101,15150,49,0.324,14,35,51,63,H1
"Floyd County, VA",2009-2010,15150,15334,184,1.215,5,179,51,63,H1
"Floyd County, VA",2010-2011,15334,15393,59,0.385,3,56,51,63,H1
"Floyd County, VA",2011-2012,15393,15426,33,0.214,-3,36,51,63,H1
"Floyd County, VA",2012-2013,15426,15528,102,0.661,9,93,51,63,H1
"Floyd County, VA",2013-2014,15528,15578,50,0.322,-12,62,51,63,H1
"Floyd County, VA",2014-2015,15581,15651,70,0.449,-4,74,51,63,H1
"Floyd County, VA",2015-2016,15651,15658,7,0.045,-25,32,51,63,H1
"Floyd County, VA",2016-2017,15658,15755,97,0.619,-26,123,51,63,H1
"Fluvanna County, VA",2000-2001,20191,21027,836,4.14,71,765,51,65,H1
"Fluvanna County, VA",2001-2002,21027,21921,894,4.252,103,791,51,65,H1
"Fluvanna County, VA",2002-2003,21921,22835,914,4.17,142,772,51,65,H1
"Fluvanna County, VA",2003-2004,22835,23451,616,2.698,180,436,51,65,H1
"Fluvanna County, VA",2004-2005,23451,24318,867,3.697,201,666,51,65,H1
"Fluvanna County, VA",2005-2006,24318,24638,320,1.316,155,165,51,65,H1
"Fluvanna County, VA",2006-2007,24638,25134,496,2.013,154,342,51,65,H1
"Fluvanna County, VA",2007-2008,25134,25461,327,1.301,171,156,51,65,H1
"Fluvanna County, VA",2008-2009,25461,25576,115,0.452,139,-24,51,65,H1
"Fluvanna County, VA",2009-2010,25576,25773,197,0.77,126,71,51,65,H1
"Fluvanna County, VA",2010-2011,25773,26002,229,0.889,85,144,51,65,H1
"Fluvanna County, VA",2011-2012,26002,25943,-59,-0.227,74,-133,51,65,H1
"Fluvanna County, VA",2012-2013,25943,25916,-27,-0.104,66,-93,51,65,H1
"Fluvanna County, VA",2013-2014,25916,26092,176,0.679,63,113,51,65,H1
"Fluvanna County, VA",2014-2015,26056,26235,179,0.687,65,114,51,65,H1
"Fluvanna County, VA",2015-2016,26235,26169,-66,-0.252,29,-95,51,65,H1
"Fluvanna County, VA",2016-2017,26169,26452,283,1.081,36,247,51,65,H1
"Franklin County, VA",2000-2001,47546,48384,838,1.763,100,738,51,67,H1
"Franklin County, VA",2001-2002,48384,49167,783,1.618,100,683,51,67,H1
"Franklin County, VA",2002-2003,49167,50012,845,1.719,72,773,51,67,H1
"Franklin County, VA",2003-2004,50012,51001,989,1.978,67,922,51,67,H1
"Franklin County, VA",2004-2005,51001,51976,975,1.912,14,961,51,67,H1
"Franklin County, VA",2005-2006,51976,53037,1061,2.041,93,968,51,67,H1
"Franklin County, VA",2006-2007,53037,54447,1410,2.659,124,1286,51,67,H1
"Franklin County, VA",2007-2008,54447,55284,837,1.537,41,796,51,67,H1
"Franklin County, VA",2008-2009,55284,55732,448,0.81,93,355,51,67,H1
"Franklin County, VA",2009-2010,55732,56221,489,0.877,99,390,51,67,H1
"Franklin County, VA",2010-2011,56221,56442,221,0.393,-41,262,51,67,H1
"Franklin County, VA",2011-2012,56442,56392,-50,-0.089,-36,-14,51,67,H1
"Franklin County, VA",2012-2013,56392,56388,-4,-0.007,-34,30,51,67,H1
"Franklin County, VA",2013-2014,56388,56358,-30,-0.053,-73,43,51,67,H1
"Franklin County, VA",2014-2015,56233,56264,31,0.055,-110,141,51,67,H1
"Franklin County, VA",2015-2016,56264,56159,-105,-0.187,-56,-49,51,67,H1
"Franklin County, VA",2016-2017,56159,56445,286,0.509,-120,406,51,67,H1
"Frederick County, VA",2000-2001,59639,61360,1721,2.886,353,1368,51,69,H1
"Frederick County, VA",2001-2002,61360,63313,1953,3.183,335,1618,51,69,H1
"Frederick County, VA",2002-2003,63313,65379,2066,3.263,390,1676,51,69,H1
"Frederick County, VA",2003-2004,65379,67442,2063,3.155,423,1640,51,69,H1
"Frederick County, VA",2004-2005,67442,69921,2479,3.676,381,2098,51,69,H1
"Frederick County, VA",2005-2006,69921,72456,2535,3.626,453,2082,51,69,H1
"Frederick County, VA",2006-2007,72456,74670,2214,3.056,526,1688,51,69,H1
"Frederick County, VA",2007-2008,74670,76060,1390,1.862,474,916,51,69,H1
"Frederick County, VA",2008-2009,76060,77477,1417,1.863,547,870,51,69,H1
"Frederick County, VA",2009-2010,77477,78592,1115,1.439,444,671,51,69,H1
"Frederick County, VA",2010-2011,78592,79499,907,1.154,371,536,51,69,H1
"Frederick County, VA",2011-2012,79499,80161,662,0.833,305,357,51,69,H1
"Frederick County, VA",2012-2013,80161,81257,1096,1.367,322,774,51,69,H1
"Frederick County, VA",2013-2014,81257,82377,1120,1.378,340,780,51,69,H1
"Frederick County, VA",2014-2015,82467,83199,732,0.888,369,363,51,69,H1
"Frederick County, VA",2015-2016,83199,84684,1485,1.785,327,1158,51,69,H1
"Frederick County, VA",2016-2017,84684,86484,1800,2.126,324,1476,51,69,H1
"Giles County, VA",2000-2001,16738,16799,61,0.364,42,19,51,71,H1
"Giles County, VA",2001-2002,16799,16800,1,0.006,5,-4,51,71,H1
"Giles County, VA",2002-2003,16800,16821,21,0.125,-26,47,51,71,H1
"Giles County, VA",2003-2004,16821,16786,-35,-0.208,-42,7,51,71,H1
"Giles County, VA",2004-2005,16786,16963,177,1.054,-48,225,51,71,H1
"Giles County, VA",2005-2006,16963,17161,198,1.167,-47,245,51,71,H1
"Giles County, VA",2006-2007,17161,17138,-23,-0.134,-27,4,51,71,H1
"Giles County, VA",2007-2008,17138,17168,30,0.175,-37,67,51,71,H1
"Giles County, VA",2008-2009,17168,17264,96,0.559,-32,128,51,71,H1
"Giles County, VA",2009-2010,17264,17297,33,0.191,-27,60,51,71,H1
"Giles County, VA",2010-2011,17297,17104,-193,-1.116,-30,-163,51,71,H1
"Giles County, VA",2011-2012,17104,16968,-136,-0.795,-43,-93,51,71,H1
"Giles County, VA",2012-2013,16968,16939,-29,-0.171,-38,9,51,71,H1
"Giles County, VA",2013-2014,16939,16815,-124,-0.732,-22,-102,51,71,H1
"Giles County, VA",2014-2015,16786,16708,-78,-0.465,-48,-30,51,71,H1
"Giles County, VA",2015-2016,16708,16887,179,1.071,-22,201,51,71,H1
"Giles County, VA",2016-2017,16887,16837,-50,-0.296,-15,-35,51,71,H1
"Gloucester County, VA",2000-2001,34793,34852,59,0.17,83,-24,51,73,H1
"Gloucester County, VA",2001-2002,34852,35103,251,0.72,135,116,51,73,H1
"Gloucester County, VA",2002-2003,35103,35454,351,1,90,261,51,73,H1
"Gloucester County, VA",2003-2004,35454,35714,260,0.733,135,125,51,73,H1
"Gloucester County, VA",2004-2005,35714,36011,297,0.832,88,209,51,73,H1
"Gloucester County, VA",2005-2006,36011,36220,209,0.58,55,154,51,73,H1
"Gloucester County, VA",2006-2007,36220,36466,246,0.679,8,238,51,73,H1
"Gloucester County, VA",2007-2008,36466,36638,172,0.472,79,93,51,73,H1
"Gloucester County, VA",2008-2009,36638,36778,140,0.382,89,51,51,73,H1
"Gloucester County, VA",2009-2010,36778,36929,151,0.411,80,71,51,73,H1
"Gloucester County, VA",2010-2011,36929,36878,-51,-0.138,-4,-47,51,73,H1
"Gloucester County, VA",2011-2012,36878,36894,16,0.043,-13,29,51,73,H1
"Gloucester County, VA",2012-2013,36894,36848,-46,-0.125,43,-89,51,73,H1
"Gloucester County, VA",2013-2014,36848,37141,293,0.795,-32,325,51,73,H1
"Gloucester County, VA",2014-2015,37181,37143,-38,-0.102,-42,4,51,73,H1
"Gloucester County, VA",2015-2016,37143,37101,-42,-0.113,-44,2,51,73,H1
"Gloucester County, VA",2016-2017,37101,37292,191,0.515,-78,269,51,73,H1
"Goochland County, VA",2000-2001,16935,17250,315,1.86,52,263,51,75,H1
"Goochland County, VA",2001-2002,17250,17610,360,2.087,51,309,51,75,H1
"Goochland County, VA",2002-2003,17610,18062,452,2.567,20,432,51,75,H1
"Goochland County, VA",2003-2004,18062,18570,508,2.813,47,461,51,75,H1
"Goochland County, VA",2004-2005,18570,19349,779,4.195,45,734,51,75,H1
"Goochland County, VA",2005-2006,19349,20176,827,4.274,53,774,51,75,H1
"Goochland County, VA",2006-2007,20176,20869,693,3.435,53,640,51,75,H1
"Goochland County, VA",2007-2008,20869,21285,416,1.993,47,369,51,75,H1
"Goochland County, VA",2008-2009,21285,21604,319,1.499,39,280,51,75,H1
"Goochland County, VA",2009-2010,21604,21751,147,0.68,2,145,51,75,H1
"Goochland County, VA",2010-2011,21751,21458,-293,-1.347,-13,-280,51,75,H1
"Goochland County, VA",2011-2012,21458,21350,-108,-0.503,-25,-83,51,75,H1
"Goochland County, VA",2012-2013,21350,21639,289,1.354,7,282,51,75,H1
"Goochland County, VA",2013-2014,21639,21936,297,1.373,3,294,51,75,H1
"Goochland County, VA",2014-2015,21917,22253,336,1.533,1,335,51,75,H1
"Goochland County, VA",2015-2016,22253,22475,222,0.998,-10,232,51,75,H1
"Goochland County, VA",2016-2017,22475,22685,210,0.934,-29,239,51,75,H1
"Grayson County, VA",2000-2001,16782,16548,-234,-1.394,-73,-161,51,77,H1
"Grayson County, VA",2001-2002,16548,16558,10,0.06,-10,20,51,77,H1
"Grayson County, VA",2002-2003,16558,16414,-144,-0.87,-73,-71,51,77,H1
"Grayson County, VA",2003-2004,16414,16301,-113,-0.688,-74,-39,51,77,H1
"Grayson County, VA",2004-2005,16301,16153,-148,-0.908,-104,-44,51,77,H1
"Grayson County, VA",2005-2006,16153,16096,-57,-0.353,-63,6,51,77,H1
"Grayson County, VA",2006-2007,16096,16066,-30,-0.186,-27,-3,51,77,H1
"Grayson County, VA",2007-2008,16066,15938,-128,-0.797,-71,-57,51,77,H1
"Grayson County, VA",2008-2009,15938,15696,-242,-1.518,-70,-172,51,77,H1
"Grayson County, VA",2009-2010,15696,15462,-234,-1.491,-72,-162,51,77,H1
"Grayson County, VA",2010-2011,15462,15365,-97,-0.627,-90,-7,51,77,H1
"Grayson County, VA",2011-2012,15365,15179,-186,-1.211,-94,-92,51,77,H1
"Grayson County, VA",2012-2013,15179,15176,-3,-0.02,-63,60,51,77,H1
"Grayson County, VA",2013-2014,15176,15093,-83,-0.547,-37,-46,51,77,H1
"Grayson County, VA",2014-2015,15999,16012,13,0.081,-25,38,51,77,H1
"Grayson County, VA",2015-2016,16012,15869,-143,-0.893,-70,-73,51,77,H1
"Grayson County, VA",2016-2017,15869,15665,-204,-1.286,-55,-149,51,77,H1
"Greene County, VA",2000-2001,15454,15793,339,2.194,103,236,51,79,H1
"Greene County, VA",2001-2002,15793,16308,515,3.261,139,376,51,79,H1
"Greene County, VA",2002-2003,16308,16677,369,2.263,151,218,51,79,H1
"Greene County, VA",2003-2004,16677,16895,218,1.307,141,77,51,79,H1
"Greene County, VA",2004-2005,16895,17155,260,1.539,115,145,51,79,H1
"Greene County, VA",2005-2006,17155,17607,452,2.635,149,303,51,79,H1
"Greene County, VA",2006-2007,17607,17972,365,2.073,163,202,51,79,H1
"Greene County, VA",2007-2008,17972,18131,159,0.885,130,29,51,79,H1
"Greene County, VA",2008-2009,18131,18237,106,0.585,127,-21,51,79,H1
"Greene County, VA",2009-2010,18237,18455,218,1.195,130,88,51,79,H1
"Greene County, VA",2010-2011,18455,18696,241,1.306,59,182,51,79,H1
"Greene County, VA",2011-2012,18696,18807,111,0.594,105,6,51,79,H1
"Greene County, VA",2012-2013,18807,18839,32,0.17,62,-30,51,79,H1
"Greene County, VA",2013-2014,18839,19031,192,1.019,85,107,51,79,H1
"Greene County, VA",2014-2015,19061,19162,101,0.53,46,55,51,79,H1
"Greene County, VA",2015-2016,19162,19331,169,0.882,52,117,51,79,H1
"Greene County, VA",2016-2017,19331,19612,281,1.454,49,232,51,79,H1
"Greensville County, VA",2000-2001,11566,11605,39,0.337,-6,45,51,81,H1
"Greensville County, VA",2001-2002,11605,11639,34,0.293,29,5,51,81,H1
"Greensville County, VA",2002-2003,11639,11876,237,2.036,28,209,51,81,H1
"Greensville County, VA",2003-2004,11876,11428,-448,-3.772,39,-487,51,81,H1
"Greensville County, VA",2004-2005,11428,12063,635,5.557,28,607,51,81,H1
"Greensville County, VA",2005-2006,12063,12048,-15,-0.124,43,-58,51,81,H1
"Greensville County, VA",2006-2007,12048,12147,99,0.822,63,36,51,81,H1
"Greensville County, VA",2007-2008,12147,12206,59,0.486,50,9,51,81,H1
"Greensville County, VA",2008-2009,12206,12272,66,0.541,48,18,51,81,H1
"Greensville County, VA",2009-2010,12272,12233,-39,-0.318,42,-81,51,81,H1
"Greensville County, VA",2010-2011,12233,12055,-178,-1.455,17,-195,51,81,H1
"Greensville County, VA",2011-2012,12055,11824,-231,-1.916,14,-245,51,81,H1
"Greensville County, VA",2012-2013,11824,11761,-63,-0.533,34,-97,51,81,H1
"Greensville County, VA",2013-2014,11761,11681,-80,-0.68,17,-97,51,81,H1
"Greensville County, VA",2014-2015,11539,11885,346,2.999,6,340,51,81,H1
"Greensville County, VA",2015-2016,11885,11551,-334,-2.81,19,-353,51,81,H1
"Greensville County, VA",2016-2017,11551,11679,128,1.108,24,104,51,81,H1
"Halifax County, VA",2000-2001,37299,37003,-296,-0.794,-6,-290,51,83,H1
"Halifax County, VA",2001-2002,37003,36919,-84,-0.227,-40,-44,51,83,H1
"Halifax County, VA",2002-2003,36919,36645,-274,-0.742,-61,-213,51,83,H1
"Halifax County, VA",2003-2004,36645,36382,-263,-0.718,-61,-202,51,83,H1
"Halifax County, VA",2004-2005,36382,36340,-42,-0.115,-51,9,51,83,H1
"Halifax County, VA",2005-2006,36340,36383,43,0.118,-91,134,51,83,H1
"Halifax County, VA",2006-2007,36383,36338,-45,-0.124,-21,-24,51,83,H1
"Halifax County, VA",2007-2008,36338,36347,9,0.025,-114,123,51,83,H1
"Halifax County, VA",2008-2009,36347,36293,-54,-0.149,-80,26,51,83,H1
"Halifax County, VA",2009-2010,36293,36154,-139,-0.383,-49,-90,51,83,H1
"Halifax County, VA",2010-2011,36154,36001,-153,-0.423,-155,2,51,83,H1
"Halifax County, VA",2011-2012,36001,35774,-227,-0.631,-84,-143,51,83,H1
"Halifax County, VA",2012-2013,35774,35389,-385,-1.076,-116,-269,51,83,H1
"Halifax County, VA",2013-2014,35389,35200,-189,-0.534,-134,-55,51,83,H1
"Halifax County, VA",2014-2015,35223,35125,-98,-0.278,-111,13,51,83,H1
"Halifax County, VA",2015-2016,35125,34964,-161,-0.458,-62,-99,51,83,H1
"Halifax County, VA",2016-2017,34964,34563,-401,-1.147,-98,-303,51,83,H1
"Hanover County, VA",2000-2001,86972,88845,1873,2.154,446,1427,51,85,H1
"Hanover County, VA",2001-2002,88845,91370,2525,2.842,455,2070,51,85,H1
"Hanover County, VA",2002-2003,91370,93466,2096,2.294,394,1702,51,85,H1
"Hanover County, VA",2003-2004,93466,95295,1829,1.957,464,1365,51,85,H1
"Hanover County, VA",2004-2005,95295,96451,1156,1.213,414,742,51,85,H1
"Hanover County, VA",2005-2006,96451,98025,1574,1.632,330,1244,51,85,H1
"Hanover County, VA",2006-2007,98025,98830,805,0.821,355,450,51,85,H1
"Hanover County, VA",2007-2008,98830,99404,574,0.581,270,304,51,85,H1
"Hanover County, VA",2008-2009,99404,99651,247,0.248,330,-83,51,85,H1
"Hanover County, VA",2009-2010,99651,99921,270,0.271,188,82,51,85,H1
"Hanover County, VA",2010-2011,99921,99975,54,0.054,131,-77,51,85,H1
"Hanover County, VA",2011-2012,99975,100432,457,0.457,10,447,51,85,H1
"Hanover County, VA",2012-2013,100432,101198,766,0.763,52,714,51,85,H1
"Hanover County, VA",2013-2014,101198,101918,720,0.711,108,612,51,85,H1
"Hanover County, VA",2014-2015,101872,103227,1355,1.33,139,1216,51,85,H1
"Hanover County, VA",2015-2016,103227,104347,1120,1.085,113,1007,51,85,H1
"Hanover County, VA",2016-2017,104347,105923,1576,1.51,167,1409,51,85,H1
"Henrico County, VA",2000-2001,264385,267722,3337,1.262,1360,1977,51,87,H1
"Henrico County, VA",2001-2002,267722,270608,2886,1.078,1272,1614,51,87,H1
"Henrico County, VA",2002-2003,270608,274555,3947,1.459,1416,2531,51,87,H1
"Henrico County, VA",2003-2004,274555,280290,5735,2.089,1517,4218,51,87,H1
"Henrico County, VA",2004-2005,280290,286441,6151,2.195,1660,4491,51,87,H1
"Henrico County, VA",2005-2006,286441,291460,5019,1.752,1717,3302,51,87,H1
"Henrico County, VA",2006-2007,291460,296408,4948,1.698,1725,3223,51,87,H1
"Henrico County, VA",2007-2008,296408,300198,3790,1.279,1735,2055,51,87,H1
"Henrico County, VA",2008-2009,300198,304763,4565,1.521,1584,2981,51,87,H1
"Henrico County, VA",2009-2010,304763,307542,2779,0.912,1641,1138,51,87,H1
"Henrico County, VA",2010-2011,307542,310550,3008,0.978,1381,1627,51,87,H1
"Henrico County, VA",2011-2012,310550,315431,4881,1.572,1582,3299,51,87,H1
"Henrico County, VA",2012-2013,315431,318943,3512,1.113,1367,2145,51,87,H1
"Henrico County, VA",2013-2014,318943,321924,2981,0.935,1396,1585,51,87,H1
"Henrico County, VA",2014-2015,322818,325155,2337,0.724,1371,966,51,87,H1
"Henrico County, VA",2015-2016,325155,326147,992,0.305,1254,-262,51,87,H1
"Henrico County, VA",2016-2017,326147,327898,1751,0.537,1222,529,51,87,H1
"Henry County, VA",2000-2001,57903,57393,-510,-0.881,88,-598,51,89,H1
"Henry County, VA",2001-2002,57393,56986,-407,-0.709,-24,-383,51,89,H1
"Henry County, VA",2002-2003,56986,56506,-480,-0.842,28,-508,51,89,H1
"Henry County, VA",2003-2004,56506,56183,-323,-0.572,-32,-291,51,89,H1
"Henry County, VA",2004-2005,56183,55651,-532,-0.947,-68,-464,51,89,H1
"Henry County, VA",2005-2006,55651,55464,-187,-0.336,20,-207,51,89,H1
"Henry County, VA",2006-2007,55464,55284,-180,-0.325,0,-180,51,89,H1
"Henry County, VA",2007-2008,55284,55073,-211,-0.382,-78,-133,51,89,H1
"Henry County, VA",2008-2009,55073,54402,-671,-1.218,-41,-630,51,89,H1
"Henry County, VA",2009-2010,54402,54094,-308,-0.566,-4,-304,51,89,H1
"Henry County, VA",2010-2011,54094,53274,-820,-1.516,-213,-607,51,89,H1
"Henry County, VA",2011-2012,53274,52824,-450,-0.845,-182,-268,51,89,H1
"Henry County, VA",2012-2013,52824,52527,-297,-0.562,-258,-39,51,89,H1
"Henry County, VA",2013-2014,52527,52081,-446,-0.849,-231,-215,51,89,H1
"Henry County, VA",2014-2015,52153,51881,-272,-0.522,-200,-72,51,89,H1
"Henry County, VA",2015-2016,51881,51604,-277,-0.534,-221,-56,51,89,H1
"Henry County, VA",2016-2017,51604,51227,-377,-0.731,-291,-86,51,89,H1
"Highland County, VA",2000-2001,2529,2530,1,0.04,-4,5,51,91,H1
"Highland County, VA",2001-2002,2530,2450,-80,-3.162,-25,-55,51,91,H1
"Highland County, VA",2002-2003,2450,2490,40,1.633,-15,55,51,91,H1
"Highland County, VA",2003-2004,2490,2442,-48,-1.928,-20,-28,51,91,H1
"Highland County, VA",2004-2005,2442,2463,21,0.86,-13,34,51,91,H1
"Highland County, VA",2005-2006,2463,2479,16,0.65,-17,33,51,91,H1
"Highland County, VA",2006-2007,2479,2424,-55,-2.219,-14,-41,51,91,H1
"Highland County, VA",2007-2008,2424,2403,-21,-0.866,1,-22,51,91,H1
"Highland County, VA",2008-2009,2403,2363,-40,-1.665,-7,-33,51,91,H1
"Highland County, VA",2009-2010,2363,2294,-69,-2.92,-5,-64,51,91,H1
"Highland County, VA",2010-2011,2294,2279,-15,-0.654,-4,-11,51,91,H1
"Highland County, VA",2011-2012,2279,2249,-30,-1.316,-11,-19,51,91,H1
"Highland County, VA",2012-2013,2249,2219,-30,-1.334,-13,-17,51,91,H1
"Highland County, VA",2013-2014,2219,2248,29,1.307,-8,37,51,91,H1
"Highland County, VA",2014-2015,2251,2214,-37,-1.644,-3,-34,51,91,H1
"Highland County, VA",2015-2016,2214,2212,-2,-0.09,0,-2,51,91,H1
"Highland County, VA",2016-2017,2212,2212,0,0,-9,9,51,91,H1
"Isle of Wight County, VA",2000-2001,29849,30119,270,0.905,50,220,51,93,H1
"Isle of Wight County, VA",2001-2002,30119,30497,378,1.255,67,311,51,93,H1
"Isle of Wight County, VA",2002-2003,30497,31224,727,2.384,79,648,51,93,H1
"Isle of Wight County, VA",2003-2004,31224,31899,675,2.162,2,673,51,93,H1
"Isle of Wight County, VA",2004-2005,31899,32566,667,2.091,58,609,51,93,H1
"Isle of Wight County, VA",2005-2006,32566,33716,1150,3.531,68,1082,51,93,H1
"Isle of Wight County, VA",2006-2007,33716,34581,865,2.566,67,798,51,93,H1
"Isle of Wight County, VA",2007-2008,34581,34955,374,1.082,76,298,51,93,H1
"Isle of Wight County, VA",2008-2009,34955,35270,315,0.901,85,230,51,93,H1
"Isle of Wight County, VA",2009-2010,35270,35288,18,0.051,31,-13,51,93,H1
"Isle of Wight County, VA",2010-2011,35288,35274,-14,-0.04,5,-19,51,93,H1
"Isle of Wight County, VA",2011-2012,35274,35380,106,0.301,1,105,51,93,H1
"Isle of Wight County, VA",2012-2013,35380,35643,263,0.743,-77,340,51,93,H1
"Isle of Wight County, VA",2013-2014,35643,36007,364,1.021,-20,384,51,93,H1
"Isle of Wight County, VA",2014-2015,36004,36314,310,0.861,-28,338,51,93,H1
"Isle of Wight County, VA",2015-2016,36314,36324,10,0.028,40,-30,51,93,H1
"Isle of Wight County, VA",2016-2017,36324,36552,228,0.628,-22,250,51,93,H1
"James City County, VA",2000-2001,48536,49786,1250,2.575,116,1134,51,95,H1
"James City County, VA",2001-2002,49786,51722,1936,3.889,114,1822,51,95,H1
"James City County, VA",2002-2003,51722,53734,2012,3.89,70,1942,51,95,H1
"James City County, VA",2003-2004,53734,56182,2448,4.556,38,2410,51,95,H1
"James City County, VA",2004-2005,56182,58428,2246,3.998,50,2196,51,95,H1
"James City County, VA",2005-2006,58428,61133,2705,4.63,79,2626,51,95,H1
"James City County, VA",2006-2007,61133,63007,1874,3.065,135,1739,51,95,H1
"James City County, VA",2007-2008,63007,64436,1429,2.268,80,1349,51,95,H1
"James City County, VA",2008-2009,64436,66118,1682,2.61,94,1588,51,95,H1
"James City County, VA",2009-2010,66118,67751,1633,2.47,77,1556,51,95,H1
"James City County, VA",2010-2011,67751,68329,578,0.853,145,433,51,95,H1
"James City County, VA",2011-2012,68329,69532,1203,1.761,131,1072,51,95,H1
"James City County, VA",2012-2013,69532,70964,1432,2.059,62,1370,51,95,H1
"James City County, VA",2013-2014,70964,72583,1619,2.281,110,1509,51,95,H1
"James City County, VA",2014-2015,72142,73147,1005,1.393,137,868,51,95,H1
"James City County, VA",2015-2016,73147,74069,922,1.26,29,893,51,95,H1
"James City County, VA",2016-2017,74069,75524,1455,1.964,27,1428,51,95,H1
"King and Queen County, VA",2000-2001,6620,6607,-13,-0.196,-3,-10,51,97,H1
"King and Queen County, VA",2001-2002,6607,6586,-21,-0.318,-12,-9,51,97,H1
"King and Queen County, VA",2002-2003,6586,6558,-28,-0.425,-31,3,51,97,H1
"King and Queen County, VA",2003-2004,6558,6739,181,2.76,-8,189,51,97,H1
"King and Queen County, VA",2004-2005,6739,6792,53,0.786,-2,55,51,97,H1
"King and Queen County, VA",2005-2006,6792,6915,123,1.811,-4,127,51,97,H1
"King and Queen County, VA",2006-2007,6915,6948,33,0.477,-9,42,51,97,H1
"King and Queen County, VA",2007-2008,6948,6916,-32,-0.461,17,-49,51,97,H1
"King and Queen County, VA",2008-2009,6916,6893,-23,-0.333,-5,-18,51,97,H1
"King and Queen County, VA",2009-2010,6893,6970,77,1.117,-20,97,51,97,H1
"King and Queen County, VA",2010-2011,6970,7032,62,0.89,-23,85,51,97,H1
"King and Queen County, VA",2011-2012,7032,7068,36,0.512,-9,45,51,97,H1
"King and Queen County, VA",2012-2013,7068,7118,50,0.707,7,43,51,97,H1
"King and Queen County, VA",2013-2014,7118,7175,57,0.801,-8,65,51,97,H1
"King and Queen County, VA",2014-2015,7162,7158,-4,-0.056,-32,28,51,97,H1
"King and Queen County, VA",2015-2016,7158,7067,-91,-1.271,6,-97,51,97,H1
"King and Queen County, VA",2016-2017,7067,7003,-64,-0.906,-26,-38,51,97,H1
"King George County, VA",2000-2001,16916,17136,220,1.301,93,127,51,99,H1
"King George County, VA",2001-2002,17136,17717,581,3.391,109,472,51,99,H1
"King George County, VA",2002-2003,17717,18326,609,3.437,152,457,51,99,H1
"King George County, VA",2003-2004,18326,19124,798,4.354,177,621,51,99,H1
"King George County, VA",2004-2005,19124,20476,1352,7.07,185,1167,51,99,H1
"King George County, VA",2005-2006,20476,21519,1043,5.094,179,864,51,99,H1
"King George County, VA",2006-2007,21519,22444,925,4.299,203,722,51,99,H1
"King George County, VA",2007-2008,22444,22996,552,2.459,245,307,51,99,H1
"King George County, VA",2008-2009,22996,23335,339,1.474,262,77,51,99,H1
"King George County, VA",2009-2010,23335,23676,341,1.461,175,166,51,99,H1
"King George County, VA",2010-2011,23676,24279,603,2.547,189,414,51,99,H1
"King George County, VA",2011-2012,24279,24608,329,1.355,165,164,51,99,H1
"King George County, VA",2012-2013,24608,24950,342,1.39,148,194,51,99,H1
"King George County, VA",2013-2014,24950,25371,421,1.687,176,245,51,99,H1
"King George County, VA",2014-2015,25331,25515,184,0.726,167,17,51,99,H1
"King George County, VA",2015-2016,25515,25918,403,1.579,166,237,51,99,H1
"King George County, VA",2016-2017,25918,26337,419,1.617,162,257,51,99,H1
"King William County, VA",2000-2001,13238,13412,174,1.314,61,113,51,101,H1
"King William County, VA",2001-2002,13412,13589,177,1.32,41,136,51,101,H1
"King William County, VA",2002-2003,13589,13808,219,1.612,70,149,51,101,H1
"King William County, VA",2003-2004,13808,13975,167,1.209,67,100,51,101,H1
"King William County, VA",2004-2005,13975,14278,303,2.168,61,242,51,101,H1
"King William County, VA",2005-2006,14278,14874,596,4.174,72,524,51,101,H1
"King William County, VA",2006-2007,14874,15296,422,2.837,84,338,51,101,H1
"King William County, VA",2007-2008,15296,15604,308,2.014,85,223,51,101,H1
"King William County, VA",2008-2009,15604,15768,164,1.051,111,53,51,101,H1
"King William County, VA",2009-2010,15768,15977,209,1.325,87,122,51,101,H1
"King William County, VA",2010-2011,15977,15981,4,0.025,67,-63,51,101,H1
"King William County, VA",2011-2012,15981,15977,-4,-0.025,41,-45,51,101,H1
"King William County, VA",2012-2013,15977,16103,126,0.789,57,69,51,101,H1
"King William County, VA",2013-2014,16103,16186,83,0.515,74,9,51,101,H1
"King William County, VA",2014-2015,16159,16269,110,0.681,62,48,51,101,H1
"King William County, VA",2015-2016,16269,16412,143,0.879,44,99,51,101,H1
"King William County, VA",2016-2017,16412,16708,296,1.804,65,231,51,101,H1
"Lancaster County, VA",2000-2001,11549,11401,-148,-1.281,-129,-19,51,103,H1
"Lancaster County, VA",2001-2002,11401,11417,16,0.14,-71,87,51,103,H1
"Lancaster County, VA",2002-2003,11417,11519,102,0.893,-99,201,51,103,H1
"Lancaster County, VA",2003-2004,11519,11514,-5,-0.043,-105,100,51,103,H1
"Lancaster County, VA",2004-2005,11514,11533,19,0.165,-98,117,51,103,H1
"Lancaster County, VA",2005-2006,11533,11551,18,0.156,-107,125,51,103,H1
"Lancaster County, VA",2006-2007,11551,11573,22,0.19,-52,74,51,103,H1
"Lancaster County, VA",2007-2008,11573,11481,-92,-0.795,-108,16,51,103,H1
"Lancaster County, VA",2008-2009,11481,11403,-78,-0.679,-110,32,51,103,H1
"Lancaster County, VA",2009-2010,11403,11369,-34,-0.298,-95,61,51,103,H1
"Lancaster County, VA",2010-2011,11369,11350,-19,-0.167,-111,92,51,103,H1
"Lancaster County, VA",2011-2012,11350,11230,-120,-1.057,-113,-7,51,103,H1
"Lancaster County, VA",2012-2013,11230,11128,-102,-0.908,-102,0,51,103,H1
"Lancaster County, VA",2013-2014,11128,11044,-84,-0.755,-103,19,51,103,H1
"Lancaster County, VA",2014-2015,11003,10965,-38,-0.345,-126,88,51,103,H1
"Lancaster County, VA",2015-2016,10965,10778,-187,-1.705,-107,-80,51,103,H1
"Lancaster County, VA",2016-2017,10778,10788,10,0.093,-104,114,51,103,H1
"Lee County, VA",2000-2001,23548,23320,-228,-0.968,-45,-183,51,105,H1
"Lee County, VA",2001-2002,23320,24278,958,4.108,-45,1003,51,105,H1
"Lee County, VA",2002-2003,24278,24967,689,2.838,-69,758,51,105,H1
"Lee County, VA",2003-2004,24967,25168,201,0.805,-113,314,51,105,H1
"Lee County, VA",2004-2005,25168,25150,-18,-0.072,-85,67,51,105,H1
"Lee County, VA",2005-2006,25150,25228,78,0.31,-57,135,51,105,H1
"Lee County, VA",2006-2007,25228,25322,94,0.373,-64,158,51,105,H1
"Lee County, VA",2007-2008,25322,25463,141,0.557,-19,160,51,105,H1
"Lee County, VA",2008-2009,25463,25578,115,0.452,-33,148,51,105,H1
"Lee County, VA",2009-2010,25578,25543,-35,-0.137,-47,12,51,105,H1
"Lee County, VA",2010-2011,25543,25663,120,0.47,-11,131,51,105,H1
"Lee County, VA",2011-2012,25663,25539,-124,-0.483,-39,-85,51,105,H1
"Lee County, VA",2012-2013,25539,25202,-337,-1.32,-34,-303,51,105,H1
"Lee County, VA",2013-2014,25202,24951,-251,-0.996,-62,-189,51,105,H1
"Lee County, VA",2014-2015,24913,24742,-171,-0.686,-89,-82,51,105,H1
"Lee County, VA",2015-2016,24742,24051,-691,-2.793,-78,-613,51,105,H1
"Lee County, VA",2016-2017,24051,23758,-293,-1.218,-97,-196,51,105,H1
"Loudoun County, VA",2000-2001,173907,189910,16003,9.202,3021,12982,51,107,H1
"Loudoun County, VA",2001-2002,189910,203543,13633,7.179,3328,10305,51,107,H1
"Loudoun County, VA",2002-2003,203543,220366,16823,8.265,3544,13279,51,107,H1
"Loudoun County, VA",2003-2004,220366,238299,17933,8.138,3920,14013,51,107,H1
"Loudoun County, VA",2004-2005,238299,254909,16610,6.97,4229,12381,51,107,H1
"Loudoun County, VA",2005-2006,254909,267194,12285,4.819,4288,7997,51,107,H1
"Loudoun County, VA",2006-2007,267194,279704,12510,4.682,4297,8213,51,107,H1
"Loudoun County, VA",2007-2008,279704,292570,12866,4.6,4342,8524,51,107,H1
"Loudoun County, VA",2008-2009,292570,303661,11091,3.791,4493,6598,51,107,H1
"Loudoun County, VA",2009-2010,303661,315505,11844,3.9,3901,7943,51,107,H1
"Loudoun County, VA",2010-2011,315505,326900,11395,3.612,3991,7404,51,107,H1
"Loudoun County, VA",2011-2012,326900,338165,11265,3.446,3915,7350,51,107,H1
"Loudoun County, VA",2012-2013,338165,350959,12794,3.783,3808,8986,51,107,H1
"Loudoun County, VA",2013-2014,350959,363050,12091,3.445,3909,8182,51,107,H1
"Loudoun County, VA",2014-2015,363494,375629,12135,3.338,3946,8189,51,107,H1
"Loudoun County, VA",2015-2016,375629,386279,10650,2.835,3942,6708,51,107,H1
"Loudoun County, VA",2016-2017,386279,398080,11801,3.055,3864,7937,51,107,H1
"Louisa County, VA",2000-2001,25819,26320,501,1.94,60,441,51,109,H1
"Louisa County, VA",2001-2002,26320,27027,707,2.686,73,634,51,109,H1
"Louisa County, VA",2002-2003,27027,27867,840,3.108,14,826,51,109,H1
"Louisa County, VA",2003-2004,27867,28582,715,2.566,78,637,51,109,H1
"Louisa County, VA",2004-2005,28582,29835,1253,4.384,135,1118,51,109,H1
"Louisa County, VA",2005-2006,29835,30946,1111,3.724,131,980,51,109,H1
"Louisa County, VA",2006-2007,30946,31716,770,2.488,126,644,51,109,H1
"Louisa County, VA",2007-2008,31716,32475,759,2.393,150,609,51,109,H1
"Louisa County, VA",2008-2009,32475,32840,365,1.124,103,262,51,109,H1
"Louisa County, VA",2009-2010,32840,33348,508,1.547,60,448,51,109,H1
"Louisa County, VA",2010-2011,33348,33499,151,0.453,79,72,51,109,H1
"Louisa County, VA",2011-2012,33499,33517,18,0.054,81,-63,51,109,H1
"Louisa County, VA",2012-2013,33517,34004,487,1.453,95,392,51,109,H1
"Louisa County, VA",2013-2014,34004,34348,344,1.012,74,270,51,109,H1
"Louisa County, VA",2014-2015,34312,34602,290,0.845,45,245,51,109,H1
"Louisa County, VA",2015-2016,34602,35276,674,1.948,45,629,51,109,H1
"Louisa County, VA",2016-2017,35276,35860,584,1.656,24,560,51,109,H1
"Lunenburg County, VA",2000-2001,13093,13050,-43,-0.328,-37,-6,51,111,H1
"Lunenburg County, VA",2001-2002,13050,13109,59,0.452,-38,97,51,111,H1
"Lunenburg County, VA",2002-2003,13109,13064,-45,-0.343,-20,-25,51,111,H1
"Lunenburg County, VA",2003-2004,13064,12952,-112,-0.857,-40,-72,51,111,H1
"Lunenburg County, VA",2004-2005,12952,13030,78,0.602,-9,87,51,111,H1
"Lunenburg County, VA",2005-2006,13030,13070,40,0.307,4,36,51,111,H1
"Lunenburg County, VA",2006-2007,13070,13024,-46,-0.352,-4,-42,51,111,H1
"Lunenburg County, VA",2007-2008,13024,12936,-88,-0.676,-40,-48,51,111,H1
"Lunenburg County, VA",2008-2009,12936,12887,-49,-0.379,-28,-21,51,111,H1
"Lunenburg County, VA",2009-2010,12887,12898,11,0.085,-7,18,51,111,H1
"Lunenburg County, VA",2010-2011,12898,12875,-23,-0.178,-22,-1,51,111,H1
"Lunenburg County, VA",2011-2012,12875,12599,-276,-2.144,-9,-267,51,111,H1
"Lunenburg County, VA",2012-2013,12599,12498,-101,-0.802,-41,-60,51,111,H1
"Lunenburg County, VA",2013-2014,12498,12466,-32,-0.256,-44,12,51,111,H1
"Lunenburg County, VA",2014-2015,12462,12299,-163,-1.308,-50,-113,51,111,H1
"Lunenburg County, VA",2015-2016,12299,12266,-33,-0.268,-40,7,51,111,H1
"Lunenburg County, VA",2016-2017,12266,12235,-31,-0.253,-52,21,51,111,H1
"Madison County, VA",2000-2001,12535,12643,108,0.862,-11,119,51,113,H1
"Madison County, VA",2001-2002,12643,12838,195,1.542,38,157,51,113,H1
"Madison County, VA",2002-2003,12838,12865,27,0.21,2,25,51,113,H1
"Madison County, VA",2003-2004,12865,12902,37,0.288,15,22,51,113,H1
"Madison County, VA",2004-2005,12902,13106,204,1.581,40,164,51,113,H1
"Madison County, VA",2005-2006,13106,13291,185,1.412,32,153,51,113,H1
"Madison County, VA",2006-2007,13291,13429,138,1.038,11,127,51,113,H1
"Madison County, VA",2007-2008,13429,13332,-97,-0.722,33,-130,51,113,H1
"Madison County, VA",2008-2009,13332,13358,26,0.195,28,-2,51,113,H1
"Madison County, VA",2009-2010,13358,13295,-63,-0.472,12,-75,51,113,H1
"Madison County, VA",2010-2011,13295,13192,-103,-0.775,-4,-99,51,113,H1
"Madison County, VA",2011-2012,13192,13207,15,0.114,-16,31,51,113,H1
"Madison County, VA",2012-2013,13207,13187,-20,-0.151,-3,-17,51,113,H1
"Madison County, VA",2013-2014,13187,13157,-30,-0.227,8,-38,51,113,H1
"Madison County, VA",2014-2015,13121,13134,13,0.099,22,-9,51,113,H1
"Madison County, VA",2015-2016,13134,13108,-26,-0.198,27,-53,51,113,H1
"Madison County, VA",2016-2017,13108,13277,169,1.289,35,134,51,113,H1
"Mathews County, VA",2000-2001,9142,9145,3,0.033,-56,59,51,115,H1
"Mathews County, VA",2001-2002,9145,9118,-27,-0.295,-52,25,51,115,H1
"Mathews County, VA",2002-2003,9118,9091,-27,-0.296,-74,47,51,115,H1
"Mathews County, VA",2003-2004,9091,9021,-70,-0.77,-60,-10,51,115,H1
"Mathews County, VA",2004-2005,9021,8962,-59,-0.654,-80,21,51,115,H1
"Mathews County, VA",2005-2006,8962,8987,25,0.279,-84,109,51,115,H1
"Mathews County, VA",2006-2007,8987,9026,39,0.434,-41,80,51,115,H1
"Mathews County, VA",2007-2008,9026,9041,15,0.166,-39,54,51,115,H1
"Mathews County, VA",2008-2009,9041,8997,-44,-0.487,-36,-8,51,115,H1
"Mathews County, VA",2009-2010,8997,8973,-24,-0.267,-51,27,51,115,H1
"Mathews County, VA",2010-2011,8973,8963,-10,-0.111,-59,49,51,115,H1
"Mathews County, VA",2011-2012,8963,8921,-42,-0.469,-44,2,51,115,H1
"Mathews County, VA",2012-2013,8921,8922,1,0.011,-47,48,51,115,H1
"Mathews County, VA",2013-2014,8922,8836,-86,-0.964,-45,-41,51,115,H1
"Mathews County, VA",2014-2015,8794,8862,68,0.773,-63,131,51,115,H1
"Mathews County, VA",2015-2016,8862,8806,-56,-0.632,-65,9,51,115,H1
"Mathews County, VA",2016-2017,8806,8779,-27,-0.307,-61,34,51,115,H1
"Mecklenburg County, VA",2000-2001,32384,32425,41,0.127,-48,89,51,117,H1
"Mecklenburg County, VA",2001-2002,32425,32528,103,0.318,-59,162,51,117,H1
"Mecklenburg County, VA",2002-2003,32528,32546,18,0.055,-51,69,51,117,H1
"Mecklenburg County, VA",2003-2004,32546,32547,1,0.003,-60,61,51,117,H1
"Mecklenburg County, VA",2004-2005,32547,32554,7,0.022,-144,151,51,117,H1
"Mecklenburg County, VA",2005-2006,32554,32642,88,0.27,-52,140,51,117,H1
"Mecklenburg County, VA",2006-2007,32642,32823,181,0.555,-104,285,51,117,H1
"Mecklenburg County, VA",2007-2008,32823,32920,97,0.296,-127,224,51,117,H1
"Mecklenburg County, VA",2008-2009,32920,32815,-105,-0.319,-100,-5,51,117,H1
"Mecklenburg County, VA",2009-2010,32815,32700,-115,-0.35,-103,-12,51,117,H1
"Mecklenburg County, VA",2010-2011,32700,32578,-122,-0.373,-160,38,51,117,H1
"Mecklenburg County, VA",2011-2012,32578,31758,-820,-2.517,-129,-691,51,117,H1
"Mecklenburg County, VA",2012-2013,31758,31336,-422,-1.329,-167,-255,51,117,H1
"Mecklenburg County, VA",2013-2014,31336,31192,-144,-0.46,-166,22,51,117,H1
"Mecklenburg County, VA",2014-2015,31112,31081,-31,-0.1,-176,145,51,117,H1
"Mecklenburg County, VA",2015-2016,31081,30786,-295,-0.949,-188,-107,51,117,H1
"Mecklenburg County, VA",2016-2017,30786,30686,-100,-0.325,-198,98,51,117,H1
"Middlesex County, VA",2000-2001,9932,10007,75,0.755,-73,148,51,119,H1
"Middlesex County, VA",2001-2002,10007,10029,22,0.22,-84,106,51,119,H1
"Middlesex County, VA",2002-2003,10029,10238,209,2.084,-51,260,51,119,H1
"Middlesex County, VA",2003-2004,10238,10399,161,1.573,-54,215,51,119,H1
"Middlesex County, VA",2004-2005,10399,10526,127,1.221,-66,193,51,119,H1
"Middlesex County, VA",2005-2006,10526,10732,206,1.957,-73,279,51,119,H1
"Middlesex County, VA",2006-2007,10732,10763,31,0.289,-59,90,51,119,H1
"Middlesex County, VA",2007-2008,10763,10806,43,0.4,-35,78,51,119,H1
"Middlesex County, VA",2008-2009,10806,10875,69,0.639,-56,125,51,119,H1
"Middlesex County, VA",2009-2010,10875,10970,95,0.874,-63,158,51,119,H1
"Middlesex County, VA",2010-2011,10970,10834,-136,-1.24,-52,-84,51,119,H1
"Middlesex County, VA",2011-2012,10834,10827,-7,-0.065,-77,70,51,119,H1
"Middlesex County, VA",2012-2013,10827,10758,-69,-0.637,-47,-22,51,119,H1
"Middlesex County, VA",2013-2014,10758,10696,-62,-0.576,-43,-19,51,119,H1
"Middlesex County, VA",2014-2015,10621,10606,-15,-0.141,-44,29,51,119,H1
"Middlesex County, VA",2015-2016,10606,10768,162,1.527,-46,208,51,119,H1
"Middlesex County, VA",2016-2017,10768,10679,-89,-0.827,-40,-49,51,119,H1
"Montgomery County, VA",2000-2001,83799,85236,1437,1.715,325,1112,51,121,H1
"Montgomery County, VA",2001-2002,85236,85746,510,0.598,192,318,51,121,H1
"Montgomery County, VA",2002-2003,85746,86708,962,1.122,297,665,51,121,H1
"Montgomery County, VA",2003-2004,86708,87289,581,0.67,344,237,51,121,H1
"Montgomery County, VA",2004-2005,87289,88696,1407,1.612,284,1123,51,121,H1
"Montgomery County, VA",2005-2006,88696,90062,1366,1.54,310,1056,51,121,H1
"Montgomery County, VA",2006-2007,90062,91548,1486,1.65,419,1067,51,121,H1
"Montgomery County, VA",2007-2008,91548,92724,1176,1.285,426,750,51,121,H1
"Montgomery County, VA",2008-2009,92724,93772,1048,1.13,399,649,51,121,H1
"Montgomery County, VA",2009-2010,93772,94610,838,0.894,339,499,51,121,H1
"Montgomery County, VA",2010-2011,94610,94841,231,0.244,248,-17,51,121,H1
"Montgomery County, VA",2011-2012,94841,95651,810,0.854,345,465,51,121,H1
"Montgomery County, VA",2012-2013,95651,96696,1045,1.093,318,727,51,121,H1
"Montgomery County, VA",2013-2014,96696,97244,548,0.567,349,199,51,121,H1
"Montgomery County, VA",2014-2015,97369,97653,284,0.292,311,-27,51,121,H1
"Montgomery County, VA",2015-2016,97653,98440,787,0.806,261,526,51,121,H1
"Montgomery County, VA",2016-2017,98440,98559,119,0.121,223,-104,51,121,H1
"Nelson County, VA",2000-2001,14451,14496,45,0.311,6,39,51,125,H1
"Nelson County, VA",2001-2002,14496,14614,118,0.814,-38,156,51,125,H1
"Nelson County, VA",2002-2003,14614,14718,104,0.712,-8,112,51,125,H1
"Nelson County, VA",2003-2004,14718,14699,-19,-0.129,-6,-13,51,125,H1
"Nelson County, VA",2004-2005,14699,14828,129,0.878,-1,130,51,125,H1
"Nelson County, VA",2005-2006,14828,14809,-19,-0.128,-22,3,51,125,H1
"Nelson County, VA",2006-2007,14809,14993,184,1.242,27,157,51,125,H1
"Nelson County, VA",2007-2008,14993,15050,57,0.38,1,56,51,125,H1
"Nelson County, VA",2008-2009,15050,15090,40,0.266,-14,54,51,125,H1
"Nelson County, VA",2009-2010,15090,14981,-109,-0.722,-42,-67,51,125,H1
"Nelson County, VA",2010-2011,14981,15034,53,0.354,-45,98,51,125,H1
"Nelson County, VA",2011-2012,15034,14807,-227,-1.51,-44,-183,51,125,H1
"Nelson County, VA",2012-2013,14807,14789,-18,-0.122,-36,18,51,125,H1
"Nelson County, VA",2013-2014,14789,14850,61,0.412,-20,81,51,125,H1
"Nelson County, VA",2014-2015,14843,14785,-58,-0.391,-7,-51,51,125,H1
"Nelson County, VA",2015-2016,14785,14895,110,0.744,-36,146,51,125,H1
"Nelson County, VA",2016-2017,14895,14943,48,0.322,-25,73,51,125,H1
"New Kent County, VA",2000-2001,13537,13876,339,2.504,47,292,51,127,H1
"New Kent County, VA",2001-2002,13876,14192,316,2.277,32,284,51,127,H1
"New Kent County, VA",2002-2003,14192,14764,572,4.03,63,509,51,127,H1
"New Kent County, VA",2003-2004,14764,15317,553,3.746,52,501,51,127,H1
"New Kent County, VA",2004-2005,15317,15953,636,4.152,49,587,51,127,H1
"New Kent County, VA",2005-2006,15953,16680,727,4.557,55,672,51,127,H1
"New Kent County, VA",2006-2007,16680,17254,574,3.441,80,494,51,127,H1
"New Kent County, VA",2007-2008,17254,17728,474,2.747,52,422,51,127,H1
"New Kent County, VA",2008-2009,17728,18057,329,1.856,73,256,51,127,H1
"New Kent County, VA",2009-2010,18057,18546,489,2.708,42,447,51,127,H1
"New Kent County, VA",2010-2011,18546,18754,208,1.122,38,170,51,127,H1
"New Kent County, VA",2011-2012,18754,19132,378,2.016,74,304,51,127,H1
"New Kent County, VA",2012-2013,19132,19482,350,1.829,45,305,51,127,H1
"New Kent County, VA",2013-2014,19482,20021,539,2.767,65,474,51,127,H1
"New Kent County, VA",2014-2015,19999,20392,393,1.965,54,339,51,127,H1
"New Kent County, VA",2015-2016,20392,21030,638,3.129,58,580,51,127,H1
"New Kent County, VA",2016-2017,21030,21682,652,3.1,76,576,51,127,H1
"Northampton County, VA",2000-2001,13025,12843,-182,-1.397,-42,-140,51,131,H1
"Northampton County, VA",2001-2002,12843,12729,-114,-0.888,-47,-67,51,131,H1
"Northampton County, VA",2002-2003,12729,12714,-15,-0.118,-56,41,51,131,H1
"Northampton County, VA",2003-2004,12714,12759,45,0.354,-46,91,51,131,H1
"Northampton County, VA",2004-2005,12759,12771,12,0.094,-32,44,51,131,H1
"Northampton County, VA",2005-2006,12771,12776,5,0.039,-14,19,51,131,H1
"Northampton County, VA",2006-2007,12776,12649,-127,-0.994,-43,-84,51,131,H1
"Northampton County, VA",2007-2008,12649,12586,-63,-0.498,10,-73,51,131,H1
"Northampton County, VA",2008-2009,12586,12460,-126,-1.001,-6,-120,51,131,H1
"Northampton County, VA",2009-2010,12460,12397,-63,-0.506,-49,-14,51,131,H1
"Northampton County, VA",2010-2011,12397,12432,35,0.282,-21,56,51,131,H1
"Northampton County, VA",2011-2012,12432,12237,-195,-1.569,-56,-139,51,131,H1
"Northampton County, VA",2012-2013,12237,12082,-155,-1.267,-51,-104,51,131,H1
"Northampton County, VA",2013-2014,12082,12121,39,0.323,-74,113,51,131,H1
"Northampton County, VA",2014-2015,12085,12155,70,0.579,-63,133,51,131,H1
"Northampton County, VA",2015-2016,12155,12006,-149,-1.226,-83,-66,51,131,H1
"Northampton County, VA",2016-2017,12006,11846,-160,-1.333,-98,-62,51,131,H1
"Northumberland County, VA",2000-2001,12229,12239,10,0.082,-63,73,51,133,H1
"Northumberland County, VA",2001-2002,12239,12451,212,1.732,-64,276,51,133,H1
"Northumberland County, VA",2002-2003,12451,12543,92,0.739,-62,154,51,133,H1
"Northumberland County, VA",2003-2004,12543,12487,-56,-0.446,-66,10,51,133,H1
"Northumberland County, VA",2004-2005,12487,12501,14,0.112,-47,61,51,133,H1
"Northumberland County, VA",2005-2006,12501,12430,-71,-0.568,-72,1,51,133,H1
"Northumberland County, VA",2006-2007,12430,12466,36,0.29,-68,104,51,133,H1
"Northumberland County, VA",2007-2008,12466,12496,30,0.241,-69,99,51,133,H1
"Northumberland County, VA",2008-2009,12496,12379,-117,-0.936,-55,-62,51,133,H1
"Northumberland County, VA",2009-2010,12379,12350,-29,-0.234,-57,28,51,133,H1
"Northumberland County, VA",2010-2011,12350,12416,66,0.534,-59,125,51,133,H1
"Northumberland County, VA",2011-2012,12416,12354,-62,-0.499,-95,33,51,133,H1
"Northumberland County, VA",2012-2013,12354,12231,-123,-0.996,-83,-40,51,133,H1
"Northumberland County, VA",2013-2014,12231,12251,20,0.164,-88,108,51,133,H1
"Northumberland County, VA",2014-2015,12252,12232,-20,-0.163,-84,64,51,133,H1
"Northumberland County, VA",2015-2016,12232,12195,-37,-0.302,-107,70,51,133,H1
"Northumberland County, VA",2016-2017,12195,12275,80,0.656,-99,179,51,133,H1
"Nottoway County, VA",2000-2001,15773,15849,76,0.482,-31,107,51,135,H1
"Nottoway County, VA",2001-2002,15849,15756,-93,-0.587,-23,-70,51,135,H1
"Nottoway County, VA",2002-2003,15756,15693,-63,-0.4,-43,-20,51,135,H1
"Nottoway County, VA",2003-2004,15693,15628,-65,-0.414,-22,-43,51,135,H1
"Nottoway County, VA",2004-2005,15628,15795,167,1.069,4,163,51,135,H1
"Nottoway County, VA",2005-2006,15795,15719,-76,-0.481,-30,-46,51,135,H1
"Nottoway County, VA",2006-2007,15719,15799,80,0.509,-16,96,51,135,H1
"Nottoway County, VA",2007-2008,15799,15847,48,0.304,-1,49,51,135,H1
"Nottoway County, VA",2008-2009,15847,15894,47,0.297,-4,51,51,135,H1
"Nottoway County, VA",2009-2010,15894,15834,-60,-0.378,-9,-51,51,135,H1
"Nottoway County, VA",2010-2011,15834,15889,55,0.347,-31,86,51,135,H1
"Nottoway County, VA",2011-2012,15889,15776,-113,-0.711,-34,-79,51,135,H1
"Nottoway County, VA",2012-2013,15776,15701,-75,-0.475,2,-77,51,135,H1
"Nottoway County, VA",2013-2014,15701,15579,-122,-0.777,-17,-105,51,135,H1
"Nottoway County, VA",2014-2015,15560,15673,113,0.726,-18,131,51,135,H1
"Nottoway County, VA",2015-2016,15673,15510,-163,-1.04,-31,-132,51,135,H1
"Nottoway County, VA",2016-2017,15510,15434,-76,-0.49,-60,-16,51,135,H1
"Orange County, VA",2000-2001,25981,26431,450,1.732,-25,475,51,137,H1
"Orange County, VA",2001-2002,26431,27128,697,2.637,18,679,51,137,H1
"Orange County, VA",2002-2003,27128,27951,823,3.034,12,811,51,137,H1
"Orange County, VA",2003-2004,27951,28658,707,2.529,61,646,51,137,H1
"Orange County, VA",2004-2005,28658,29990,1332,4.648,89,1243,51,137,H1
"Orange County, VA",2005-2006,29990,31438,1448,4.828,21,1427,51,137,H1
"Orange County, VA",2006-2007,31438,32273,835,2.656,119,716,51,137,H1
"Orange County, VA",2007-2008,32273,33077,804,2.491,128,676,51,137,H1
"Orange County, VA",2008-2009,33077,33329,252,0.762,108,144,51,137,H1
"Orange County, VA",2009-2010,33329,33485,156,0.468,30,126,51,137,H1
"Orange County, VA",2010-2011,33485,33872,387,1.156,70,317,51,137,H1
"Orange County, VA",2011-2012,33872,34187,315,0.93,57,258,51,137,H1
"Orange County, VA",2012-2013,34187,34623,436,1.275,54,382,51,137,H1
"Orange County, VA",2013-2014,34623,35026,403,1.164,74,329,51,137,H1
"Orange County, VA",2014-2015,34978,35385,407,1.164,86,321,51,137,H1
"Orange County, VA",2015-2016,35385,35481,96,0.271,34,62,51,137,H1
"Orange County, VA",2016-2017,35481,36073,592,1.668,60,532,51,137,H1
"Page County, VA",2000-2001,23149,23171,22,0.095,20,2,51,139,H1
"Page County, VA",2001-2002,23171,23265,94,0.406,37,57,51,139,H1
"Page County, VA",2002-2003,23265,23531,266,1.143,30,236,51,139,H1
"Page County, VA",2003-2004,23531,23527,-4,-0.017,9,-13,51,139,H1
"Page County, VA",2004-2005,23527,23708,181,0.769,9,172,51,139,H1
"Page County, VA",2005-2006,23708,24045,337,1.421,26,311,51,139,H1
"Page County, VA",2006-2007,24045,24222,177,0.736,13,164,51,139,H1
"Page County, VA",2007-2008,24222,24208,-14,-0.058,-12,-2,51,139,H1
"Page County, VA",2008-2009,24208,24076,-132,-0.545,-2,-130,51,139,H1
"Page County, VA",2009-2010,24076,24048,-28,-0.116,-1,-27,51,139,H1
"Page County, VA",2010-2011,24048,23990,-58,-0.241,-72,14,51,139,H1
"Page County, VA",2011-2012,23990,23872,-118,-0.492,-68,-50,51,139,H1
"Page County, VA",2012-2013,23872,23769,-103,-0.431,-20,-83,51,139,H1
"Page County, VA",2013-2014,23769,23848,79,0.332,-37,116,51,139,H1
"Page County, VA",2014-2015,23845,23726,-119,-0.499,-45,-74,51,139,H1
"Page County, VA",2015-2016,23726,23591,-135,-0.569,-71,-64,51,139,H1
"Page County, VA",2016-2017,23591,23731,140,0.593,-51,191,51,139,H1
"Patrick County, VA",2000-2001,19418,19293,-125,-0.644,-64,-61,51,141,H1
"Patrick County, VA",2001-2002,19293,19071,-222,-1.151,-49,-173,51,141,H1
"Patrick County, VA",2002-2003,19071,18979,-92,-0.482,-21,-71,51,141,H1
"Patrick County, VA",2003-2004,18979,18836,-143,-0.753,-73,-70,51,141,H1
"Patrick County, VA",2004-2005,18836,18802,-34,-0.181,-46,12,51,141,H1
"Patrick County, VA",2005-2006,18802,18766,-36,-0.191,-44,8,51,141,H1
"Patrick County, VA",2006-2007,18766,18748,-18,-0.096,-73,55,51,141,H1
"Patrick County, VA",2007-2008,18748,18677,-71,-0.379,-86,15,51,141,H1
"Patrick County, VA",2008-2009,18677,18562,-115,-0.616,-49,-66,51,141,H1
"Patrick County, VA",2009-2010,18562,18476,-86,-0.463,-46,-40,51,141,H1
"Patrick County, VA",2010-2011,18476,18368,-108,-0.585,-118,10,51,141,H1
"Patrick County, VA",2011-2012,18368,18403,35,0.191,-76,111,51,141,H1
"Patrick County, VA",2012-2013,18403,18316,-87,-0.473,-129,42,51,141,H1
"Patrick County, VA",2013-2014,18316,18264,-52,-0.284,-98,46,51,141,H1
"Patrick County, VA",2014-2015,18224,18045,-179,-0.982,-99,-80,51,141,H1
"Patrick County, VA",2015-2016,18045,17769,-276,-1.53,-140,-136,51,141,H1
"Patrick County, VA",2016-2017,17769,17665,-104,-0.585,-116,12,51,141,H1
"Pittsylvania County, VA",2000-2001,61835,62037,202,0.327,136,66,51,143,H1
"Pittsylvania County, VA",2001-2002,62037,61975,-62,-0.1,63,-125,51,143,H1
"Pittsylvania County, VA",2002-2003,61975,62107,132,0.213,49,83,51,143,H1
"Pittsylvania County, VA",2003-2004,62107,62279,172,0.277,77,95,51,143,H1
"Pittsylvania County, VA",2004-2005,62279,62467,188,0.302,21,167,51,143,H1
"Pittsylvania County, VA",2005-2006,62467,62586,119,0.191,1,118,51,143,H1
"Pittsylvania County, VA",2006-2007,62586,62803,217,0.347,101,116,51,143,H1
"Pittsylvania County, VA",2007-2008,62803,63472,669,1.065,-37,706,51,143,H1
"Pittsylvania County, VA",2008-2009,63472,63386,-86,-0.135,33,-119,51,143,H1
"Pittsylvania County, VA",2009-2010,63386,63571,185,0.292,51,134,51,143,H1
"Pittsylvania County, VA",2010-2011,63571,63374,-197,-0.31,-159,-38,51,143,H1
"Pittsylvania County, VA",2011-2012,63374,62898,-476,-0.751,-201,-275,51,143,H1
"Pittsylvania County, VA",2012-2013,62898,62547,-351,-0.558,-225,-126,51,143,H1
"Pittsylvania County, VA",2013-2014,62547,62383,-164,-0.262,-183,19,51,143,H1
"Pittsylvania County, VA",2014-2015,62546,62194,-352,-0.563,-200,-152,51,143,H1
"Pittsylvania County, VA",2015-2016,62194,61673,-521,-0.838,-184,-337,51,143,H1
"Pittsylvania County, VA",2016-2017,61673,61258,-415,-0.673,-251,-164,51,143,H1
"Powhatan County, VA",2000-2001,22585,23090,505,2.236,154,351,51,145,H1
"Powhatan County, VA",2001-2002,23090,24105,1015,4.396,107,908,51,145,H1
"Powhatan County, VA",2002-2003,24105,24888,783,3.248,145,638,51,145,H1
"Powhatan County, VA",2003-2004,24888,25568,680,2.732,101,579,51,145,H1
"Powhatan County, VA",2004-2005,25568,26372,804,3.145,109,695,51,145,H1
"Powhatan County, VA",2005-2006,26372,27391,1019,3.864,108,911,51,145,H1
"Powhatan County, VA",2006-2007,27391,27599,208,0.759,69,139,51,145,H1
"Powhatan County, VA",2007-2008,27599,27745,146,0.529,109,37,51,145,H1
"Powhatan County, VA",2008-2009,27745,27983,238,0.858,123,115,51,145,H1
"Powhatan County, VA",2009-2010,27983,28079,96,0.343,65,31,51,145,H1
"Powhatan County, VA",2010-2011,28079,28078,-1,-0.004,48,-49,51,145,H1
"Powhatan County, VA",2011-2012,28078,28116,38,0.135,45,-7,51,145,H1
"Powhatan County, VA",2012-2013,28116,28241,125,0.445,34,91,51,145,H1
"Powhatan County, VA",2013-2014,28241,28449,208,0.737,27,181,51,145,H1
"Powhatan County, VA",2014-2015,28462,28031,-431,-1.514,3,-434,51,145,H1
"Powhatan County, VA",2015-2016,28031,28398,367,1.309,-12,379,51,145,H1
"Powhatan County, VA",2016-2017,28398,28601,203,0.715,-17,220,51,145,H1
"Prince Edward County, VA",2000-2001,19708,19737,29,0.147,-31,60,51,147,H1
"Prince Edward County, VA",2001-2002,19737,20264,527,2.67,6,521,51,147,H1
"Prince Edward County, VA",2002-2003,20264,20203,-61,-0.301,-37,-24,51,147,H1
"Prince Edward County, VA",2003-2004,20203,20639,436,2.158,-20,456,51,147,H1
"Prince Edward County, VA",2004-2005,20639,21341,702,3.401,3,699,51,147,H1
"Prince Edward County, VA",2005-2006,21341,21722,381,1.785,-29,410,51,147,H1
"Prince Edward County, VA",2006-2007,21722,22293,571,2.629,-3,574,51,147,H1
"Prince Edward County, VA",2007-2008,22293,22959,666,2.987,-6,672,51,147,H1
"Prince Edward County, VA",2008-2009,22959,23260,301,1.311,-17,318,51,147,H1
"Prince Edward County, VA",2009-2010,23260,23371,111,0.477,-27,138,51,147,H1
"Prince Edward County, VA",2010-2011,23371,23223,-148,-0.633,-40,-108,51,147,H1
"Prince Edward County, VA",2011-2012,23223,23211,-12,-0.052,-2,-10,51,147,H1
"Prince Edward County, VA",2012-2013,23211,22820,-391,-1.685,8,-399,51,147,H1
"Prince Edward County, VA",2013-2014,22820,23074,254,1.113,-10,264,51,147,H1
"Prince Edward County, VA",2014-2015,23026,22952,-74,-0.321,-9,-65,51,147,H1
"Prince Edward County, VA",2015-2016,22952,23023,71,0.309,59,12,51,147,H1
"Prince Edward County, VA",2016-2017,23023,22703,-320,-1.39,21,-341,51,147,H1
"Prince George County, VA",2000-2001,33100,33586,486,1.468,259,227,51,149,H1
"Prince George County, VA",2001-2002,33586,34258,672,2.001,166,506,51,149,H1
"Prince George County, VA",2002-2003,34258,34345,87,0.254,209,-122,51,149,H1
"Prince George County, VA",2003-2004,34345,34925,580,1.689,208,372,51,149,H1
"Prince George County, VA",2004-2005,34925,34798,-127,-0.364,168,-295,51,149,H1
"Prince George County, VA",2005-2006,34798,34575,-223,-0.641,170,-393,51,149,H1
"Prince George County, VA",2006-2007,34575,34466,-109,-0.315,171,-280,51,149,H1
"Prince George County, VA",2007-2008,34466,35059,593,1.721,214,379,51,149,H1
"Prince George County, VA",2008-2009,35059,35828,769,2.193,205,564,51,149,H1
"Prince George County, VA",2009-2010,35828,35619,-209,-0.583,243,-452,51,149,H1
"Prince George County, VA",2010-2011,35619,36668,1049,2.945,138,911,51,149,H1
"Prince George County, VA",2011-2012,36668,37036,368,1.004,97,271,51,149,H1
"Prince George County, VA",2012-2013,37036,37303,267,0.721,90,177,51,149,H1
"Prince George County, VA",2013-2014,37303,37333,30,0.08,100,-70,51,149,H1
"Prince George County, VA",2014-2015,37563,37862,299,0.796,87,212,51,149,H1
"Prince George County, VA",2015-2016,37862,37807,-55,-0.145,128,-183,51,149,H1
"Prince George County, VA",2016-2017,37807,37809,2,0.005,93,-91,51,149,H1
"Prince William County, VA",2000-2001,284565,298843,14278,5.017,4089,10189,51,153,H1
"Prince William County, VA",2001-2002,298843,311749,12906,4.319,4390,8516,51,153,H1
"Prince William County, VA",2002-2003,311749,323377,11628,3.73,4553,7075,51,153,H1
"Prince William County, VA",2003-2004,323377,337439,14062,4.348,5064,8998,51,153,H1
"Prince William County, VA",2004-2005,337439,350612,13173,3.904,5236,7937,51,153,H1
"Prince William County, VA",2005-2006,350612,359174,8562,2.442,5623,2939,51,153,H1
"Prince William County, VA",2006-2007,359174,368016,8842,2.462,5657,3185,51,153,H1
"Prince William County, VA",2007-2008,368016,374776,6760,1.837,5139,1621,51,153,H1
"Prince William County, VA",2008-2009,374776,389001,14225,3.796,4982,9243,51,153,H1
"Prince William County, VA",2009-2010,389001,406370,17369,4.465,5019,12350,51,153,H1
"Prince William County, VA",2010-2011,406370,420004,13634,3.355,5162,8472,51,153,H1
"Prince William County, VA",2011-2012,420004,431226,11222,2.672,5295,5927,51,153,H1
"Prince William County, VA",2012-2013,431226,440166,8940,2.073,5205,3735,51,153,H1
"Prince William County, VA",2013-2014,440166,446094,5928,1.347,5213,715,51,153,H1
"Prince William County, VA",2014-2015,445006,451721,6715,1.509,5121,1594,51,153,H1
"Prince William County, VA",2015-2016,451721,456560,4839,1.071,4856,-17,51,153,H1
"Prince William County, VA",2016-2017,456560,463023,6463,1.416,4773,1690,51,153,H1
"Pulaski County, VA",2000-2001,35144,35120,-24,-0.068,11,-35,51,155,H1
"Pulaski County, VA",2001-2002,35120,34817,-303,-0.863,-112,-191,51,155,H1
"Pulaski County, VA",2002-2003,34817,34789,-28,-0.08,-38,10,51,155,H1
"Pulaski County, VA",2003-2004,34789,34829,40,0.115,-64,104,51,155,H1
"Pulaski County, VA",2004-2005,34829,34748,-81,-0.233,-61,-20,51,155,H1
"Pulaski County, VA",2005-2006,34748,34891,143,0.412,-127,270,51,155,H1
"Pulaski County, VA",2006-2007,34891,35058,167,0.479,-65,232,51,155,H1
"Pulaski County, VA",2007-2008,35058,35051,-7,-0.02,-70,63,51,155,H1
"Pulaski County, VA",2008-2009,35051,34988,-63,-0.18,-63,0,51,155,H1
"Pulaski County, VA",2009-2010,34988,34819,-169,-0.483,-59,-110,51,155,H1
"Pulaski County, VA",2010-2011,34819,34749,-70,-0.201,-135,65,51,155,H1
"Pulaski County, VA",2011-2012,34749,34747,-2,-0.006,-114,112,51,155,H1
"Pulaski County, VA",2012-2013,34747,34512,-235,-0.676,-121,-114,51,155,H1
"Pulaski County, VA",2013-2014,34512,34322,-190,-0.551,-78,-112,51,155,H1
"Pulaski County, VA",2014-2015,34312,34332,20,0.058,-84,104,51,155,H1
"Pulaski County, VA",2015-2016,34332,34240,-92,-0.268,-105,13,51,155,H1
"Pulaski County, VA",2016-2017,34240,34184,-56,-0.164,-123,67,51,155,H1
"Rappahannock County, VA",2000-2001,6980,7157,177,2.536,28,149,51,157,H1
"Rappahannock County, VA",2001-2002,7157,7197,40,0.559,0,40,51,157,H1
"Rappahannock County, VA",2002-2003,7197,7200,3,0.042,-1,4,51,157,H1
"Rappahannock County, VA",2003-2004,7200,7289,89,1.236,6,83,51,157,H1
"Rappahannock County, VA",2004-2005,7289,7384,95,1.303,5,90,51,157,H1
"Rappahannock County, VA",2005-2006,7384,7348,-36,-0.488,8,-44,51,157,H1
"Rappahannock County, VA",2006-2007,7348,7403,55,0.749,-4,59,51,157,H1
"Rappahannock County, VA",2007-2008,7403,7420,17,0.23,18,-1,51,157,H1
"Rappahannock County, VA",2008-2009,7420,7333,-87,-1.173,1,-88,51,157,H1
"Rappahannock County, VA",2009-2010,7333,7499,166,2.264,-4,170,51,157,H1
"Rappahannock County, VA",2010-2011,7499,7485,-14,-0.187,-1,-13,51,157,H1
"Rappahannock County, VA",2011-2012,7485,7430,-55,-0.735,-35,-20,51,157,H1
"Rappahannock County, VA",2012-2013,7430,7453,23,0.31,7,16,51,157,H1
"Rappahannock County, VA",2013-2014,7453,7361,-92,-1.234,-9,-83,51,157,H1
"Rappahannock County, VA",2014-2015,7360,7378,18,0.245,-23,41,51,157,H1
"Rappahannock County, VA",2015-2016,7378,7333,-45,-0.61,-21,-24,51,157,H1
"Rappahannock County, VA",2016-2017,7333,7321,-12,-0.164,-30,18,51,157,H1
"Richmond County, VA",2000-2001,8803,8924,121,1.375,-26,147,51,159,H1
"Richmond County, VA",2001-2002,8924,9003,79,0.885,-20,99,51,159,H1
"Richmond County, VA",2002-2003,9003,9103,100,1.111,-36,136,51,159,H1
"Richmond County, VA",2003-2004,9103,9202,99,1.088,-22,121,51,159,H1
"Richmond County, VA",2004-2005,9202,9213,11,0.12,-42,53,51,159,H1
"Richmond County, VA",2005-2006,9213,9328,115,1.248,-28,143,51,159,H1
"Richmond County, VA",2006-2007,9328,9426,98,1.051,-30,128,51,159,H1
"Richmond County, VA",2007-2008,9426,9386,-40,-0.424,-3,-37,51,159,H1
"Richmond County, VA",2008-2009,9386,9251,-135,-1.438,-29,-106,51,159,H1
"Richmond County, VA",2009-2010,9251,9264,13,0.141,-30,43,51,159,H1
"Richmond County, VA",2010-2011,9264,9189,-75,-0.81,-27,-48,51,159,H1
"Richmond County, VA",2011-2012,9189,9052,-137,-1.491,-45,-92,51,159,H1
"Richmond County, VA",2012-2013,9052,8951,-101,-1.116,-10,-91,51,159,H1
"Richmond County, VA",2013-2014,8951,8902,-49,-0.547,-19,-30,51,159,H1
"Richmond County, VA",2014-2015,8871,8908,37,0.417,-11,48,51,159,H1
"Richmond County, VA",2015-2016,8908,8784,-124,-1.392,-18,-106,51,159,H1
"Richmond County, VA",2016-2017,8784,8939,155,1.765,-25,180,51,159,H1
"Roanoke County, VA",2000-2001,85744,85941,197,0.23,-24,221,51,161,H1
"Roanoke County, VA",2001-2002,85941,86569,628,0.731,372,256,51,161,H1
"Roanoke County, VA",2002-2003,86569,87338,769,0.888,-81,850,51,161,H1
"Roanoke County, VA",2003-2004,87338,88177,839,0.961,308,531,51,161,H1
"Roanoke County, VA",2004-2005,88177,89245,1068,1.211,405,663,51,161,H1
"Roanoke County, VA",2005-2006,89245,90489,1244,1.394,72,1172,51,161,H1
"Roanoke County, VA",2006-2007,90489,91120,631,0.697,46,585,51,161,H1
"Roanoke County, VA",2007-2008,91120,91704,584,0.641,87,497,51,161,H1
"Roanoke County, VA",2008-2009,91704,92215,511,0.557,230,281,51,161,H1
"Roanoke County, VA",2009-2010,92215,92456,241,0.261,152,89,51,161,H1
"Roanoke County, VA",2010-2011,92456,93004,548,0.593,-133,681,51,161,H1
"Roanoke County, VA",2011-2012,93004,93031,27,0.029,-161,188,51,161,H1
"Roanoke County, VA",2012-2013,93031,93694,663,0.713,-103,766,51,161,H1
"Roanoke County, VA",2013-2014,93694,93785,91,0.097,-97,188,51,161,H1
"Roanoke County, VA",2014-2015,93979,94409,430,0.458,-58,488,51,161,H1
"Roanoke County, VA",2015-2016,94409,93363,-1046,-1.108,-183,-863,51,161,H1
"Roanoke County, VA",2016-2017,93363,93730,367,0.393,-223,590,51,161,H1
"Rockbridge County, VA",2000-2001,20835,20905,70,0.336,-5,75,51,163,H1
"Rockbridge County, VA",2001-2002,20905,20989,84,0.402,12,72,51,163,H1
"Rockbridge County, VA",2002-2003,20989,21189,200,0.953,16,184,51,163,H1
"Rockbridge County, VA",2003-2004,21189,21432,243,1.147,41,202,51,163,H1
"Rockbridge County, VA",2004-2005,21432,21738,306,1.428,31,275,51,163,H1
"Rockbridge County, VA",2005-2006,21738,21931,193,0.888,21,172,51,163,H1
"Rockbridge County, VA",2006-2007,21931,22228,297,1.354,51,246,51,163,H1
"Rockbridge County, VA",2007-2008,22228,22363,135,0.607,27,108,51,163,H1
"Rockbridge County, VA",2008-2009,22363,22269,-94,-0.42,20,-114,51,163,H1
"Rockbridge County, VA",2009-2010,22269,22280,11,0.049,16,-5,51,163,H1
"Rockbridge County, VA",2010-2011,22280,22504,224,1.005,-70,294,51,163,H1
"Rockbridge County, VA",2011-2012,22504,22392,-112,-0.498,-84,-28,51,163,H1
"Rockbridge County, VA",2012-2013,22392,22334,-58,-0.259,-62,4,51,163,H1
"Rockbridge County, VA",2013-2014,22334,22327,-7,-0.031,-55,48,51,163,H1
"Rockbridge County, VA",2014-2015,22426,22354,-72,-0.321,-63,-9,51,163,H1
"Rockbridge County, VA",2015-2016,22354,22411,57,0.255,-104,161,51,163,H1
"Rockbridge County, VA",2016-2017,22411,22659,248,1.107,-82,330,51,163,H1
"Rockingham County, VA",2000-2001,67977,68671,694,1.021,347,347,51,165,H1
"Rockingham County, VA",2001-2002,68671,69315,644,0.938,299,345,51,165,H1
"Rockingham County, VA",2002-2003,69315,69975,660,0.952,236,424,51,165,H1
"Rockingham County, VA",2003-2004,69975,70789,814,1.163,274,540,51,165,H1
"Rockingham County, VA",2004-2005,70789,72030,1241,1.753,270,971,51,165,H1
"Rockingham County, VA",2005-2006,72030,7.30E+04,970,1.347,293,677,51,165,H1
"Rockingham County, VA",2006-2007,7.30E+04,74274,1274,1.745,291,983,51,165,H1
"Rockingham County, VA",2007-2008,74274,75075,801,1.078,239,562,51,165,H1
"Rockingham County, VA",2008-2009,75075,75850,775,1.032,292,483,51,165,H1
"Rockingham County, VA",2009-2010,75850,76354,504,0.664,302,202,51,165,H1
"Rockingham County, VA",2010-2011,76354,77109,755,0.989,232,523,51,165,H1
"Rockingham County, VA",2011-2012,77109,77375,266,0.345,136,130,51,165,H1
"Rockingham County, VA",2012-2013,77375,77715,340,0.439,68,272,51,165,H1
"Rockingham County, VA",2013-2014,77715,78171,456,0.587,109,347,51,165,H1
"Rockingham County, VA",2014-2015,78137,78593,456,0.584,85,371,51,165,H1
"Rockingham County, VA",2015-2016,78593,79298,705,0.897,102,603,51,165,H1
"Rockingham County, VA",2016-2017,79298,80227,929,1.172,52,877,51,165,H1
"Russell County, VA",2000-2001,29251,29001,-250,-0.855,-34,-216,51,167,H1
"Russell County, VA",2001-2002,29001,28741,-260,-0.897,-36,-224,51,167,H1
"Russell County, VA",2002-2003,28741,28766,25,0.087,8,17,51,167,H1
"Russell County, VA",2003-2004,28766,28546,-220,-0.765,-80,-140,51,167,H1
"Russell County, VA",2004-2005,28546,28508,-38,-0.133,-76,38,51,167,H1
"Russell County, VA",2005-2006,28508,28618,110,0.386,-15,125,51,167,H1
"Russell County, VA",2006-2007,28618,28889,271,0.947,-65,336,51,167,H1
"Russell County, VA",2007-2008,28889,28831,-58,-0.201,-34,-24,51,167,H1
"Russell County, VA",2008-2009,28831,29012,181,0.628,-55,236,51,167,H1
"Russell County, VA",2009-2010,29012,28842,-170,-0.586,-64,-106,51,167,H1
"Russell County, VA",2010-2011,28842,28657,-185,-0.641,-92,-93,51,167,H1
"Russell County, VA",2011-2012,28657,28426,-231,-0.806,-56,-175,51,167,H1
"Russell County, VA",2012-2013,28426,28274,-152,-0.535,-54,-98,51,167,H1
"Russell County, VA",2013-2014,28274,28023,-251,-0.888,-67,-184,51,167,H1
"Russell County, VA",2014-2015,28012,27891,-121,-0.432,-52,-69,51,167,H1
"Russell County, VA",2015-2016,27891,27394,-497,-1.782,-109,-388,51,167,H1
"Russell County, VA",2016-2017,27394,27048,-346,-1.263,-129,-217,51,167,H1
"Scott County, VA",2000-2001,23351,23127,-224,-0.959,-85,-139,51,169,H1
"Scott County, VA",2001-2002,23127,23048,-79,-0.342,-65,-14,51,169,H1
"Scott County, VA",2002-2003,23048,22978,-70,-0.304,-63,-7,51,169,H1
"Scott County, VA",2003-2004,22978,22954,-24,-0.104,-98,74,51,169,H1
"Scott County, VA",2004-2005,22954,23084,130,0.566,-108,238,51,169,H1
"Scott County, VA",2005-2006,23084,23272,188,0.814,-56,244,51,169,H1
"Scott County, VA",2006-2007,23272,23302,30,0.129,-71,101,51,169,H1
"Scott County, VA",2007-2008,23302,23237,-65,-0.279,-90,25,51,169,H1
"Scott County, VA",2008-2009,23237,23212,-25,-0.108,-79,54,51,169,H1
"Scott County, VA",2009-2010,23212,23125,-87,-0.375,-66,-21,51,169,H1
"Scott County, VA",2010-2011,23125,22961,-164,-0.709,-86,-78,51,169,H1
"Scott County, VA",2011-2012,22961,22801,-160,-0.697,-93,-67,51,169,H1
"Scott County, VA",2012-2013,22801,22632,-169,-0.741,-129,-40,51,169,H1
"Scott County, VA",2013-2014,22632,22384,-248,-1.096,-100,-148,51,169,H1
"Scott County, VA",2014-2015,22360,22126,-234,-1.047,-99,-135,51,169,H1
"Scott County, VA",2015-2016,22126,22028,-98,-0.443,-148,50,51,169,H1
"Scott County, VA",2016-2017,22028,21865,-163,-0.74,-115,-48,51,169,H1
"Shenandoah County, VA",2000-2001,35240,35835,595,1.688,44,551,51,171,H1
"Shenandoah County, VA",2001-2002,35835,36525,690,1.925,71,619,51,171,H1
"Shenandoah County, VA",2002-2003,36525,37309,784,2.146,-7,791,51,171,H1
"Shenandoah County, VA",2003-2004,37309,38272,963,2.581,55,908,51,171,H1
"Shenandoah County, VA",2004-2005,38272,39406,1134,2.963,30,1104,51,171,H1
"Shenandoah County, VA",2005-2006,39406,40610,1204,3.055,105,1099,51,171,H1
"Shenandoah County, VA",2006-2007,40610,41214,604,1.487,121,483,51,171,H1
"Shenandoah County, VA",2007-2008,41214,41720,506,1.228,51,455,51,171,H1
"Shenandoah County, VA",2008-2009,41720,41743,23,0.055,51,-28,51,171,H1
"Shenandoah County, VA",2009-2010,41743,42050,307,0.735,32,275,51,171,H1
"Shenandoah County, VA",2010-2011,42050,42283,233,0.554,45,188,51,171,H1
"Shenandoah County, VA",2011-2012,42283,42641,358,0.847,18,340,51,171,H1
"Shenandoah County, VA",2012-2013,42641,42729,88,0.206,29,59,51,171,H1
"Shenandoah County, VA",2013-2014,42729,43021,292,0.683,34,258,51,171,H1
"Shenandoah County, VA",2014-2015,42913,43190,277,0.645,18,259,51,171,H1
"Shenandoah County, VA",2015-2016,43190,42928,-262,-0.607,-31,-231,51,171,H1
"Shenandoah County, VA",2016-2017,42928,43225,297,0.692,-24,321,51,171,H1
"Smyth County, VA",2000-2001,33079,32931,-148,-0.447,-32,-116,51,173,H1
"Smyth County, VA",2001-2002,32931,32849,-82,-0.249,-82,0,51,173,H1
"Smyth County, VA",2002-2003,32849,32733,-116,-0.353,-58,-58,51,173,H1
"Smyth County, VA",2003-2004,32733,32570,-163,-0.498,-63,-100,51,173,H1
"Smyth County, VA",2004-2005,32570,32519,-51,-0.157,-133,82,51,173,H1
"Smyth County, VA",2005-2006,32519,32632,113,0.347,-100,213,51,173,H1
"Smyth County, VA",2006-2007,32632,32449,-183,-0.561,-50,-133,51,173,H1
"Smyth County, VA",2007-2008,32449,32386,-63,-0.194,-71,8,51,173,H1
"Smyth County, VA",2008-2009,32386,32283,-103,-0.318,-64,-39,51,173,H1
"Smyth County, VA",2009-2010,32283,32193,-90,-0.279,-72,-18,51,173,H1
"Smyth County, VA",2010-2011,32193,32030,-163,-0.506,-98,-65,51,173,H1
"Smyth County, VA",2011-2012,32030,31863,-167,-0.521,-104,-63,51,173,H1
"Smyth County, VA",2012-2013,31863,31741,-122,-0.383,-132,10,51,173,H1
"Smyth County, VA",2013-2014,31741,31555,-186,-0.586,-140,-46,51,173,H1
"Smyth County, VA",2014-2015,31572,31470,-102,-0.323,-136,34,51,173,H1
"Smyth County, VA",2015-2016,31470,31075,-395,-1.255,-179,-216,51,173,H1
"Smyth County, VA",2016-2017,31075,30656,-419,-1.348,-184,-235,51,173,H1
"Southampton County, VA",2000-2001,17493,17489,-4,-0.023,-11,7,51,175,H1
"Southampton County, VA",2001-2002,17489,17353,-136,-0.778,-18,-118,51,175,H1
"Southampton County, VA",2002-2003,17353,17409,56,0.323,-12,68,51,175,H1
"Southampton County, VA",2003-2004,17409,17535,126,0.724,-20,146,51,175,H1
"Southampton County, VA",2004-2005,17535,17810,275,1.568,-27,302,51,175,H1
"Southampton County, VA",2005-2006,17810,18028,218,1.224,-16,234,51,175,H1
"Southampton County, VA",2006-2007,18028,18571,543,3.012,1,542,51,175,H1
"Southampton County, VA",2007-2008,18571,18706,135,0.727,-33,168,51,175,H1
"Southampton County, VA",2008-2009,18706,18607,-99,-0.529,-12,-87,51,175,H1
"Southampton County, VA",2009-2010,18607,18588,-19,-0.102,-27,8,51,175,H1
"Southampton County, VA",2010-2011,18588,18571,-17,-0.091,-54,37,51,175,H1
"Southampton County, VA",2011-2012,18571,18417,-154,-0.829,-46,-108,51,175,H1
"Southampton County, VA",2012-2013,18417,18186,-231,-1.254,-39,-192,51,175,H1
"Southampton County, VA",2013-2014,18186,18059,-127,-0.698,-54,-73,51,175,H1
"Southampton County, VA",2014-2015,18267,18109,-158,-0.865,-64,-94,51,175,H1
"Southampton County, VA",2015-2016,18109,18019,-90,-0.497,-65,-25,51,175,H1
"Southampton County, VA",2016-2017,18019,17750,-269,-1.493,-92,-177,51,175,H1
"Spotsylvania County, VA",2000-2001,91387,96326,4939,5.404,843,4096,51,177,H1
"Spotsylvania County, VA",2001-2002,96326,101802,5476,5.685,967,4509,51,177,H1
"Spotsylvania County, VA",2002-2003,101802,106525,4723,4.639,967,3756,51,177,H1
"Spotsylvania County, VA",2003-2004,106525,110580,4055,3.807,987,3068,51,177,H1
"Spotsylvania County, VA",2004-2005,110580,115017,4437,4.012,1103,3334,51,177,H1
"Spotsylvania County, VA",2005-2006,115017,117891,2874,2.499,1034,1840,51,177,H1
"Spotsylvania County, VA",2006-2007,117891,119083,1192,1.011,1159,33,51,177,H1
"Spotsylvania County, VA",2007-2008,119083,120195,1112,0.934,994,118,51,177,H1
"Spotsylvania County, VA",2008-2009,120195,121038,843,0.701,1011,-168,51,177,H1
"Spotsylvania County, VA",2009-2010,121038,123158,2120,1.752,820,1300,51,177,H1
"Spotsylvania County, VA",2010-2011,123158,124823,1665,1.352,843,822,51,177,H1
"Spotsylvania County, VA",2011-2012,124823,126137,1314,1.053,734,580,51,177,H1
"Spotsylvania County, VA",2012-2013,126137,127696,1559,1.236,719,840,51,177,H1
"Spotsylvania County, VA",2013-2014,127696,129188,1492,1.168,721,771,51,177,H1
"Spotsylvania County, VA",2014-2015,129202,130475,1273,0.985,684,589,51,177,H1
"Spotsylvania County, VA",2015-2016,130475,131405,930,0.713,727,203,51,177,H1
"Spotsylvania County, VA",2016-2017,131405,133033,1628,1.239,641,987,51,177,H1
"Stafford County, VA",2000-2001,93625,98320,4695,5.015,965,3730,51,179,H1
"Stafford County, VA",2001-2002,98320,103943,5623,5.719,1030,4593,51,179,H1
"Stafford County, VA",2002-2003,103943,109166,5223,5.025,1054,4169,51,179,H1
"Stafford County, VA",2003-2004,109166,113798,4632,4.243,1128,3504,51,179,H1
"Stafford County, VA",2004-2005,113798,117611,3813,3.351,1071,2742,51,179,H1
"Stafford County, VA",2005-2006,117611,119892,2281,1.939,1137,1144,51,179,H1
"Stafford County, VA",2006-2007,119892,122526,2634,2.197,1241,1393,51,179,H1
"Stafford County, VA",2007-2008,122526,124323,1797,1.467,1176,621,51,179,H1
"Stafford County, VA",2008-2009,124323,126449,2126,1.71,1159,967,51,179,H1
"Stafford County, VA",2009-2010,126449,129787,3338,2.64,1052,2286,51,179,H1
"Stafford County, VA",2010-2011,129787,132219,2432,1.874,1160,1272,51,179,H1
"Stafford County, VA",2011-2012,132219,134374,2155,1.63,1048,1107,51,179,H1
"Stafford County, VA",2012-2013,134374,136988,2614,1.945,1020,1594,51,179,H1
"Stafford County, VA",2013-2014,136988,139992,3004,2.193,1061,1943,51,179,H1
"Stafford County, VA",2014-2015,140047,142003,1956,1.397,1133,823,51,179,H1
"Stafford County, VA",2015-2016,142003,143477,1474,1.038,912,562,51,179,H1
"Stafford County, VA",2016-2017,143477,146649,3172,2.211,912,2260,51,179,H1
"Surry County, VA",2000-2001,6833,6829,-4,-0.059,19,-23,51,181,H1
"Surry County, VA",2001-2002,6829,6886,57,0.835,-14,71,51,181,H1
"Surry County, VA",2002-2003,6886,6901,15,0.218,-12,27,51,181,H1
"Surry County, VA",2003-2004,6901,6873,-28,-0.406,1,-29,51,181,H1
"Surry County, VA",2004-2005,6873,6865,-8,-0.116,-8,0,51,181,H1
"Surry County, VA",2005-2006,6865,6991,126,1.835,19,107,51,181,H1
"Surry County, VA",2006-2007,6991,7042,51,0.73,5,46,51,181,H1
"Surry County, VA",2007-2008,7042,7061,19,0.27,28,-9,51,181,H1
"Surry County, VA",2008-2009,7061,7037,-24,-0.34,10,-34,51,181,H1
"Surry County, VA",2009-2010,7037,7060,23,0.327,1,22,51,181,H1
"Surry County, VA",2010-2011,7060,6940,-120,-1.7,-15,-105,51,181,H1
"Surry County, VA",2011-2012,6940,6840,-100,-1.441,-12,-88,51,181,H1
"Surry County, VA",2012-2013,6840,6794,-46,-0.673,10,-56,51,181,H1
"Surry County, VA",2013-2014,6794,6790,-4,-0.059,13,-17,51,181,H1
"Surry County, VA",2014-2015,6804,6709,-95,-1.396,11,-106,51,181,H1
"Surry County, VA",2015-2016,6709,6570,-139,-2.072,-11,-128,51,181,H1
"Surry County, VA",2016-2017,6570,6540,-30,-0.457,-3,-27,51,181,H1
"Sussex County, VA",2000-2001,12456,12318,-138,-1.108,-29,-109,51,183,H1
"Sussex County, VA",2001-2002,12318,12109,-209,-1.697,-6,-203,51,183,H1
"Sussex County, VA",2002-2003,12109,12205,96,0.793,-39,135,51,183,H1
"Sussex County, VA",2003-2004,12205,12014,-191,-1.565,-26,-165,51,183,H1
"Sussex County, VA",2004-2005,12014,11933,-81,-0.674,-18,-63,51,183,H1
"Sussex County, VA",2005-2006,11933,12193,260,2.179,-5,265,51,183,H1
"Sussex County, VA",2006-2007,12193,12191,-2,-0.016,-17,15,51,183,H1
"Sussex County, VA",2007-2008,12191,12215,24,0.197,-11,35,51,183,H1
"Sussex County, VA",2008-2009,12215,12175,-40,-0.327,-29,-11,51,183,H1
"Sussex County, VA",2009-2010,12175,12004,-171,-1.405,-30,-141,51,183,H1
"Sussex County, VA",2010-2011,12004,12091,87,0.725,-37,124,51,183,H1
"Sussex County, VA",2011-2012,12091,11941,-150,-1.241,-29,-121,51,183,H1
"Sussex County, VA",2012-2013,11941,11808,-133,-1.114,-22,-111,51,183,H1
"Sussex County, VA",2013-2014,11808,11767,-41,-0.347,-35,-6,51,183,H1
"Sussex County, VA",2014-2015,11763,11715,-48,-0.408,-36,-12,51,183,H1
"Sussex County, VA",2015-2016,11715,11426,-289,-2.467,-53,-236,51,183,H1
"Sussex County, VA",2016-2017,11426,11373,-53,-0.464,-48,-5,51,183,H1
"Tazewell County, VA",2000-2001,44418,43985,-433,-0.975,-109,-324,51,185,H1
"Tazewell County, VA",2001-2002,43985,43995,10,0.023,-99,109,51,185,H1
"Tazewell County, VA",2002-2003,43995,44042,47,0.107,-68,115,51,185,H1
"Tazewell County, VA",2003-2004,44042,44102,60,0.136,-102,162,51,185,H1
"Tazewell County, VA",2004-2005,44102,44025,-77,-0.175,-123,46,51,185,H1
"Tazewell County, VA",2005-2006,44025,44195,170,0.386,-66,236,51,185,H1
"Tazewell County, VA",2006-2007,44195,44169,-26,-0.059,-72,46,51,185,H1
"Tazewell County, VA",2007-2008,44169,45020,851,1.927,-139,990,51,185,H1
"Tazewell County, VA",2008-2009,45020,45069,49,0.109,-113,162,51,185,H1
"Tazewell County, VA",2009-2010,45069,45157,88,0.195,-69,157,51,185,H1
"Tazewell County, VA",2010-2011,45157,44690,-467,-1.034,-227,-240,51,185,H1
"Tazewell County, VA",2011-2012,44690,44248,-442,-0.989,-212,-230,51,185,H1
"Tazewell County, VA",2012-2013,44248,44107,-141,-0.319,-144,3,51,185,H1
"Tazewell County, VA",2013-2014,44107,43452,-655,-1.485,-162,-493,51,185,H1
"Tazewell County, VA",2014-2015,43436,42899,-537,-1.236,-181,-356,51,185,H1
"Tazewell County, VA",2015-2016,42899,42046,-853,-1.988,-195,-658,51,185,H1
"Tazewell County, VA",2016-2017,42046,41095,-951,-2.262,-226,-725,51,185,H1
"Warren County, VA",2000-2001,31690,32222,532,1.679,132,400,51,187,H1
"Warren County, VA",2001-2002,32222,33031,809,2.511,151,658,51,187,H1
"Warren County, VA",2002-2003,33031,33797,766,2.319,158,608,51,187,H1
"Warren County, VA",2003-2004,33797,34434,637,1.885,146,491,51,187,H1
"Warren County, VA",2004-2005,34434,35405,971,2.82,177,794,51,187,H1
"Warren County, VA",2005-2006,35405,36231,826,2.333,198,628,51,187,H1
"Warren County, VA",2006-2007,36231,36814,583,1.609,226,357,51,187,H1
"Warren County, VA",2007-2008,36814,37259,445,1.209,152,293,51,187,H1
"Warren County, VA",2008-2009,37259,37240,-19,-0.051,174,-193,51,187,H1
"Warren County, VA",2009-2010,37240,37504,264,0.709,148,116,51,187,H1
"Warren County, VA",2010-2011,37504,37650,146,0.389,116,30,51,187,H1
"Warren County, VA",2011-2012,37650,37963,313,0.831,80,233,51,187,H1
"Warren County, VA",2012-2013,37963,38607,644,1.696,130,514,51,187,H1
"Warren County, VA",2013-2014,38607,38987,380,0.984,147,233,51,187,H1
"Warren County, VA",2014-2015,39028,39083,55,0.141,145,-90,51,187,H1
"Warren County, VA",2015-2016,39083,39066,-17,-0.043,76,-93,51,187,H1
"Warren County, VA",2016-2017,39066,39563,497,1.272,95,402,51,187,H1
"Washington County, VA",2000-2001,51230,51441,211,0.412,30,181,51,191,H1
"Washington County, VA",2001-2002,51441,51670,229,0.445,-8,237,51,191,H1
"Washington County, VA",2002-2003,51670,51908,238,0.461,-26,264,51,191,H1
"Washington County, VA",2003-2004,51908,52341,433,0.834,-77,510,51,191,H1
"Washington County, VA",2004-2005,52341,52940,599,1.144,-84,683,51,191,H1
"Washington County, VA",2005-2006,52940,53322,382,0.722,-101,483,51,191,H1
"Washington County, VA",2006-2007,53322,54216,894,1.677,-24,918,51,191,H1
"Washington County, VA",2007-2008,54216,54475,259,0.478,-25,284,51,191,H1
"Washington County, VA",2008-2009,54475,54722,247,0.453,-72,319,51,191,H1
"Washington County, VA",2009-2010,54722,54865,143,0.261,-87,230,51,191,H1
"Washington County, VA",2010-2011,54865,54735,-130,-0.237,-74,-56,51,191,H1
"Washington County, VA",2011-2012,54735,55073,338,0.618,-79,417,51,191,H1
"Washington County, VA",2012-2013,55073,54763,-310,-0.563,-143,-167,51,191,H1
"Washington County, VA",2013-2014,54763,54729,-34,-0.062,-5,-29,51,191,H1
"Washington County, VA",2014-2015,54663,54591,-72,-0.132,35,-107,51,191,H1
"Washington County, VA",2015-2016,54591,54237,-354,-0.648,-62,-292,51,191,H1
"Washington County, VA",2016-2017,54237,54387,150,0.277,-94,244,51,191,H1
"Westmoreland County, VA",2000-2001,16644,16518,-126,-0.757,-43,-83,51,193,H1
"Westmoreland County, VA",2001-2002,16518,16528,10,0.061,-38,48,51,193,H1
"Westmoreland County, VA",2002-2003,16528,16718,190,1.15,-12,202,51,193,H1
"Westmoreland County, VA",2003-2004,16718,16658,-60,-0.359,-47,-13,51,193,H1
"Westmoreland County, VA",2004-2005,16658,16757,99,0.594,-20,119,51,193,H1
"Westmoreland County, VA",2005-2006,16757,16841,84,0.501,3,81,51,193,H1
"Westmoreland County, VA",2006-2007,16841,17127,286,1.698,-14,300,51,193,H1
"Westmoreland County, VA",2007-2008,17127,17305,178,1.039,-22,200,51,193,H1
"Westmoreland County, VA",2008-2009,17305,17448,143,0.826,-32,175,51,193,H1
"Westmoreland County, VA",2009-2010,17448,17444,-4,-0.023,-16,12,51,193,H1
"Westmoreland County, VA",2010-2011,17444,17608,164,0.94,-29,193,51,193,H1
"Westmoreland County, VA",2011-2012,17608,17497,-111,-0.63,-6,-105,51,193,H1
"Westmoreland County, VA",2012-2013,17497,17562,65,0.371,0,65,51,193,H1
"Westmoreland County, VA",2013-2014,17562,17477,-85,-0.484,-7,-78,51,193,H1
"Westmoreland County, VA",2014-2015,17462,17629,167,0.956,-18,185,51,193,H1
"Westmoreland County, VA",2015-2016,17629,17659,30,0.17,-15,45,51,193,H1
"Westmoreland County, VA",2016-2017,17659,17780,121,0.685,-8,129,51,193,H1
"Wise County, VA",2000-2001,42077,41810,-267,-0.635,25,-292,51,195,H1
"Wise County, VA",2001-2002,41810,41667,-143,-0.342,82,-225,51,195,H1
"Wise County, VA",2002-2003,41667,41640,-27,-0.065,17,-44,51,195,H1
"Wise County, VA",2003-2004,41640,41591,-49,-0.118,2,-51,51,195,H1
"Wise County, VA",2004-2005,41591,41585,-6,-0.014,-27,21,51,195,H1
"Wise County, VA",2005-2006,41585,41531,-54,-0.13,41,-95,51,195,H1
"Wise County, VA",2006-2007,41531,41543,12,0.029,-9,21,51,195,H1
"Wise County, VA",2007-2008,41543,41489,-54,-0.13,-6,-48,51,195,H1
"Wise County, VA",2008-2009,41489,41454,-35,-0.084,17,-52,51,195,H1
"Wise County, VA",2009-2010,41454,41594,140,0.338,42,98,51,195,H1
"Wise County, VA",2010-2011,41594,41384,-210,-0.505,-57,-153,51,195,H1
"Wise County, VA",2011-2012,41384,40828,-556,-1.344,-94,-462,51,195,H1
"Wise County, VA",2012-2013,40828,40620,-208,-0.509,-63,-145,51,195,H1
"Wise County, VA",2013-2014,40620,39935,-685,-1.686,-38,-647,51,195,H1
"Wise County, VA",2014-2015,39952,39718,-234,-0.586,-25,-209,51,195,H1
"Wise County, VA",2015-2016,39718,39034,-684,-1.722,-48,-636,51,195,H1
"Wise County, VA",2016-2017,39034,38586,-448,-1.148,-80,-368,51,195,H1
"Wythe County, VA",2000-2001,27621,27585,-36,-0.13,-3,-33,51,197,H1
"Wythe County, VA",2001-2002,27585,27710,125,0.453,-9,134,51,197,H1
"Wythe County, VA",2002-2003,27710,27859,149,0.538,-29,178,51,197,H1
"Wythe County, VA",2003-2004,27859,27947,88,0.316,-12,100,51,197,H1
"Wythe County, VA",2004-2005,27947,28349,402,1.438,31,371,51,197,H1
"Wythe County, VA",2005-2006,28349,28628,279,0.984,22,257,51,197,H1
"Wythe County, VA",2006-2007,28628,28827,199,0.695,27,172,51,197,H1
"Wythe County, VA",2007-2008,28827,29123,296,1.027,-36,332,51,197,H1
"Wythe County, VA",2008-2009,29123,29216,93,0.319,-44,137,51,197,H1
"Wythe County, VA",2009-2010,29216,29254,38,0.13,-74,112,51,197,H1
"Wythe County, VA",2010-2011,29254,29228,-26,-0.089,-61,35,51,197,H1
"Wythe County, VA",2011-2012,29228,29351,123,0.421,-18,141,51,197,H1
"Wythe County, VA",2012-2013,29351,29339,-12,-0.041,-95,83,51,197,H1
"Wythe County, VA",2013-2014,29339,29121,-218,-0.743,-69,-149,51,197,H1
"Wythe County, VA",2014-2015,29060,29119,59,0.203,-87,146,51,197,H1
"Wythe County, VA",2015-2016,29119,28942,-177,-0.608,-113,-64,51,197,H1
"Wythe County, VA",2016-2017,28942,28882,-60,-0.207,-86,26,51,197,H1
"York County, VA",2000-2001,57119,58651,1532,2.682,342,1190,51,199,H1
"York County, VA",2001-2002,58651,60126,1475,2.515,317,1158,51,199,H1
"York County, VA",2002-2003,60126,60620,494,0.822,256,238,51,199,H1
"York County, VA",2003-2004,60620,61926,1306,2.154,250,1056,51,199,H1
"York County, VA",2004-2005,61926,63076,1150,1.857,203,947,51,199,H1
"York County, VA",2005-2006,63076,63912,836,1.325,176,660,51,199,H1
"York County, VA",2006-2007,63912,64710,798,1.249,279,519,51,199,H1
"York County, VA",2007-2008,64710,64944,234,0.362,218,16,51,199,H1
"York County, VA",2008-2009,64944,65197,253,0.39,218,35,51,199,H1
"York County, VA",2009-2010,65197,65198,1,0.002,190,-189,51,199,H1
"York County, VA",2010-2011,65198,65810,612,0.939,235,377,51,199,H1
"York County, VA",2011-2012,65810,65746,-64,-0.097,158,-222,51,199,H1
"York County, VA",2012-2013,65746,65944,198,0.301,247,-49,51,199,H1
"York County, VA",2013-2014,65944,66342,398,0.604,160,238,51,199,H1
"York County, VA",2014-2015,66616,67837,1221,1.833,167,1054,51,199,H1
"York County, VA",2015-2016,67837,67742,-95,-0.14,189,-284,51,199,H1
"York County, VA",2016-2017,67742,67739,-3,-0.004,125,-128,51,199,H1
"Alexandria city, VA",2000-2001,129225,130932,1707,1.321,1581,126,51,510,C7
"Alexandria city, VA",2001-2002,130932,130614,-318,-0.243,1667,-1985,51,510,C7
"Alexandria city, VA",2002-2003,130614,129421,-1193,-0.913,1713,-2906,51,510,C7
"Alexandria city, VA",2003-2004,129421,128765,-656,-0.507,1584,-2240,51,510,C7
"Alexandria city, VA",2004-2005,128765,128181,-584,-0.454,1669,-2253,51,510,C7
"Alexandria city, VA",2005-2006,128181,127676,-505,-0.394,1915,-2420,51,510,C7
"Alexandria city, VA",2006-2007,127676,129175,1499,1.174,2031,-532,51,510,C7
"Alexandria city, VA",2007-2008,129175,132949,3774,2.922,1791,1983,51,510,C7
"Alexandria city, VA",2008-2009,132949,137523,4574,3.44,1689,2885,51,510,C7
"Alexandria city, VA",2009-2010,137523,140829,3306,2.404,1931,1375,51,510,C7
"Alexandria city, VA",2010-2011,140829,144461,3632,2.579,1955,1677,51,510,C7
"Alexandria city, VA",2011-2012,144461,146934,2473,1.712,1941,532,51,510,C7
"Alexandria city, VA",2012-2013,146934,149312,2378,1.618,2096,282,51,510,C7
"Alexandria city, VA",2013-2014,149312,150575,1263,0.846,2057,-794,51,510,C7
"Alexandria city, VA",2014-2015,151440,153511,2071,1.368,2059,12,51,510,C7
"Alexandria city, VA",2015-2016,153511,157288,3777,2.46,2056,1721,51,510,C7
"Alexandria city, VA",2016-2017,157288,160035,2747,1.746,2048,699,51,510,C7
"Bedford city, VA",2000-2001,6425,6400,-25,-0.389,-2,-23,51,515,C7
"Bedford city, VA",2001-2002,6400,6320,-80,-1.25,-34,-46,51,515,C7
"Bedford city, VA",2002-2003,6320,6237,-83,-1.313,-66,-17,51,515,C7
"Bedford city, VA",2003-2004,6237,6198,-39,-0.625,-50,11,51,515,C7
"Bedford city, VA",2004-2005,6198,6186,-12,-0.194,-49,37,51,515,C7
"Bedford city, VA",2005-2006,6186,6147,-39,-0.63,-25,-14,51,515,C7
"Bedford city, VA",2006-2007,6147,6169,22,0.358,-33,55,51,515,C7
"Bedford city, VA",2007-2008,6169,6150,-19,-0.308,-18,-1,51,515,C7
"Bedford city, VA",2008-2009,6150,6174,24,0.39,-40,64,51,515,C7
"Bedford city, VA",2009-2010,6174,0,-6174,-100,-48,-6126,51,515,C7
"Bristol city, VA",2000-2001,17289,17330,41,0.237,-54,95,51,520,C7
"Bristol city, VA",2001-2002,17330,17087,-243,-1.402,-71,-172,51,520,C7
"Bristol city, VA",2002-2003,17087,17465,378,2.212,-97,475,51,520,C7
"Bristol city, VA",2003-2004,17465,17536,71,0.407,-81,152,51,520,C7
"Bristol city, VA",2004-2005,17536,17493,-43,-0.245,-84,41,51,520,C7
"Bristol city, VA",2005-2006,17493,17684,191,1.092,-42,233,51,520,C7
"Bristol city, VA",2006-2007,17684,17540,-144,-0.814,-16,-128,51,520,C7
"Bristol city, VA",2007-2008,17540,17631,91,0.519,5,86,51,520,C7
"Bristol city, VA",2008-2009,17631,17842,211,1.197,-53,264,51,520,C7
"Bristol city, VA",2009-2010,17842,17855,13,0.073,-71,84,51,520,C7
"Bristol city, VA",2010-2011,17855,17776,-79,-0.442,-125,46,51,520,C7
"Bristol city, VA",2011-2012,17776,17724,-52,-0.293,-86,34,51,520,C7
"Bristol city, VA",2012-2013,17724,17436,-288,-1.625,-63,-225,51,520,C7
"Bristol city, VA",2013-2014,17436,17184,-252,-1.445,-148,-104,51,520,C7
"Bristol city, VA",2014-2015,17339,17141,-198,-1.142,-175,-23,51,520,C7
"Bristol city, VA",2015-2016,17141,16927,-214,-1.248,-122,-92,51,520,C7
"Bristol city, VA",2016-2017,16927,16790,-137,-0.809,-79,-58,51,520,C7
"Buena Vista city, VA",2000-2001,6381,6423,42,0.658,18,24,51,530,C7
"Buena Vista city, VA",2001-2002,6423,6412,-11,-0.171,-2,-9,51,530,C7
"Buena Vista city, VA",2002-2003,6412,6555,143,2.23,-19,162,51,530,C7
"Buena Vista city, VA",2003-2004,6555,6588,33,0.503,-44,77,51,530,C7
"Buena Vista city, VA",2004-2005,6588,6634,46,0.698,-20,66,51,530,C7
"Buena Vista city, VA",2005-2006,6634,6679,45,0.678,-38,83,51,530,C7
"Buena Vista city, VA",2006-2007,6679,6618,-61,-0.913,-29,-32,51,530,C7
"Buena Vista city, VA",2007-2008,6618,6664,46,0.695,-20,66,51,530,C7
"Buena Vista city, VA",2008-2009,6664,6677,13,0.195,-24,37,51,530,C7
"Buena Vista city, VA",2009-2010,6677,6646,-31,-0.464,-24,-7,51,530,C7
"Buena Vista city, VA",2010-2011,6646,6721,75,1.128,10,65,51,530,C7
"Buena Vista city, VA",2011-2012,6721,6768,47,0.699,10,37,51,530,C7
"Buena Vista city, VA",2012-2013,6768,6675,-93,-1.374,14,-107,51,530,C7
"Buena Vista city, VA",2013-2014,6675,6603,-72,-1.079,14,-86,51,530,C7
"Buena Vista city, VA",2014-2015,6583,6618,35,0.532,14,21,51,530,C7
"Buena Vista city, VA",2015-2016,6618,6384,-234,-3.536,-70,-164,51,530,C7
"Buena Vista city, VA",2016-2017,6384,6327,-57,-0.893,-75,18,51,530,C7
"Charlottesville city, VA",2000-2001,41351,41436,85,0.206,201,-116,51,540,C7
"Charlottesville city, VA",2001-2002,41436,41449,13,0.031,165,-152,51,540,C7
"Charlottesville city, VA",2002-2003,41449,40695,-754,-1.819,162,-916,51,540,C7
"Charlottesville city, VA",2003-2004,40695,40281,-414,-1.017,209,-623,51,540,C7
"Charlottesville city, VA",2004-2005,40281,40597,316,0.784,163,153,51,540,C7
"Charlottesville city, VA",2005-2006,40597,41066,469,1.155,275,194,51,540,C7
"Charlottesville city, VA",2006-2007,41066,41538,472,1.149,238,234,51,540,C7
"Charlottesville city, VA",2007-2008,41538,42130,592,1.425,294,298,51,540,C7
"Charlottesville city, VA",2008-2009,42130,43054,924,2.193,235,689,51,540,C7
"Charlottesville city, VA",2009-2010,43054,43546,492,1.143,204,288,51,540,C7
"Charlottesville city, VA",2010-2011,43546,43770,224,0.514,251,-27,51,540,C7
"Charlottesville city, VA",2011-2012,43770,44521,751,1.716,303,448,51,540,C7
"Charlottesville city, VA",2012-2013,44521,45093,572,1.285,340,232,51,540,C7
"Charlottesville city, VA",2013-2014,45093,45593,500,1.109,313,187,51,540,C7
"Charlottesville city, VA",2014-2015,45622,46597,975,2.137,353,622,51,540,C7
"Charlottesville city, VA",2015-2016,46597,47286,689,1.479,328,361,51,540,C7
"Charlottesville city, VA",2016-2017,47286,48019,733,1.55,300,433,51,540,C7
"Chesapeake city, VA",2000-2001,200224,202325,2101,1.049,1457,644,51,550,C7
"Chesapeake city, VA",2001-2002,202325,203970,1645,0.813,1283,362,51,550,C7
"Chesapeake city, VA",2002-2003,203970,206909,2939,1.441,1403,1536,51,550,C7
"Chesapeake city, VA",2003-2004,206909,211927,5018,2.425,1530,3488,51,550,C7
"Chesapeake city, VA",2004-2005,211927,215128,3201,1.51,1492,1709,51,550,C7
"Chesapeake city, VA",2005-2006,215128,217271,2143,0.996,1444,699,51,550,C7
"Chesapeake city, VA",2006-2007,217271,217450,179,0.082,1460,-1281,51,550,C7
"Chesapeake city, VA",2007-2008,217450,218458,1008,0.464,1452,-444,51,550,C7
"Chesapeake city, VA",2008-2009,218458,220176,1718,0.786,1464,254,51,550,C7
"Chesapeake city, VA",2009-2010,220176,223517,3341,1.517,1309,2032,51,550,C7
"Chesapeake city, VA",2010-2011,223517,225333,1816,0.812,1200,616,51,550,C7
"Chesapeake city, VA",2011-2012,225333,228188,2855,1.267,1219,1636,51,550,C7
"Chesapeake city, VA",2012-2013,228188,230431,2243,0.983,1165,1078,51,550,C7
"Chesapeake city, VA",2013-2014,230431,233371,2940,1.276,1172,1768,51,550,C7
"Chesapeake city, VA",2014-2015,233479,235429,1950,0.835,1158,792,51,550,C7
"Chesapeake city, VA",2015-2016,235429,237621,2192,0.931,1211,981,51,550,C7
"Chesapeake city, VA",2016-2017,237621,240397,2776,1.168,1143,1633,51,550,C7
"Colonial Heights city, VA",2000-2001,16905,17002,97,0.574,-4,101,51,570,C7
"Colonial Heights city, VA",2001-2002,17002,17026,24,0.141,3,21,51,570,C7
"Colonial Heights city, VA",2002-2003,17026,17056,30,0.176,-18,48,51,570,C7
"Colonial Heights city, VA",2003-2004,17056,17296,240,1.407,3,237,51,570,C7
"Colonial Heights city, VA",2004-2005,17296,17348,52,0.301,-7,59,51,570,C7
"Colonial Heights city, VA",2005-2006,17348,17604,256,1.476,28,228,51,570,C7
"Colonial Heights city, VA",2006-2007,17604,17462,-142,-0.807,23,-165,51,570,C7
"Colonial Heights city, VA",2007-2008,17462,17387,-75,-0.43,11,-86,51,570,C7
"Colonial Heights city, VA",2008-2009,17387,17525,138,0.794,15,123,51,570,C7
"Colonial Heights city, VA",2009-2010,17525,17390,-135,-0.77,46,-181,51,570,C7
"Colonial Heights city, VA",2010-2011,17390,17369,-21,-0.121,26,-47,51,570,C7
"Colonial Heights city, VA",2011-2012,17369,17510,141,0.812,29,112,51,570,C7
"Colonial Heights city, VA",2012-2013,17510,17708,198,1.131,109,89,51,570,C7
"Colonial Heights city, VA",2013-2014,17708,17731,23,0.13,85,-62,51,570,C7
"Colonial Heights city, VA",2014-2015,17575,17820,245,1.394,131,114,51,570,C7
"Colonial Heights city, VA",2015-2016,17820,17642,-178,-0.999,91,-269,51,570,C7
"Colonial Heights city, VA",2016-2017,17642,17830,188,1.066,110,78,51,570,C7
"Covington city, VA",2000-2001,6281,6319,38,0.605,-23,61,51,580,C7
"Covington city, VA",2001-2002,6319,6283,-36,-0.57,-15,-21,51,580,C7
"Covington city, VA",2002-2003,6283,6230,-53,-0.844,-27,-26,51,580,C7
"Covington city, VA",2003-2004,6230,6192,-38,-0.61,-5,-33,51,580,C7
"Covington city, VA",2004-2005,6192,6073,-119,-1.922,-72,-47,51,580,C7
"Covington city, VA",2005-2006,6073,5979,-94,-1.548,-40,-54,51,580,C7
"Covington city, VA",2006-2007,5979,6057,78,1.305,-40,118,51,580,C7
"Covington city, VA",2007-2008,6057,5991,-66,-1.09,-25,-41,51,580,C7
"Covington city, VA",2008-2009,5991,5948,-43,-0.718,-27,-16,51,580,C7
"Covington city, VA",2009-2010,5948,5955,7,0.118,-29,36,51,580,C7
"Covington city, VA",2010-2011,5955,5855,-100,-1.679,18,-118,51,580,C7
"Covington city, VA",2011-2012,5855,5821,-34,-0.581,50,-84,51,580,C7
"Covington city, VA",2012-2013,5821,5833,12,0.206,15,-3,51,580,C7
"Covington city, VA",2013-2014,5833,5802,-31,-0.531,29,-60,51,580,C7
"Covington city, VA",2014-2015,5696,5658,-38,-0.667,22,-60,51,580,C7
"Covington city, VA",2015-2016,5658,5582,-76,-1.343,-62,-14,51,580,C7
"Covington city, VA",2016-2017,5582,5531,-51,-0.914,-54,3,51,580,C7
"Danville city, VA",2000-2001,48104,47415,-689,-1.432,-180,-509,51,590,C7
"Danville city, VA",2001-2002,47415,46929,-486,-1.025,-213,-273,51,590,C7
"Danville city, VA",2002-2003,46929,46515,-414,-0.882,-155,-259,51,590,C7
"Danville city, VA",2003-2004,46515,45788,-727,-1.563,-116,-611,51,590,C7
"Danville city, VA",2004-2005,45788,45086,-702,-1.533,-102,-600,51,590,C7
"Danville city, VA",2005-2006,45086,44586,-500,-1.109,-187,-313,51,590,C7
"Danville city, VA",2006-2007,44586,44162,-424,-0.951,-56,-368,51,590,C7
"Danville city, VA",2007-2008,44162,43765,-397,-0.899,-146,-251,51,590,C7
"Danville city, VA",2008-2009,43765,43496,-269,-0.615,-141,-128,51,590,C7
"Danville city, VA",2009-2010,43496,42933,-563,-1.294,-126,-437,51,590,C7
"Danville city, VA",2010-2011,42933,42586,-347,-0.808,-109,-238,51,590,C7
"Danville city, VA",2011-2012,42586,42786,200,0.47,-106,306,51,590,C7
"Danville city, VA",2012-2013,42786,42770,-16,-0.037,-114,98,51,590,C7
"Danville city, VA",2013-2014,42770,42444,-326,-0.762,-96,-230,51,590,C7
"Danville city, VA",2014-2015,42280,42082,-198,-0.468,-92,-106,51,590,C7
"Danville city, VA",2015-2016,42082,41643,-439,-1.043,-164,-275,51,590,C7
"Danville city, VA",2016-2017,41643,41130,-513,-1.232,-128,-385,51,590,C7
"Emporia city, VA",2000-2001,5655,5618,-37,-0.654,-23,-14,51,595,C7
"Emporia city, VA",2001-2002,5618,5736,118,2.1,-26,144,51,595,C7
"Emporia city, VA",2002-2003,5736,5693,-43,-0.75,-34,-9,51,595,C7
"Emporia city, VA",2003-2004,5693,5659,-34,-0.597,-47,13,51,595,C7
"Emporia city, VA",2004-2005,5659,5657,-2,-0.035,-27,25,51,595,C7
"Emporia city, VA",2005-2006,5657,5734,77,1.361,-31,108,51,595,C7
"Emporia city, VA",2006-2007,5734,5755,21,0.366,-37,58,51,595,C7
"Emporia city, VA",2007-2008,5755,5820,65,1.129,-21,86,51,595,C7
"Emporia city, VA",2008-2009,5820,5865,45,0.773,-27,72,51,595,C7
"Emporia city, VA",2009-2010,5865,5922,57,0.972,-27,84,51,595,C7
"Emporia city, VA",2010-2011,5922,5758,-164,-2.769,-61,-103,51,595,C7
"Emporia city, VA",2011-2012,5758,5704,-54,-0.938,-57,3,51,595,C7
"Emporia city, VA",2012-2013,5704,5565,-139,-2.437,-39,-100,51,595,C7
"Emporia city, VA",2013-2014,5565,5462,-103,-1.851,-45,-58,51,595,C7
"Emporia city, VA",2014-2015,5592,5496,-96,-1.717,-26,-70,51,595,C7
"Emporia city, VA",2015-2016,5496,5375,-121,-2.202,-37,-84,51,595,C7
"Emporia city, VA",2016-2017,5375,5282,-93,-1.73,-76,-17,51,595,C7
"Fairfax city, VA",2000-2001,21600,21668,68,0.315,128,-60,51,600,C7
"Fairfax city, VA",2001-2002,21668,21603,-65,-0.3,31,-96,51,600,C7
"Fairfax city, VA",2002-2003,21603,21518,-85,-0.393,166,-251,51,600,C7
"Fairfax city, VA",2003-2004,21518,21160,-358,-1.664,52,-410,51,600,C7
"Fairfax city, VA",2004-2005,21160,20860,-300,-1.418,-28,-272,51,600,C7
"Fairfax city, VA",2005-2006,20860,21407,547,2.622,188,359,51,600,C7
"Fairfax city, VA",2006-2007,21407,21682,275,1.285,195,80,51,600,C7
"Fairfax city, VA",2007-2008,21682,22112,430,1.983,252,178,51,600,C7
"Fairfax city, VA",2008-2009,22112,22418,306,1.384,177,129,51,600,C7
"Fairfax city, VA",2009-2010,22418,22604,186,0.83,126,60,51,600,C7
"Fairfax city, VA",2010-2011,22604,22792,188,0.832,131,57,51,600,C7
"Fairfax city, VA",2011-2012,22792,23461,669,2.935,402,267,51,600,C7
"Fairfax city, VA",2012-2013,23461,24194,733,3.124,462,271,51,600,C7
"Fairfax city, VA",2013-2014,24194,24483,289,1.195,383,-94,51,600,C7
"Fairfax city, VA",2014-2015,23694,24013,319,1.346,394,-75,51,600,C7
"Fairfax city, VA",2015-2016,24013,23827,-186,-0.775,463,-649,51,600,C7
"Fairfax city, VA",2016-2017,23827,24097,270,1.133,408,-138,51,600,C7
"Falls Church city, VA",2000-2001,10441,10550,109,1.044,18,91,51,610,C7
"Falls Church city, VA",2001-2002,10550,10600,50,0.474,115,-65,51,610,C7
"Falls Church city, VA",2002-2003,10600,10596,-4,-0.038,138,-142,51,610,C7
"Falls Church city, VA",2003-2004,10596,10589,-7,-0.066,18,-25,51,610,C7
"Falls Church city, VA",2004-2005,10589,10840,251,2.37,21,230,51,610,C7
"Falls Church city, VA",2005-2006,10840,10852,12,0.111,53,-41,51,610,C7
"Falls Church city, VA",2006-2007,10852,10947,95,0.875,45,50,51,610,C7
"Falls Church city, VA",2007-2008,10947,11219,272,2.485,84,188,51,610,C7
"Falls Church city, VA",2008-2009,11219,11787,568,5.063,68,500,51,610,C7
"Falls Church city, VA",2009-2010,11787,12446,659,5.591,86,573,51,610,C7
"Falls Church city, VA",2010-2011,12446,12720,274,2.202,69,205,51,610,C7
"Falls Church city, VA",2011-2012,12720,13136,416,3.27,98,318,51,610,C7
"Falls Church city, VA",2012-2013,13136,13469,333,2.535,129,204,51,610,C7
"Falls Church city, VA",2013-2014,13469,13601,132,0.98,132,0,51,610,C7
"Falls Church city, VA",2014-2015,13481,13892,411,3.049,146,265,51,610,C7
"Falls Church city, VA",2015-2016,13892,13868,-24,-0.173,162,-186,51,610,C7
"Falls Church city, VA",2016-2017,13868,14583,715,5.156,138,577,51,610,C7
"Franklin city, VA",2000-2001,8269,8160,-109,-1.318,-24,-85,51,620,C7
"Franklin city, VA",2001-2002,8160,8044,-116,-1.422,-5,-111,51,620,C7
"Franklin city, VA",2002-2003,8044,8113,69,0.858,-1,70,51,620,C7
"Franklin city, VA",2003-2004,8113,8177,64,0.789,23,41,51,620,C7
"Franklin city, VA",2004-2005,8177,8278,101,1.235,41,60,51,620,C7
"Franklin city, VA",2005-2006,8278,8489,211,2.549,17,194,51,620,C7
"Franklin city, VA",2006-2007,8489,8611,122,1.437,17,105,51,620,C7
"Franklin city, VA",2007-2008,8611,8538,-73,-0.848,41,-114,51,620,C7
"Franklin city, VA",2008-2009,8538,8489,-49,-0.574,22,-71,51,620,C7
"Franklin city, VA",2009-2010,8489,8585,96,1.131,23,73,51,620,C7
"Franklin city, VA",2010-2011,8585,8431,-154,-1.794,3,-157,51,620,C7
"Franklin city, VA",2011-2012,8431,8494,63,0.747,49,14,51,620,C7
"Franklin city, VA",2012-2013,8494,8632,138,1.625,50,88,51,620,C7
"Franklin city, VA",2013-2014,8632,8526,-106,-1.228,63,-169,51,620,C7
"Franklin city, VA",2014-2015,8423,8490,67,0.795,75,-8,51,620,C7
"Franklin city, VA",2015-2016,8490,8228,-262,-3.086,-21,-241,51,620,C7
"Franklin city, VA",2016-2017,8228,8176,-52,-0.632,-26,-26,51,620,C7
"Fredericksburg city, VA",2000-2001,19461,20061,600,3.083,135,465,51,630,C7
"Fredericksburg city, VA",2001-2002,20061,20501,440,2.193,142,298,51,630,C7
"Fredericksburg city, VA",2002-2003,20501,20659,158,0.771,167,-9,51,630,C7
"Fredericksburg city, VA",2003-2004,20659,21567,908,4.395,182,726,51,630,C7
"Fredericksburg city, VA",2004-2005,21567,21660,93,0.431,192,-99,51,630,C7
"Fredericksburg city, VA",2005-2006,21660,22479,819,3.781,178,641,51,630,C7
"Fredericksburg city, VA",2006-2007,22479,22898,419,1.864,251,168,51,630,C7
"Fredericksburg city, VA",2007-2008,22898,23277,379,1.655,233,146,51,630,C7
"Fredericksburg city, VA",2008-2009,23277,23775,498,2.139,185,313,51,630,C7
"Fredericksburg city, VA",2009-2010,23775,24192,417,1.754,167,250,51,630,C7
"Fredericksburg city, VA",2010-2011,24192,25641,1449,5.99,225,1224,51,630,C7
"Fredericksburg city, VA",2011-2012,25641,27113,1472,5.741,265,1207,51,630,C7
"Fredericksburg city, VA",2012-2013,27113,27862,749,2.763,243,506,51,630,C7
"Fredericksburg city, VA",2013-2014,27862,28350,488,1.751,234,254,51,630,C7
"Fredericksburg city, VA",2014-2015,28305,28118,-187,-0.661,208,-395,51,630,C7
"Fredericksburg city, VA",2015-2016,28118,28271,153,0.544,189,-36,51,630,C7
"Fredericksburg city, VA",2016-2017,28271,28360,89,0.315,163,-74,51,630,C7
"Galax city, VA",2000-2001,6921,6775,-146,-2.11,0,-146,51,640,C7
"Galax city, VA",2001-2002,6775,6738,-37,-0.546,16,-53,51,640,C7
"Galax city, VA",2002-2003,6738,6744,6,0.089,-8,14,51,640,C7
"Galax city, VA",2003-2004,6744,6790,46,0.682,-2,48,51,640,C7
"Galax city, VA",2004-2005,6790,6821,31,0.457,-18,49,51,640,C7
"Galax city, VA",2005-2006,6821,6879,58,0.85,-10,68,51,640,C7
"Galax city, VA",2006-2007,6879,6880,1,0.015,-35,36,51,640,C7
"Galax city, VA",2007-2008,6880,6888,8,0.116,-3,11,51,640,C7
"Galax city, VA",2008-2009,6888,6966,78,1.132,-10,88,51,640,C7
"Galax city, VA",2009-2010,6966,7077,111,1.593,17,94,51,640,C7
"Galax city, VA",2010-2011,7077,6877,-200,-2.826,16,-216,51,640,C7
"Galax city, VA",2011-2012,6877,6921,44,0.64,6,38,51,640,C7
"Galax city, VA",2012-2013,6921,7014,93,1.344,21,72,51,640,C7
"Galax city, VA",2013-2014,7014,7014,0,0,36,-36,51,640,C7
"Galax city, VA",2014-2015,6912,6914,2,0.029,10,-8,51,640,C7
"Galax city, VA",2015-2016,6914,6664,-250,-3.616,-64,-186,51,640,C7
"Galax city, VA",2016-2017,6664,6625,-39,-0.585,-39,0,51,640,C7
"Hampton city, VA",2000-2001,146054,143432,-2622,-1.795,866,-3488,51,650,C7
"Hampton city, VA",2001-2002,143432,141844,-1588,-1.107,753,-2341,51,650,C7
"Hampton city, VA",2002-2003,141844,140413,-1431,-1.009,706,-2137,51,650,C7
"Hampton city, VA",2003-2004,140413,140200,-213,-0.152,765,-978,51,650,C7
"Hampton city, VA",2004-2005,140200,141314,1114,0.795,883,231,51,650,C7
"Hampton city, VA",2005-2006,141314,140839,-475,-0.336,1059,-1534,51,650,C7
"Hampton city, VA",2006-2007,140839,140222,-617,-0.438,1033,-1650,51,650,C7
"Hampton city, VA",2007-2008,140222,138957,-1265,-0.902,917,-2182,51,650,C7
"Hampton city, VA",2008-2009,138957,137833,-1124,-0.809,831,-1955,51,650,C7
"Hampton city, VA",2009-2010,137833,137416,-417,-0.303,895,-1312,51,650,C7
"Hampton city, VA",2010-2011,137416,136435,-981,-0.714,556,-1537,51,650,C7
"Hampton city, VA",2011-2012,136435,136843,408,0.299,660,-252,51,650,C7
"Hampton city, VA",2012-2013,136843,136948,105,0.077,671,-566,51,650,C7
"Hampton city, VA",2013-2014,136948,136879,-69,-0.05,625,-694,51,650,C7
"Hampton city, VA",2014-2015,137813,136454,-1359,-0.986,620,-1979,51,650,C7
"Hampton city, VA",2015-2016,136454,135332,-1122,-0.822,356,-1478,51,650,C7
"Hampton city, VA",2016-2017,135332,134669,-663,-0.49,337,-1.00E+03,51,650,C7
"Harrisonburg city, VA",2000-2001,40437,41646,1209,2.99,171,1038,51,660,C7
"Harrisonburg city, VA",2001-2002,41646,42837,1191,2.86,277,914,51,660,C7
"Harrisonburg city, VA",2002-2003,42837,43176,339,0.791,294,45,51,660,C7
"Harrisonburg city, VA",2003-2004,43176,43753,577,1.336,297,280,51,660,C7
"Harrisonburg city, VA",2004-2005,43753,44572,819,1.872,247,572,51,660,C7
"Harrisonburg city, VA",2005-2006,44572,45858,1286,2.885,264,1022,51,660,C7
"Harrisonburg city, VA",2006-2007,45858,46551,693,1.511,291,402,51,660,C7
"Harrisonburg city, VA",2007-2008,46551,47286,735,1.579,247,488,51,660,C7
"Harrisonburg city, VA",2008-2009,47286,48294,1008,2.132,308,700,51,660,C7
"Harrisonburg city, VA",2009-2010,48294,49072,778,1.611,334,444,51,660,C7
"Harrisonburg city, VA",2010-2011,49072,49811,739,1.506,289,450,51,660,C7
"Harrisonburg city, VA",2011-2012,49811,51224,1413,2.837,256,1157,51,660,C7
"Harrisonburg city, VA",2012-2013,51224,51518,294,0.574,395,-101,51,660,C7
"Harrisonburg city, VA",2013-2014,51518,52478,960,1.863,381,579,51,660,C7
"Harrisonburg city, VA",2014-2015,52258,52538,280,0.536,378,-98,51,660,C7
"Harrisonburg city, VA",2015-2016,52538,53943,1405,2.674,438,967,51,660,C7
"Harrisonburg city, VA",2016-2017,53943,54215,272,0.504,453,-181,51,660,C7
"Hopewell city, VA",2000-2001,22277,22147,-130,-0.584,78,-208,51,670,C7
"Hopewell city, VA",2001-2002,22147,22291,144,0.65,74,70,51,670,C7
"Hopewell city, VA",2002-2003,22291,22046,-245,-1.099,54,-299,51,670,C7
"Hopewell city, VA",2003-2004,22046,21998,-48,-0.218,79,-127,51,670,C7
"Hopewell city, VA",2004-2005,21998,22131,133,0.605,59,74,51,670,C7
"Hopewell city, VA",2005-2006,22131,22295,164,0.741,98,66,51,670,C7
"Hopewell city, VA",2006-2007,22295,22549,254,1.139,144,110,51,670,C7
"Hopewell city, VA",2007-2008,22549,22576,27,0.12,146,-119,51,670,C7
"Hopewell city, VA",2008-2009,22576,22455,-121,-0.536,103,-224,51,670,C7
"Hopewell city, VA",2009-2010,22455,22641,186,0.828,106,80,51,670,C7
"Hopewell city, VA",2010-2011,22641,22506,-135,-0.596,68,-203,51,670,C7
"Hopewell city, VA",2011-2012,22506,22322,-184,-0.818,82,-266,51,670,C7
"Hopewell city, VA",2012-2013,22322,22209,-113,-0.506,129,-242,51,670,C7
"Hopewell city, VA",2013-2014,22209,22196,-13,-0.059,74,-87,51,670,C7
"Hopewell city, VA",2014-2015,22137,22378,241,1.089,108,133,51,670,C7
"Hopewell city, VA",2015-2016,22378,22619,241,1.077,90,151,51,670,C7
"Hopewell city, VA",2016-2017,22619,22621,2,0.009,92,-90,51,670,C7
"Lexington city, VA",2000-2001,6825,6858,33,0.484,1,32,51,678,C7
"Lexington city, VA",2001-2002,6858,6842,-16,-0.233,-48,32,51,678,C7
"Lexington city, VA",2002-2003,6842,6750,-92,-1.345,-19,-73,51,678,C7
"Lexington city, VA",2003-2004,6750,6810,60,0.889,-28,88,51,678,C7
"Lexington city, VA",2004-2005,6810,6903,93,1.366,-26,119,51,678,C7
"Lexington city, VA",2005-2006,6903,6978,75,1.086,-46,121,51,678,C7
"Lexington city, VA",2006-2007,6978,6956,-22,-0.315,-7,-15,51,678,C7
"Lexington city, VA",2007-2008,6956,6963,7,0.101,-11,18,51,678,C7
"Lexington city, VA",2008-2009,6963,7006,43,0.618,-26,69,51,678,C7
"Lexington city, VA",2009-2010,7006,7062,56,0.799,-31,87,51,678,C7
"Lexington city, VA",2010-2011,7062,6934,-128,-1.813,1,-129,51,678,C7
"Lexington city, VA",2011-2012,6934,7032,98,1.413,22,76,51,678,C7
"Lexington city, VA",2012-2013,7032,7232,200,2.844,19,181,51,678,C7
"Lexington city, VA",2013-2014,7232,7311,79,1.092,45,34,51,678,C7
"Lexington city, VA",2014-2015,7149,7262,113,1.581,47,66,51,678,C7
"Lexington city, VA",2015-2016,7262,7087,-175,-2.41,-62,-113,51,678,C7
"Lexington city, VA",2016-2017,7087,7106,19,0.268,-41,60,51,678,C7
"Lynchburg city, VA",2000-2001,65330,65003,-327,-0.501,-25,-302,51,680,C7
"Lynchburg city, VA",2001-2002,65003,65263,260,0.4,62,198,51,680,C7
"Lynchburg city, VA",2002-2003,65263,66496,1233,1.889,95,1138,51,680,C7
"Lynchburg city, VA",2003-2004,66496,67021,525,0.79,103,422,51,680,C7
"Lynchburg city, VA",2004-2005,67021,68773,1752,2.614,110,1642,51,680,C7
"Lynchburg city, VA",2005-2006,68773,70919,2146,3.12,224,1922,51,680,C7
"Lynchburg city, VA",2006-2007,70919,72869,1950,2.75,276,1674,51,680,C7
"Lynchburg city, VA",2007-2008,72869,74018,1149,1.577,306,843,51,680,C7
"Lynchburg city, VA",2008-2009,74018,75137,1119,1.512,257,862,51,680,C7
"Lynchburg city, VA",2009-2010,75137,75773,636,0.846,264,372,51,680,C7
"Lynchburg city, VA",2010-2011,75773,76813,1040,1.373,270,770,51,680,C7
"Lynchburg city, VA",2011-2012,76813,77788,975,1.269,305,670,51,680,C7
"Lynchburg city, VA",2012-2013,77788,78710,922,1.185,348,574,51,680,C7
"Lynchburg city, VA",2013-2014,78710,79047,337,0.428,384,-47,51,680,C7
"Lynchburg city, VA",2014-2015,78627,79812,1185,1.507,486,699,51,680,C7
"Lynchburg city, VA",2015-2016,79812,79912,100,0.125,498,-398,51,680,C7
"Lynchburg city, VA",2016-2017,79912,80995,1083,1.355,491,592,51,680,C7
"Manassas city, VA",2000-2001,34914,35341,427,1.223,497,-70,51,683,C7
"Manassas city, VA",2001-2002,35341,35878,537,1.519,468,69,51,683,C7
"Manassas city, VA",2002-2003,35878,36253,375,1.045,555,-180,51,683,C7
"Manassas city, VA",2003-2004,36253,36564,311,0.858,431,-120,51,683,C7
"Manassas city, VA",2004-2005,36564,36452,-112,-0.306,447,-559,51,683,C7
"Manassas city, VA",2005-2006,36452,35631,-821,-2.252,581,-1402,51,683,C7
"Manassas city, VA",2006-2007,35631,34969,-662,-1.858,572,-1234,51,683,C7
"Manassas city, VA",2007-2008,34969,34858,-111,-0.317,433,-544,51,683,C7
"Manassas city, VA",2008-2009,34858,36674,1816,5.21,389,1427,51,683,C7
"Manassas city, VA",2009-2010,36674,38276,1602,4.368,399,1203,51,683,C7
"Manassas city, VA",2010-2011,38276,39358,1082,2.827,502,580,51,683,C7
"Manassas city, VA",2011-2012,39358,40742,1384,3.516,565,819,51,683,C7
"Manassas city, VA",2012-2013,40742,41725,983,2.413,587,396,51,683,C7
"Manassas city, VA",2013-2014,41725,42081,356,0.853,608,-252,51,683,C7
"Manassas city, VA",2014-2015,41363,41764,401,0.969,602,-201,51,683,C7
"Manassas city, VA",2015-2016,41764,41457,-307,-0.735,566,-873,51,683,C7
"Manassas city, VA",2016-2017,41457,41501,44,0.106,589,-545,51,683,C7
"Manassas Park city, VA",2000-2001,10305,10777,472,4.58,176,296,51,685,C7
"Manassas Park city, VA",2001-2002,10777,11150,373,3.461,199,174,51,685,C7
"Manassas Park city, VA",2002-2003,11150,11357,207,1.857,191,16,51,685,C7
"Manassas Park city, VA",2003-2004,11357,11982,625,5.503,219,406,51,685,C7
"Manassas Park city, VA",2004-2005,11982,12451,469,3.914,250,219,51,685,C7
"Manassas Park city, VA",2005-2006,12451,12490,39,0.313,274,-235,51,685,C7
"Manassas Park city, VA",2006-2007,12490,12677,187,1.497,250,-63,51,685,C7
"Manassas Park city, VA",2007-2008,12677,12744,67,0.529,182,-115,51,685,C7
"Manassas Park city, VA",2008-2009,12744,13613,869,6.819,201,668,51,685,C7
"Manassas Park city, VA",2009-2010,13613,14409,796,5.847,247,549,51,685,C7
"Manassas Park city, VA",2010-2011,14409,14891,482,3.345,-8,490,51,685,C7
"Manassas Park city, VA",2011-2012,14891,15079,188,1.263,107,81,51,685,C7
"Manassas Park city, VA",2012-2013,15079,15409,330,2.188,119,211,51,685,C7
"Manassas Park city, VA",2013-2014,15409,15174,-235,-1.525,-18,-217,51,685,C7
"Manassas Park city, VA",2014-2015,15805,15726,-79,-0.5,-17,-62,51,685,C7
"Manassas Park city, VA",2015-2016,15726,16085,359,2.283,-22,381,51,685,C7
"Manassas Park city, VA",2016-2017,16085,16591,506,3.146,-32,538,51,685,C7
"Martinsville city, VA",2000-2001,15331,15173,-158,-1.031,-94,-64,51,690,C7
"Martinsville city, VA",2001-2002,15173,14867,-306,-2.017,-60,-246,51,690,C7
"Martinsville city, VA",2002-2003,14867,14796,-71,-0.478,-65,-6,51,690,C7
"Martinsville city, VA",2003-2004,14796,14448,-348,-2.352,-92,-256,51,690,C7
"Martinsville city, VA",2004-2005,14448,14405,-43,-0.298,-59,16,51,690,C7
"Martinsville city, VA",2005-2006,14405,14281,-124,-0.861,-123,-1,51,690,C7
"Martinsville city, VA",2006-2007,14281,14042,-239,-1.674,-83,-156,51,690,C7
"Martinsville city, VA",2007-2008,14042,14040,-2,-0.014,26,-28,51,690,C7
"Martinsville city, VA",2008-2009,14040,14012,-28,-0.199,-85,57,51,690,C7
"Martinsville city, VA",2009-2010,14012,13740,-272,-1.941,-82,-190,51,690,C7
"Martinsville city, VA",2010-2011,13740,13777,37,0.269,30,7,51,690,C7
"Martinsville city, VA",2011-2012,13777,13747,-30,-0.218,-22,-8,51,690,C7
"Martinsville city, VA",2012-2013,13747,13748,1,0.007,-20,21,51,690,C7
"Martinsville city, VA",2013-2014,13748,13711,-37,-0.269,-2,-35,51,690,C7
"Martinsville city, VA",2014-2015,13552,13645,93,0.686,14,79,51,690,C7
"Martinsville city, VA",2015-2016,13645,13119,-526,-3.855,-5,-521,51,690,C7
"Martinsville city, VA",2016-2017,13119,13142,23,0.175,55,-32,51,690,C7
"Newport News city, VA",2000-2001,180236,181873,1637,0.908,1753,-116,51,700,C7
"Newport News city, VA",2001-2002,181873,183061,1188,0.653,1774,-586,51,700,C7
"Newport News city, VA",2002-2003,183061,183404,343,0.187,1766,-1423,51,700,C7
"Newport News city, VA",2003-2004,183404,185204,1800,0.981,1779,21,51,700,C7
"Newport News city, VA",2004-2005,185204,183651,-1553,-0.839,1824,-3377,51,700,C7
"Newport News city, VA",2005-2006,183651,183581,-70,-0.038,1877,-1947,51,700,C7
"Newport News city, VA",2006-2007,183581,182528,-1053,-0.574,1904,-2957,51,700,C7
"Newport News city, VA",2007-2008,182528,181287,-1241,-0.68,1908,-3149,51,700,C7
"Newport News city, VA",2008-2009,181287,1.81E+05,-287,-0.158,1838,-2125,51,700,C7
"Newport News city, VA",2009-2010,1.81E+05,180989,-11,-0.006,1987,-1998,51,700,C7
"Newport News city, VA",2010-2011,180989,180356,-633,-0.35,1554,-2187,51,700,C7
"Newport News city, VA",2011-2012,180356,180487,131,0.073,1580,-1449,51,700,C7
"Newport News city, VA",2012-2013,180487,182015,1528,0.847,1479,49,51,700,C7
"Newport News city, VA",2013-2014,182015,182965,950,0.522,1475,-525,51,700,C7
"Newport News city, VA",2014-2015,182499,182385,-114,-0.062,1439,-1553,51,700,C7
"Newport News city, VA",2015-2016,182385,180388,-1997,-1.095,1262,-3259,51,700,C7
"Newport News city, VA",2016-2017,180388,179388,-1.00E+03,-0.554,1219,-2219,51,700,C7
"Norfolk city, VA",2000-2001,234986,236489,1503,0.64,2018,-515,51,710,C7
"Norfolk city, VA",2001-2002,236489,241704,5215,2.205,2043,3172,51,710,C7
"Norfolk city, VA",2002-2003,241704,239286,-2418,-1,1948,-4366,51,710,C7
"Norfolk city, VA",2003-2004,239286,243836,4550,1.901,2069,2481,51,710,C7
"Norfolk city, VA",2004-2005,243836,239650,-4186,-1.717,2051,-6237,51,710,C7
"Norfolk city, VA",2005-2006,239650,243406,3756,1.567,2153,1603,51,710,C7
"Norfolk city, VA",2006-2007,243406,241248,-2158,-0.887,2024,-4182,51,710,C7
"Norfolk city, VA",2007-2008,241248,241201,-47,-0.019,2186,-2233,51,710,C7
"Norfolk city, VA",2008-2009,241201,241725,524,0.217,2159,-1635,51,710,C7
"Norfolk city, VA",2009-2010,241725,242943,1218,0.504,2156,-938,51,710,C7
"Norfolk city, VA",2010-2011,242943,243723,780,0.321,1863,-1083,51,710,C7
"Norfolk city, VA",2011-2012,243723,246150,2427,0.996,2004,423,51,710,C7
"Norfolk city, VA",2012-2013,246150,245480,-670,-0.272,1747,-2417,51,710,C7
"Norfolk city, VA",2013-2014,245480,245428,-52,-0.021,1734,-1786,51,710,C7
"Norfolk city, VA",2014-2015,246199,246393,194,0.079,1732,-1538,51,710,C7
"Norfolk city, VA",2015-2016,246393,245532,-861,-0.349,1644,-2505,51,710,C7
"Norfolk city, VA",2016-2017,245532,244703,-829,-0.338,1544,-2373,51,710,C7
"Norton city, VA",2000-2001,3916,3896,-20,-0.511,2,-22,51,720,C7
"Norton city, VA",2001-2002,3896,3929,33,0.847,-19,52,51,720,C7
"Norton city, VA",2002-2003,3929,3944,15,0.382,-14,29,51,720,C7
"Norton city, VA",2003-2004,3944,3847,-97,-2.459,-23,-74,51,720,C7
"Norton city, VA",2004-2005,3847,3767,-80,-2.08,-31,-49,51,720,C7
"Norton city, VA",2005-2006,3767,3825,58,1.54,5,53,51,720,C7
"Norton city, VA",2006-2007,3825,3869,44,1.15,12,32,51,720,C7
"Norton city, VA",2007-2008,3869,3861,-8,-0.207,17,-25,51,720,C7
"Norton city, VA",2008-2009,3861,3903,42,1.088,-2,44,51,720,C7
"Norton city, VA",2009-2010,3903,3964,61,1.563,2,59,51,720,C7
"Norton city, VA",2010-2011,3964,4015,51,1.287,25,26,51,720,C7
"Norton city, VA",2011-2012,4015,4049,34,0.847,11,23,51,720,C7
"Norton city, VA",2012-2013,4049,4017,-32,-0.79,30,-62,51,720,C7
"Norton city, VA",2013-2014,4017,4031,14,0.349,26,-12,51,720,C7
"Norton city, VA",2014-2015,4023,3939,-84,-2.088,23,-107,51,720,C7
"Norton city, VA",2015-2016,3939,3988,49,1.244,-10,59,51,720,C7
"Norton city, VA",2016-2017,3988,3936,-52,-1.304,-6,-46,51,720,C7
"Petersburg city, VA",2000-2001,33561,33183,-378,-1.126,36,-414,51,730,C7
"Petersburg city, VA",2001-2002,33183,32803,-380,-1.145,77,-457,51,730,C7
"Petersburg city, VA",2002-2003,32803,32645,-158,-0.482,20,-178,51,730,C7
"Petersburg city, VA",2003-2004,32645,32292,-353,-1.081,89,-442,51,730,C7
"Petersburg city, VA",2004-2005,32292,31930,-362,-1.121,-2,-360,51,730,C7
"Petersburg city, VA",2005-2006,31930,32181,251,0.786,81,170,51,730,C7
"Petersburg city, VA",2006-2007,32181,32318,137,0.426,196,-59,51,730,C7
"Petersburg city, VA",2007-2008,32318,32321,3,0.009,203,-200,51,730,C7
"Petersburg city, VA",2008-2009,32321,32168,-153,-0.473,116,-269,51,730,C7
"Petersburg city, VA",2009-2010,32168,32573,405,1.259,196,209,51,730,C7
"Petersburg city, VA",2010-2011,32573,32159,-414,-1.271,283,-697,51,730,C7
"Petersburg city, VA",2011-2012,32159,32167,8,0.025,269,-261,51,730,C7
"Petersburg city, VA",2012-2013,32167,32593,426,1.324,256,170,51,730,C7
"Petersburg city, VA",2013-2014,32593,32701,108,0.331,241,-133,51,730,C7
"Petersburg city, VA",2014-2015,32245,32477,232,0.719,301,-69,51,730,C7
"Petersburg city, VA",2015-2016,32477,31850,-627,-1.931,240,-867,51,730,C7
"Petersburg city, VA",2016-2017,31850,31750,-100,-0.314,216,-316,51,730,C7
"Poquoson city, VA",2000-2001,11582,11523,-59,-0.509,26,-85,51,735,C7
"Poquoson city, VA",2001-2002,11523,11697,174,1.51,-7,181,51,735,C7
"Poquoson city, VA",2002-2003,11697,11797,100,0.855,0,100,51,735,C7
"Poquoson city, VA",2003-2004,11797,11772,-25,-0.212,3,-28,51,735,C7
"Poquoson city, VA",2004-2005,11772,11879,107,0.909,2,105,51,735,C7
"Poquoson city, VA",2005-2006,11879,12008,129,1.086,-1,130,51,735,C7
"Poquoson city, VA",2006-2007,12008,12089,81,0.675,-24,105,51,735,C7
"Poquoson city, VA",2007-2008,12089,12103,14,0.116,-16,30,51,735,C7
"Poquoson city, VA",2008-2009,12103,12153,50,0.413,-13,63,51,735,C7
"Poquoson city, VA",2009-2010,12153,12154,1,0.008,-22,23,51,735,C7
"Poquoson city, VA",2010-2011,12154,12055,-99,-0.815,-15,-84,51,735,C7
"Poquoson city, VA",2011-2012,12055,12134,79,0.655,-15,94,51,735,C7
"Poquoson city, VA",2012-2013,12134,12125,-9,-0.074,-12,3,51,735,C7
"Poquoson city, VA",2013-2014,12125,12048,-77,-0.635,6,-83,51,735,C7
"Poquoson city, VA",2014-2015,12034,12059,25,0.208,-1,26,51,735,C7
"Poquoson city, VA",2015-2016,12059,11947,-112,-0.929,-7,-105,51,735,C7
"Poquoson city, VA",2016-2017,11947,12053,106,0.887,-8,114,51,735,C7
"Portsmouth city, VA",2000-2001,100337,99166,-1171,-1.167,473,-1644,51,740,C7
"Portsmouth city, VA",2001-2002,99166,98297,-869,-0.876,454,-1323,51,740,C7
"Portsmouth city, VA",2002-2003,98297,97184,-1113,-1.132,495,-1608,51,740,C7
"Portsmouth city, VA",2003-2004,97184,97428,244,0.251,525,-281,51,740,C7
"Portsmouth city, VA",2004-2005,97428,98069,641,0.658,548,93,51,740,C7
"Portsmouth city, VA",2005-2006,98069,99213,1144,1.167,642,502,51,740,C7
"Portsmouth city, VA",2006-2007,99213,97831,-1382,-1.393,749,-2131,51,740,C7
"Portsmouth city, VA",2007-2008,97831,95802,-2029,-2.074,537,-2566,51,740,C7
"Portsmouth city, VA",2008-2009,95802,95384,-418,-0.436,582,-1.00E+03,51,740,C7
"Portsmouth city, VA",2009-2010,95384,95495,111,0.116,716,-605,51,740,C7
"Portsmouth city, VA",2010-2011,95495,95816,321,0.336,578,-257,51,740,C7
"Portsmouth city, VA",2011-2012,95816,96546,730,0.762,538,192,51,740,C7
"Portsmouth city, VA",2012-2013,96546,96174,-372,-0.385,508,-880,51,740,C7
"Portsmouth city, VA",2013-2014,96174,96004,-170,-0.177,495,-665,51,740,C7
"Portsmouth city, VA",2014-2015,95955,96201,246,0.256,512,-266,51,740,C7
"Portsmouth city, VA",2015-2016,96201,94997,-1204,-1.252,418,-1622,51,740,C7
"Portsmouth city, VA",2016-2017,94997,94572,-425,-0.447,439,-864,51,740,C7
"Radford city, VA",2000-2001,15872,16193,321,2.022,11,310,51,750,C7
"Radford city, VA",2001-2002,16193,15963,-230,-1.42,35,-265,51,750,C7
"Radford city, VA",2002-2003,15963,15691,-272,-1.704,19,-291,51,750,C7
"Radford city, VA",2003-2004,15691,15743,52,0.331,20,32,51,750,C7
"Radford city, VA",2004-2005,15743,15995,252,1.601,12,240,51,750,C7
"Radford city, VA",2005-2006,15995,16163,168,1.05,1,167,51,750,C7
"Radford city, VA",2006-2007,16163,16341,178,1.101,42,136,51,750,C7
"Radford city, VA",2007-2008,16341,16304,-37,-0.226,18,-55,51,750,C7
"Radford city, VA",2008-2009,16304,16361,57,0.35,18,39,51,750,C7
"Radford city, VA",2009-2010,16361,16452,91,0.556,10,81,51,750,C7
"Radford city, VA",2010-2011,16452,16824,372,2.261,54,318,51,750,C7
"Radford city, VA",2011-2012,16824,16766,-58,-0.345,33,-91,51,750,C7
"Radford city, VA",2012-2013,16766,17277,511,3.048,57,454,51,750,C7
"Radford city, VA",2013-2014,17277,17646,369,2.136,82,287,51,750,C7
"Radford city, VA",2014-2015,17390,17403,13,0.075,97,-84,51,750,C7
"Radford city, VA",2015-2016,17403,17410,7,0.04,37,-30,51,750,C7
"Radford city, VA",2016-2017,17410,17658,248,1.424,65,183,51,750,C7
"Richmond city, VA",2000-2001,196782,197575,793,0.403,703,90,51,760,C7
"Richmond city, VA",2001-2002,197575,197513,-62,-0.031,822,-884,51,760,C7
"Richmond city, VA",2002-2003,197513,197306,-207,-0.105,799,-1006,51,760,C7
"Richmond city, VA",2003-2004,197306,196878,-428,-0.217,699,-1127,51,760,C7
"Richmond city, VA",2004-2005,196878,197465,587,0.298,867,-280,51,760,C7
"Richmond city, VA",2005-2006,197465,198618,1153,0.584,1068,85,51,760,C7
"Richmond city, VA",2006-2007,198618,200201,1583,0.797,1086,497,51,760,C7
"Richmond city, VA",2007-2008,200201,202254,2053,1.025,1307,746,51,760,C7
"Richmond city, VA",2008-2009,202254,203678,1424,0.704,1044,380,51,760,C7
"Richmond city, VA",2009-2010,203678,204256,578,0.284,929,-351,51,760,C7
"Richmond city, VA",2010-2011,204256,206977,2721,1.332,1044,1677,51,760,C7
"Richmond city, VA",2011-2012,206977,211526,4549,2.198,1197,3352,51,760,C7
"Richmond city, VA",2012-2013,211526,214704,3178,1.502,966,2212,51,760,C7
"Richmond city, VA",2013-2014,214704,217853,3149,1.467,986,2163,51,760,C7
"Richmond city, VA",2014-2015,216910,220289,3379,1.558,907,2472,51,760,C7
"Richmond city, VA",2015-2016,220289,225288,4999,2.269,1223,3776,51,760,C7
"Richmond city, VA",2016-2017,225288,227032,1744,0.774,1091,653,51,760,C7
"Roanoke city, VA",2000-2001,94941,94931,-10,-0.011,139,-149,51,770,C7
"Roanoke city, VA",2001-2002,94931,93956,-975,-1.027,-267,-708,51,770,C7
"Roanoke city, VA",2002-2003,93956,93716,-240,-0.255,64,-304,51,770,C7
"Roanoke city, VA",2003-2004,93716,93614,-102,-0.109,-87,-15,51,770,C7
"Roanoke city, VA",2004-2005,93614,93932,318,0.34,-168,486,51,770,C7
"Roanoke city, VA",2005-2006,93932,94247,315,0.335,117,198,51,770,C7
"Roanoke city, VA",2006-2007,94247,94916,669,0.71,364,305,51,770,C7
"Roanoke city, VA",2007-2008,94916,95813,897,0.945,281,616,51,770,C7
"Roanoke city, VA",2008-2009,95813,97023,1210,1.263,70,1140,51,770,C7
"Roanoke city, VA",2009-2010,97023,96812,-211,-0.217,184,-395,51,770,C7
"Roanoke city, VA",2010-2011,96812,96810,-2,-0.002,230,-232,51,770,C7
"Roanoke city, VA",2011-2012,96810,97879,1069,1.104,364,705,51,770,C7
"Roanoke city, VA",2012-2013,97879,98815,936,0.956,316,620,51,770,C7
"Roanoke city, VA",2013-2014,98815,99428,613,0.62,347,266,51,770,C7
"Roanoke city, VA",2014-2015,99774,99897,123,0.123,365,-242,51,770,C7
"Roanoke city, VA",2015-2016,99897,99743,-154,-0.154,472,-626,51,770,C7
"Roanoke city, VA",2016-2017,99743,99837,94,0.094,428,-334,51,770,C7
"Salem city, VA",2000-2001,24747,24487,-260,-1.051,-147,-113,51,775,C7
"Salem city, VA",2001-2002,24487,24554,67,0.274,-52,119,51,775,C7
"Salem city, VA",2002-2003,24554,24465,-89,-0.362,-48,-41,51,775,C7
"Salem city, VA",2003-2004,24465,24096,-369,-1.508,-81,-288,51,775,C7
"Salem city, VA",2004-2005,24096,24310,214,0.888,-34,248,51,775,C7
"Salem city, VA",2005-2006,24310,24508,198,0.814,-120,318,51,775,C7
"Salem city, VA",2006-2007,24508,24482,-26,-0.106,-49,23,51,775,C7
"Salem city, VA",2007-2008,24482,24673,191,0.78,-38,229,51,775,C7
"Salem city, VA",2008-2009,24673,24684,11,0.045,-29,40,51,775,C7
"Salem city, VA",2009-2010,24684,24928,244,0.988,-31,275,51,775,C7
"Salem city, VA",2010-2011,24928,24854,-74,-0.297,-29,-45,51,775,C7
"Salem city, VA",2011-2012,24854,25053,199,0.801,-14,213,51,775,C7
"Salem city, VA",2012-2013,25053,25282,229,0.914,-7,236,51,775,C7
"Salem city, VA",2013-2014,25282,25483,201,0.795,6,195,51,775,C7
"Salem city, VA",2014-2015,25350,25432,82,0.323,-19,101,51,775,C7
"Salem city, VA",2015-2016,25432,25547,115,0.452,27,88,51,775,C7
"Salem city, VA",2016-2017,25547,25862,315,1.233,57,258,51,775,C7
"Staunton city, VA",2000-2001,23896,23734,-162,-0.678,-42,-120,51,790,C7
"Staunton city, VA",2001-2002,23734,23691,-43,-0.181,-71,28,51,790,C7
"Staunton city, VA",2002-2003,23691,23726,35,0.148,-20,55,51,790,C7
"Staunton city, VA",2003-2004,23726,23501,-225,-0.948,-47,-178,51,790,C7
"Staunton city, VA",2004-2005,23501,23603,102,0.434,-26,128,51,790,C7
"Staunton city, VA",2005-2006,23603,23638,35,0.148,-24,59,51,790,C7
"Staunton city, VA",2006-2007,23638,23920,282,1.193,-82,364,51,790,C7
"Staunton city, VA",2007-2008,23920,23945,25,0.105,7,18,51,790,C7
"Staunton city, VA",2008-2009,23945,23764,-181,-0.756,1,-182,51,790,C7
"Staunton city, VA",2009-2010,23764,23825,61,0.257,-8,69,51,790,C7
"Staunton city, VA",2010-2011,23825,24058,233,0.978,18,215,51,790,C7
"Staunton city, VA",2011-2012,24058,23921,-137,-0.569,-53,-84,51,790,C7
"Staunton city, VA",2012-2013,23921,24318,397,1.66,-32,429,51,790,C7
"Staunton city, VA",2013-2014,24318,24538,220,0.905,13,207,51,790,C7
"Staunton city, VA",2014-2015,24427,24416,-11,-0.045,19,-30,51,790,C7
"Staunton city, VA",2015-2016,24416,24257,-159,-0.651,39,-198,51,790,C7
"Staunton city, VA",2016-2017,24257,24528,271,1.117,53,218,51,790,C7
"Suffolk city, VA",2000-2001,64216,66448,2232,3.476,352,1880,51,800,C7
"Suffolk city, VA",2001-2002,66448,69274,2826,4.253,375,2451,51,800,C7
"Suffolk city, VA",2002-2003,69274,72721,3447,4.976,429,3018,51,800,C7
"Suffolk city, VA",2003-2004,72721,75725,3004,4.131,497,2507,51,800,C7
"Suffolk city, VA",2004-2005,75725,77957,2232,2.948,504,1728,51,800,C7
"Suffolk city, VA",2005-2006,77957,80291,2334,2.994,498,1836,51,800,C7
"Suffolk city, VA",2006-2007,80291,81273,982,1.223,537,445,51,800,C7
"Suffolk city, VA",2007-2008,81273,82603,1330,1.636,456,874,51,800,C7
"Suffolk city, VA",2008-2009,82603,83648,1045,1.265,466,579,51,800,C7
"Suffolk city, VA",2009-2010,83648,84881,1233,1.474,411,822,51,800,C7
"Suffolk city, VA",2010-2011,84881,84768,-113,-0.133,435,-548,51,800,C7
"Suffolk city, VA",2011-2012,84768,85183,415,0.49,400,15,51,800,C7
"Suffolk city, VA",2012-2013,85183,85749,566,0.664,349,217,51,800,C7
"Suffolk city, VA",2013-2014,85749,86806,1057,1.233,374,683,51,800,C7
"Suffolk city, VA",2014-2015,86944,88161,1217,1.4,379,838,51,800,C7
"Suffolk city, VA",2015-2016,88161,89294,1133,1.285,469,664,51,800,C7
"Suffolk city, VA",2016-2017,89294,90237,943,1.056,430,513,51,800,C7
"Virginia Beach city, VA",2000-2001,426918,428396,1478,0.346,3898,-2420,51,810,C7
"Virginia Beach city, VA",2001-2002,428396,430183,1787,0.417,3685,-1898,51,810,C7
"Virginia Beach city, VA",2002-2003,430183,431600,1417,0.329,3767,-2350,51,810,C7
"Virginia Beach city, VA",2003-2004,431600,437494,5894,1.366,4036,1858,51,810,C7
"Virginia Beach city, VA",2004-2005,437494,436210,-1284,-0.293,3784,-5068,51,810,C7
"Virginia Beach city, VA",2005-2006,436210,437739,1529,0.351,4024,-2495,51,810,C7
"Virginia Beach city, VA",2006-2007,437739,434732,-3007,-0.687,3963,-6970,51,810,C7
"Virginia Beach city, VA",2007-2008,434732,433331,-1401,-0.322,3722,-5123,51,810,C7
"Virginia Beach city, VA",2008-2009,433331,435004,1673,0.386,3558,-1885,51,810,C7
"Virginia Beach city, VA",2009-2010,435004,439073,4069,0.935,3773,296,51,810,C7
"Virginia Beach city, VA",2010-2011,439073,442984,3911,0.891,3449,462,51,810,C7
"Virginia Beach city, VA",2011-2012,442984,445769,2785,0.629,3529,-744,51,810,C7
"Virginia Beach city, VA",2012-2013,445769,449308,3539,0.794,3183,356,51,810,C7
"Virginia Beach city, VA",2013-2014,449308,450980,1672,0.372,3202,-1530,51,810,C7
"Virginia Beach city, VA",2014-2015,450879,452745,1866,0.414,2998,-1132,51,810,C7
"Virginia Beach city, VA",2015-2016,452745,451404,-1341,-0.296,2832,-4173,51,810,C7
"Virginia Beach city, VA",2016-2017,451404,450435,-969,-0.215,2655,-3624,51,810,C7
"Waynesboro city, VA",2000-2001,19661,19744,83,0.422,29,54,51,820,C7
"Waynesboro city, VA",2001-2002,19744,20010,266,1.347,13,253,51,820,C7
"Waynesboro city, VA",2002-2003,20010,20163,153,0.765,66,87,51,820,C7
"Waynesboro city, VA",2003-2004,20163,20351,188,0.932,105,83,51,820,C7
"Waynesboro city, VA",2004-2005,20351,20533,182,0.894,72,110,51,820,C7
"Waynesboro city, VA",2005-2006,20533,20728,195,0.95,38,157,51,820,C7
"Waynesboro city, VA",2006-2007,20728,20747,19,0.092,11,8,51,820,C7
"Waynesboro city, VA",2007-2008,20747,20920,173,0.834,128,45,51,820,C7
"Waynesboro city, VA",2008-2009,20920,20985,65,0.311,81,-16,51,820,C7
"Waynesboro city, VA",2009-2010,20985,21068,83,0.396,95,-12,51,820,C7
"Waynesboro city, VA",2010-2011,21068,21094,26,0.123,94,-68,51,820,C7
"Waynesboro city, VA",2011-2012,21094,21105,11,0.052,94,-83,51,820,C7
"Waynesboro city, VA",2012-2013,21105,21250,145,0.687,82,63,51,820,C7
"Waynesboro city, VA",2013-2014,21250,21366,116,0.546,99,17,51,820,C7
"Waynesboro city, VA",2014-2015,21186,21491,305,1.44,122,183,51,820,C7
"Waynesboro city, VA",2015-2016,21491,21802,311,1.447,149,162,51,820,C7
"Waynesboro city, VA",2016-2017,21802,22327,525,2.408,132,393,51,820,C7
"Williamsburg city, VA",2000-2001,12012,12024,12,0.1,-57,69,51,830,C7
"Williamsburg city, VA",2001-2002,12024,11829,-195,-1.622,-40,-155,51,830,C7
"Williamsburg city, VA",2002-2003,11829,11796,-33,-0.279,44,-77,51,830,C7
"Williamsburg city, VA",2003-2004,11796,11986,190,1.611,67,123,51,830,C7
"Williamsburg city, VA",2004-2005,11986,12400,414,3.454,85,329,51,830,C7
"Williamsburg city, VA",2005-2006,12400,12810,410,3.306,119,291,51,830,C7
"Williamsburg city, VA",2006-2007,12810,13142,332,2.592,73,259,51,830,C7
"Williamsburg city, VA",2007-2008,13142,13296,154,1.172,82,72,51,830,C7
"Williamsburg city, VA",2008-2009,13296,13687,391,2.941,95,296,51,830,C7
"Williamsburg city, VA",2009-2010,13687,13689,2,0.015,55,-53,51,830,C7
"Williamsburg city, VA",2010-2011,13689,14262,573,4.186,-19,592,51,830,C7
"Williamsburg city, VA",2011-2012,14262,14617,355,2.489,-15,370,51,830,C7
"Williamsburg city, VA",2012-2013,14617,14745,128,0.876,-28,156,51,830,C7
"Williamsburg city, VA",2013-2014,14745,14691,-54,-0.366,-20,-34,51,830,C7
"Williamsburg city, VA",2014-2015,14837,15052,215,1.449,-21,236,51,830,C7
"Williamsburg city, VA",2015-2016,15052,14952,-100,-0.664,28,-128,51,830,C7
"Williamsburg city, VA",2016-2017,14952,15031,79,0.528,-15,94,51,830,C7
"Winchester city, VA",2000-2001,23699,24224,525,2.215,82,443,51,840,C7
"Winchester city, VA",2001-2002,24224,24602,378,1.56,128,250,51,840,C7
"Winchester city, VA",2002-2003,24602,24649,47,0.191,84,-37,51,840,C7
"Winchester city, VA",2003-2004,24649,25175,526,2.134,194,332,51,840,C7
"Winchester city, VA",2004-2005,25175,25565,390,1.549,194,196,51,840,C7
"Winchester city, VA",2005-2006,25565,25757,192,0.751,134,58,51,840,C7
"Winchester city, VA",2006-2007,25757,25701,-56,-0.217,214,-270,51,840,C7
"Winchester city, VA",2007-2008,25701,26004,303,1.179,192,111,51,840,C7
"Winchester city, VA",2008-2009,26004,26036,32,0.123,150,-118,51,840,C7
"Winchester city, VA",2009-2010,26036,26183,147,0.565,130,17,51,840,C7
"Winchester city, VA",2010-2011,26183,26756,573,2.188,186,387,51,840,C7
"Winchester city, VA",2011-2012,26756,27178,422,1.577,123,299,51,840,C7
"Winchester city, VA",2012-2013,27178,27497,319,1.174,123,196,51,840,C7
"Winchester city, VA",2013-2014,27497,27543,46,0.167,120,-74,51,840,C7
"Winchester city, VA",2014-2015,27383,27284,-99,-0.362,89,-188,51,840,C7
"Winchester city, VA",2015-2016,27284,27566,282,1.034,105,177,51,840,C7
"Winchester city, VA",2016-2017,27566,27932,366,1.328,97,269,51,840,C7